fips,month,labor_force,employed,unemployed,unemployment_rate
01001,2019-12-01,26127,25513,614,2.4
01003,2019-12-01,95993,93689,2304,2.4
01005,2019-12-01,8624,8349,275,3.2
01007,2019-12-01,8752,8534,218,2.5
01009,2019-12-01,25508,24930,578,2.3
01011,2019-12-01,4757,4588,169,3.6
01013,2019-12-01,9225,8906,319,3.5
01015,2019-12-01,46320,44930,1390,3
01017,2019-12-01,15830,15449,381,2.4
01019,2019-12-01,11486,11201,285,2.5
01021,2019-12-01,19958,19498,460,2.3
01023,2019-12-01,4603,4407,196,4.3
01025,2019-12-01,7496,7089,407,5.4
01027,2019-12-01,6105,5942,163,2.7
01029,2019-12-01,5821,5664,157,2.7
01031,2019-12-01,21198,20692,506,2.4
01033,2019-12-01,23527,22739,788,3.3
01035,2019-12-01,4483,4329,154,3.4
01037,2019-12-01,4525,4416,109,2.4
01039,2019-12-01,15532,15073,459,3
01041,2019-12-01,6350,6201,149,2.3
01043,2019-12-01,38760,37929,831,2.1
01045,2019-12-01,20648,20126,522,2.5
01047,2019-12-01,14546,13915,631,4.3
01049,2019-12-01,30958,30235,723,2.3
01051,2019-12-01,37543,36694,849,2.3
01053,2019-12-01,14787,14334,453,3.1
01055,2019-12-01,42804,41591,1213,2.8
01057,2019-12-01,6551,6378,173,2.6
01059,2019-12-01,14712,14364,348,2.4
01061,2019-12-01,10983,10716,267,2.4
01063,2019-12-01,2864,2727,137,4.8
01065,2019-12-01,6111,5907,204,3.3
01067,2019-12-01,6915,6717,198,2.9
01069,2019-12-01,46329,45167,1162,2.5
01071,2019-12-01,23229,22548,681,2.9
01073,2019-12-01,321910,314357,7553,2.3
01075,2019-12-01,5846,5691,155,2.7
01077,2019-12-01,42304,41101,1203,2.8
01079,2019-12-01,14317,13940,377,2.6
01081,2019-12-01,77615,75898,1717,2.2
01083,2019-12-01,43962,43003,959,2.2
01085,2019-12-01,3557,3384,173,4.9
01087,2019-12-01,7880,7595,285,3.6
01089,2019-12-01,185936,182025,3911,2.1
01091,2019-12-01,7617,7388,229,3
01093,2019-12-01,12854,12476,378,2.9
01095,2019-12-01,43945,43046,899,2
01097,2019-12-01,189207,183131,6076,3.2
01099,2019-12-01,7367,7041,326,4.4
01101,2019-12-01,105682,102896,2786,2.6
01103,2019-12-01,58527,57250,1277,2.2
01105,2019-12-01,3379,3245,134,4
01107,2019-12-01,7939,7728,211,2.7
01109,2019-12-01,15461,15024,437,2.8
01111,2019-12-01,9646,9409,237,2.5
01113,2019-12-01,23875,23273,602,2.5
01115,2019-12-01,40911,39994,917,2.2
01117,2019-12-01,117216,115105,2111,1.8
01119,2019-12-01,4874,4688,186,3.8
01121,2019-12-01,35719,34675,1044,2.9
01123,2019-12-01,18548,18089,459,2.5
01125,2019-12-01,106133,103785,2348,2.2
01127,2019-12-01,25553,24838,715,2.8
01129,2019-12-01,6818,6514,304,4.5
01131,2019-12-01,2740,2560,180,6.6
01133,2019-12-01,10080,9778,302,3
02013,2019-12-01,1137,1055,82,7.2
02016,2019-12-01,2521,2370,151,6
02020,2019-12-01,147801,140718,7083,4.8
02050,2019-12-01,7158,6368,790,11
02060,2019-12-01,234,205,29,12.4
02068,2019-12-01,581,466,115,19.8
02070,2019-12-01,1584,1452,132,8.3
02090,2019-12-01,44329,41985,2344,5.3
02100,2019-12-01,979,840,139,14.2
02105,2019-12-01,968,827,141,14.6
02110,2019-12-01,16284,15572,712,4.4
02122,2019-12-01,25535,23643,1892,7.4
02130,2019-12-01,6518,6086,432,6.6
02150,2019-12-01,5405,4891,514,9.5
02158,2019-12-01,2644,2210,434,16.4
02164,2019-12-01,573,517,56,9.8
02170,2019-12-01,47235,44078,3157,6.7
02180,2019-12-01,4178,3802,376,9
02185,2019-12-01,3538,3338,200,5.7
02188,2019-12-01,3058,2673,385,12.6
02195,2019-12-01,1317,1206,111,8.4
02198,2019-12-01,2750,2510,240,8.7
02220,2019-12-01,4038,3851,187,4.6
02230,2019-12-01,627,504,123,19.6
02240,2019-12-01,2798,2547,251,9
02261,2019-12-01,4236,3831,405,9.6
02275,2019-12-01,979,897,82,8.4
02282,2019-12-01,231,208,23,10
02290,2019-12-01,2432,2153,279,11.5
04001,2019-12-01,20475,18461,2014,9.8
04003,2019-12-01,51388,48698,2690,5.2
04005,2019-12-01,77257,73032,4225,5.5
04007,2019-12-01,21538,20445,1093,5.1
04009,2019-12-01,15713,15023,690,4.4
04011,2019-12-01,4536,4385,151,3.3
04012,2019-12-01,9661,9151,510,5.3
04013,2019-12-01,NA,NA,84040,3.6
04015,2019-12-01,88387,83680,4707,5.3
04017,2019-12-01,40889,38046,2843,7
04019,2019-12-01,504172,483909,20263,4
04021,2019-12-01,192051,183536,8515,4.4
04023,2019-12-01,19943,18404,1539,7.7
04025,2019-12-01,107107,102814,4293,4
04027,2019-12-01,101964,87383,14581,14.3
05001,2019-12-01,9419,9136,283,3
05003,2019-12-01,7585,7158,427,5.6
05005,2019-12-01,16140,15523,617,3.8
05007,2019-12-01,137770,134463,3307,2.4
05009,2019-12-01,15960,15475,485,3
05011,2019-12-01,4489,4332,157,3.5
05013,2019-12-01,2441,2345,96,3.9
05015,2019-12-01,12565,12203,362,2.9
05017,2019-12-01,3259,3041,218,6.7
05019,2019-12-01,9756,9415,341,3.5
05021,2019-12-01,5625,5341,284,5
05023,2019-12-01,9065,8638,427,4.7
05025,2019-12-01,3208,3081,127,4
05027,2019-12-01,9151,8784,367,4
05029,2019-12-01,8284,7951,333,4
05031,2019-12-01,55922,54519,1403,2.5
05033,2019-12-01,26734,25922,812,3
05035,2019-12-01,21355,20548,807,3.8
05037,2019-12-01,7395,7091,304,4.1
05039,2019-12-01,2826,2703,123,4.4
05041,2019-12-01,5382,5147,235,4.4
05043,2019-12-01,7936,7548,388,4.9
05045,2019-12-01,61703,59931,1772,2.9
05047,2019-12-01,7417,7179,238,3.2
05049,2019-12-01,4931,4758,173,3.5
05051,2019-12-01,40408,39008,1400,3.5
05053,2019-12-01,8323,8072,251,3
05055,2019-12-01,19978,19316,662,3.3
05057,2019-12-01,9825,9467,358,3.6
05059,2019-12-01,13898,13445,453,3.3
05061,2019-12-01,5743,5545,198,3.4
05063,2019-12-01,16555,15937,618,3.7
05065,2019-12-01,4900,4612,288,5.9
05067,2019-12-01,5871,5464,407,6.9
05069,2019-12-01,27477,26032,1445,5.3
05071,2019-12-01,10216,9824,392,3.8
05073,2019-12-01,2439,2343,96,3.9
05075,2019-12-01,6835,6560,275,4
05077,2019-12-01,2838,2707,131,4.6
05079,2019-12-01,3932,3766,166,4.2
05081,2019-12-01,5523,5297,226,4.1
05083,2019-12-01,8551,8167,384,4.5
05085,2019-12-01,34203,33076,1127,3.3
05087,2019-12-01,7481,7313,168,2.2
05089,2019-12-01,6579,6321,258,3.9
05091,2019-12-01,19724,18982,742,3.8
05093,2019-12-01,17257,16421,836,4.8
05095,2019-12-01,2747,2622,125,4.6
05097,2019-12-01,2891,2762,129,4.5
05099,2019-12-01,3600,3471,129,3.6
05101,2019-12-01,3325,3213,112,3.4
05103,2019-12-01,9774,9292,482,4.9
05105,2019-12-01,4215,4063,152,3.6
05107,2019-12-01,6329,5938,391,6.2
05109,2019-12-01,4227,4066,161,3.8
05111,2019-12-01,10386,10037,349,3.4
05113,2019-12-01,8162,7803,359,4.4
05115,2019-12-01,28903,27693,1210,4.2
05117,2019-12-01,3599,3442,157,4.4
05119,2019-12-01,188032,181818,6214,3.3
05121,2019-12-01,7363,7071,292,4
05123,2019-12-01,8095,7716,379,4.7
05125,2019-12-01,58378,56834,1544,2.6
05127,2019-12-01,4320,4176,144,3.3
05129,2019-12-01,2819,2674,145,5.1
05131,2019-12-01,56319,54555,1764,3.1
05133,2019-12-01,5528,5270,258,4.7
05135,2019-12-01,5670,5387,283,5
05137,2019-12-01,4613,4402,211,4.6
05139,2019-12-01,15788,14947,841,5.3
05141,2019-12-01,5636,5353,283,5
05143,2019-12-01,125398,122658,2740,2.2
05145,2019-12-01,33765,32279,1486,4.4
05147,2019-12-01,2773,2634,139,5
05149,2019-12-01,8418,8135,283,3.4
06001,2019-12-01,845181,823865,21316,2.5
06003,2019-12-01,608,585,23,3.8
06005,2019-12-01,14803,14263,540,3.6
06007,2019-12-01,98635,94342,4293,4.4
06009,2019-12-01,21678,20943,735,3.4
06011,2019-12-01,10507,9014,1493,14.2
06013,2019-12-01,562014,547030,14984,2.7
06015,2019-12-01,9552,9006,546,5.7
06017,2019-12-01,92267,89444,2823,3.1
06019,2019-12-01,449548,418389,31159,6.9
06021,2019-12-01,12957,12261,696,5.4
06023,2019-12-01,62522,60597,1925,3.1
06025,2019-12-01,71883,59622,12261,17.1
06027,2019-12-01,8662,8395,267,3.1
06029,2019-12-01,389804,362153,27651,7.1
06031,2019-12-01,57722,53282,4440,7.7
06033,2019-12-01,28784,27317,1467,5.1
06035,2019-12-01,9674,9277,397,4.1
06037,2019-12-01,NA,NA,224411,4.3
06039,2019-12-01,61963,57803,4160,6.7
06041,2019-12-01,140629,137879,2750,2
06043,2019-12-01,7124,6808,316,4.4
06045,2019-12-01,38382,36948,1434,3.7
06047,2019-12-01,114943,105874,9069,7.9
06049,2019-12-01,3033,2818,215,7.1
06051,2019-12-01,8734,8450,284,3.3
06053,2019-12-01,210947,195663,15284,7.2
06055,2019-12-01,71939,69883,2056,2.9
06057,2019-12-01,48863,47443,1420,2.9
06059,2019-12-01,NA,NA,39118,2.4
06061,2019-12-01,188635,183581,5054,2.7
06063,2019-12-01,7512,6932,580,7.7
06065,2019-12-01,NA,NA,40572,3.6
06067,2019-12-01,714835,691943,22892,3.2
06069,2019-12-01,31303,29775,1528,4.9
06071,2019-12-01,975489,943280,32209,3.3
06073,2019-12-01,NA,NA,44242,2.8
06075,2019-12-01,589286,578146,11140,1.9
06077,2019-12-01,325993,307645,18348,5.6
06079,2019-12-01,139351,135817,3534,2.5
06081,2019-12-01,464779,456645,8134,1.8
06083,2019-12-01,214976,207294,7682,3.6
06085,2019-12-01,NA,NA,23028,2.2
06087,2019-12-01,139049,132443,6606,4.8
06089,2019-12-01,74102,71028,3074,4.1
06091,2019-12-01,1322,1262,60,4.5
06093,2019-12-01,16852,15784,1068,6.3
06095,2019-12-01,209564,202607,6957,3.3
06097,2019-12-01,259689,253575,6114,2.4
06099,2019-12-01,242518,229013,13505,5.6
06101,2019-12-01,46236,42929,3307,7.2
06103,2019-12-01,25386,24148,1238,4.9
06105,2019-12-01,4474,4239,235,5.3
06107,2019-12-01,202541,183652,18889,9.3
06109,2019-12-01,21469,20635,834,3.9
06111,2019-12-01,424525,410292,14233,3.4
06113,2019-12-01,108879,104652,4227,3.9
06115,2019-12-01,30800,29092,1708,5.5
08001,2019-12-01,277770,270813,6957,2.5
08003,2019-12-01,8932,8656,276,3.1
08005,2019-12-01,370624,362076,8548,2.3
08007,2019-12-01,6783,6600,183,2.7
08009,2019-12-01,2285,2255,30,1.3
08011,2019-12-01,2025,1981,44,2.2
08013,2019-12-01,197746,193839,3907,2
08014,2019-12-01,40845,40001,844,2.1
08015,2019-12-01,9651,9447,204,2.1
08017,2019-12-01,1274,1257,17,1.3
08019,2019-12-01,6135,6016,119,1.9
08021,2019-12-01,4327,4194,133,3.1
08023,2019-12-01,1927,1864,63,3.3
08025,2019-12-01,1534,1480,54,3.5
08027,2019-12-01,2110,2054,56,2.7
08029,2019-12-01,14730,14296,434,2.9
08031,2019-12-01,423917,414090,9827,2.3
08033,2019-12-01,1210,1180,30,2.5
08035,2019-12-01,197525,193632,3893,2
08037,2019-12-01,38840,38137,703,1.8
08039,2019-12-01,15602,15321,281,1.8
08041,2019-12-01,343832,334234,9598,2.8
08043,2019-12-01,14865,14274,591,4
08045,2019-12-01,33835,33012,823,2.4
08047,2019-12-01,3834,3761,73,1.9
08049,2019-12-01,10483,10302,181,1.7
08051,2019-12-01,12000,11774,226,1.9
08053,2019-12-01,389,375,14,3.6
08055,2019-12-01,2545,2416,129,5.1
08057,2019-12-01,1050,1031,19,1.8
08059,2019-12-01,340652,333266,7386,2.2
08061,2019-12-01,1059,1048,11,1
08063,2019-12-01,4562,4496,66,1.4
08065,2019-12-01,5265,5181,84,1.6
08067,2019-12-01,32030,31343,687,2.1
08069,2019-12-01,209156,205003,4153,2
08071,2019-12-01,6714,6491,223,3.3
08073,2019-12-01,2467,2411,56,2.3
08075,2019-12-01,11355,11139,216,1.9
08077,2019-12-01,76241,73867,2374,3.1
08079,2019-12-01,557,546,11,2
08081,2019-12-01,7431,7192,239,3.2
08083,2019-12-01,12866,12346,520,4
08085,2019-12-01,22175,21614,561,2.5
08087,2019-12-01,16949,16573,376,2.2
08089,2019-12-01,8631,8344,287,3.3
08091,2019-12-01,2355,2278,77,3.3
08093,2019-12-01,11316,11077,239,2.1
08095,2019-12-01,2810,2776,34,1.2
08097,2019-12-01,11629,11300,329,2.8
08099,2019-12-01,6667,6534,133,2
08101,2019-12-01,76594,73860,2734,3.6
08103,2019-12-01,3009,2922,87,2.9
08105,2019-12-01,5738,5505,233,4.1
08107,2019-12-01,17200,16903,297,1.7
08109,2019-12-01,3808,3668,140,3.7
08111,2019-12-01,507,488,19,3.7
08113,2019-12-01,6448,6284,164,2.5
08115,2019-12-01,1318,1297,21,1.6
08117,2019-12-01,25565,25224,341,1.3
08119,2019-12-01,12771,12447,324,2.5
08121,2019-12-01,3061,3010,51,1.7
08123,2019-12-01,172545,168655,3890,2.3
08125,2019-12-01,6394,6313,81,1.3
09001,2019-12-01,482315,467277,15038,3.1
09003,2019-12-01,485242,468918,16324,3.4
09005,2019-12-01,105362,102206,3156,3
09007,2019-12-01,94284,91661,2623,2.8
09009,2019-12-01,464244,448627,15617,3.4
09011,2019-12-01,136738,132425,4313,3.2
09013,2019-12-01,87519,85012,2507,2.9
09015,2019-12-01,64500,62238,2262,3.5
10001,2019-12-01,80327,77341,2986,3.7
10003,2019-12-01,301422,291335,10087,3.3
10005,2019-12-01,106540,102313,4227,4
11001,2019-12-01,416329,397389,18940,4.5
12001,2019-12-01,140376,136953,3423,2.4
12003,2019-12-01,12010,11692,318,2.6
12005,2019-12-01,81471,79066,2405,3
12007,2019-12-01,11192,10898,294,2.6
12009,2019-12-01,285212,277466,7746,2.7
12011,2019-12-01,NA,NA,26811,2.6
12013,2019-12-01,4737,4582,155,3.3
12015,2019-12-01,72814,70598,2216,3
12017,2019-12-01,46961,45017,1944,4.1
12019,2019-12-01,109095,106332,2763,2.5
12021,2019-12-01,184631,179927,4704,2.5
12023,2019-12-01,30325,29525,800,2.6
12027,2019-12-01,14711,14271,440,3
12029,2019-12-01,5872,5667,205,3.5
12031,2019-12-01,497767,484351,13416,2.7
12033,2019-12-01,145900,141872,4028,2.8
12035,2019-12-01,47053,45498,1555,3.3
12037,2019-12-01,4468,4348,120,2.7
12039,2019-12-01,18795,18152,643,3.4
12041,2019-12-01,7195,6987,208,2.9
12043,2019-12-01,5479,5296,183,3.3
12045,2019-12-01,5561,5366,195,3.5
12047,2019-12-01,4214,4058,156,3.7
12049,2019-12-01,8950,8596,354,4
12051,2019-12-01,15933,15173,760,4.8
12053,2019-12-01,72300,69714,2586,3.6
12055,2019-12-01,36638,35223,1415,3.9
12057,2019-12-01,757213,737843,19370,2.6
12059,2019-12-01,7006,6796,210,3
12061,2019-12-01,66150,64044,2106,3.2
12063,2019-12-01,17114,16586,528,3.1
12065,2019-12-01,5643,5488,155,2.7
12067,2019-12-01,2824,2754,70,2.5
12069,2019-12-01,160371,155998,4373,2.7
12071,2019-12-01,353248,344074,9174,2.6
12073,2019-12-01,155941,151948,3993,2.6
12075,2019-12-01,16706,16208,498,3
12077,2019-12-01,2630,2551,79,3
12079,2019-12-01,7497,7255,242,3.2
12081,2019-12-01,181336,176542,4794,2.6
12083,2019-12-01,137663,133193,4470,3.2
12085,2019-12-01,74393,72437,1956,2.6
12086,2019-12-01,NA,NA,23646,1.7
12087,2019-12-01,47857,47029,828,1.7
12089,2019-12-01,41728,40684,1044,2.5
12091,2019-12-01,94702,92494,2208,2.3
12093,2019-12-01,18123,17629,494,2.7
12095,2019-12-01,768745,750030,18715,2.4
12097,2019-12-01,185651,180524,5127,2.8
12099,2019-12-01,735236,715236,20000,2.7
12101,2019-12-01,239444,232367,7077,3
12103,2019-12-01,497735,485209,12526,2.5
12105,2019-12-01,308057,298597,9460,3.1
12107,2019-12-01,26496,25501,995,3.8
12109,2019-12-01,134084,131113,2971,2.2
12111,2019-12-01,145449,140635,4814,3.3
12113,2019-12-01,82991,80886,2105,2.5
12115,2019-12-01,190002,185038,4964,2.6
12117,2019-12-01,257406,251096,6310,2.5
12119,2019-12-01,32789,31500,1289,3.9
12121,2019-12-01,18033,17496,537,3
12123,2019-12-01,8182,7937,245,3
12125,2019-12-01,4660,4540,120,2.6
12127,2019-12-01,254308,246741,7567,3
12129,2019-12-01,14993,14624,369,2.5
12131,2019-12-01,30850,30062,788,2.6
12133,2019-12-01,9598,9320,278,2.9
13001,2019-12-01,9422,9102,320,3.4
13003,2019-12-01,4672,4546,126,2.7
13005,2019-12-01,4854,4677,177,3.6
13007,2019-12-01,1154,1107,47,4.1
13009,2019-12-01,17417,16761,656,3.8
13011,2019-12-01,9702,9483,219,2.3
13013,2019-12-01,40948,40004,944,2.3
13015,2019-12-01,51416,49804,1612,3.1
13017,2019-12-01,5308,5016,292,5.5
13019,2019-12-01,7499,7167,332,4.4
13021,2019-12-01,67979,65861,2118,3.1
13023,2019-12-01,4445,4275,170,3.8
13025,2019-12-01,7150,6896,254,3.6
13027,2019-12-01,6848,6647,201,2.9
13029,2019-12-01,18160,17703,457,2.5
13031,2019-12-01,36161,35042,1119,3.1
13033,2019-12-01,9120,8738,382,4.2
13035,2019-12-01,10870,10575,295,2.7
13037,2019-12-01,2257,2192,65,2.9
13039,2019-12-01,20829,20206,623,3
13043,2019-12-01,5569,5401,168,3
13045,2019-12-01,55806,54244,1562,2.8
13047,2019-12-01,33665,32764,901,2.7
13049,2019-12-01,4801,4655,146,3
13051,2019-12-01,138786,134914,3872,2.8
13053,2019-12-01,1984,1912,72,3.6
13055,2019-12-01,11134,9775,1359,12.2
13057,2019-12-01,137554,134474,3080,2.2
13059,2019-12-01,59225,57596,1629,2.8
13061,2019-12-01,868,811,57,6.6
13063,2019-12-01,139417,134601,4816,3.5
13065,2019-12-01,2508,2420,88,3.5
13067,2019-12-01,430626,420158,10468,2.4
13069,2019-12-01,18949,18142,807,4.3
13071,2019-12-01,21063,20496,567,2.7
13073,2019-12-01,75115,73255,1860,2.5
13075,2019-12-01,8013,7747,266,3.3
13077,2019-12-01,75623,73793,1830,2.4
13079,2019-12-01,5600,5442,158,2.8
13081,2019-12-01,9382,9073,309,3.3
13083,2019-12-01,8166,7935,231,2.8
13085,2019-12-01,12437,12142,295,2.4
13087,2019-12-01,11444,11076,368,3.2
13089,2019-12-01,404537,393076,11461,2.8
13091,2019-12-01,6961,6635,326,4.7
13093,2019-12-01,5096,4929,167,3.3
13095,2019-12-01,38552,37006,1546,4
13097,2019-12-01,74144,71971,2173,2.9
13099,2019-12-01,4439,4278,161,3.6
13101,2019-12-01,1896,1851,45,2.4
13103,2019-12-01,30746,29992,754,2.5
13105,2019-12-01,7646,7371,275,3.6
13107,2019-12-01,8257,7875,382,4.6
13109,2019-12-01,4858,4722,136,2.8
13111,2019-12-01,11376,11050,326,2.9
13113,2019-12-01,58750,57354,1396,2.4
13115,2019-12-01,44694,43021,1673,3.7
13117,2019-12-01,123634,120927,2707,2.2
13119,2019-12-01,9816,9509,307,3.1
13121,2019-12-01,563666,547729,15937,2.8
13123,2019-12-01,11758,11402,356,3
13125,2019-12-01,1264,1228,36,2.8
13127,2019-12-01,39063,37982,1081,2.8
13129,2019-12-01,28137,27165,972,3.5
13131,2019-12-01,10303,10006,297,2.9
13133,2019-12-01,6890,6649,241,3.5
13135,2019-12-01,495462,483334,12128,2.4
13137,2019-12-01,19026,18459,567,3
13139,2019-12-01,102925,100611,2314,2.2
13141,2019-12-01,2449,2313,136,5.6
13143,2019-12-01,12703,12345,358,2.8
13145,2019-12-01,16592,16158,434,2.6
13147,2019-12-01,10884,10551,333,3.1
13149,2019-12-01,5307,5159,148,2.8
13151,2019-12-01,117073,113759,3314,2.8
13153,2019-12-01,70424,68512,1912,2.7
13155,2019-12-01,3334,3188,146,4.4
13157,2019-12-01,37500,36704,796,2.1
13159,2019-12-01,7008,6831,177,2.5
13161,2019-12-01,5973,5710,263,4.4
13163,2019-12-01,6596,6320,276,4.2
13165,2019-12-01,3101,2959,142,4.6
13167,2019-12-01,3982,3859,123,3.1
13169,2019-12-01,13728,13361,367,2.7
13171,2019-12-01,8310,8044,266,3.2
13173,2019-12-01,3752,3615,137,3.7
13175,2019-12-01,18927,18142,785,4.1
13177,2019-12-01,14839,14453,386,2.6
13179,2019-12-01,26311,25475,836,3.2
13181,2019-12-01,3541,3425,116,3.3
13183,2019-12-01,8153,7913,240,2.9
13185,2019-12-01,51301,49779,1522,3
13187,2019-12-01,16774,16367,407,2.4
13189,2019-12-01,8862,8460,402,4.5
13191,2019-12-01,6104,5924,180,2.9
13193,2019-12-01,4634,4457,177,3.8
13195,2019-12-01,13319,12973,346,2.6
13197,2019-12-01,3276,3162,114,3.5
13199,2019-12-01,8983,8637,346,3.9
13201,2019-12-01,2718,2640,78,2.9
13205,2019-12-01,8505,8136,369,4.3
13207,2019-12-01,13010,12649,361,2.8
13209,2019-12-01,3753,3601,152,4.1
13211,2019-12-01,9300,9055,245,2.6
13213,2019-12-01,15586,14690,896,5.7
13215,2019-12-01,77054,74185,2869,3.7
13217,2019-12-01,52789,51135,1654,3.1
13219,2019-12-01,19550,19158,392,2
13221,2019-12-01,6938,6756,182,2.6
13223,2019-12-01,87146,85027,2119,2.4
13225,2019-12-01,11750,11377,373,3.2
13227,2019-12-01,15488,15098,390,2.5
13229,2019-12-01,8651,8400,251,2.9
13231,2019-12-01,8998,8768,230,2.6
13233,2019-12-01,18485,17893,592,3.2
13235,2019-12-01,4027,3904,123,3.1
13237,2019-12-01,8164,7870,294,3.6
13239,2019-12-01,788,754,34,4.3
13241,2019-12-01,6917,6706,211,3.1
13243,2019-12-01,2510,2409,101,4
13245,2019-12-01,84980,81874,3106,3.7
13247,2019-12-01,45285,43871,1414,3.1
13249,2019-12-01,2211,2143,68,3.1
13251,2019-12-01,5069,4777,292,5.8
13253,2019-12-01,2977,2858,119,4
13255,2019-12-01,28981,28038,943,3.3
13257,2019-12-01,10570,10201,369,3.5
13259,2019-12-01,2399,2321,78,3.3
13261,2019-12-01,12794,12252,542,4.2
13263,2019-12-01,2800,2694,106,3.8
13265,2019-12-01,557,531,26,4.7
13267,2019-12-01,9458,9149,309,3.3
13269,2019-12-01,3149,3046,103,3.3
13271,2019-12-01,3923,3567,356,9.1
13273,2019-12-01,3512,3371,141,4
13275,2019-12-01,16236,15684,552,3.4
13277,2019-12-01,19830,19256,574,2.9
13279,2019-12-01,11466,11040,426,3.7
13281,2019-12-01,3741,3586,155,4.1
13283,2019-12-01,2546,2439,107,4.2
13285,2019-12-01,37460,36485,975,2.6
13287,2019-12-01,3130,3014,116,3.7
13289,2019-12-01,2893,2755,138,4.8
13291,2019-12-01,10194,9921,273,2.7
13293,2019-12-01,11352,11011,341,3
13295,2019-12-01,31857,30458,1399,4.4
13297,2019-12-01,46620,45460,1160,2.5
13299,2019-12-01,15528,15004,524,3.4
13301,2019-12-01,2880,2762,118,4.1
13303,2019-12-01,6963,6703,260,3.7
13305,2019-12-01,11199,10832,367,3.3
13307,2019-12-01,1015,977,38,3.7
13309,2019-12-01,1583,1466,117,7.4
13311,2019-12-01,16390,16036,354,2.2
13313,2019-12-01,43562,41576,1986,4.6
13315,2019-12-01,2651,2547,104,3.9
13317,2019-12-01,3775,3595,180,4.8
13319,2019-12-01,3980,3848,132,3.3
13321,2019-12-01,8942,8644,298,3.3
15001,2019-12-01,91694,89111,2583,2.8
15003,2019-12-01,452859,443191,9668,2.1
15007,2019-12-01,36383,35522,861,2.4
15009,2019-12-01,86389,84519,1870,2.2
16001,2019-12-01,258737,252619,6118,2.4
16003,2019-12-01,1666,1567,99,5.9
16005,2019-12-01,43565,42373,1192,2.7
16007,2019-12-01,2896,2809,87,3
16009,2019-12-01,4061,3885,176,4.3
16011,2019-12-01,23300,22656,644,2.8
16013,2019-12-01,12529,12204,325,2.6
16015,2019-12-01,3579,3426,153,4.3
16017,2019-12-01,20186,19342,844,4.2
16019,2019-12-01,58135,56792,1343,2.3
16021,2019-12-01,5245,5026,219,4.2
16023,2019-12-01,1402,1362,40,2.9
16025,2019-12-01,679,661,18,2.7
16027,2019-12-01,105319,102076,3243,3.1
16029,2019-12-01,4106,3982,124,3
16031,2019-12-01,12103,11813,290,2.4
16033,2019-12-01,373,357,16,4.3
16035,2019-12-01,2801,2659,142,5.1
16037,2019-12-01,2039,1944,95,4.7
16039,2019-12-01,11388,11050,338,3
16041,2019-12-01,7132,6973,159,2.2
16043,2019-12-01,7922,7726,196,2.5
16045,2019-12-01,8413,8123,290,3.4
16047,2019-12-01,8225,7983,242,2.9
16049,2019-12-01,6394,6104,290,4.5
16051,2019-12-01,14200,13876,324,2.3
16053,2019-12-01,12178,11844,334,2.7
16055,2019-12-01,80167,77136,3031,3.8
16057,2019-12-01,20965,20482,483,2.3
16059,2019-12-01,3464,3269,195,5.6
16061,2019-12-01,1583,1493,90,5.7
16063,2019-12-01,2694,2583,111,4.1
16065,2019-12-01,22167,21805,362,1.6
16067,2019-12-01,11276,10969,307,2.7
16069,2019-12-01,21307,20694,613,2.9
16071,2019-12-01,2301,2248,53,2.3
16073,2019-12-01,5182,4987,195,3.8
16075,2019-12-01,11615,11220,395,3.4
16077,2019-12-01,3860,3701,159,4.1
16079,2019-12-01,5141,4818,323,6.3
16081,2019-12-01,6416,6275,141,2.2
16083,2019-12-01,41686,40509,1177,2.8
16085,2019-12-01,5453,5231,222,4.1
16087,2019-12-01,4605,4430,175,3.8
17001,2019-12-01,31943,30931,1012,3.2
17003,2019-12-01,2050,1934,116,5.7
17005,2019-12-01,7710,7437,273,3.5
17007,2019-12-01,25982,24416,1566,6
17009,2019-12-01,2969,2903,66,2.2
17011,2019-12-01,16970,16097,873,5.1
17013,2019-12-01,2308,2200,108,4.7
17015,2019-12-01,7233,6912,321,4.4
17017,2019-12-01,5980,5748,232,3.9
17019,2019-12-01,111809,108287,3522,3.2
17021,2019-12-01,14216,13521,695,4.9
17023,2019-12-01,7600,7257,343,4.5
17025,2019-12-01,6370,6103,267,4.2
17027,2019-12-01,20291,19729,562,2.8
17029,2019-12-01,23947,23128,819,3.4
17031,2019-12-01,NA,NA,75565,2.9
17033,2019-12-01,8597,8229,368,4.3
17035,2019-12-01,6100,5902,198,3.2
17037,2019-12-01,54976,52852,2124,3.9
17039,2019-12-01,7358,7074,284,3.9
17041,2019-12-01,10257,9943,314,3.1
17043,2019-12-01,502257,491173,11084,2.2
17045,2019-12-01,8738,8375,363,4.2
17047,2019-12-01,2636,2523,113,4.3
17049,2019-12-01,19255,18704,551,2.9
17051,2019-12-01,9719,9309,410,4.2
17053,2019-12-01,6553,6282,271,4.1
17055,2019-12-01,16232,15402,830,5.1
17057,2019-12-01,15037,14221,816,5.4
17059,2019-12-01,2318,2214,104,4.5
17061,2019-12-01,5893,5667,226,3.8
17063,2019-12-01,25056,24167,889,3.5
17065,2019-12-01,4430,4287,143,3.2
17067,2019-12-01,8294,7934,360,4.3
17069,2019-12-01,1335,1253,82,6.1
17071,2019-12-01,3570,3430,140,3.9
17073,2019-12-01,24909,23661,1248,5
17075,2019-12-01,14427,13760,667,4.6
17077,2019-12-01,27989,27036,953,3.4
17079,2019-12-01,4640,4457,183,3.9
17081,2019-12-01,17372,16632,740,4.3
17083,2019-12-01,10948,10496,452,4.1
17085,2019-12-01,10574,10073,501,4.7
17087,2019-12-01,4130,3902,228,5.5
17089,2019-12-01,273682,261311,12371,4.5
17091,2019-12-01,56636,53596,3040,5.4
17093,2019-12-01,67811,66035,1776,2.6
17095,2019-12-01,21315,20308,1007,4.7
17097,2019-12-01,374640,359069,15571,4.2
17099,2019-12-01,54628,51740,2888,5.3
17101,2019-12-01,5869,5551,318,5.4
17103,2019-12-01,17675,16955,720,4.1
17105,2019-12-01,16364,15741,623,3.8
17107,2019-12-01,12423,11922,501,4
17109,2019-12-01,13468,12967,501,3.7
17111,2019-12-01,163703,159332,4371,2.7
17113,2019-12-01,87529,84643,2886,3.3
17115,2019-12-01,48099,45589,2510,5.2
17117,2019-12-01,22891,21947,944,4.1
17119,2019-12-01,134013,129275,4738,3.5
17121,2019-12-01,17429,16682,747,4.3
17123,2019-12-01,5243,4980,263,5
17125,2019-12-01,6221,5882,339,5.4
17127,2019-12-01,5697,5382,315,5.5
17129,2019-12-01,6398,6166,232,3.6
17131,2019-12-01,8028,7618,410,5.1
17133,2019-12-01,18751,18228,523,2.8
17135,2019-12-01,11593,10934,659,5.7
17137,2019-12-01,16341,15667,674,4.1
17139,2019-12-01,7538,7318,220,2.9
17141,2019-12-01,24543,23320,1223,5
17143,2019-12-01,84068,79755,4313,5.1
17145,2019-12-01,8310,7931,379,4.6
17147,2019-12-01,8782,8497,285,3.2
17149,2019-12-01,6847,6536,311,4.5
17151,2019-12-01,1667,1578,89,5.3
17153,2019-12-01,2019,1893,126,6.2
17155,2019-12-01,3075,2896,179,5.8
17157,2019-12-01,14132,13644,488,3.5
17159,2019-12-01,7182,6909,273,3.8
17161,2019-12-01,71352,67788,3564,5
17163,2019-12-01,126402,121344,5058,4
17165,2019-12-01,9617,9140,477,5
17167,2019-12-01,99716,95963,3753,3.8
17169,2019-12-01,3112,2968,144,4.6
17171,2019-12-01,2530,2394,136,5.4
17173,2019-12-01,10421,10016,405,3.9
17175,2019-12-01,2473,2332,141,5.7
17177,2019-12-01,21446,20533,913,4.3
17179,2019-12-01,62937,60228,2709,4.3
17181,2019-12-01,7478,7041,437,5.8
17183,2019-12-01,33140,31426,1714,5.2
17185,2019-12-01,5940,5761,179,3
17187,2019-12-01,8386,8064,322,3.8
17189,2019-12-01,10090,9869,221,2.2
17191,2019-12-01,6991,6692,299,4.3
17193,2019-12-01,6508,6260,248,3.8
17195,2019-12-01,28541,27301,1240,4.3
17197,2019-12-01,352832,342104,10728,3
17199,2019-12-01,32111,30834,1277,4
17201,2019-12-01,138050,130045,8005,5.8
17203,2019-12-01,18433,17801,632,3.4
18001,2019-12-01,16977,16583,394,2.3
18003,2019-12-01,184893,179630,5263,2.8
18005,2019-12-01,44704,43747,957,2.1
18007,2019-12-01,4693,4566,127,2.7
18009,2019-12-01,4873,4685,188,3.9
18011,2019-12-01,36072,35329,743,2.1
18013,2019-12-01,7656,7462,194,2.5
18015,2019-12-01,10506,10237,269,2.6
18017,2019-12-01,17754,17169,585,3.3
18019,2019-12-01,61603,59816,1787,2.9
18021,2019-12-01,12045,11663,382,3.2
18023,2019-12-01,17180,16786,394,2.3
18025,2019-12-01,4808,4612,196,4.1
18027,2019-12-01,16728,16338,390,2.3
18029,2019-12-01,25777,24953,824,3.2
18031,2019-12-01,14674,14292,382,2.6
18033,2019-12-01,22611,22048,563,2.5
18035,2019-12-01,54147,52302,1845,3.4
18037,2019-12-01,22989,22543,446,1.9
18039,2019-12-01,110818,107779,3039,2.7
18041,2019-12-01,8571,8177,394,4.6
18043,2019-12-01,41650,40471,1179,2.8
18045,2019-12-01,8029,7756,273,3.4
18047,2019-12-01,11276,10937,339,3
18049,2019-12-01,9796,9481,315,3.2
18051,2019-12-01,19566,19110,456,2.3
18053,2019-12-01,32119,31059,1060,3.3
18055,2019-12-01,13669,13160,509,3.7
18057,2019-12-01,182546,178710,3836,2.1
18059,2019-12-01,40013,39058,955,2.4
18061,2019-12-01,20306,19727,579,2.9
18063,2019-12-01,89402,87333,2069,2.3
18065,2019-12-01,22001,21363,638,2.9
18067,2019-12-01,36962,35680,1282,3.5
18069,2019-12-01,18092,17581,511,2.8
18071,2019-12-01,22919,22443,476,2.1
18073,2019-12-01,16317,15756,561,3.4
18075,2019-12-01,9403,9143,260,2.8
18077,2019-12-01,14908,14444,464,3.1
18079,2019-12-01,13620,13216,404,3
18081,2019-12-01,82491,80583,1908,2.3
18083,2019-12-01,18622,18125,497,2.7
18085,2019-12-01,41863,40771,1092,2.6
18087,2019-12-01,19922,19494,428,2.1
18089,2019-12-01,230317,219211,11106,4.8
18091,2019-12-01,47670,45716,1954,4.1
18093,2019-12-01,21194,20485,709,3.3
18095,2019-12-01,58897,56888,2009,3.4
18097,2019-12-01,487220,473273,13947,2.9
18099,2019-12-01,22852,22208,644,2.8
18101,2019-12-01,5360,5247,113,2.1
18103,2019-12-01,15214,14657,557,3.7
18105,2019-12-01,71013,69166,1847,2.6
18107,2019-12-01,18707,18206,501,2.7
18109,2019-12-01,36130,35161,969,2.7
18111,2019-12-01,6979,6717,262,3.8
18113,2019-12-01,23398,22742,656,2.8
18115,2019-12-01,3181,3080,101,3.2
18117,2019-12-01,8608,8346,262,3
18119,2019-12-01,9524,9199,325,3.4
18121,2019-12-01,7001,6741,260,3.7
18123,2019-12-01,9200,8905,295,3.2
18125,2019-12-01,6188,5982,206,3.3
18127,2019-12-01,86605,83591,3014,3.5
18129,2019-12-01,13558,13221,337,2.5
18131,2019-12-01,6473,6269,204,3.2
18133,2019-12-01,16700,16191,509,3
18135,2019-12-01,11220,10800,420,3.7
18137,2019-12-01,14152,13744,408,2.9
18139,2019-12-01,8893,8697,196,2.2
18141,2019-12-01,135284,130711,4573,3.4
18143,2019-12-01,10551,10222,329,3.1
18145,2019-12-01,23049,22457,592,2.6
18147,2019-12-01,10202,9885,317,3.1
18149,2019-12-01,9793,9403,390,4
18151,2019-12-01,20618,20152,466,2.3
18153,2019-12-01,8433,8078,355,4.2
18155,2019-12-01,4959,4812,147,3
18157,2019-12-01,101136,98707,2429,2.4
18159,2019-12-01,9169,8975,194,2.1
18161,2019-12-01,3562,3457,105,2.9
18163,2019-12-01,93776,91232,2544,2.7
18165,2019-12-01,7012,6665,347,4.9
18167,2019-12-01,48101,46227,1874,3.9
18169,2019-12-01,15048,14644,404,2.7
18171,2019-12-01,4247,4124,123,2.9
18173,2019-12-01,32831,31955,876,2.7
18175,2019-12-01,13755,13355,400,2.9
18177,2019-12-01,30482,29499,983,3.2
18179,2019-12-01,14415,14060,355,2.5
18181,2019-12-01,13466,13161,305,2.3
18183,2019-12-01,17690,17252,438,2.5
19001,2019-12-01,4356,4250,106,2.4
19003,2019-12-01,2216,2180,36,1.6
19005,2019-12-01,7666,7383,283,3.7
19007,2019-12-01,6036,5823,213,3.5
19009,2019-12-01,3206,3125,81,2.5
19011,2019-12-01,13850,13396,454,3.3
19013,2019-12-01,69873,67362,2511,3.6
19015,2019-12-01,15181,14814,367,2.4
19017,2019-12-01,14150,13771,379,2.7
19019,2019-12-01,11531,11161,370,3.2
19021,2019-12-01,12360,12115,245,2
19023,2019-12-01,8205,7918,287,3.5
19025,2019-12-01,4384,4268,116,2.6
19027,2019-12-01,11287,11068,219,1.9
19029,2019-12-01,7005,6815,190,2.7
19031,2019-12-01,11048,10746,302,2.7
19033,2019-12-01,23902,23228,674,2.8
19035,2019-12-01,6325,6164,161,2.5
19037,2019-12-01,6775,6545,230,3.4
19039,2019-12-01,4951,4811,140,2.8
19041,2019-12-01,8742,8485,257,2.9
19043,2019-12-01,10355,9881,474,4.6
19045,2019-12-01,23216,22270,946,4.1
19047,2019-12-01,8520,8151,369,4.3
19049,2019-12-01,50443,49381,1062,2.1
19051,2019-12-01,4327,4202,125,2.9
19053,2019-12-01,4567,4469,98,2.1
19055,2019-12-01,10907,10632,275,2.5
19057,2019-12-01,19208,18393,815,4.2
19059,2019-12-01,9915,9584,331,3.3
19061,2019-12-01,57289,55510,1779,3.1
19063,2019-12-01,5336,5214,122,2.3
19065,2019-12-01,11043,10632,411,3.7
19067,2019-12-01,8904,8495,409,4.6
19069,2019-12-01,5850,5715,135,2.3
19071,2019-12-01,3806,3724,82,2.2
19073,2019-12-01,5631,5508,123,2.2
19075,2019-12-01,6711,6520,191,2.8
19077,2019-12-01,5809,5642,167,2.9
19079,2019-12-01,7091,6876,215,3
19081,2019-12-01,6068,5906,162,2.7
19083,2019-12-01,8255,7998,257,3.1
19085,2019-12-01,7639,7442,197,2.6
19087,2019-12-01,9972,9679,293,2.9
19089,2019-12-01,5370,5218,152,2.8
19091,2019-12-01,5279,5122,157,3
19093,2019-12-01,4268,4182,86,2
19095,2019-12-01,10828,10575,253,2.3
19097,2019-12-01,11212,10817,395,3.5
19099,2019-12-01,20183,19567,616,3.1
19101,2019-12-01,10465,10218,247,2.4
19103,2019-12-01,86638,84694,1944,2.2
19105,2019-12-01,11036,10633,403,3.7
19107,2019-12-01,5380,5200,180,3.3
19109,2019-12-01,8705,8518,187,2.1
19111,2019-12-01,16464,15815,649,3.9
19113,2019-12-01,123808,119946,3862,3.1
19115,2019-12-01,6239,6021,218,3.5
19117,2019-12-01,4717,4619,98,2.1
19119,2019-12-01,7340,7190,150,2
19121,2019-12-01,8756,8453,303,3.5
19123,2019-12-01,12098,11787,311,2.6
19125,2019-12-01,18773,18328,445,2.4
19127,2019-12-01,18263,17231,1032,5.7
19129,2019-12-01,7629,7442,187,2.5
19131,2019-12-01,7310,7185,125,1.7
19133,2019-12-01,4544,4402,142,3.1
19135,2019-12-01,4141,4021,120,2.9
19137,2019-12-01,5140,4993,147,2.9
19139,2019-12-01,22142,21472,670,3
19141,2019-12-01,8511,8315,196,2.3
19143,2019-12-01,3660,3590,70,1.9
19145,2019-12-01,6498,6313,185,2.8
19147,2019-12-01,4903,4789,114,2.3
19149,2019-12-01,15228,14852,376,2.5
19151,2019-12-01,4824,4736,88,1.8
19153,2019-12-01,272980,265144,7836,2.9
19155,2019-12-01,49713,48464,1249,2.5
19157,2019-12-01,10749,10431,318,3
19159,2019-12-01,2546,2483,63,2.5
19161,2019-12-01,5407,5280,127,2.3
19163,2019-12-01,90184,86842,3342,3.7
19165,2019-12-01,6866,6706,160,2.3
19167,2019-12-01,21989,21532,457,2.1
19169,2019-12-01,60047,58787,1260,2.1
19171,2019-12-01,9697,9306,391,4
19173,2019-12-01,3304,3240,64,1.9
19175,2019-12-01,6460,6270,190,2.9
19177,2019-12-01,3771,3670,101,2.7
19179,2019-12-01,17945,17324,621,3.5
19181,2019-12-01,28740,28010,730,2.5
19183,2019-12-01,12234,11916,318,2.6
19185,2019-12-01,2920,2843,77,2.6
19187,2019-12-01,20021,19379,642,3.2
19189,2019-12-01,5247,5094,153,2.9
19191,2019-12-01,12603,12202,401,3.2
19193,2019-12-01,56508,54802,1706,3
19195,2019-12-01,4353,4218,135,3.1
19197,2019-12-01,7182,6996,186,2.6
20001,2019-12-01,6386,6175,211,3.3
20003,2019-12-01,4219,4104,115,2.7
20005,2019-12-01,6996,6659,337,4.8
20007,2019-12-01,2373,2309,64,2.7
20009,2019-12-01,13337,12916,421,3.2
20011,2019-12-01,6637,6390,247,3.7
20013,2019-12-01,5365,5213,152,2.8
20015,2019-12-01,32601,31602,999,3.1
20017,2019-12-01,1523,1482,41,2.7
20019,2019-12-01,1460,1411,49,3.4
20021,2019-12-01,10159,9872,287,2.8
20023,2019-12-01,1390,1361,29,2.1
20025,2019-12-01,1117,1092,25,2.2
20027,2019-12-01,3842,3737,105,2.7
20029,2019-12-01,3796,3688,108,2.8
20031,2019-12-01,4169,3991,178,4.3
20033,2019-12-01,885,861,24,2.7
20035,2019-12-01,16296,15775,521,3.2
20037,2019-12-01,18698,18054,644,3.4
20039,2019-12-01,1294,1258,36,2.8
20041,2019-12-01,8826,8545,281,3.2
20043,2019-12-01,4142,4025,117,2.8
20045,2019-12-01,66297,64601,1696,2.6
20047,2019-12-01,1624,1594,30,1.8
20049,2019-12-01,1208,1176,32,2.6
20051,2019-12-01,17177,16830,347,2
20053,2019-12-01,2747,2683,64,2.3
20055,2019-12-01,20752,20336,416,2
20057,2019-12-01,17142,16772,370,2.2
20059,2019-12-01,14068,13677,391,2.8
20061,2019-12-01,11328,10885,443,3.9
20063,2019-12-01,1521,1491,30,2
20065,2019-12-01,1123,1089,34,3
20067,2019-12-01,3247,3166,81,2.5
20069,2019-12-01,3340,3276,64,1.9
20071,2019-12-01,810,793,17,2.1
20073,2019-12-01,3453,3352,101,2.9
20075,2019-12-01,1686,1657,29,1.7
20077,2019-12-01,2862,2791,71,2.5
20079,2019-12-01,17034,16594,440,2.6
20081,2019-12-01,2240,2199,41,1.8
20083,2019-12-01,1026,999,27,2.6
20085,2019-12-01,7106,6925,181,2.5
20087,2019-12-01,10038,9749,289,2.9
20089,2019-12-01,1287,1255,32,2.5
20091,2019-12-01,340790,332435,8355,2.5
20093,2019-12-01,2096,2054,42,2
20095,2019-12-01,3475,3375,100,2.9
20097,2019-12-01,1340,1310,30,2.2
20099,2019-12-01,9953,9616,337,3.4
20101,2019-12-01,817,797,20,2.4
20103,2019-12-01,36699,35558,1141,3.1
20105,2019-12-01,1755,1719,36,2.1
20107,2019-12-01,4485,4231,254,5.7
20109,2019-12-01,1686,1657,29,1.7
20111,2019-12-01,16695,16172,523,3.1
20113,2019-12-01,17200,16852,348,2
20115,2019-12-01,6073,5914,159,2.6
20117,2019-12-01,5526,5391,135,2.4
20119,2019-12-01,2188,2144,44,2
20121,2019-12-01,17600,17059,541,3.1
20123,2019-12-01,3286,3217,69,2.1
20125,2019-12-01,14691,14089,602,4.1
20127,2019-12-01,3050,2967,83,2.7
20129,2019-12-01,1153,1123,30,2.6
20131,2019-12-01,5437,5297,140,2.6
20133,2019-12-01,6185,5926,259,4.2
20135,2019-12-01,1370,1334,36,2.6
20137,2019-12-01,2705,2651,54,2
20139,2019-12-01,7936,7665,271,3.4
20141,2019-12-01,2102,2065,37,1.8
20143,2019-12-01,3030,2957,73,2.4
20145,2019-12-01,2925,2851,74,2.5
20147,2019-12-01,2662,2601,61,2.3
20149,2019-12-01,12600,12292,308,2.4
20151,2019-12-01,4955,4850,105,2.1
20153,2019-12-01,1544,1514,30,1.9
20155,2019-12-01,29548,28699,849,2.9
20157,2019-12-01,2302,2251,51,2.2
20159,2019-12-01,5214,5087,127,2.4
20161,2019-12-01,35513,34654,859,2.4
20163,2019-12-01,2550,2474,76,3
20165,2019-12-01,1658,1619,39,2.4
20167,2019-12-01,3297,3206,91,2.8
20169,2019-12-01,30033,29184,849,2.8
20171,2019-12-01,2933,2881,52,1.8
20173,2019-12-01,251488,243395,8093,3.2
20175,2019-12-01,9427,9168,259,2.7
20177,2019-12-01,89595,86710,2885,3.2
20179,2019-12-01,1454,1424,30,2.1
20181,2019-12-01,2842,2768,74,2.6
20183,2019-12-01,2011,1962,49,2.4
20185,2019-12-01,2112,2058,54,2.6
20187,2019-12-01,1023,998,25,2.4
20189,2019-12-01,2552,2491,61,2.4
20191,2019-12-01,10949,10624,325,3
20193,2019-12-01,4327,4246,81,1.9
20195,2019-12-01,1449,1412,37,2.6
20197,2019-12-01,3644,3537,107,2.9
20199,2019-12-01,812,793,19,2.3
20201,2019-12-01,3006,2949,57,1.9
20203,2019-12-01,1245,1221,24,1.9
20205,2019-12-01,3982,3823,159,4
20207,2019-12-01,1610,1544,66,4.1
20209,2019-12-01,77490,74592,2898,3.7
21001,2019-12-01,7229,6883,346,4.8
21003,2019-12-01,9184,8840,344,3.7
21005,2019-12-01,12459,12032,427,3.4
21007,2019-12-01,3576,3379,197,5.5
21009,2019-12-01,18822,18035,787,4.2
21011,2019-12-01,4664,4395,269,5.8
21013,2019-12-01,8518,7950,568,6.7
21015,2019-12-01,71168,69014,2154,3
21017,2019-12-01,9930,9581,349,3.5
21019,2019-12-01,17851,16904,947,5.3
21021,2019-12-01,12347,11842,505,4.1
21023,2019-12-01,3854,3687,167,4.3
21025,2019-12-01,3458,3157,301,8.7
21027,2019-12-01,7941,7543,398,5
21029,2019-12-01,43021,41469,1552,3.6
21031,2019-12-01,5208,4983,225,4.3
21033,2019-12-01,5525,5269,256,4.6
21035,2019-12-01,18684,18012,672,3.6
21037,2019-12-01,50970,49386,1584,3.1
21039,2019-12-01,2290,2202,88,3.8
21041,2019-12-01,5375,5182,193,3.6
21043,2019-12-01,9868,9054,814,8.2
21045,2019-12-01,6723,6478,245,3.6
21047,2019-12-01,25276,24036,1240,4.9
21049,2019-12-01,17246,16622,624,3.6
21051,2019-12-01,5183,4842,341,6.6
21053,2019-12-01,4034,3821,213,5.3
21055,2019-12-01,3826,3675,151,3.9
21057,2019-12-01,3212,3086,126,3.9
21059,2019-12-01,47482,45767,1715,3.6
21061,2019-12-01,4880,4657,223,4.6
21063,2019-12-01,2103,1912,191,9.1
21065,2019-12-01,5437,5168,269,4.9
21067,2019-12-01,175216,170118,5098,2.9
21069,2019-12-01,6162,5850,312,5.1
21071,2019-12-01,11035,10320,715,6.5
21073,2019-12-01,26034,25216,818,3.1
21075,2019-12-01,2058,1962,96,4.7
21077,2019-12-01,4110,3968,142,3.5
21079,2019-12-01,7703,7369,334,4.3
21081,2019-12-01,11775,11351,424,3.6
21083,2019-12-01,15994,15328,666,4.2
21085,2019-12-01,11138,10649,489,4.4
21087,2019-12-01,5210,5009,201,3.9
21089,2019-12-01,13465,12592,873,6.5
21091,2019-12-01,3972,3841,131,3.3
21093,2019-12-01,48895,47094,1801,3.7
21095,2019-12-01,6679,5940,739,11.1
21097,2019-12-01,8875,8550,325,3.7
21099,2019-12-01,8086,7608,478,5.9
21101,2019-12-01,22082,21262,820,3.7
21103,2019-12-01,8331,8060,271,3.3
21105,2019-12-01,1775,1691,84,4.7
21107,2019-12-01,18549,17766,783,4.2
21109,2019-12-01,4144,3891,253,6.1
21111,2019-12-01,402027,388284,13743,3.4
21113,2019-12-01,26598,25759,839,3.2
21115,2019-12-01,6727,6303,424,6.3
21117,2019-12-01,88136,85260,2876,3.3
21119,2019-12-01,4446,4153,293,6.6
21121,2019-12-01,9813,9256,557,5.7
21123,2019-12-01,6029,5776,253,4.2
21125,2019-12-01,24306,23239,1067,4.4
21127,2019-12-01,5265,4897,368,7
21129,2019-12-01,2059,1946,113,5.5
21131,2019-12-01,2730,2464,266,9.7
21133,2019-12-01,6419,5898,521,8.1
21135,2019-12-01,4719,4292,427,9
21137,2019-12-01,9168,8760,408,4.5
21139,2019-12-01,3687,3499,188,5.1
21141,2019-12-01,12678,12192,486,3.8
21143,2019-12-01,3026,2899,127,4.2
21145,2019-12-01,29533,28175,1358,4.6
21147,2019-12-01,4673,4410,263,5.6
21149,2019-12-01,4238,4072,166,3.9
21151,2019-12-01,48161,46554,1607,3.3
21153,2019-12-01,3286,2890,396,12.1
21155,2019-12-01,9686,9369,317,3.3
21157,2019-12-01,15081,14465,616,4.1
21159,2019-12-01,2747,2564,183,6.7
21161,2019-12-01,7136,6749,387,5.4
21163,2019-12-01,12262,11740,522,4.3
21165,2019-12-01,2322,2166,156,6.7
21167,2019-12-01,9971,9536,435,4.4
21169,2019-12-01,4159,3954,205,4.9
21171,2019-12-01,4770,4612,158,3.3
21173,2019-12-01,11657,11111,546,4.7
21175,2019-12-01,4598,4345,253,5.5
21177,2019-12-01,10376,9741,635,6.1
21179,2019-12-01,23349,22453,896,3.8
21181,2019-12-01,3363,3226,137,4.1
21183,2019-12-01,9754,9305,449,4.6
21185,2019-12-01,33538,32614,924,2.8
21187,2019-12-01,5110,4925,185,3.6
21189,2019-12-01,1137,1065,72,6.3
21191,2019-12-01,7046,6799,247,3.5
21193,2019-12-01,8269,7723,546,6.6
21195,2019-12-01,19654,18512,1142,5.8
21197,2019-12-01,5101,4816,285,5.6
21199,2019-12-01,26837,25671,1166,4.3
21201,2019-12-01,836,798,38,4.5
21203,2019-12-01,6796,6514,282,4.1
21205,2019-12-01,10476,9938,538,5.1
21207,2019-12-01,6203,5865,338,5.4
21209,2019-12-01,29195,28275,920,3.2
21211,2019-12-01,25737,24998,739,2.9
21213,2019-12-01,8987,8613,374,4.2
21215,2019-12-01,10285,9970,315,3.1
21217,2019-12-01,13120,12650,470,3.6
21219,2019-12-01,5541,5332,209,3.8
21221,2019-12-01,6092,5840,252,4.1
21223,2019-12-01,3925,3766,159,4.1
21225,2019-12-01,6207,5952,255,4.1
21227,2019-12-01,65983,63421,2562,3.9
21229,2019-12-01,6347,6121,226,3.6
21231,2019-12-01,7514,7125,389,5.2
21233,2019-12-01,5669,5451,218,3.8
21235,2019-12-01,13514,12850,664,4.9
21237,2019-12-01,1997,1847,150,7.5
21239,2019-12-01,15141,14689,452,3
22001,2019-12-01,23679,22394,1285,5.4
22003,2019-12-01,8824,8239,585,6.6
22005,2019-12-01,63944,61243,2701,4.2
22007,2019-12-01,8837,8303,534,6
22009,2019-12-01,14993,14044,949,6.3
22011,2019-12-01,14391,13606,785,5.5
22013,2019-12-01,5465,5121,344,6.3
22015,2019-12-01,57408,54920,2488,4.3
22017,2019-12-01,103144,97506,5638,5.5
22019,2019-12-01,103592,98969,4623,4.5
22021,2019-12-01,3791,3500,291,7.7
22023,2019-12-01,3843,3680,163,4.2
22025,2019-12-01,3345,3126,219,6.5
22027,2019-12-01,5852,5472,380,6.5
22029,2019-12-01,7074,6599,475,6.7
22031,2019-12-01,10848,10152,696,6.4
22033,2019-12-01,230393,220084,10309,4.5
22035,2019-12-01,1859,1646,213,11.5
22037,2019-12-01,7927,7575,352,4.4
22039,2019-12-01,11771,11070,701,6
22041,2019-12-01,7273,6731,542,7.5
22043,2019-12-01,8226,7648,578,7
22045,2019-12-01,27959,26343,1616,5.8
22047,2019-12-01,14034,13165,869,6.2
22049,2019-12-01,6776,6451,325,4.8
22051,2019-12-01,214052,205295,8757,4.1
22053,2019-12-01,13009,12393,616,4.7
22055,2019-12-01,113213,108278,4935,4.4
22057,2019-12-01,41788,39971,1817,4.3
22059,2019-12-01,6746,6457,289,4.3
22061,2019-12-01,22179,21042,1137,5.1
22063,2019-12-01,68528,65724,2804,4.1
22065,2019-12-01,3446,3170,276,8
22067,2019-12-01,10088,9126,962,9.5
22069,2019-12-01,16608,15555,1053,6.3
22071,2019-12-01,179138,170426,8712,4.9
22073,2019-12-01,70175,66312,3863,5.5
22075,2019-12-01,10014,9586,428,4.3
22077,2019-12-01,9790,9254,536,5.5
22079,2019-12-01,54878,52053,2825,5.1
22081,2019-12-01,3716,3503,213,5.7
22083,2019-12-01,8124,7567,557,6.9
22085,2019-12-01,9068,8600,468,5.2
22087,2019-12-01,19843,18860,983,5
22089,2019-12-01,25206,24113,1093,4.3
22091,2019-12-01,4270,3994,276,6.5
22093,2019-12-01,9278,8702,576,6.2
22095,2019-12-01,19821,18620,1201,6.1
22097,2019-12-01,31849,29758,2091,6.6
22099,2019-12-01,22155,20986,1169,5.3
22101,2019-12-01,19858,18679,1179,5.9
22103,2019-12-01,119335,114440,4895,4.1
22105,2019-12-01,54896,51815,3081,5.6
22107,2019-12-01,1309,1199,110,8.4
22109,2019-12-01,46094,43957,2137,4.6
22111,2019-12-01,9056,8510,546,6
22113,2019-12-01,23917,22666,1251,5.2
22115,2019-12-01,15727,14767,960,6.1
22117,2019-12-01,16644,15676,968,5.8
22119,2019-12-01,14465,13556,909,6.3
22121,2019-12-01,13629,13021,608,4.5
22123,2019-12-01,3659,3176,483,13.2
22125,2019-12-01,5365,5131,234,4.4
22127,2019-12-01,4816,4489,327,6.8
23001,2019-12-01,55516,54015,1501,2.7
23003,2019-12-01,30000,28709,1291,4.3
23005,2019-12-01,163827,160206,3621,2.2
23007,2019-12-01,14452,13951,501,3.5
23009,2019-12-01,27724,26628,1096,4
23011,2019-12-01,61641,59922,1719,2.8
23013,2019-12-01,19653,19097,556,2.8
23015,2019-12-01,16341,15882,459,2.8
23017,2019-12-01,26369,25473,896,3.4
23019,2019-12-01,77662,75311,2351,3
23021,2019-12-01,7236,6960,276,3.8
23023,2019-12-01,19247,18823,424,2.2
23025,2019-12-01,22068,21068,1000,4.5
23027,2019-12-01,20414,19778,636,3.1
23029,2019-12-01,13823,13261,562,4.1
23031,2019-12-01,112921,109891,3030,2.7
24001,2019-12-01,32023,30591,1432,4.5
24003,2019-12-01,318588,310668,7920,2.5
24005,2019-12-01,458445,444346,14099,3.1
24009,2019-12-01,50681,49400,1281,2.5
24011,2019-12-01,18084,17527,557,3.1
24013,2019-12-01,96751,94442,2309,2.4
24015,2019-12-01,53208,51451,1757,3.3
24017,2019-12-01,88445,85770,2675,3
24019,2019-12-01,15223,14586,637,4.2
24021,2019-12-01,135197,131633,3564,2.6
24023,2019-12-01,15486,14786,700,4.5
24025,2019-12-01,142311,138454,3857,2.7
24027,2019-12-01,189696,185505,4191,2.2
24029,2019-12-01,9949,9588,361,3.6
24031,2019-12-01,564087,550548,13539,2.4
24033,2019-12-01,516196,499789,16407,3.2
24035,2019-12-01,28181,27448,733,2.6
24037,2019-12-01,57301,55796,1505,2.6
24039,2019-12-01,8967,8468,499,5.6
24041,2019-12-01,19398,18832,566,2.9
24043,2019-12-01,76547,74077,2470,3.2
24045,2019-12-01,50287,48021,2266,4.5
24047,2019-12-01,25750,23306,2444,9.5
24510,2019-12-01,290523,278177,12346,4.2
25001,2019-12-01,110894,106645,4249,3.8
25003,2019-12-01,65063,63043,2020,3.1
25005,2019-12-01,306280,296654,9626,3.1
25007,2019-12-01,8560,8163,397,4.6
25009,2019-12-01,430487,420080,10407,2.4
25011,2019-12-01,41679,40769,910,2.2
25013,2019-12-01,231489,223719,7770,3.4
25015,2019-12-01,91474,89652,1822,2
25017,2019-12-01,930476,913870,16606,1.8
25019,2019-12-01,6688,6329,359,5.4
25021,2019-12-01,396424,388516,7908,2
25023,2019-12-01,287192,279949,7243,2.5
25025,2019-12-01,461862,452543,9319,2
25027,2019-12-01,454423,442619,11804,2.6
26001,2019-12-01,3755,3521,234,6.2
26003,2019-12-01,3031,2762,269,8.9
26005,2019-12-01,61579,59883,1696,2.8
26007,2019-12-01,13229,12667,562,4.2
26009,2019-12-01,9928,9436,492,5
26011,2019-12-01,5936,5543,393,6.6
26013,2019-12-01,3195,2980,215,6.7
26015,2019-12-01,31391,30479,912,2.9
26017,2019-12-01,49453,47373,2080,4.2
26019,2019-12-01,8751,8304,447,5.1
26021,2019-12-01,72410,69820,2590,3.6
26023,2019-12-01,19155,18516,639,3.3
26025,2019-12-01,62350,60200,2150,3.4
26027,2019-12-01,24332,23460,872,3.6
26029,2019-12-01,12283,11699,584,4.8
26031,2019-12-01,9838,8663,1175,11.9
26033,2019-12-01,15907,14881,1026,6.4
26035,2019-12-01,11564,10855,709,6.1
26037,2019-12-01,41124,40102,1022,2.5
26039,2019-12-01,5491,5158,333,6.1
26041,2019-12-01,17054,16034,1020,6
26043,2019-12-01,12216,11684,532,4.4
26045,2019-12-01,57356,55749,1607,2.8
26047,2019-12-01,17188,16208,980,5.7
26049,2019-12-01,183587,176302,7285,4
26051,2019-12-01,9679,9130,549,5.7
26053,2019-12-01,6038,5754,284,4.7
26055,2019-12-01,48974,47436,1538,3.1
26057,2019-12-01,18063,17393,670,3.7
26059,2019-12-01,20251,19541,710,3.5
26061,2019-12-01,16443,15750,693,4.2
26063,2019-12-01,15096,14505,591,3.9
26065,2019-12-01,151224,147144,4080,2.7
26067,2019-12-01,30090,29265,825,2.7
26069,2019-12-01,10090,9493,597,5.9
26071,2019-12-01,5093,4807,286,5.6
26073,2019-12-01,34613,33430,1183,3.4
26075,2019-12-01,73961,71582,2379,3.2
26077,2019-12-01,133921,130309,3612,2.7
26079,2019-12-01,7836,7380,456,5.8
26081,2019-12-01,356995,348545,8450,2.4
26083,2019-12-01,906,838,68,7.5
26085,2019-12-01,3786,3565,221,5.8
26087,2019-12-01,41625,39344,2281,5.5
26089,2019-12-01,10295,9957,338,3.3
26091,2019-12-01,46306,44923,1383,3
26093,2019-12-01,104219,101131,3088,3
26095,2019-12-01,2262,2107,155,6.9
26097,2019-12-01,4188,3486,702,16.8
26099,2019-12-01,450438,434047,16391,3.6
26101,2019-12-01,10190,9638,552,5.4
26103,2019-12-01,32961,31574,1387,4.2
26105,2019-12-01,13171,12507,664,5
26107,2019-12-01,18273,17496,777,4.3
26109,2019-12-01,11042,10494,548,5
26111,2019-12-01,39763,38450,1313,3.3
26113,2019-12-01,6829,6515,314,4.6
26115,2019-12-01,75201,72915,2286,3
26117,2019-12-01,28012,27018,994,3.5
26119,2019-12-01,2994,2701,293,9.8
26121,2019-12-01,76923,74004,2919,3.8
26123,2019-12-01,23165,22292,873,3.8
26125,2019-12-01,679992,660057,19935,2.9
26127,2019-12-01,11455,10766,689,6
26129,2019-12-01,7832,7294,538,6.9
26131,2019-12-01,2089,1936,153,7.3
26133,2019-12-01,11267,10849,418,3.7
26135,2019-12-01,2933,2716,217,7.4
26137,2019-12-01,11388,10878,510,4.5
26139,2019-12-01,159487,155897,3590,2.3
26141,2019-12-01,4794,4400,394,8.2
26143,2019-12-01,7382,6827,555,7.5
26145,2019-12-01,86682,83144,3538,4.1
26147,2019-12-01,76151,72793,3358,4.4
26149,2019-12-01,27385,26498,887,3.2
26151,2019-12-01,19094,18321,773,4
26153,2019-12-01,3297,3041,256,7.8
26155,2019-12-01,33500,32247,1253,3.7
26157,2019-12-01,23646,22624,1022,4.3
26159,2019-12-01,34982,33509,1473,4.2
26161,2019-12-01,200349,196082,4267,2.1
26163,2019-12-01,810632,774479,36153,4.5
26165,2019-12-01,14751,14142,609,4.1
27001,2019-12-01,7397,6778,619,8.4
27003,2019-12-01,200257,193999,6258,3.1
27005,2019-12-01,18935,17963,972,5.1
27007,2019-12-01,24903,23649,1254,5
27009,2019-12-01,22382,21309,1073,4.8
27011,2019-12-01,2496,2348,148,5.9
27013,2019-12-01,41456,40377,1079,2.6
27015,2019-12-01,14387,13806,581,4
27017,2019-12-01,18060,17082,978,5.4
27019,2019-12-01,59305,57657,1648,2.8
27021,2019-12-01,14230,13143,1087,7.6
27023,2019-12-01,7112,6796,316,4.4
27025,2019-12-01,30564,29201,1363,4.5
27027,2019-12-01,36705,35593,1112,3
27029,2019-12-01,4701,4211,490,10.4
27031,2019-12-01,3019,2828,191,6.3
27033,2019-12-01,6100,5899,201,3.3
27035,2019-12-01,32164,30279,1885,5.9
27037,2019-12-01,244624,237642,6982,2.9
27039,2019-12-01,12000,11543,457,3.8
27041,2019-12-01,21018,20205,813,3.9
27043,2019-12-01,7111,6750,361,5.1
27045,2019-12-01,11684,11233,451,3.9
27047,2019-12-01,16330,15734,596,3.6
27049,2019-12-01,27508,26572,936,3.4
27051,2019-12-01,3359,3175,184,5.5
27053,2019-12-01,713985,695396,18589,2.6
27055,2019-12-01,10592,10220,372,3.5
27057,2019-12-01,9963,9260,703,7.1
27059,2019-12-01,21802,20701,1101,5
27061,2019-12-01,21975,20436,1539,7
27063,2019-12-01,5766,5588,178,3.1
27065,2019-12-01,9392,8582,810,8.6
27067,2019-12-01,24731,23694,1037,4.2
27069,2019-12-01,2429,2323,106,4.4
27071,2019-12-01,5905,5496,409,6.9
27073,2019-12-01,3620,3484,136,3.8
27075,2019-12-01,5352,5128,224,4.2
27077,2019-12-01,2559,2438,121,4.7
27079,2019-12-01,16650,15613,1037,6.2
27081,2019-12-01,3364,3191,173,5.1
27083,2019-12-01,14659,14138,521,3.6
27085,2019-12-01,19445,18614,831,4.3
27087,2019-12-01,2320,2180,140,6
27089,2019-12-01,5560,5126,434,7.8
27091,2019-12-01,10062,9713,349,3.5
27093,2019-12-01,13642,12938,704,5.2
27095,2019-12-01,13324,12385,939,7
27097,2019-12-01,17916,16556,1360,7.6
27099,2019-12-01,20484,19836,648,3.2
27101,2019-12-01,4930,4666,264,5.4
27103,2019-12-01,21410,20874,536,2.5
27105,2019-12-01,11372,11053,319,2.8
27107,2019-12-01,3315,3136,179,5.4
27109,2019-12-01,89100,86818,2282,2.6
27111,2019-12-01,31775,30048,1727,5.4
27113,2019-12-01,8808,8235,573,6.5
27115,2019-12-01,15487,14347,1140,7.4
27117,2019-12-01,4944,4759,185,3.7
27119,2019-12-01,16872,16203,669,4
27121,2019-12-01,6645,6400,245,3.7
27123,2019-12-01,292786,284453,8333,2.8
27125,2019-12-01,2244,2104,140,6.2
27127,2019-12-01,7787,7487,300,3.9
27129,2019-12-01,8666,8205,461,5.3
27131,2019-12-01,37629,36272,1357,3.6
27133,2019-12-01,5727,5581,146,2.5
27135,2019-12-01,7959,7626,333,4.2
27137,2019-12-01,102499,98065,4434,4.3
27139,2019-12-01,84637,82261,2376,2.8
27141,2019-12-01,53401,51238,2163,4.1
27143,2019-12-01,8753,8328,425,4.9
27145,2019-12-01,91549,88354,3195,3.5
27147,2019-12-01,21600,20890,710,3.3
27149,2019-12-01,5473,5295,178,3.3
27151,2019-12-01,5062,4753,309,6.1
27153,2019-12-01,13913,13129,784,5.6
27155,2019-12-01,1757,1684,73,4.2
27157,2019-12-01,12479,11973,506,4.1
27159,2019-12-01,6152,5655,497,8.1
27161,2019-12-01,9079,8639,440,4.8
27163,2019-12-01,145139,141051,4088,2.8
27165,2019-12-01,6574,6314,260,4
27167,2019-12-01,3495,3374,121,3.5
27169,2019-12-01,28882,28031,851,2.9
27171,2019-12-01,77000,74124,2876,3.7
27173,2019-12-01,5506,5290,216,3.9
28001,2019-12-01,11436,10631,805,7
28003,2019-12-01,16159,15433,726,4.5
28005,2019-12-01,4391,4070,321,7.3
28007,2019-12-01,7053,6614,439,6.2
28009,2019-12-01,3092,2902,190,6.1
28011,2019-12-01,12048,11138,910,7.6
28013,2019-12-01,5546,5236,310,5.6
28015,2019-12-01,3469,3254,215,6.2
28017,2019-12-01,6846,6492,354,5.2
28019,2019-12-01,3732,3511,221,5.9
28021,2019-12-01,3041,2714,327,10.8
28023,2019-12-01,5945,5573,372,6.3
28025,2019-12-01,7798,7163,635,8.1
28027,2019-12-01,8268,7623,645,7.8
28029,2019-12-01,11145,10475,670,6
28031,2019-12-01,8159,7780,379,4.6
28033,2019-12-01,92289,88522,3767,4.1
28035,2019-12-01,33571,32015,1556,4.6
28037,2019-12-01,2777,2570,207,7.5
28039,2019-12-01,8846,8155,691,7.8
28041,2019-12-01,4377,3984,393,9
28043,2019-12-01,9364,8905,459,4.9
28045,2019-12-01,18915,17887,1028,5.4
28047,2019-12-01,87112,82724,4388,5
28049,2019-12-01,107238,101994,5244,4.9
28051,2019-12-01,5664,5095,569,10
28053,2019-12-01,2201,1944,257,11.7
28055,2019-12-01,369,336,33,8.9
28057,2019-12-01,10585,10132,453,4.3
28059,2019-12-01,58958,55515,3443,5.8
28061,2019-12-01,6206,5722,484,7.8
28063,2019-12-01,2059,1703,356,17.3
28065,2019-12-01,4110,3837,273,6.6
28067,2019-12-01,26102,24772,1330,5.1
28069,2019-12-01,3509,3250,259,7.4
28071,2019-12-01,28899,27834,1065,3.7
28073,2019-12-01,31079,29879,1200,3.9
28075,2019-12-01,30632,29076,1556,5.1
28077,2019-12-01,4596,4275,321,7
28079,2019-12-01,7800,7376,424,5.4
28081,2019-12-01,41672,39976,1696,4.1
28083,2019-12-01,10044,9293,751,7.5
28085,2019-12-01,14652,13798,854,5.8
28087,2019-12-01,25735,24425,1310,5.1
28089,2019-12-01,53412,51242,2170,4.1
28091,2019-12-01,10007,9455,552,5.5
28093,2019-12-01,14676,13832,844,5.8
28095,2019-12-01,15676,14871,805,5.1
28097,2019-12-01,3894,3660,234,6
28099,2019-12-01,10023,9433,590,5.9
28101,2019-12-01,8915,8439,476,5.3
28103,2019-12-01,3750,3471,279,7.4
28105,2019-12-01,22822,21705,1117,4.9
28107,2019-12-01,12607,11821,786,6.2
28109,2019-12-01,23910,22725,1185,5
28111,2019-12-01,4334,4046,288,6.6
28113,2019-12-01,14502,13573,929,6.4
28115,2019-12-01,14920,14312,608,4.1
28117,2019-12-01,11298,10787,511,4.5
28119,2019-12-01,2321,2122,199,8.6
28121,2019-12-01,76393,73550,2843,3.7
28123,2019-12-01,12575,12050,525,4.2
28125,2019-12-01,1609,1450,159,9.9
28127,2019-12-01,10729,10206,523,4.9
28129,2019-12-01,6770,6400,370,5.5
28131,2019-12-01,6884,6472,412,6
28133,2019-12-01,7713,6902,811,10.5
28135,2019-12-01,5199,4874,325,6.3
28137,2019-12-01,12444,11786,658,5.3
28139,2019-12-01,9427,9003,424,4.5
28141,2019-12-01,8572,8117,455,5.3
28143,2019-12-01,4459,4182,277,6.2
28145,2019-12-01,14444,13854,590,4.1
28147,2019-12-01,4899,4547,352,7.2
28149,2019-12-01,20417,19230,1187,5.8
28151,2019-12-01,16996,15653,1343,7.9
28153,2019-12-01,7349,6898,451,6.1
28155,2019-12-01,3985,3770,215,5.4
28157,2019-12-01,2855,2549,306,10.7
28159,2019-12-01,7402,6984,418,5.6
28161,2019-12-01,4967,4717,250,5
28163,2019-12-01,9333,8766,567,6.1
29001,2019-12-01,10369,10030,339,3.3
29003,2019-12-01,9789,9528,261,2.7
29005,2019-12-01,2662,2573,89,3.3
29007,2019-12-01,10678,10333,345,3.2
29009,2019-12-01,15483,14889,594,3.8
29011,2019-12-01,5192,5013,179,3.4
29013,2019-12-01,7893,7595,298,3.8
29015,2019-12-01,7185,6838,347,4.8
29017,2019-12-01,5531,5317,214,3.9
29019,2019-12-01,99481,97069,2412,2.4
29021,2019-12-01,44825,43455,1370,3.1
29023,2019-12-01,18276,17416,860,4.7
29025,2019-12-01,4368,4228,140,3.2
29027,2019-12-01,21220,20573,647,3
29029,2019-12-01,18301,17164,1137,6.2
29031,2019-12-01,41392,40164,1228,3
29033,2019-12-01,4714,4543,171,3.6
29035,2019-12-01,2554,2432,122,4.8
29037,2019-12-01,55207,53529,1678,3
29039,2019-12-01,5750,5547,203,3.5
29041,2019-12-01,3797,3667,130,3.4
29043,2019-12-01,45463,44188,1275,2.8
29045,2019-12-01,3197,3075,122,3.8
29047,2019-12-01,137324,133415,3909,2.8
29049,2019-12-01,10755,10427,328,3
29051,2019-12-01,38822,37767,1055,2.7
29053,2019-12-01,7526,7273,253,3.4
29055,2019-12-01,10985,10510,475,4.3
29057,2019-12-01,3533,3415,118,3.3
29059,2019-12-01,7189,6780,409,5.7
29061,2019-12-01,4071,3937,134,3.3
29063,2019-12-01,4815,4670,145,3
29065,2019-12-01,6304,6047,257,4.1
29067,2019-12-01,5153,4843,310,6
29069,2019-12-01,11424,10780,644,5.6
29071,2019-12-01,53487,51644,1843,3.4
29073,2019-12-01,7695,7423,272,3.5
29075,2019-12-01,3464,3365,99,2.9
29077,2019-12-01,153178,148575,4603,3
29079,2019-12-01,4407,4244,163,3.7
29081,2019-12-01,3777,3649,128,3.4
29083,2019-12-01,9722,9377,345,3.5
29085,2019-12-01,3802,3626,176,4.6
29087,2019-12-01,2534,2470,64,2.5
29089,2019-12-01,4917,4773,144,2.9
29091,2019-12-01,16898,16078,820,4.9
29093,2019-12-01,3532,3349,183,5.2
29095,2019-12-01,365774,352321,13453,3.7
29097,2019-12-01,58049,56206,1843,3.2
29099,2019-12-01,118932,115032,3900,3.3
29101,2019-12-01,23201,22369,832,3.6
29103,2019-12-01,1777,1724,53,3
29105,2019-12-01,17760,15981,1779,10
29107,2019-12-01,16849,16331,518,3.1
29109,2019-12-01,18027,17358,669,3.7
29111,2019-12-01,5004,4841,163,3.3
29113,2019-12-01,28476,27532,944,3.3
29115,2019-12-01,5150,4893,257,5
29117,2019-12-01,7328,7128,200,2.7
29119,2019-12-01,10864,10485,379,3.5
29121,2019-12-01,7594,7330,264,3.5
29123,2019-12-01,5509,5301,208,3.8
29125,2019-12-01,3902,3763,139,3.6
29127,2019-12-01,14724,14258,466,3.2
29129,2019-12-01,1852,1794,58,3.1
29131,2019-12-01,12307,11770,537,4.4
29133,2019-12-01,5784,5534,250,4.3
29135,2019-12-01,7193,6984,209,2.9
29137,2019-12-01,3906,3733,173,4.4
29139,2019-12-01,5730,5553,177,3.1
29141,2019-12-01,8131,7737,394,4.8
29143,2019-12-01,8232,7853,379,4.6
29145,2019-12-01,27615,26731,884,3.2
29147,2019-12-01,10953,10661,292,2.7
29149,2019-12-01,4043,3858,185,4.6
29151,2019-12-01,7027,6862,165,2.3
29153,2019-12-01,3371,3118,253,7.5
29155,2019-12-01,6354,5995,359,5.6
29157,2019-12-01,10061,9786,275,2.7
29159,2019-12-01,21095,20388,707,3.4
29161,2019-12-01,19934,19258,676,3.4
29163,2019-12-01,7504,7225,279,3.7
29165,2019-12-01,59109,57523,1586,2.7
29167,2019-12-01,14680,14202,478,3.3
29169,2019-12-01,14715,14022,693,4.7
29171,2019-12-01,2225,2150,75,3.4
29173,2019-12-01,5708,5529,179,3.1
29175,2019-12-01,10528,10107,421,4
29177,2019-12-01,11062,10676,386,3.5
29179,2019-12-01,2996,2871,125,4.2
29181,2019-12-01,5026,4777,249,5
29183,2019-12-01,227773,221693,6080,2.7
29185,2019-12-01,3748,3572,176,4.7
29186,2019-12-01,9171,8907,264,2.9
29187,2019-12-01,26896,25788,1108,4.1
29189,2019-12-01,535325,518621,16704,3.1
29195,2019-12-01,10566,10221,345,3.3
29197,2019-12-01,1932,1860,72,3.7
29199,2019-12-01,2365,2310,55,2.3
29201,2019-12-01,20054,19310,744,3.7
29203,2019-12-01,3209,3000,209,6.5
29205,2019-12-01,3060,2962,98,3.2
29207,2019-12-01,13062,12434,628,4.8
29209,2019-12-01,13731,13082,649,4.7
29211,2019-12-01,2661,2563,98,3.7
29213,2019-12-01,26567,25463,1104,4.2
29215,2019-12-01,9102,8642,460,5.1
29217,2019-12-01,9397,9066,331,3.5
29219,2019-12-01,18029,17478,551,3.1
29221,2019-12-01,10282,9781,501,4.9
29223,2019-12-01,5276,5029,247,4.7
29225,2019-12-01,17497,16772,725,4.1
29227,2019-12-01,1160,1128,32,2.8
29229,2019-12-01,7693,7072,621,8.1
29510,2019-12-01,153635,147586,6049,3.9
30001,2019-12-01,5009,4843,166,3.3
30003,2019-12-01,4740,4424,316,6.7
30005,2019-12-01,2524,2421,103,4.1
30007,2019-12-01,2558,2451,107,4.2
30009,2019-12-01,5482,5283,199,3.6
30011,2019-12-01,660,647,13,2
30013,2019-12-01,37894,36616,1278,3.4
30015,2019-12-01,2509,2428,81,3.2
30017,2019-12-01,6093,5907,186,3.1
30019,2019-12-01,906,883,23,2.5
30021,2019-12-01,4603,4478,125,2.7
30023,2019-12-01,4904,4738,166,3.4
30025,2019-12-01,1708,1669,39,2.3
30027,2019-12-01,6038,5820,218,3.6
30029,2019-12-01,47451,44991,2460,5.2
30031,2019-12-01,68746,67096,1650,2.4
30033,2019-12-01,764,738,26,3.4
30035,2019-12-01,5431,5028,403,7.4
30037,2019-12-01,368,355,13,3.5
30039,2019-12-01,1647,1539,108,6.6
30041,2019-12-01,7598,7346,252,3.3
30043,2019-12-01,5655,5444,211,3.7
30045,2019-12-01,1008,976,32,3.2
30047,2019-12-01,13112,12547,565,4.3
30049,2019-12-01,35311,34244,1067,3
30051,2019-12-01,975,952,23,2.4
30053,2019-12-01,8038,7334,704,8.8
30055,2019-12-01,974,953,21,2.2
30057,2019-12-01,5187,5014,173,3.3
30059,2019-12-01,1002,967,35,3.5
30061,2019-12-01,1683,1573,110,6.5
30063,2019-12-01,63663,61408,2255,3.5
30065,2019-12-01,2280,2188,92,4
30067,2019-12-01,8699,8345,354,4.1
30069,2019-12-01,289,276,13,4.5
30071,2019-12-01,1928,1842,86,4.5
30073,2019-12-01,2656,2570,86,3.2
30075,2019-12-01,975,952,23,2.4
30077,2019-12-01,3008,2907,101,3.4
30079,2019-12-01,481,464,17,3.5
30081,2019-12-01,20172,19327,845,4.2
30083,2019-12-01,5917,5774,143,2.4
30085,2019-12-01,4474,4293,181,4
30087,2019-12-01,3779,3621,158,4.2
30089,2019-12-01,4771,4476,295,6.2
30091,2019-12-01,1741,1699,42,2.4
30093,2019-12-01,17016,16346,670,3.9
30095,2019-12-01,5310,5140,170,3.2
30097,2019-12-01,1816,1765,51,2.8
30099,2019-12-01,2759,2647,112,4.1
30101,2019-12-01,2102,2042,60,2.9
30103,2019-12-01,339,331,8,2.4
30105,2019-12-01,4037,3901,136,3.4
30107,2019-12-01,810,775,35,4.3
30109,2019-12-01,464,451,13,2.8
30111,2019-12-01,81095,78573,2522,3.1
31001,2019-12-01,16640,16132,508,3.1
31003,2019-12-01,3572,3500,72,2
31005,2019-12-01,232,219,13,5.6
31007,2019-12-01,392,379,13,3.3
31009,2019-12-01,269,253,16,5.9
31011,2019-12-01,2981,2909,72,2.4
31013,2019-12-01,5362,5204,158,2.9
31015,2019-12-01,1094,1059,35,3.2
31017,2019-12-01,1393,1353,40,2.9
31019,2019-12-01,27659,27090,569,2.1
31021,2019-12-01,3468,3348,120,3.5
31023,2019-12-01,4474,4370,104,2.3
31025,2019-12-01,13578,13185,393,2.9
31027,2019-12-01,4532,4433,99,2.2
31029,2019-12-01,2292,2249,43,1.9
31031,2019-12-01,3391,3324,67,2
31033,2019-12-01,4314,4172,142,3.3
31035,2019-12-01,3293,3189,104,3.2
31037,2019-12-01,5540,5409,131,2.4
31039,2019-12-01,4655,4540,115,2.5
31041,2019-12-01,6402,6274,128,2
31043,2019-12-01,10715,10293,422,3.9
31045,2019-12-01,4906,4786,120,2.4
31047,2019-12-01,12970,12636,334,2.6
31049,2019-12-01,955,931,24,2.5
31051,2019-12-01,3053,2959,94,3.1
31053,2019-12-01,19476,18960,516,2.6
31055,2019-12-01,299109,290524,8585,2.9
31057,2019-12-01,1202,1170,32,2.7
31059,2019-12-01,3147,3078,69,2.2
31061,2019-12-01,1452,1409,43,3
31063,2019-12-01,1641,1590,51,3.1
31065,2019-12-01,2544,2480,64,2.5
31067,2019-12-01,10877,10535,342,3.1
31069,2019-12-01,1086,1049,37,3.4
31071,2019-12-01,1176,1152,24,2
31073,2019-12-01,1094,1070,24,2.2
31075,2019-12-01,438,427,11,2.5
31077,2019-12-01,1230,1203,27,2.2
31079,2019-12-01,31446,30473,973,3.1
31081,2019-12-01,4748,4620,128,2.7
31083,2019-12-01,1763,1710,53,3
31085,2019-12-01,637,621,16,2.5
31087,2019-12-01,1258,1221,37,2.9
31089,2019-12-01,5809,5681,128,2.2
31091,2019-12-01,382,369,13,3.4
31093,2019-12-01,3325,3239,86,2.6
31095,2019-12-01,4143,4047,96,2.3
31097,2019-12-01,2050,1986,64,3.1
31099,2019-12-01,3787,3720,67,1.8
31101,2019-12-01,4503,4356,147,3.3
31103,2019-12-01,614,601,13,2.1
31105,2019-12-01,1991,1946,45,2.3
31107,2019-12-01,4614,4494,120,2.6
31109,2019-12-01,177971,173808,4163,2.3
31111,2019-12-01,18113,17530,583,3.2
31113,2019-12-01,484,471,13,2.7
31115,2019-12-01,424,400,24,5.7
31117,2019-12-01,450,439,11,2.4
31119,2019-12-01,19561,19093,468,2.4
31121,2019-12-01,3986,3879,107,2.7
31123,2019-12-01,2628,2548,80,3
31125,2019-12-01,2025,1921,104,5.1
31127,2019-12-01,3599,3492,107,3
31129,2019-12-01,2411,2358,53,2.2
31131,2019-12-01,8413,8191,222,2.6
31133,2019-12-01,1482,1453,29,2
31135,2019-12-01,1837,1794,43,2.3
31137,2019-12-01,4983,4871,112,2.2
31139,2019-12-01,4055,3967,88,2.2
31141,2019-12-01,17582,17106,476,2.7
31143,2019-12-01,2972,2886,86,2.9
31145,2019-12-01,5822,5691,131,2.3
31147,2019-12-01,4185,4075,110,2.6
31149,2019-12-01,903,876,27,3
31151,2019-12-01,7326,7120,206,2.8
31153,2019-12-01,96421,94011,2410,2.5
31155,2019-12-01,11213,10943,270,2.4
31157,2019-12-01,18095,17467,628,3.5
31159,2019-12-01,9027,8805,222,2.5
31161,2019-12-01,2679,2618,61,2.3
31163,2019-12-01,1696,1645,51,3
31165,2019-12-01,762,743,19,2.5
31167,2019-12-01,3486,3414,72,2.1
31169,2019-12-01,2768,2701,67,2.4
31171,2019-12-01,435,416,19,4.4
31173,2019-12-01,3092,2966,126,4.1
31175,2019-12-01,2112,2064,48,2.3
31177,2019-12-01,11276,11011,265,2.4
31179,2019-12-01,5875,5760,115,2
31181,2019-12-01,1688,1635,53,3.1
31183,2019-12-01,578,565,13,2.2
31185,2019-12-01,7186,7034,152,2.1
32001,2019-12-01,11074,10745,329,3
32003,2019-12-01,NA,NA,39891,3.5
32005,2019-12-01,23093,22276,817,3.5
32007,2019-12-01,26639,25950,689,2.6
32009,2019-12-01,447,428,19,4.3
32011,2019-12-01,1070,1046,24,2.2
32013,2019-12-01,8147,7938,209,2.6
32015,2019-12-01,3184,3089,95,3
32017,2019-12-01,2113,2045,68,3.2
32019,2019-12-01,23184,22229,955,4.1
32021,2019-12-01,1994,1927,67,3.4
32023,2019-12-01,17509,16718,791,4.5
32027,2019-12-01,2523,2428,95,3.8
32029,2019-12-01,2074,2002,72,3.5
32031,2019-12-01,259618,252484,7134,2.7
32033,2019-12-01,4635,4521,114,2.5
32510,2019-12-01,26336,25433,903,3.4
33001,2019-12-01,30897,30183,714,2.3
33003,2019-12-01,23349,22854,495,2.1
33005,2019-12-01,41281,40339,942,2.3
33007,2019-12-01,14674,14240,434,3
33009,2019-12-01,50242,49280,962,1.9
33011,2019-12-01,243268,237512,5756,2.4
33013,2019-12-01,84127,82490,1637,1.9
33015,2019-12-01,187512,182904,4608,2.5
33017,2019-12-01,74679,73123,1556,2.1
33019,2019-12-01,23020,22551,469,2
34001,2019-12-01,120456,113885,6571,5.5
34003,2019-12-01,490413,476456,13957,2.8
34005,2019-12-01,233300,225747,7553,3.2
34007,2019-12-01,256556,245963,10593,4.1
34009,2019-12-01,43012,38504,4508,10.5
34011,2019-12-01,65813,61832,3981,6
34013,2019-12-01,372921,355956,16965,4.5
34015,2019-12-01,151788,146057,5731,3.8
34017,2019-12-01,367680,355800,11880,3.2
34019,2019-12-01,64974,63215,1759,2.7
34021,2019-12-01,206536,200083,6453,3.1
34023,2019-12-01,443823,430370,13453,3
34025,2019-12-01,332234,321753,10481,3.2
34027,2019-12-01,259168,251968,7200,2.8
34029,2019-12-01,278635,267909,10726,3.8
34031,2019-12-01,246678,235960,10718,4.3
34033,2019-12-01,29328,27777,1551,5.3
34035,2019-12-01,173038,167867,5171,3
34037,2019-12-01,74731,72041,2690,3.6
34039,2019-12-01,279272,268924,10348,3.7
34041,2019-12-01,56777,54819,1958,3.4
35001,2019-12-01,338145,324560,13585,4
35003,2019-12-01,1135,1055,80,7
35005,2019-12-01,27334,26056,1278,4.7
35006,2019-12-01,9061,8531,530,5.8
35007,2019-12-01,5271,5040,231,4.4
35009,2019-12-01,21898,21085,813,3.7
35011,2019-12-01,800,769,31,3.9
35013,2019-12-01,99485,94243,5242,5.3
35015,2019-12-01,36007,34991,1016,2.8
35017,2019-12-01,12521,11959,562,4.5
35019,2019-12-01,1528,1463,65,4.3
35021,2019-12-01,274,262,12,4.4
35023,2019-12-01,2013,1925,88,4.4
35025,2019-12-01,32466,31266,1200,3.7
35027,2019-12-01,8912,8513,399,4.5
35028,2019-12-01,9499,9225,274,2.9
35029,2019-12-01,9827,8367,1460,14.9
35031,2019-12-01,24420,22866,1554,6.4
35033,2019-12-01,2241,2098,143,6.4
35035,2019-12-01,25104,23966,1138,4.5
35037,2019-12-01,3239,3097,142,4.4
35039,2019-12-01,16820,15976,844,5
35041,2019-12-01,7805,7488,317,4.1
35043,2019-12-01,67247,64341,2906,4.3
35045,2019-12-01,52185,49286,2899,5.6
35047,2019-12-01,10712,10128,584,5.5
35049,2019-12-01,76226,73546,2680,3.5
35051,2019-12-01,3901,3673,228,5.8
35053,2019-12-01,6433,6103,330,5.1
35055,2019-12-01,15723,14861,862,5.5
35057,2019-12-01,5851,5482,369,6.3
35059,2019-12-01,1792,1719,73,4.1
35061,2019-12-01,30987,29501,1486,4.8
36001,2019-12-01,157856,152160,5696,3.6
36003,2019-12-01,19909,18732,1177,5.9
36005,2019-12-01,590723,565019,25704,4.4
36007,2019-12-01,83186,79005,4181,5
36009,2019-12-01,34622,32608,2014,5.8
36011,2019-12-01,35830,34154,1676,4.7
36013,2019-12-01,54196,51284,2912,5.4
36015,2019-12-01,35098,33527,1571,4.5
36017,2019-12-01,22004,20909,1095,5
36019,2019-12-01,36453,34753,1700,4.7
36021,2019-12-01,31006,29979,1027,3.3
36023,2019-12-01,22918,21673,1245,5.4
36025,2019-12-01,18944,18021,923,4.9
36027,2019-12-01,143918,138687,5231,3.6
36029,2019-12-01,440751,420669,20082,4.6
36031,2019-12-01,17048,16093,955,5.6
36033,2019-12-01,19630,18563,1067,5.4
36035,2019-12-01,22711,21472,1239,5.5
36037,2019-12-01,29682,28375,1307,4.4
36039,2019-12-01,20516,19504,1012,4.9
36041,2019-12-01,2114,1912,202,9.6
36043,2019-12-01,27843,26334,1509,5.4
36045,2019-12-01,43754,40739,3015,6.9
36047,2019-12-01,NA,NA,38025,3.2
36049,2019-12-01,11894,11098,796,6.7
36051,2019-12-01,30734,29355,1379,4.5
36053,2019-12-01,32948,31315,1633,5
36055,2019-12-01,359998,344339,15659,4.3
36057,2019-12-01,22489,21251,1238,5.5
36059,2019-12-01,707352,683043,24309,3.4
36061,2019-12-01,903737,878653,25084,2.8
36063,2019-12-01,99089,93529,5560,5.6
36065,2019-12-01,100429,95885,4544,4.5
36067,2019-12-01,220473,211506,8967,4.1
36069,2019-12-01,55321,53005,2316,4.2
36071,2019-12-01,183775,176624,7151,3.9
36073,2019-12-01,17673,16719,954,5.4
36075,2019-12-01,53216,50027,3189,6
36077,2019-12-01,27724,26421,1303,4.7
36079,2019-12-01,51213,49255,1958,3.8
36081,2019-12-01,NA,NA,30615,2.7
36083,2019-12-01,81341,78286,3055,3.8
36085,2019-12-01,220013,213450,6563,3
36087,2019-12-01,153959,148534,5425,3.5
36089,2019-12-01,43921,41402,2519,5.7
36091,2019-12-01,119495,115305,4190,3.5
36093,2019-12-01,76287,73332,2955,3.9
36095,2019-12-01,14758,14037,721,4.9
36097,2019-12-01,7916,7475,441,5.6
36099,2019-12-01,16077,15361,716,4.5
36101,2019-12-01,42461,40317,2144,5
36103,2019-12-01,778232,748689,29543,3.8
36105,2019-12-01,36200,34598,1602,4.4
36107,2019-12-01,22633,21627,1006,4.4
36109,2019-12-01,49738,48073,1665,3.3
36111,2019-12-01,87580,84291,3289,3.8
36113,2019-12-01,30913,29161,1752,5.7
36115,2019-12-01,27402,26168,1234,4.5
36117,2019-12-01,44049,41961,2088,4.7
36119,2019-12-01,480882,462585,18297,3.8
36121,2019-12-01,18141,17172,969,5.3
36123,2019-12-01,11973,11437,536,4.5
37001,2019-12-01,82658,80033,2625,3.2
37003,2019-12-01,18128,17626,502,2.8
37005,2019-12-01,4396,4199,197,4.5
37007,2019-12-01,10925,10507,418,3.8
37009,2019-12-01,13021,12628,393,3
37011,2019-12-01,7169,6928,241,3.4
37013,2019-12-01,19549,18792,757,3.9
37015,2019-12-01,7877,7557,320,4.1
37017,2019-12-01,14782,14167,615,4.2
37019,2019-12-01,53137,50617,2520,4.7
37021,2019-12-01,141638,138003,3635,2.6
37023,2019-12-01,41243,39906,1337,3.2
37025,2019-12-01,110223,106840,3383,3.1
37027,2019-12-01,36706,35461,1245,3.4
37029,2019-12-01,4671,4511,160,3.4
37031,2019-12-01,31674,30577,1097,3.5
37033,2019-12-01,9993,9609,384,3.8
37035,2019-12-01,79223,76760,2463,3.1
37037,2019-12-01,35988,34946,1042,2.9
37039,2019-12-01,11057,10633,424,3.8
37041,2019-12-01,5613,5401,212,3.8
37043,2019-12-01,4133,3968,165,4
37045,2019-12-01,48725,46946,1779,3.7
37047,2019-12-01,23137,22121,1016,4.4
37049,2019-12-01,41904,40472,1432,3.4
37051,2019-12-01,128172,122502,5670,4.4
37053,2019-12-01,14067,13620,447,3.2
37055,2019-12-01,17629,16823,806,4.6
37057,2019-12-01,81266,78610,2656,3.3
37059,2019-12-01,20761,20143,618,3
37061,2019-12-01,25974,25068,906,3.5
37063,2019-12-01,171635,166705,4930,2.9
37065,2019-12-01,21462,20434,1028,4.8
37067,2019-12-01,188207,182184,6023,3.2
37069,2019-12-01,31494,30435,1059,3.4
37071,2019-12-01,112328,108414,3914,3.5
37073,2019-12-01,5351,5163,188,3.5
37075,2019-12-01,3119,2952,167,5.4
37077,2019-12-01,29981,29118,863,2.9
37079,2019-12-01,9673,9378,295,3
37081,2019-12-01,264438,255358,9080,3.4
37083,2019-12-01,20406,19341,1065,5.2
37085,2019-12-01,53579,51546,2033,3.8
37087,2019-12-01,30201,29314,887,2.9
37089,2019-12-01,55618,54041,1577,2.8
37091,2019-12-01,9195,8811,384,4.2
37093,2019-12-01,20265,19381,884,4.4
37095,2019-12-01,1844,1655,189,10.2
37097,2019-12-01,90564,87683,2881,3.2
37099,2019-12-01,19755,19098,657,3.3
37101,2019-12-01,100002,96886,3116,3.1
37103,2019-12-01,4466,4319,147,3.3
37105,2019-12-01,26118,25136,982,3.8
37107,2019-12-01,28070,27141,929,3.3
37109,2019-12-01,44048,42680,1368,3.1
37111,2019-12-01,20452,19741,711,3.5
37113,2019-12-01,15463,14956,507,3.3
37115,2019-12-01,10245,9937,308,3
37117,2019-12-01,9131,8743,388,4.2
37119,2019-12-01,627840,608435,19405,3.1
37121,2019-12-01,5990,5750,240,4
37123,2019-12-01,11489,11088,401,3.5
37125,2019-12-01,42403,41022,1381,3.3
37127,2019-12-01,43739,41996,1743,4
37129,2019-12-01,125535,121794,3741,3
37131,2019-12-01,7788,7419,369,4.7
37133,2019-12-01,65958,63370,2588,3.9
37135,2019-12-01,79138,77019,2119,2.7
37137,2019-12-01,5376,5208,168,3.1
37139,2019-12-01,16736,16071,665,4
37141,2019-12-01,29345,28353,992,3.4
37143,2019-12-01,5019,4799,220,4.4
37145,2019-12-01,18509,17852,657,3.5
37147,2019-12-01,90462,87238,3224,3.6
37149,2019-12-01,8999,8706,293,3.3
37151,2019-12-01,66941,64788,2153,3.2
37153,2019-12-01,16716,15925,791,4.7
37155,2019-12-01,50730,48370,2360,4.7
37157,2019-12-01,40541,38990,1551,3.8
37159,2019-12-01,67192,64656,2536,3.8
37161,2019-12-01,25326,24211,1115,4.4
37163,2019-12-01,30058,29085,973,3.2
37165,2019-12-01,11607,10940,667,5.7
37167,2019-12-01,30469,29456,1013,3.3
37169,2019-12-01,21837,21141,696,3.2
37171,2019-12-01,34066,32961,1105,3.2
37173,2019-12-01,6742,6515,227,3.4
37175,2019-12-01,14473,14002,471,3.3
37177,2019-12-01,1342,1266,76,5.7
37179,2019-12-01,125276,121665,3611,2.9
37181,2019-12-01,17314,16424,890,5.1
37183,2019-12-01,599569,582580,16989,2.8
37185,2019-12-01,6664,6319,345,5.2
37187,2019-12-01,4405,4170,235,5.3
37189,2019-12-01,29799,28991,808,2.7
37191,2019-12-01,52215,50391,1824,3.5
37193,2019-12-01,29347,28300,1047,3.6
37195,2019-12-01,35038,33330,1708,4.9
37197,2019-12-01,17873,17326,547,3.1
37199,2019-12-01,8407,8122,285,3.4
38001,2019-12-01,1044,1018,26,2.5
38003,2019-12-01,5109,5001,108,2.1
38005,2019-12-01,2275,2189,86,3.8
38007,2019-12-01,352,342,10,2.8
38009,2019-12-01,2833,2750,83,2.9
38011,2019-12-01,1698,1664,34,2
38013,2019-12-01,1038,1006,32,3.1
38015,2019-12-01,48663,47564,1099,2.3
38017,2019-12-01,101697,99842,1855,1.8
38019,2019-12-01,1856,1809,47,2.5
38021,2019-12-01,2227,2187,40,1.8
38023,2019-12-01,1371,1348,23,1.7
38025,2019-12-01,3113,3067,46,1.5
38027,2019-12-01,1201,1161,40,3.3
38029,2019-12-01,1417,1351,66,4.7
38031,2019-12-01,1457,1415,42,2.9
38033,2019-12-01,792,782,10,1.3
38035,2019-12-01,36967,36289,678,1.8
38037,2019-12-01,1160,1131,29,2.5
38039,2019-12-01,981,957,24,2.4
38041,2019-12-01,1334,1304,30,2.2
38043,2019-12-01,1213,1166,47,3.9
38045,2019-12-01,2000,1967,33,1.7
38047,2019-12-01,862,840,22,2.6
38049,2019-12-01,2983,2887,96,3.2
38051,2019-12-01,1083,1051,32,3
38053,2019-12-01,10208,10026,182,1.8
38055,2019-12-01,4541,4392,149,3.3
38057,2019-12-01,3348,3186,162,4.8
38059,2019-12-01,15989,15529,460,2.9
38061,2019-12-01,7331,7229,102,1.4
38063,2019-12-01,1335,1296,39,2.9
38065,2019-12-01,852,815,37,4.3
38067,2019-12-01,3220,3115,105,3.3
38069,2019-12-01,1653,1607,46,2.8
38071,2019-12-01,5383,5221,162,3
38073,2019-12-01,2748,2705,43,1.6
38075,2019-12-01,1204,1171,33,2.7
38077,2019-12-01,8336,8185,151,1.8
38079,2019-12-01,4507,4178,329,7.3
38081,2019-12-01,2582,2548,34,1.3
38083,2019-12-01,688,639,49,7.1
38085,2019-12-01,1204,1170,34,2.8
38087,2019-12-01,386,377,9,2.3
38089,2019-12-01,18030,17675,355,2
38091,2019-12-01,946,930,16,1.7
38093,2019-12-01,9998,9785,213,2.1
38095,2019-12-01,1043,1011,32,3.1
38097,2019-12-01,4302,4216,86,2
38099,2019-12-01,4940,4791,149,3
38101,2019-12-01,30876,30169,707,2.3
38103,2019-12-01,1835,1769,66,3.6
38105,2019-12-01,24085,23622,463,1.9
39001,2019-12-01,10562,9864,698,6.6
39003,2019-12-01,47440,45624,1816,3.8
39005,2019-12-01,26450,25382,1068,4
39007,2019-12-01,43946,41800,2146,4.9
39009,2019-12-01,28085,26755,1330,4.7
39011,2019-12-01,24791,24089,702,2.8
39013,2019-12-01,30307,28468,1839,6.1
39015,2019-12-01,19623,18695,928,4.7
39017,2019-12-01,195551,188951,6600,3.4
39019,2019-12-01,12883,12226,657,5.1
39021,2019-12-01,19936,19257,679,3.4
39023,2019-12-01,63022,60465,2557,4.1
39025,2019-12-01,107032,103467,3565,3.3
39027,2019-12-01,17794,17038,756,4.2
39029,2019-12-01,47044,44955,2089,4.4
39031,2019-12-01,14042,13114,928,6.6
39033,2019-12-01,18101,17296,805,4.4
39035,2019-12-01,604664,582953,21711,3.6
39037,2019-12-01,25480,24595,885,3.5
39039,2019-12-01,18013,17280,733,4.1
39041,2019-12-01,111107,107946,3161,2.8
39043,2019-12-01,35320,33551,1769,5
39045,2019-12-01,78541,75831,2710,3.5
39047,2019-12-01,13944,13470,474,3.4
39049,2019-12-01,702350,680181,22169,3.2
39051,2019-12-01,22328,21467,861,3.9
39053,2019-12-01,12105,11434,671,5.5
39055,2019-12-01,48487,47005,1482,3.1
39057,2019-12-01,83394,80577,2817,3.4
39059,2019-12-01,18342,17259,1083,5.9
39061,2019-12-01,416835,402950,13885,3.3
39063,2019-12-01,41802,40574,1228,2.9
39065,2019-12-01,13615,13074,541,4
39067,2019-12-01,6671,6285,386,5.8
39069,2019-12-01,13112,12497,615,4.7
39071,2019-12-01,16921,16040,881,5.2
39073,2019-12-01,13213,12607,606,4.6
39075,2019-12-01,20531,19953,578,2.8
39077,2019-12-01,27338,25723,1615,5.9
39079,2019-12-01,12577,11753,824,6.6
39081,2019-12-01,27534,26007,1527,5.5
39083,2019-12-01,31437,30296,1141,3.6
39085,2019-12-01,124833,120775,4058,3.3
39087,2019-12-01,23755,22632,1123,4.7
39089,2019-12-01,91070,87953,3117,3.4
39091,2019-12-01,22698,21882,816,3.6
39093,2019-12-01,151769,146017,5752,3.8
39095,2019-12-01,209140,200401,8739,4.2
39097,2019-12-01,20888,20239,649,3.1
39099,2019-12-01,101701,96408,5293,5.2
39101,2019-12-01,28101,27071,1030,3.7
39103,2019-12-01,96353,93492,2861,3
39105,2019-12-01,8927,8324,603,6.8
39107,2019-12-01,23049,22485,564,2.4
39109,2019-12-01,54277,52423,1854,3.4
39111,2019-12-01,5300,4827,473,8.9
39113,2019-12-01,253002,243485,9517,3.8
39115,2019-12-01,6619,6113,506,7.6
39117,2019-12-01,16935,16262,673,4
39119,2019-12-01,39747,37817,1930,4.9
39121,2019-12-01,4616,4283,333,7.2
39123,2019-12-01,20057,18729,1328,6.6
39125,2019-12-01,8493,8186,307,3.6
39127,2019-12-01,16044,15225,819,5.1
39129,2019-12-01,26607,25620,987,3.7
39131,2019-12-01,10671,10003,668,6.3
39133,2019-12-01,86945,83395,3550,4.1
39135,2019-12-01,21066,20323,743,3.5
39137,2019-12-01,18603,18048,555,3
39139,2019-12-01,51966,49597,2369,4.6
39141,2019-12-01,35463,33957,1506,4.2
39143,2019-12-01,29980,28726,1254,4.2
39145,2019-12-01,28795,27032,1763,6.1
39147,2019-12-01,27028,25956,1072,4
39149,2019-12-01,23812,23032,780,3.3
39151,2019-12-01,184552,176328,8224,4.5
39153,2019-12-01,270842,260084,10758,4
39155,2019-12-01,85589,80791,4798,5.6
39157,2019-12-01,44444,42494,1950,4.4
39159,2019-12-01,29098,28239,859,3
39161,2019-12-01,14887,14403,484,3.3
39163,2019-12-01,5533,5196,337,6.1
39165,2019-12-01,119443,115715,3728,3.1
39167,2019-12-01,27244,25788,1456,5.3
39169,2019-12-01,62015,60104,1911,3.1
39171,2019-12-01,18871,18263,608,3.2
39173,2019-12-01,70841,68515,2326,3.3
39175,2019-12-01,12921,12542,379,2.9
40001,2019-12-01,7970,7641,329,4.1
40003,2019-12-01,2776,2724,52,1.9
40005,2019-12-01,4940,4717,223,4.5
40007,2019-12-01,2861,2809,52,1.8
40009,2019-12-01,9885,9459,426,4.3
40011,2019-12-01,4636,4535,101,2.2
40013,2019-12-01,21337,20727,610,2.9
40015,2019-12-01,11664,11219,445,3.8
40017,2019-12-01,74667,72510,2157,2.9
40019,2019-12-01,21423,20691,732,3.4
40021,2019-12-01,18332,17640,692,3.8
40023,2019-12-01,5360,5080,280,5.2
40025,2019-12-01,1284,1264,20,1.6
40027,2019-12-01,143281,139655,3626,2.5
40029,2019-12-01,2429,2317,112,4.6
40031,2019-12-01,48291,46690,1601,3.3
40033,2019-12-01,2708,2625,83,3.1
40035,2019-12-01,5830,5626,204,3.5
40037,2019-12-01,31582,30458,1124,3.6
40039,2019-12-01,15733,15298,435,2.8
40041,2019-12-01,17751,17116,635,3.6
40043,2019-12-01,2855,2791,64,2.2
40045,2019-12-01,2096,2032,64,3.1
40047,2019-12-01,26722,25898,824,3.1
40049,2019-12-01,12459,12030,429,3.4
40051,2019-12-01,26591,25717,874,3.3
40053,2019-12-01,2570,2515,55,2.1
40055,2019-12-01,1791,1717,74,4.1
40057,2019-12-01,1135,1105,30,2.6
40059,2019-12-01,1713,1665,48,2.8
40061,2019-12-01,4164,3916,248,6
40063,2019-12-01,5303,5035,268,5.1
40065,2019-12-01,10654,10354,300,2.8
40067,2019-12-01,2485,2405,80,3.2
40069,2019-12-01,3676,3496,180,4.9
40071,2019-12-01,18092,17371,721,4
40073,2019-12-01,9032,8850,182,2
40075,2019-12-01,3396,3278,118,3.5
40077,2019-12-01,3125,2896,229,7.3
40079,2019-12-01,18947,18058,889,4.7
40081,2019-12-01,15792,15242,550,3.5
40083,2019-12-01,22098,21524,574,2.6
40085,2019-12-01,6112,5974,138,2.3
40087,2019-12-01,19651,19109,542,2.8
40089,2019-12-01,14456,13567,889,6.1
40091,2019-12-01,7092,6632,460,6.5
40093,2019-12-01,3755,3681,74,2
40095,2019-12-01,6812,6576,236,3.5
40097,2019-12-01,19286,18730,556,2.9
40099,2019-12-01,6269,6071,198,3.2
40101,2019-12-01,29746,28661,1085,3.6
40103,2019-12-01,5589,5450,139,2.5
40105,2019-12-01,4567,4428,139,3
40107,2019-12-01,4548,4331,217,4.8
40109,2019-12-01,385882,374779,11103,2.9
40111,2019-12-01,15674,14926,748,4.8
40113,2019-12-01,20659,19914,745,3.6
40115,2019-12-01,13897,13474,423,3
40117,2019-12-01,7339,7053,286,3.9
40119,2019-12-01,37431,36484,947,2.5
40121,2019-12-01,16991,16182,809,4.8
40123,2019-12-01,19247,18714,533,2.8
40125,2019-12-01,32486,31368,1118,3.4
40127,2019-12-01,4205,3984,221,5.3
40129,2019-12-01,1819,1761,58,3.2
40131,2019-12-01,45128,43833,1295,2.9
40133,2019-12-01,9469,9005,464,4.9
40135,2019-12-01,16116,15421,695,4.3
40137,2019-12-01,18367,17511,856,4.7
40139,2019-12-01,11076,10870,206,1.9
40141,2019-12-01,2967,2843,124,4.2
40143,2019-12-01,323297,313599,9698,3
40145,2019-12-01,37994,36829,1165,3.1
40147,2019-12-01,22038,21355,683,3.1
40149,2019-12-01,5136,4927,209,4.1
40151,2019-12-01,4570,4494,76,1.7
40153,2019-12-01,8831,8496,335,3.8
41001,2019-12-01,7056,6788,268,3.8
41003,2019-12-01,48517,47530,987,2
41005,2019-12-01,219024,213308,5716,2.6
41007,2019-12-01,18634,18030,604,3.2
41009,2019-12-01,24418,23505,913,3.7
41011,2019-12-01,25815,24819,996,3.9
41013,2019-12-01,9457,8989,468,4.9
41015,2019-12-01,8620,8231,389,4.5
41017,2019-12-01,95386,92333,3053,3.2
41019,2019-12-01,45829,44025,1804,3.9
41021,2019-12-01,868,837,31,3.6
41023,2019-12-01,3049,2859,190,6.2
41025,2019-12-01,3481,3320,161,4.6
41027,2019-12-01,13736,13399,337,2.5
41029,2019-12-01,102395,99167,3228,3.2
41031,2019-12-01,9802,9390,412,4.2
41033,2019-12-01,35320,33918,1402,4
41035,2019-12-01,28501,26852,1649,5.8
41037,2019-12-01,3547,3398,149,4.2
41039,2019-12-01,180491,174928,5563,3.1
41041,2019-12-01,19950,19208,742,3.7
41043,2019-12-01,58446,56468,1978,3.4
41045,2019-12-01,12116,11712,404,3.3
41047,2019-12-01,160104,155151,4953,3.1
41049,2019-12-01,5441,5247,194,3.6
41051,2019-12-01,455097,443644,11453,2.5
41053,2019-12-01,39585,38351,1234,3.1
41055,2019-12-01,924,892,32,3.5
41057,2019-12-01,11416,11025,391,3.4
41059,2019-12-01,35266,33868,1398,4
41061,2019-12-01,11683,11216,467,4
41063,2019-12-01,3224,3072,152,4.7
41065,2019-12-01,12236,11784,452,3.7
41067,2019-12-01,325176,317612,7564,2.3
41069,2019-12-01,697,671,26,3.7
41071,2019-12-01,54472,53067,1405,2.6
42001,2019-12-01,54708,52876,1832,3.3
42003,2019-12-01,651334,624607,26727,4.1
42005,2019-12-01,32831,30749,2082,6.3
42007,2019-12-01,84645,80559,4086,4.8
42009,2019-12-01,23721,22268,1453,6.1
42011,2019-12-01,217465,207996,9469,4.4
42013,2019-12-01,59652,56650,3002,5
42015,2019-12-01,28963,27532,1431,4.9
42017,2019-12-01,345150,332013,13137,3.8
42019,2019-12-01,100616,96334,4282,4.3
42021,2019-12-01,58471,55041,3430,5.9
42023,2019-12-01,2081,1908,173,8.3
42025,2019-12-01,32744,30801,1943,5.9
42027,2019-12-01,81215,78391,2824,3.5
42029,2019-12-01,285758,277087,8671,3
42031,2019-12-01,17141,16158,983,5.7
42033,2019-12-01,36460,34100,2360,6.5
42035,2019-12-01,18425,17246,1179,6.4
42037,2019-12-01,33705,31879,1826,5.4
42039,2019-12-01,38657,36655,2002,5.2
42041,2019-12-01,133637,129197,4440,3.3
42043,2019-12-01,146005,140115,5890,4
42045,2019-12-01,301853,290048,11805,3.9
42047,2019-12-01,15528,14417,1111,7.2
42049,2019-12-01,128865,122483,6382,5
42051,2019-12-01,58045,54004,4041,7
42053,2019-12-01,1807,1653,154,8.5
42055,2019-12-01,79539,76197,3342,4.2
42057,2019-12-01,8109,7573,536,6.6
42059,2019-12-01,16720,15765,955,5.7
42061,2019-12-01,20279,18664,1615,8
42063,2019-12-01,39757,37492,2265,5.7
42065,2019-12-01,20684,19405,1279,6.2
42067,2019-12-01,12704,12056,648,5.1
42069,2019-12-01,105702,100408,5294,5
42071,2019-12-01,285807,276305,9502,3.3
42073,2019-12-01,40924,38421,2503,6.1
42075,2019-12-01,73136,70120,3016,4.1
42077,2019-12-01,195539,186442,9097,4.7
42079,2019-12-01,158790,149253,9537,6
42081,2019-12-01,57240,54074,3166,5.5
42083,2019-12-01,17484,16341,1143,6.5
42085,2019-12-01,49082,46459,2623,5.3
42087,2019-12-01,21193,20107,1086,5.1
42089,2019-12-01,83934,79190,4744,5.7
42091,2019-12-01,455624,440241,15383,3.4
42093,2019-12-01,9120,8771,349,3.8
42095,2019-12-01,163441,156126,7315,4.5
42097,2019-12-01,42894,40144,2750,6.4
42099,2019-12-01,24860,23853,1007,4.1
42101,2019-12-01,729738,690247,39491,5.4
42103,2019-12-01,25574,24036,1538,6
42105,2019-12-01,7282,6728,554,7.6
42107,2019-12-01,66833,63037,3796,5.7
42109,2019-12-01,20600,19346,1254,6.1
42111,2019-12-01,34177,31929,2248,6.6
42113,2019-12-01,2683,2493,190,7.1
42115,2019-12-01,20662,19634,1028,5
42117,2019-12-01,19371,18173,1198,6.2
42119,2019-12-01,19997,19148,849,4.2
42121,2019-12-01,22314,21128,1186,5.3
42123,2019-12-01,18903,17950,953,5
42125,2019-12-01,107957,102740,5217,4.8
42127,2019-12-01,22165,20889,1276,5.8
42129,2019-12-01,182547,173807,8740,4.8
42131,2019-12-01,13738,12996,742,5.4
42133,2019-12-01,237714,228723,8991,3.8
44001,2019-12-01,26188,25482,706,2.7
44003,2019-12-01,91457,88708,2749,3
44005,2019-12-01,44616,43340,1276,2.9
44007,2019-12-01,327222,316112,11110,3.4
44009,2019-12-01,69285,67329,1956,2.8
45001,2019-12-01,10138,9840,298,2.9
45003,2019-12-01,74745,72970,1775,2.4
45005,2019-12-01,2676,2543,133,5
45007,2019-12-01,91598,89575,2023,2.2
45009,2019-12-01,4945,4715,230,4.7
45011,2019-12-01,8187,7887,300,3.7
45013,2019-12-01,77375,75731,1644,2.1
45015,2019-12-01,104569,102348,2221,2.1
45017,2019-12-01,6596,6398,198,3
45019,2019-12-01,212623,208673,3950,1.9
45021,2019-12-01,25239,24562,677,2.7
45023,2019-12-01,13492,12996,496,3.7
45025,2019-12-01,22029,21488,541,2.5
45027,2019-12-01,12702,12272,430,3.4
45029,2019-12-01,16765,16315,450,2.7
45031,2019-12-01,30527,29673,854,2.8
45033,2019-12-01,13056,12601,455,3.5
45035,2019-12-01,78491,76917,1574,2
45037,2019-12-01,10712,10460,252,2.4
45039,2019-12-01,9613,9234,379,3.9
45041,2019-12-01,67226,65612,1614,2.4
45043,2019-12-01,25442,24595,847,3.3
45045,2019-12-01,256113,250986,5127,2
45047,2019-12-01,31607,30788,819,2.6
45049,2019-12-01,8383,8198,185,2.2
45051,2019-12-01,145007,140213,4794,3.3
45053,2019-12-01,12631,12372,259,2.1
45055,2019-12-01,29296,28555,741,2.5
45057,2019-12-01,41494,40297,1197,2.9
45059,2019-12-01,30322,29566,756,2.5
45061,2019-12-01,6651,6381,270,4.1
45063,2019-12-01,150174,147345,2829,1.9
45065,2019-12-01,3380,3293,87,2.6
45067,2019-12-01,12831,12390,441,3.4
45069,2019-12-01,9157,8814,343,3.7
45071,2019-12-01,19122,18680,442,2.3
45073,2019-12-01,35025,34247,778,2.2
45075,2019-12-01,34973,33531,1442,4.1
45077,2019-12-01,57692,56367,1325,2.3
45079,2019-12-01,198728,194263,4465,2.2
45081,2019-12-01,8918,8724,194,2.2
45083,2019-12-01,153496,150257,3239,2.1
45085,2019-12-01,43703,42381,1322,3
45087,2019-12-01,11669,11327,342,2.9
45089,2019-12-01,11886,11379,507,4.3
45091,2019-12-01,141013,137775,3238,2.3
46003,2019-12-01,1526,1479,47,3.1
46005,2019-12-01,9552,9244,308,3.2
46007,2019-12-01,1098,1040,58,5.3
46009,2019-12-01,2886,2780,106,3.7
46011,2019-12-01,19486,18767,719,3.7
46013,2019-12-01,20786,20119,667,3.2
46015,2019-12-01,2441,2364,77,3.2
46017,2019-12-01,675,630,45,6.7
46019,2019-12-01,5015,4809,206,4.1
46021,2019-12-01,792,761,31,3.9
46023,2019-12-01,3730,3575,155,4.2
46025,2019-12-01,1898,1840,58,3.1
46027,2019-12-01,7491,7206,285,3.8
46029,2019-12-01,15571,15066,505,3.2
46031,2019-12-01,1385,1314,71,5.1
46033,2019-12-01,3990,3788,202,5.1
46035,2019-12-01,11060,10697,363,3.3
46037,2019-12-01,2751,2609,142,5.2
46039,2019-12-01,2148,2027,121,5.6
46041,2019-12-01,2221,2066,155,7
46043,2019-12-01,1605,1553,52,3.2
46045,2019-12-01,2045,1979,66,3.2
46047,2019-12-01,2859,2736,123,4.3
46049,2019-12-01,1082,1045,37,3.4
46051,2019-12-01,4439,4287,152,3.4
46053,2019-12-01,2103,2026,77,3.7
46055,2019-12-01,1055,1021,34,3.2
46057,2019-12-01,3355,3245,110,3.3
46059,2019-12-01,1818,1765,53,2.9
46061,2019-12-01,1750,1655,95,5.4
46063,2019-12-01,739,718,21,2.8
46065,2019-12-01,9945,9679,266,2.7
46067,2019-12-01,3632,3498,134,3.7
46069,2019-12-01,685,659,26,3.8
46071,2019-12-01,1231,1154,77,6.3
46073,2019-12-01,1112,1083,29,2.6
46075,2019-12-01,533,514,19,3.6
46077,2019-12-01,2641,2564,77,2.9
46079,2019-12-01,6674,6431,243,3.6
46081,2019-12-01,13336,12881,455,3.4
46083,2019-12-01,34565,33628,937,2.7
46085,2019-12-01,1692,1613,79,4.7
46087,2019-12-01,3082,2985,97,3.1
46089,2019-12-01,1036,984,52,5
46091,2019-12-01,2418,2310,108,4.5
46093,2019-12-01,13950,13444,506,3.6
46095,2019-12-01,748,701,47,6.3
46097,2019-12-01,1192,1148,44,3.7
46099,2019-12-01,113127,109585,3542,3.1
46101,2019-12-01,3996,3864,132,3.3
46102,2019-12-01,3590,3232,358,10
46103,2019-12-01,56118,54069,2049,3.7
46105,2019-12-01,1427,1379,48,3.4
46107,2019-12-01,1049,1012,37,3.5
46109,2019-12-01,4888,4640,248,5.1
46111,2019-12-01,1166,1124,42,3.6
46115,2019-12-01,3181,3065,116,3.6
46117,2019-12-01,1836,1783,53,2.9
46119,2019-12-01,795,774,21,2.6
46121,2019-12-01,3161,2950,211,6.7
46123,2019-12-01,3090,2995,95,3.1
46125,2019-12-01,4692,4545,147,3.1
46127,2019-12-01,8527,8205,322,3.8
46129,2019-12-01,2124,2010,114,5.4
46135,2019-12-01,11926,11544,382,3.2
46137,2019-12-01,939,889,50,5.3
47001,2019-12-01,34972,33881,1091,3.1
47003,2019-12-01,21150,20437,713,3.4
47005,2019-12-01,6951,6651,300,4.3
47007,2019-12-01,4407,4183,224,5.1
47009,2019-12-01,64232,62392,1840,2.9
47011,2019-12-01,54415,52745,1670,3.1
47013,2019-12-01,14995,14361,634,4.2
47015,2019-12-01,6747,6566,181,2.7
47017,2019-12-01,12148,11583,565,4.7
47019,2019-12-01,24293,23404,889,3.7
47021,2019-12-01,22363,21845,518,2.3
47023,2019-12-01,8649,8390,259,3
47025,2019-12-01,13186,12687,499,3.8
47027,2019-12-01,2818,2651,167,5.9
47029,2019-12-01,15002,14393,609,4.1
47031,2019-12-01,25871,25025,846,3.3
47033,2019-12-01,7092,6864,228,3.2
47035,2019-12-01,23900,22666,1234,5.2
47037,2019-12-01,413927,404589,9338,2.3
47039,2019-12-01,4621,4386,235,5.1
47041,2019-12-01,7755,7455,300,3.9
47043,2019-12-01,27670,26940,730,2.6
47045,2019-12-01,16649,15910,739,4.4
47047,2019-12-01,19465,18783,682,3.5
47049,2019-12-01,7572,7266,306,4
47051,2019-12-01,20558,19864,694,3.4
47053,2019-12-01,22415,21533,882,3.9
47055,2019-12-01,15243,14632,611,4
47057,2019-12-01,9622,9263,359,3.7
47059,2019-12-01,29704,28338,1366,4.6
47061,2019-12-01,5024,4827,197,3.9
47063,2019-12-01,28675,27655,1020,3.6
47065,2019-12-01,185110,179449,5661,3.1
47067,2019-12-01,2122,2018,104,4.9
47069,2019-12-01,9610,9116,494,5.1
47071,2019-12-01,10545,10084,461,4.4
47073,2019-12-01,23932,22993,939,3.9
47075,2019-12-01,7799,7464,335,4.3
47077,2019-12-01,12344,11871,473,3.8
47079,2019-12-01,14341,13735,606,4.2
47081,2019-12-01,11692,11374,318,2.7
47083,2019-12-01,3295,3157,138,4.2
47085,2019-12-01,8998,8654,344,3.8
47087,2019-12-01,4745,4543,202,4.3
47089,2019-12-01,25007,24196,811,3.2
47091,2019-12-01,7798,7532,266,3.4
47093,2019-12-01,246664,240364,6300,2.6
47095,2019-12-01,1741,1653,88,5.1
47097,2019-12-01,9854,9360,494,5
47099,2019-12-01,19658,18948,710,3.6
47101,2019-12-01,5220,5056,164,3.1
47103,2019-12-01,16369,15369,1000,6.1
47105,2019-12-01,23789,23031,758,3.2
47107,2019-12-01,24157,23251,906,3.8
47109,2019-12-01,8744,8217,527,6
47111,2019-12-01,11551,11228,323,2.8
47113,2019-12-01,49527,47958,1569,3.2
47115,2019-12-01,12592,12057,535,4.2
47117,2019-12-01,15873,15312,561,3.5
47119,2019-12-01,50572,49208,1364,2.7
47121,2019-12-01,5357,5063,294,5.5
47123,2019-12-01,20338,19615,723,3.6
47125,2019-12-01,86734,83771,2963,3.4
47127,2019-12-01,3684,3577,107,2.9
47129,2019-12-01,7961,7683,278,3.5
47131,2019-12-01,12559,12026,533,4.2
47133,2019-12-01,10128,9805,323,3.2
47135,2019-12-01,3123,2973,150,4.8
47137,2019-12-01,2385,2275,110,4.6
47139,2019-12-01,7860,7568,292,3.7
47141,2019-12-01,35817,34716,1101,3.1
47143,2019-12-01,13704,12975,729,5.3
47145,2019-12-01,23662,22795,867,3.7
47147,2019-12-01,38971,37947,1024,2.6
47149,2019-12-01,188644,184350,4294,2.3
47151,2019-12-01,8293,7972,321,3.9
47153,2019-12-01,6226,5983,243,3.9
47155,2019-12-01,54840,53390,1450,2.6
47157,2019-12-01,451150,434557,16593,3.7
47159,2019-12-01,9674,9418,256,2.6
47161,2019-12-01,5569,5348,221,4
47163,2019-12-01,70675,68298,2377,3.4
47165,2019-12-01,104850,102286,2564,2.4
47167,2019-12-01,28577,27536,1041,3.6
47169,2019-12-01,5557,5405,152,2.7
47171,2019-12-01,7214,6872,342,4.7
47173,2019-12-01,7692,7414,278,3.6
47175,2019-12-01,2043,1965,78,3.8
47177,2019-12-01,16663,16047,616,3.7
47179,2019-12-01,61231,59308,1923,3.1
47181,2019-12-01,6266,5967,299,4.8
47183,2019-12-01,16184,15638,546,3.4
47185,2019-12-01,12437,12019,418,3.4
47187,2019-12-01,131381,128577,2804,2.1
47189,2019-12-01,78528,76639,1889,2.4
48001,2019-12-01,24104,23450,654,2.7
48003,2019-12-01,9829,9600,229,2.3
48005,2019-12-01,36017,34638,1379,3.8
48007,2019-12-01,9411,9036,375,4
48009,2019-12-01,4144,4036,108,2.6
48011,2019-12-01,933,908,25,2.7
48013,2019-12-01,21938,21201,737,3.4
48015,2019-12-01,14210,13749,461,3.2
48017,2019-12-01,2436,2364,72,3
48019,2019-12-01,10164,9869,295,2.9
48021,2019-12-01,43487,42291,1196,2.8
48023,2019-12-01,1792,1752,40,2.2
48025,2019-12-01,9837,9410,427,4.3
48027,2019-12-01,145296,140325,4971,3.4
48029,2019-12-01,960322,933181,27141,2.8
48031,2019-12-01,6515,6376,139,2.1
48033,2019-12-01,423,414,9,2.1
48035,2019-12-01,8322,8046,276,3.3
48037,2019-12-01,40043,38526,1517,3.8
48039,2019-12-01,181774,173972,7802,4.3
48041,2019-12-01,120803,117956,2847,2.4
48043,2019-12-01,4180,4075,105,2.5
48045,2019-12-01,573,555,18,3.1
48047,2019-12-01,2616,2485,131,5
48049,2019-12-01,15505,14950,555,3.6
48051,2019-12-01,8503,8240,263,3.1
48053,2019-12-01,23540,22958,582,2.5
48055,2019-12-01,19898,19326,572,2.9
48057,2019-12-01,12154,11739,415,3.4
48059,2019-12-01,6174,5994,180,2.9
48061,2019-12-01,167835,158333,9502,5.7
48063,2019-12-01,4992,4794,198,4
48065,2019-12-01,3017,2949,68,2.3
48067,2019-12-01,12401,11908,493,4
48069,2019-12-01,3370,3293,77,2.3
48071,2019-12-01,19708,18819,889,4.5
48073,2019-12-01,20927,20152,775,3.7
48075,2019-12-01,2905,2822,83,2.9
48077,2019-12-01,4932,4793,139,2.8
48079,2019-12-01,1108,1070,38,3.4
48081,2019-12-01,1461,1424,37,2.5
48083,2019-12-01,2873,2746,127,4.4
48085,2019-12-01,573039,557280,15759,2.8
48087,2019-12-01,1144,1106,38,3.3
48089,2019-12-01,9830,9546,284,2.9
48091,2019-12-01,74184,72165,2019,2.7
48093,2019-12-01,5624,5438,186,3.3
48095,2019-12-01,1330,1296,34,2.6
48097,2019-12-01,19767,19249,518,2.6
48099,2019-12-01,24366,23496,870,3.6
48101,2019-12-01,549,522,27,4.9
48103,2019-12-01,1588,1517,71,4.5
48105,2019-12-01,1625,1563,62,3.8
48107,2019-12-01,2476,2396,80,3.2
48109,2019-12-01,1056,1019,37,3.5
48111,2019-12-01,3842,3767,75,2
48113,2019-12-01,NA,NA,42730,3.1
48115,2019-12-01,4645,4468,177,3.8
48117,2019-12-01,8463,8253,210,2.5
48119,2019-12-01,2448,2368,80,3.3
48121,2019-12-01,503039,489671,13368,2.7
48123,2019-12-01,9786,9535,251,2.6
48125,2019-12-01,670,642,28,4.2
48127,2019-12-01,7259,7079,180,2.5
48129,2019-12-01,1390,1347,43,3.1
48131,2019-12-01,4919,4678,241,4.9
48133,2019-12-01,8163,7921,242,3
48135,2019-12-01,88129,85565,2564,2.9
48137,2019-12-01,1126,1108,18,1.6
48139,2019-12-01,94182,91598,2584,2.7
48141,2019-12-01,365817,352780,13037,3.6
48143,2019-12-01,20904,20251,653,3.1
48145,2019-12-01,6580,6382,198,3
48147,2019-12-01,17422,16997,425,2.4
48149,2019-12-01,12026,11740,286,2.4
48151,2019-12-01,1612,1575,37,2.3
48153,2019-12-01,2524,2427,97,3.8
48155,2019-12-01,582,567,15,2.6
48157,2019-12-01,395701,383009,12692,3.2
48159,2019-12-01,4608,4460,148,3.2
48161,2019-12-01,6363,6071,292,4.6
48163,2019-12-01,10330,10075,255,2.5
48165,2019-12-01,9792,9572,220,2.2
48167,2019-12-01,167164,160608,6556,3.9
48169,2019-12-01,2170,2108,62,2.9
48171,2019-12-01,13634,13348,286,2.1
48173,2019-12-01,790,775,15,1.9
48175,2019-12-01,3277,3166,111,3.4
48177,2019-12-01,9546,9304,242,2.5
48179,2019-12-01,8074,7792,282,3.5
48181,2019-12-01,64218,62354,1864,2.9
48183,2019-12-01,58262,56186,2076,3.6
48185,2019-12-01,11200,10782,418,3.7
48187,2019-12-01,82389,80227,2162,2.6
48189,2019-12-01,11939,11462,477,4
48191,2019-12-01,1050,1006,44,4.2
48193,2019-12-01,3655,3553,102,2.8
48195,2019-12-01,2733,2674,59,2.2
48197,2019-12-01,1714,1670,44,2.6
48199,2019-12-01,25331,24192,1139,4.5
48201,2019-12-01,NA,NA,85762,3.7
48203,2019-12-01,29512,28360,1152,3.9
48205,2019-12-01,2771,2727,44,1.6
48207,2019-12-01,2279,2214,65,2.9
48209,2019-12-01,121589,118563,3026,2.5
48211,2019-12-01,1902,1852,50,2.6
48213,2019-12-01,36649,35469,1180,3.2
48215,2019-12-01,361012,335734,25278,7
48217,2019-12-01,16493,15998,495,3
48219,2019-12-01,11184,10893,291,2.6
48221,2019-12-01,27914,27021,893,3.2
48223,2019-12-01,17530,17032,498,2.8
48225,2019-12-01,10466,10153,313,3
48227,2019-12-01,14107,13679,428,3
48229,2019-12-01,1831,1756,75,4.1
48231,2019-12-01,44133,42686,1447,3.3
48233,2019-12-01,8758,8365,393,4.5
48235,2019-12-01,757,741,16,2.1
48237,2019-12-01,3442,3336,106,3.1
48239,2019-12-01,7704,7484,220,2.9
48241,2019-12-01,12891,12049,842,6.5
48243,2019-12-01,991,961,30,3
48245,2019-12-01,107105,100882,6223,5.8
48247,2019-12-01,1874,1791,83,4.4
48249,2019-12-01,16647,15798,849,5.1
48251,2019-12-01,83241,80778,2463,3
48253,2019-12-01,5779,5547,232,4
48255,2019-12-01,7294,7124,170,2.3
48257,2019-12-01,65696,63739,1957,3
48259,2019-12-01,22345,21806,539,2.4
48261,2019-12-01,202,193,9,4.5
48263,2019-12-01,480,467,13,2.7
48265,2019-12-01,22355,21767,588,2.6
48267,2019-12-01,1843,1791,52,2.8
48269,2019-12-01,239,235,4,1.7
48271,2019-12-01,1385,1333,52,3.8
48273,2019-12-01,13571,13020,551,4.1
48275,2019-12-01,1421,1380,41,2.9
48277,2019-12-01,24216,23469,747,3.1
48279,2019-12-01,5264,5085,179,3.4
48281,2019-12-01,9305,9024,281,3
48283,2019-12-01,4312,4204,108,2.5
48285,2019-12-01,8455,8233,222,2.6
48287,2019-12-01,10003,9749,254,2.5
48289,2019-12-01,6350,6089,261,4.1
48291,2019-12-01,33552,31774,1778,5.3
48293,2019-12-01,8617,8298,319,3.7
48295,2019-12-01,1634,1599,35,2.1
48297,2019-12-01,5625,5466,159,2.8
48299,2019-12-01,8678,8399,279,3.2
48301,2019-12-01,681,677,4,0.6
48303,2019-12-01,158392,154507,3885,2.5
48305,2019-12-01,2768,2690,78,2.8
48307,2019-12-01,3360,3212,148,4.4
48309,2019-12-01,120036,116419,3617,3
48311,2019-12-01,886,873,13,1.5
48313,2019-12-01,4533,4357,176,3.9
48315,2019-12-01,4238,4045,193,4.6
48317,2019-12-01,2899,2816,83,2.9
48319,2019-12-01,1758,1703,55,3.1
48321,2019-12-01,16695,15669,1026,6.1
48323,2019-12-01,24169,22243,1926,8
48325,2019-12-01,22064,21416,648,2.9
48327,2019-12-01,875,848,27,3.1
48329,2019-12-01,107893,105706,2187,2
48331,2019-12-01,9690,9276,414,4.3
48333,2019-12-01,1916,1857,59,3.1
48335,2019-12-01,2325,2251,74,3.2
48337,2019-12-01,9360,9122,238,2.5
48339,2019-12-01,286787,277538,9249,3.2
48341,2019-12-01,10829,10587,242,2.2
48343,2019-12-01,4800,4539,261,5.4
48345,2019-12-01,474,459,15,3.2
48347,2019-12-01,28125,27162,963,3.4
48349,2019-12-01,24258,23570,688,2.8
48351,2019-12-01,5194,4862,332,6.4
48353,2019-12-01,7185,6994,191,2.7
48355,2019-12-01,167633,160846,6787,4
48357,2019-12-01,4305,4172,133,3.1
48359,2019-12-01,919,894,25,2.7
48361,2019-12-01,36434,34575,1859,5.1
48363,2019-12-01,13556,13176,380,2.8
48365,2019-12-01,10150,9750,400,3.9
48367,2019-12-01,68211,66372,1839,2.7
48369,2019-12-01,4855,4758,97,2
48371,2019-12-01,6316,6099,217,3.4
48373,2019-12-01,18199,17297,902,5
48375,2019-12-01,55554,54161,1393,2.5
48377,2019-12-01,3158,2891,267,8.5
48379,2019-12-01,6080,5916,164,2.7
48381,2019-12-01,72492,70933,1559,2.2
48383,2019-12-01,1926,1865,61,3.2
48385,2019-12-01,991,956,35,3.5
48387,2019-12-01,5140,4916,224,4.4
48389,2019-12-01,12031,11823,208,1.7
48391,2019-12-01,3123,3017,106,3.4
48393,2019-12-01,416,406,10,2.4
48395,2019-12-01,7753,7500,253,3.3
48397,2019-12-01,52962,51488,1474,2.8
48399,2019-12-01,4618,4498,120,2.6
48401,2019-12-01,23065,22247,818,3.5
48403,2019-12-01,3644,3403,241,6.6
48405,2019-12-01,3456,3270,186,5.4
48407,2019-12-01,11858,11300,558,4.7
48409,2019-12-01,29972,28314,1658,5.5
48411,2019-12-01,2601,2523,78,3
48413,2019-12-01,1307,1269,38,2.9
48415,2019-12-01,6737,6527,210,3.1
48417,2019-12-01,1890,1850,40,2.1
48419,2019-12-01,11208,10766,442,3.9
48421,2019-12-01,1360,1333,27,2
48423,2019-12-01,107966,104609,3357,3.1
48425,2019-12-01,4433,4274,159,3.6
48427,2019-12-01,25960,22741,3219,12.4
48429,2019-12-01,4049,3938,111,2.7
48431,2019-12-01,564,548,16,2.8
48433,2019-12-01,570,554,16,2.8
48435,2019-12-01,1292,1239,53,4.1
48437,2019-12-01,2591,2505,86,3.3
48439,2019-12-01,NA,NA,32172,2.9
48441,2019-12-01,67546,65805,1741,2.6
48443,2019-12-01,367,354,13,3.5
48445,2019-12-01,4918,4756,162,3.3
48447,2019-12-01,646,624,22,3.4
48449,2019-12-01,13083,12579,504,3.9
48451,2019-12-01,54431,52897,1534,2.8
48453,2019-12-01,751789,734410,17379,2.3
48455,2019-12-01,5305,5039,266,5
48457,2019-12-01,7159,6709,450,6.3
48459,2019-12-01,17913,17248,665,3.7
48461,2019-12-01,1674,1634,40,2.4
48463,2019-12-01,11347,10957,390,3.4
48465,2019-12-01,23166,22333,833,3.6
48467,2019-12-01,26106,25298,808,3.1
48469,2019-12-01,42931,41470,1461,3.4
48471,2019-12-01,24155,23315,840,3.5
48473,2019-12-01,23660,22830,830,3.5
48475,2019-12-01,7551,7374,177,2.3
48477,2019-12-01,15304,14852,452,3
48479,2019-12-01,119349,115066,4283,3.6
48481,2019-12-01,21809,21075,734,3.4
48483,2019-12-01,2261,2195,66,2.9
48485,2019-12-01,56462,54817,1645,2.9
48487,2019-12-01,4960,4789,171,3.4
48489,2019-12-01,6664,6181,483,7.2
48491,2019-12-01,318437,310403,8034,2.5
48493,2019-12-01,25162,24509,653,2.6
48495,2019-12-01,4041,3915,126,3.1
48497,2019-12-01,32283,31322,961,3
48499,2019-12-01,17788,17126,662,3.7
48501,2019-12-01,3653,3544,109,3
48503,2019-12-01,8037,7814,223,2.8
48505,2019-12-01,4885,4601,284,5.8
48507,2019-12-01,3398,3125,273,8
49001,2019-12-01,2716,2650,66,2.4
49003,2019-12-01,25963,25382,581,2.2
49005,2019-12-01,65771,64658,1113,1.7
49007,2019-12-01,8493,8219,274,3.2
49009,2019-12-01,339,326,13,3.8
49011,2019-12-01,175052,171603,3449,2
49013,2019-12-01,7775,7496,279,3.6
49015,2019-12-01,4263,4100,163,3.8
49017,2019-12-01,2314,2097,217,9.4
49019,2019-12-01,5585,5257,328,5.9
49021,2019-12-01,24759,24181,578,2.3
49023,2019-12-01,5837,5716,121,2.1
49025,2019-12-01,3551,3448,103,2.9
49027,2019-12-01,5773,5647,126,2.2
49029,2019-12-01,5589,5480,109,2
49031,2019-12-01,475,452,23,4.8
49033,2019-12-01,973,938,35,3.6
49035,2019-12-01,645033,631786,13247,2.1
49037,2019-12-01,5431,5136,295,5.4
49039,2019-12-01,12349,12002,347,2.8
49041,2019-12-01,9619,9353,266,2.8
49043,2019-12-01,26909,26434,475,1.8
49045,2019-12-01,34574,33758,816,2.4
49047,2019-12-01,13551,12979,572,4.2
49049,2019-12-01,313739,307545,6194,2
49051,2019-12-01,16791,16413,378,2.3
49053,2019-12-01,76389,74466,1923,2.5
49055,2019-12-01,1305,1193,112,8.6
49057,2019-12-01,128336,125299,3037,2.4
50001,2019-12-01,20180,19752,428,2.1
50003,2019-12-01,17892,17370,522,2.9
50005,2019-12-01,14234,13864,370,2.6
50007,2019-12-01,94900,93396,1504,1.6
50009,2019-12-01,2631,2549,82,3.1
50011,2019-12-01,26804,26240,564,2.1
50013,2019-12-01,4013,3871,142,3.5
50015,2019-12-01,13782,13398,384,2.8
50017,2019-12-01,15724,15387,337,2.1
50019,2019-12-01,13305,12780,525,3.9
50021,2019-12-01,30231,29520,711,2.4
50023,2019-12-01,34304,33623,681,2
50025,2019-12-01,21896,21414,482,2.2
50027,2019-12-01,28723,28210,513,1.8
51001,2019-12-01,16588,15996,592,3.6
51003,2019-12-01,57881,56748,1133,2
51005,2019-12-01,6902,6665,237,3.4
51007,2019-12-01,6403,6224,179,2.8
51009,2019-12-01,15060,14623,437,2.9
51011,2019-12-01,7190,6960,230,3.2
51013,2019-12-01,156564,154142,2422,1.5
51015,2019-12-01,38007,37254,753,2
51017,2019-12-01,2515,2459,56,2.2
51019,2019-12-01,38503,37530,973,2.5
51021,2019-12-01,2882,2793,89,3.1
51023,2019-12-01,17447,17068,379,2.2
51025,2019-12-01,5996,5759,237,4
51027,2019-12-01,6701,6295,406,6.1
51029,2019-12-01,6563,6275,288,4.4
51031,2019-12-01,25970,25277,693,2.7
51033,2019-12-01,15486,15044,442,2.9
51035,2019-12-01,13337,12781,556,4.2
51036,2019-12-01,3729,3620,109,2.9
51037,2019-12-01,5335,5146,189,3.5
51041,2019-12-01,190107,185622,4485,2.4
51043,2019-12-01,7747,7595,152,2
51045,2019-12-01,2301,2243,58,2.5
51047,2019-12-01,25029,24490,539,2.2
51049,2019-12-01,4635,4514,121,2.6
51051,2019-12-01,4799,4540,259,5.4
51053,2019-12-01,13876,13497,379,2.7
51057,2019-12-01,5513,5334,179,3.2
51059,2019-12-01,644145,632136,12009,1.9
51061,2019-12-01,37909,37179,730,1.9
51063,2019-12-01,8455,8216,239,2.8
51065,2019-12-01,14053,13794,259,1.8
51067,2019-12-01,26551,25827,724,2.7
51069,2019-12-01,48791,47825,966,2
51071,2019-12-01,8153,7807,346,4.2
51073,2019-12-01,19721,19287,434,2.2
51075,2019-12-01,11382,11131,251,2.2
51077,2019-12-01,8068,7821,247,3.1
51079,2019-12-01,10629,10421,208,2
51081,2019-12-01,4299,4171,128,3
51083,2019-12-01,15494,14934,560,3.6
51085,2019-12-01,60102,58892,1210,2
51087,2019-12-01,184449,180049,4400,2.4
51089,2019-12-01,23667,22942,725,3.1
51091,2019-12-01,1264,1223,41,3.2
51093,2019-12-01,19617,19117,500,2.5
51095,2019-12-01,36763,35957,806,2.2
51097,2019-12-01,3923,3829,94,2.4
51099,2019-12-01,13579,13267,312,2.3
51101,2019-12-01,9311,9091,220,2.4
51103,2019-12-01,5503,5298,205,3.7
51105,2019-12-01,8303,7970,333,4
51107,2019-12-01,225748,221462,4286,1.9
51109,2019-12-01,20087,19619,468,2.3
51111,2019-12-01,5330,5182,148,2.8
51113,2019-12-01,7596,7463,133,1.8
51115,2019-12-01,4158,4064,94,2.3
51117,2019-12-01,12439,11951,488,3.9
51119,2019-12-01,5300,5179,121,2.3
51121,2019-12-01,50945,49677,1268,2.5
51125,2019-12-01,7567,7405,162,2.1
51127,2019-12-01,12662,12415,247,2
51131,2019-12-01,5525,5288,237,4.3
51133,2019-12-01,5792,5584,208,3.6
51135,2019-12-01,7360,7177,183,2.5
51137,2019-12-01,17585,17150,435,2.5
51139,2019-12-01,12043,11522,521,4.3
51141,2019-12-01,7160,6952,208,2.9
51143,2019-12-01,30315,29429,886,2.9
51145,2019-12-01,14366,14043,323,2.2
51147,2019-12-01,10245,9895,350,3.4
51149,2019-12-01,15289,14845,444,2.9
51153,2019-12-01,248978,243685,5293,2.1
51155,2019-12-01,16803,15832,971,5.8
51157,2019-12-01,3772,3700,72,1.9
51159,2019-12-01,4130,4024,106,2.6
51161,2019-12-01,49438,48306,1132,2.3
51163,2019-12-01,10729,10483,246,2.3
51165,2019-12-01,42928,42129,799,1.9
51167,2019-12-01,11238,10789,449,4
51169,2019-12-01,9159,8925,234,2.6
51171,2019-12-01,22454,21986,468,2.1
51173,2019-12-01,13846,13353,493,3.6
51175,2019-12-01,9224,8992,232,2.5
51177,2019-12-01,67981,66327,1654,2.4
51179,2019-12-01,73004,71316,1688,2.3
51181,2019-12-01,3666,3553,113,3.1
51183,2019-12-01,3917,3757,160,4.1
51185,2019-12-01,15644,14970,674,4.3
51187,2019-12-01,20727,20247,480,2.3
51191,2019-12-01,26848,26070,778,2.9
51193,2019-12-01,9616,9288,328,3.4
51195,2019-12-01,13409,12837,572,4.3
51197,2019-12-01,14086,13379,707,5
51199,2019-12-01,32891,32159,732,2.2
51510,2019-12-01,102848,100983,1865,1.8
51520,2019-12-01,7217,6978,239,3.3
51530,2019-12-01,3506,3422,84,2.4
51540,2019-12-01,26660,26170,490,1.8
51550,2019-12-01,123210,120143,3067,2.5
51570,2019-12-01,8921,8675,246,2.8
51580,2019-12-01,2396,2288,108,4.5
51590,2019-12-01,19368,18510,858,4.4
51595,2019-12-01,2287,2191,96,4.2
51600,2019-12-01,13641,13405,236,1.7
51610,2019-12-01,8723,8576,147,1.7
51620,2019-12-01,3599,3456,143,4
51630,2019-12-01,14322,13916,406,2.8
51640,2019-12-01,2907,2822,85,2.9
51650,2019-12-01,64646,62436,2210,3.4
51660,2019-12-01,25439,24804,635,2.5
51670,2019-12-01,9838,9427,411,4.2
51678,2019-12-01,2063,1981,82,4
51680,2019-12-01,36265,35091,1174,3.2
51683,2019-12-01,22339,21888,451,2
51685,2019-12-01,9502,9316,186,2
51690,2019-12-01,5487,5265,222,4
51700,2019-12-01,89151,86393,2758,3.1
51710,2019-12-01,111990,108587,3403,3
51720,2019-12-01,1684,1628,56,3.3
51730,2019-12-01,13190,12514,676,5.1
51735,2019-12-01,6443,6306,137,2.1
51740,2019-12-01,44488,42877,1611,3.6
51750,2019-12-01,8784,8494,290,3.3
51760,2019-12-01,119856,116483,3373,2.8
51770,2019-12-01,49181,47848,1333,2.7
51775,2019-12-01,12962,12655,307,2.4
51790,2019-12-01,12361,12083,278,2.2
51800,2019-12-01,44826,43636,1190,2.7
51810,2019-12-01,234164,228643,5521,2.4
51820,2019-12-01,10793,10527,266,2.5
51830,2019-12-01,6687,6484,203,3
51840,2019-12-01,15023,14673,350,2.3
53001,2019-12-01,8916,8238,678,7.6
53003,2019-12-01,10718,10305,413,3.9
53005,2019-12-01,104514,99030,5484,5.2
53007,2019-12-01,43733,41462,2271,5.2
53009,2019-12-01,29222,27467,1755,6
53011,2019-12-01,248649,238263,10386,4.2
53013,2019-12-01,1872,1769,103,5.5
53015,2019-12-01,48780,46121,2659,5.5
53017,2019-12-01,21388,20127,1261,5.9
53019,2019-12-01,2415,2143,272,11.3
53021,2019-12-01,42375,39338,3037,7.2
53023,2019-12-01,906,854,52,5.7
53025,2019-12-01,44287,40334,3953,8.9
53027,2019-12-01,29407,27344,2063,7
53029,2019-12-01,37517,35849,1668,4.4
53031,2019-12-01,13335,12673,662,5
53033,2019-12-01,NA,NA,31686,2.5
53035,2019-12-01,133330,128105,5225,3.9
53037,2019-12-01,23687,22459,1228,5.2
53039,2019-12-01,9826,9253,573,5.8
53041,2019-12-01,35394,33329,2065,5.8
53043,2019-12-01,5003,4755,248,5
53045,2019-12-01,26437,24974,1463,5.5
53047,2019-12-01,19101,17564,1537,8
53049,2019-12-01,8596,8008,588,6.8
53051,2019-12-01,5262,4824,438,8.3
53053,2019-12-01,454337,433261,21076,4.6
53055,2019-12-01,8396,8096,300,3.6
53057,2019-12-01,64046,60677,3369,5.3
53059,2019-12-01,5684,5404,280,4.9
53061,2019-12-01,438317,426131,12186,2.8
53063,2019-12-01,262855,250149,12706,4.8
53065,2019-12-01,19605,18238,1367,7
53067,2019-12-01,146960,140647,6313,4.3
53069,2019-12-01,1387,1296,91,6.6
53071,2019-12-01,30288,28840,1448,4.8
53073,2019-12-01,117044,111560,5484,4.7
53075,2019-12-01,24593,23662,931,3.8
53077,2019-12-01,128962,118684,10278,8
54001,2019-12-01,7374,6914,460,6.2
54003,2019-12-01,59885,58109,1776,3
54005,2019-12-01,7421,6989,432,5.8
54007,2019-12-01,5262,4780,482,9.2
54009,2019-12-01,9986,9453,533,5.3
54011,2019-12-01,41681,40109,1572,3.8
54013,2019-12-01,2660,2198,462,17.4
54015,2019-12-01,3175,2848,327,10.3
54017,2019-12-01,4012,3812,200,5
54019,2019-12-01,16246,15228,1018,6.3
54021,2019-12-01,2458,2259,199,8.1
54023,2019-12-01,5835,5509,326,5.6
54025,2019-12-01,15702,14968,734,4.7
54027,2019-12-01,10736,10345,391,3.6
54029,2019-12-01,13091,12403,688,5.3
54031,2019-12-01,5757,5452,305,5.3
54033,2019-12-01,34841,33243,1598,4.6
54035,2019-12-01,13288,12576,712,5.4
54037,2019-12-01,30087,29259,828,2.8
54039,2019-12-01,81728,78124,3604,4.4
54041,2019-12-01,6648,6138,510,7.7
54043,2019-12-01,7265,6796,469,6.5
54045,2019-12-01,11234,10517,717,6.4
54047,2019-12-01,4461,4048,413,9.3
54049,2019-12-01,25632,24357,1275,5
54051,2019-12-01,14369,13388,981,6.8
54053,2019-12-01,10183,9589,594,5.8
54055,2019-12-01,21118,19963,1155,5.5
54057,2019-12-01,12625,11878,747,5.9
54059,2019-12-01,6919,6388,531,7.7
54061,2019-12-01,55312,53466,1846,3.3
54063,2019-12-01,5978,5673,305,5.1
54065,2019-12-01,8105,7829,276,3.4
54067,2019-12-01,9608,8854,754,7.8
54069,2019-12-01,21417,20447,970,4.5
54071,2019-12-01,3664,3506,158,4.3
54073,2019-12-01,2974,2741,233,7.8
54075,2019-12-01,4053,3844,209,5.2
54077,2019-12-01,15687,14967,720,4.6
54079,2019-12-01,26846,25759,1087,4
54081,2019-12-01,30292,28870,1422,4.7
54083,2019-12-01,12313,11506,807,6.6
54085,2019-12-01,4406,4118,288,6.5
54087,2019-12-01,5203,4654,549,10.6
54089,2019-12-01,4281,4032,249,5.8
54091,2019-12-01,7938,7556,382,4.8
54093,2019-12-01,3354,3146,208,6.2
54095,2019-12-01,3122,2868,254,8.1
54097,2019-12-01,9454,8835,619,6.5
54099,2019-12-01,15931,15071,860,5.4
54101,2019-12-01,3351,3059,292,8.7
54103,2019-12-01,6732,6195,537,8
54105,2019-12-01,2332,2121,211,9
54107,2019-12-01,37041,35194,1847,5
54109,2019-12-01,6654,6206,448,6.7
55001,2019-12-01,8056,7590,466,5.8
55003,2019-12-01,7794,7427,367,4.7
55005,2019-12-01,24352,23227,1125,4.6
55007,2019-12-01,7615,7101,514,6.7
55009,2019-12-01,141028,136950,4078,2.9
55011,2019-12-01,6527,6203,324,5
55013,2019-12-01,7048,6639,409,5.8
55015,2019-12-01,27410,26694,716,2.6
55017,2019-12-01,33535,32023,1512,4.5
55019,2019-12-01,17952,17341,611,3.4
55021,2019-12-01,31850,30902,948,3
55023,2019-12-01,7716,7342,374,4.8
55025,2019-12-01,323111,316196,6915,2.1
55027,2019-12-01,47286,45843,1443,3.1
55029,2019-12-01,14243,13601,642,4.5
55031,2019-12-01,22800,21776,1024,4.5
55033,2019-12-01,24581,23707,874,3.6
55035,2019-12-01,58787,57080,1707,2.9
55037,2019-12-01,2211,2096,115,5.2
55039,2019-12-01,56847,55325,1522,2.7
55041,2019-12-01,4020,3795,225,5.6
55043,2019-12-01,28579,27670,909,3.2
55045,2019-12-01,21282,20713,569,2.7
55047,2019-12-01,9209,8821,388,4.2
55049,2019-12-01,13949,13559,390,2.8
55051,2019-12-01,2551,2390,161,6.3
55053,2019-12-01,10159,9691,468,4.6
55055,2019-12-01,45666,44340,1326,2.9
55057,2019-12-01,13367,12880,487,3.6
55059,2019-12-01,87938,84718,3220,3.7
55061,2019-12-01,11093,10751,342,3.1
55063,2019-12-01,66275,64492,1783,2.7
55065,2019-12-01,10269,10005,264,2.6
55067,2019-12-01,9299,8859,440,4.7
55069,2019-12-01,15014,14442,572,3.8
55071,2019-12-01,40589,39099,1490,3.7
55073,2019-12-01,73837,71815,2022,2.7
55075,2019-12-01,19429,18392,1037,5.3
55077,2019-12-01,7766,7420,346,4.5
55078,2019-12-01,1602,1497,105,6.6
55079,2019-12-01,462660,445927,16733,3.6
55081,2019-12-01,23224,22515,709,3.1
55083,2019-12-01,20673,19874,799,3.9
55085,2019-12-01,17381,16484,897,5.2
55087,2019-12-01,102182,99313,2869,2.8
55089,2019-12-01,48770,47560,1210,2.5
55091,2019-12-01,4088,3925,163,4
55093,2019-12-01,25345,24422,923,3.6
55095,2019-12-01,24608,23422,1186,4.8
55097,2019-12-01,38944,37680,1264,3.2
55099,2019-12-01,6522,6217,305,4.7
55101,2019-12-01,97092,93408,3684,3.8
55103,2019-12-01,9223,8952,271,2.9
55105,2019-12-01,84511,81527,2984,3.5
55107,2019-12-01,6734,6401,333,4.9
55109,2019-12-01,50308,48493,1815,3.6
55111,2019-12-01,35126,34052,1074,3.1
55113,2019-12-01,7785,7353,432,5.5
55115,2019-12-01,21071,20394,677,3.2
55117,2019-12-01,60696,59078,1618,2.7
55119,2019-12-01,11041,10561,480,4.3
55121,2019-12-01,15977,15353,624,3.9
55123,2019-12-01,15365,14821,544,3.5
55125,2019-12-01,9822,9273,549,5.6
55127,2019-12-01,57596,55872,1724,3
55129,2019-12-01,7757,7426,331,4.3
55131,2019-12-01,76628,74666,1962,2.6
55133,2019-12-01,223011,217182,5829,2.6
55135,2019-12-01,25627,24778,849,3.3
55137,2019-12-01,11422,10952,470,4.1
55139,2019-12-01,91003,88444,2559,2.8
55141,2019-12-01,35122,33812,1310,3.7
56001,2019-12-01,20632,20072,560,2.7
56003,2019-12-01,5262,5066,196,3.7
56005,2019-12-01,23483,22744,739,3.1
56007,2019-12-01,7891,7605,286,3.6
56009,2019-12-01,8928,8662,266,3
56011,2019-12-01,3660,3551,109,3
56013,2019-12-01,18735,17841,894,4.8
56015,2019-12-01,6680,6453,227,3.4
56017,2019-12-01,2137,2051,86,4
56019,2019-12-01,4073,3921,152,3.7
56021,2019-12-01,48232,46586,1646,3.4
56023,2019-12-01,8707,8400,307,3.5
56025,2019-12-01,39229,37593,1636,4.2
56027,2019-12-01,1217,1176,41,3.4
56029,2019-12-01,14721,14074,647,4.4
56031,2019-12-01,4486,4303,183,4.1
56033,2019-12-01,15540,15011,529,3.4
56035,2019-12-01,4098,3892,206,5
56037,2019-12-01,21232,20272,960,4.5
56039,2019-12-01,14971,14530,441,2.9
56041,2019-12-01,8880,8528,352,4
56043,2019-12-01,3953,3811,142,3.6
56045,2019-12-01,3793,3696,97,2.6
72001,2019-12-01,4154,3399,755,18.2
72003,2019-12-01,11355,10086,1269,11.2
72005,2019-12-01,13870,12317,1553,11.2
72007,2019-12-01,6261,5647,614,9.8
72009,2019-12-01,6238,5542,696,11.2
72011,2019-12-01,8405,7607,798,9.5
72013,2019-12-01,23317,20754,2563,11
72015,2019-12-01,4503,3791,712,15.8
72017,2019-12-01,5696,5002,694,12.2
72019,2019-12-01,7136,6454,682,9.6
72021,2019-12-01,62242,57905,4337,7
72023,2019-12-01,13057,11842,1215,9.3
72025,2019-12-01,45476,42158,3318,7.3
72027,2019-12-01,9212,8323,889,9.7
72029,2019-12-01,15289,14190,1099,7.2
72031,2019-12-01,58554,54744,3810,6.5
72033,2019-12-01,7469,6873,596,8
72035,2019-12-01,15386,14181,1205,7.8
72037,2019-12-01,3503,3157,346,9.9
72039,2019-12-01,3597,3151,446,12.4
72041,2019-12-01,14728,13684,1044,7.1
72043,2019-12-01,9759,8435,1324,13.6
72045,2019-12-01,4720,4247,473,10
72047,2019-12-01,8577,7749,828,9.7
72049,2019-12-01,878,844,34,3.9
72051,2019-12-01,12591,11777,814,6.5
72053,2019-12-01,10413,9289,1124,10.8
72054,2019-12-01,3169,2812,357,11.3
72055,2019-12-01,4011,3361,650,16.2
72057,2019-12-01,10533,9155,1378,13.1
72059,2019-12-01,4782,4045,737,15.4
72061,2019-12-01,35754,34085,1669,4.7
72063,2019-12-01,17146,16125,1021,6
72065,2019-12-01,13585,11463,2122,15.6
72067,2019-12-01,5139,4648,491,9.6
72069,2019-12-01,16402,14671,1731,10.6
72071,2019-12-01,11947,10769,1178,9.9
72073,2019-12-01,4117,3492,625,15.2
72075,2019-12-01,14465,12941,1524,10.5
72077,2019-12-01,11752,10669,1083,9.2
72079,2019-12-01,5051,4394,657,13
72081,2019-12-01,7021,5845,1176,16.7
72083,2019-12-01,2531,2206,325,12.8
72085,2019-12-01,10807,9752,1055,9.8
72087,2019-12-01,8116,7368,748,9.2
72089,2019-12-01,5920,5310,610,10.3
72091,2019-12-01,11122,10149,973,8.7
72093,2019-12-01,1872,1592,280,15
72095,2019-12-01,2830,2375,455,16.1
72097,2019-12-01,20723,18467,2256,10.9
72099,2019-12-01,10007,8858,1149,11.5
72101,2019-12-01,7634,6881,753,9.9
72103,2019-12-01,7798,7052,746,9.6
72105,2019-12-01,6791,6138,653,9.6
72107,2019-12-01,4791,4236,555,11.6
72109,2019-12-01,4176,3437,739,17.7
72111,2019-12-01,5723,4847,876,15.3
72113,2019-12-01,43811,39310,4501,10.3
72115,2019-12-01,5876,5130,746,12.7
72117,2019-12-01,4700,3858,842,17.9
72119,2019-12-01,16134,14867,1267,7.9
72121,2019-12-01,5897,5124,773,13.1
72123,2019-12-01,6892,5782,1110,16.1
72125,2019-12-01,9305,8231,1074,11.5
72127,2019-12-01,127695,119714,7981,6.3
72129,2019-12-01,11193,10124,1069,9.6
72131,2019-12-01,10166,8599,1567,15.4
72133,2019-12-01,8670,7519,1151,13.3
72135,2019-12-01,25770,24182,1588,6.2
72137,2019-12-01,27811,26032,1779,6.4
72139,2019-12-01,25706,24353,1353,5.3
72141,2019-12-01,6447,5605,842,13.1
72143,2019-12-01,9356,8462,894,9.6
72145,2019-12-01,12680,11363,1317,10.4
72147,2019-12-01,2494,2321,173,6.9
72149,2019-12-01,7372,6048,1324,18
72151,2019-12-01,8539,7284,1255,14.7
72153,2019-12-01,9719,8152,1567,16.1
01001,2020-01-01,25912,25125,787,3
01003,2020-01-01,95316,92389,2927,3.1
01005,2020-01-01,8509,8186,323,3.8
01007,2020-01-01,8629,8342,287,3.3
01009,2020-01-01,25098,24352,746,3
01011,2020-01-01,4674,4480,194,4.2
01013,2020-01-01,9155,8772,383,4.2
01015,2020-01-01,46059,44315,1744,3.8
01017,2020-01-01,15698,15187,511,3.3
01019,2020-01-01,11373,10991,382,3.4
01021,2020-01-01,19591,19032,559,2.9
01023,2020-01-01,4511,4269,242,5.4
01025,2020-01-01,7406,6947,459,6.2
01027,2020-01-01,6065,5867,198,3.3
01029,2020-01-01,5682,5490,192,3.4
01031,2020-01-01,21004,20349,655,3.1
01033,2020-01-01,23275,22298,977,4.2
01035,2020-01-01,4440,4248,192,4.3
01037,2020-01-01,4452,4297,155,3.5
01039,2020-01-01,15313,14758,555,3.6
01041,2020-01-01,6257,6040,217,3.5
01043,2020-01-01,38433,37341,1092,2.8
01045,2020-01-01,20496,19837,659,3.2
01047,2020-01-01,14490,13687,803,5.5
01049,2020-01-01,30600,29625,975,3.2
01051,2020-01-01,37258,36157,1101,3
01053,2020-01-01,14629,14071,558,3.8
01055,2020-01-01,42809,41025,1784,4.2
01057,2020-01-01,6517,6290,227,3.5
01059,2020-01-01,14531,14077,454,3.1
01061,2020-01-01,10869,10522,347,3.2
01063,2020-01-01,2848,2681,167,5.9
01065,2020-01-01,6055,5792,263,4.3
01067,2020-01-01,6878,6619,259,3.8
01069,2020-01-01,46058,44592,1466,3.2
01071,2020-01-01,23006,22148,858,3.7
01073,2020-01-01,317192,307572,9620,3
01075,2020-01-01,5796,5603,193,3.3
01077,2020-01-01,41767,40315,1452,3.5
01079,2020-01-01,14238,13762,476,3.3
01081,2020-01-01,76569,74372,2197,2.9
01083,2020-01-01,43891,42673,1218,2.8
01085,2020-01-01,3523,3325,198,5.6
01087,2020-01-01,7761,7427,334,4.3
01089,2020-01-01,185774,180806,4968,2.7
01091,2020-01-01,7580,7278,302,4
01093,2020-01-01,12661,12163,498,3.9
01095,2020-01-01,43607,42436,1171,2.7
01097,2020-01-01,188015,180522,7493,4
01099,2020-01-01,7392,6993,399,5.4
01101,2020-01-01,104878,101390,3488,3.3
01103,2020-01-01,58214,56599,1615,2.8
01105,2020-01-01,3329,3155,174,5.2
01107,2020-01-01,7902,7616,286,3.6
01109,2020-01-01,15361,14824,537,3.5
01111,2020-01-01,9530,9216,314,3.3
01113,2020-01-01,23690,22940,750,3.2
01115,2020-01-01,40279,39119,1160,2.9
01117,2020-01-01,115350,112620,2730,2.4
01119,2020-01-01,4709,4504,205,4.4
01121,2020-01-01,35396,34082,1314,3.7
01123,2020-01-01,18248,17625,623,3.4
01125,2020-01-01,105582,102633,2949,2.8
01127,2020-01-01,25271,24297,974,3.9
01129,2020-01-01,6737,6402,335,5
01131,2020-01-01,2758,2512,246,8.9
01133,2020-01-01,10008,9631,377,3.8
02013,2020-01-01,1810,1734,76,4.2
02016,2020-01-01,3963,3830,133,3.4
02020,2020-01-01,144538,137112,7426,5.1
02050,2020-01-01,6866,5990,876,12.8
02060,2020-01-01,243,209,34,14
02068,2020-01-01,547,439,108,19.7
02070,2020-01-01,1765,1611,154,8.7
02090,2020-01-01,43217,40674,2543,5.9
02100,2020-01-01,889,747,142,16
02105,2020-01-01,1046,878,168,16.1
02110,2020-01-01,16310,15541,769,4.7
02122,2020-01-01,25758,23758,2000,7.8
02130,2020-01-01,6322,5826,496,7.8
02150,2020-01-01,5744,5306,438,7.6
02158,2020-01-01,2642,2156,486,18.4
02164,2020-01-01,606,539,67,11.1
02170,2020-01-01,46577,43126,3451,7.4
02180,2020-01-01,4137,3717,420,10.2
02185,2020-01-01,3592,3380,212,5.9
02188,2020-01-01,2828,2447,381,13.5
02195,2020-01-01,1615,1466,149,9.2
02198,2020-01-01,3004,2722,282,9.4
02220,2020-01-01,4111,3910,201,4.9
02230,2020-01-01,597,477,120,20.1
02240,2020-01-01,2814,2537,277,9.8
02261,2020-01-01,4242,3787,455,10.7
02275,2020-01-01,1036,953,83,8
02282,2020-01-01,261,230,31,11.9
02290,2020-01-01,2362,2037,325,13.8
04001,2020-01-01,20785,18490,2295,11
04003,2020-01-01,51901,48897,3004,5.8
04005,2020-01-01,77687,72788,4899,6.3
04007,2020-01-01,21565,20325,1240,5.8
04009,2020-01-01,15417,14640,777,5
04011,2020-01-01,4585,4413,172,3.8
04012,2020-01-01,9751,9168,583,6
04013,2020-01-01,NA,NA,93919,4
04015,2020-01-01,89027,83775,5252,5.9
04017,2020-01-01,40989,37667,3322,8.1
04019,2020-01-01,504206,481622,22584,4.5
04021,2020-01-01,192010,182584,9426,4.9
04023,2020-01-01,20067,18466,1601,8
04025,2020-01-01,107379,102552,4827,4.5
04027,2020-01-01,100806,87020,13786,13.7
05001,2020-01-01,9260,8924,336,3.6
05003,2020-01-01,7675,7131,544,7.1
05005,2020-01-01,16005,15255,750,4.7
05007,2020-01-01,137257,133215,4042,2.9
05009,2020-01-01,15882,15266,616,3.9
05011,2020-01-01,4491,4284,207,4.6
05013,2020-01-01,2436,2312,124,5.1
05015,2020-01-01,12291,11744,547,4.5
05017,2020-01-01,3244,2959,285,8.8
05019,2020-01-01,9520,9124,396,4.2
05021,2020-01-01,5581,5247,334,6
05023,2020-01-01,8993,8478,515,5.7
05025,2020-01-01,3179,3015,164,5.2
05027,2020-01-01,9109,8658,451,5
05029,2020-01-01,8256,7846,410,5
05031,2020-01-01,55856,54045,1811,3.2
05033,2020-01-01,26619,25597,1022,3.8
05035,2020-01-01,21248,20242,1006,4.7
05037,2020-01-01,7326,6968,358,4.9
05039,2020-01-01,2815,2675,140,5
05041,2020-01-01,5309,5028,281,5.3
05043,2020-01-01,7883,7402,481,6.1
05045,2020-01-01,61559,59407,2152,3.5
05047,2020-01-01,7394,7108,286,3.9
05049,2020-01-01,4918,4697,221,4.5
05051,2020-01-01,40802,39115,1687,4.1
05053,2020-01-01,8319,7996,323,3.9
05055,2020-01-01,20018,19194,824,4.1
05057,2020-01-01,9816,9376,440,4.5
05059,2020-01-01,13840,13294,546,3.9
05061,2020-01-01,5726,5493,233,4.1
05063,2020-01-01,16491,15736,755,4.6
05065,2020-01-01,4787,4474,313,6.5
05067,2020-01-01,5813,5380,433,7.4
05069,2020-01-01,27208,25509,1699,6.2
05071,2020-01-01,10172,9681,491,4.8
05073,2020-01-01,2452,2318,134,5.5
05075,2020-01-01,6834,6510,324,4.7
05077,2020-01-01,2845,2664,181,6.4
05079,2020-01-01,3897,3683,214,5.5
05081,2020-01-01,5528,5254,274,5
05083,2020-01-01,8487,8034,453,5.3
05085,2020-01-01,33986,32760,1226,3.6
05087,2020-01-01,7432,7223,209,2.8
05089,2020-01-01,6596,6274,322,4.9
05091,2020-01-01,19707,18830,877,4.5
05093,2020-01-01,17055,16062,993,5.8
05095,2020-01-01,2768,2630,138,5
05097,2020-01-01,2877,2701,176,6.1
05099,2020-01-01,3588,3440,148,4.1
05101,2020-01-01,3326,3165,161,4.8
05103,2020-01-01,9739,9181,558,5.7
05105,2020-01-01,4227,4024,203,4.8
05107,2020-01-01,6335,5868,467,7.4
05109,2020-01-01,4209,4010,199,4.7
05111,2020-01-01,10379,9929,450,4.3
05113,2020-01-01,8152,7667,485,5.9
05115,2020-01-01,28533,27127,1406,4.9
05117,2020-01-01,3537,3383,154,4.4
05119,2020-01-01,187545,180280,7265,3.9
05121,2020-01-01,7356,7006,350,4.8
05123,2020-01-01,8076,7611,465,5.8
05125,2020-01-01,58243,56352,1891,3.2
05127,2020-01-01,4301,4129,172,4
05129,2020-01-01,2794,2618,176,6.3
05131,2020-01-01,56107,53894,2213,3.9
05133,2020-01-01,5479,5174,305,5.6
05135,2020-01-01,5666,5325,341,6
05137,2020-01-01,4556,4284,272,6
05139,2020-01-01,15801,14781,1020,6.5
05141,2020-01-01,5652,5311,341,6
05143,2020-01-01,124899,121521,3378,2.7
05145,2020-01-01,33578,31757,1821,5.4
05147,2020-01-01,2749,2584,165,6
05149,2020-01-01,8320,7956,364,4.4
06001,2020-01-01,841256,815549,25707,3.1
06003,2020-01-01,652,622,30,4.6
06005,2020-01-01,14858,14158,700,4.7
06007,2020-01-01,97828,92380,5448,5.6
06009,2020-01-01,21564,20634,930,4.3
06011,2020-01-01,10872,8786,2086,19.2
06013,2020-01-01,559573,541551,18022,3.2
06015,2020-01-01,9637,9007,630,6.5
06017,2020-01-01,92211,88755,3456,3.7
06019,2020-01-01,452463,415814,36649,8.1
06021,2020-01-01,13224,12256,968,7.3
06023,2020-01-01,61835,59314,2521,4.1
06025,2020-01-01,72432,59415,13017,18
06027,2020-01-01,8703,8364,339,3.9
06029,2020-01-01,396113,362164,33949,8.6
06031,2020-01-01,58130,52666,5464,9.4
06033,2020-01-01,29119,27369,1750,6
06035,2020-01-01,9890,9333,557,5.6
06037,2020-01-01,NA,NA,253528,4.9
06039,2020-01-01,63353,58229,5124,8.1
06041,2020-01-01,139813,136458,3355,2.4
06043,2020-01-01,7037,6595,442,6.3
06045,2020-01-01,38310,36465,1845,4.8
06047,2020-01-01,115164,103893,11271,9.8
06049,2020-01-01,3086,2786,300,9.7
06051,2020-01-01,9120,8798,322,3.5
06053,2020-01-01,214066,193310,20756,9.7
06055,2020-01-01,72496,69957,2539,3.5
06057,2020-01-01,49120,47324,1796,3.7
06059,2020-01-01,NA,NA,46574,2.9
06061,2020-01-01,188371,182162,6209,3.3
06063,2020-01-01,7494,6705,789,10.5
06065,2020-01-01,NA,NA,46839,4.2
06067,2020-01-01,714155,686476,27679,3.9
06069,2020-01-01,31509,29552,1957,6.2
06071,2020-01-01,969995,932074,37921,3.9
06073,2020-01-01,NA,NA,52875,3.3
06075,2020-01-01,586524,573037,13487,2.3
06077,2020-01-01,325129,303299,21830,6.7
06079,2020-01-01,141151,136743,4408,3.1
06081,2020-01-01,462412,452570,9842,2.1
06083,2020-01-01,214297,204278,10019,4.7
06085,2020-01-01,NA,NA,27669,2.6
06087,2020-01-01,139625,131047,8578,6.1
06089,2020-01-01,74561,70562,3999,5.4
06091,2020-01-01,1316,1234,82,6.2
06093,2020-01-01,17063,15645,1418,8.3
06095,2020-01-01,208963,200517,8446,4
06097,2020-01-01,258202,250592,7610,2.9
06099,2020-01-01,243344,227272,16072,6.6
06101,2020-01-01,46474,42413,4061,8.7
06103,2020-01-01,25712,24083,1629,6.3
06105,2020-01-01,4434,4128,306,6.9
06107,2020-01-01,204455,182017,22438,11
06109,2020-01-01,21457,20405,1052,4.9
06111,2020-01-01,423012,406575,16437,3.9
06113,2020-01-01,108995,103603,5392,4.9
06115,2020-01-01,30949,28776,2173,7
08001,2020-01-01,278584,270063,8521,3.1
08003,2020-01-01,8428,8097,331,3.9
08005,2020-01-01,372450,362251,10199,2.7
08007,2020-01-01,6673,6435,238,3.6
08009,2020-01-01,2086,2044,42,2
08011,2020-01-01,1839,1785,54,2.9
08013,2020-01-01,196326,191678,4648,2.4
08014,2020-01-01,40970,39968,1002,2.4
08015,2020-01-01,9533,9270,263,2.8
08017,2020-01-01,1178,1159,19,1.6
08019,2020-01-01,6155,6015,140,2.3
08021,2020-01-01,4010,3847,163,4.1
08023,2020-01-01,1846,1770,76,4.1
08025,2020-01-01,1514,1442,72,4.8
08027,2020-01-01,1988,1924,64,3.2
08029,2020-01-01,14247,13662,585,4.1
08031,2020-01-01,426054,414195,11859,2.8
08033,2020-01-01,1119,1075,44,3.9
08035,2020-01-01,198184,193584,4600,2.3
08037,2020-01-01,39414,38614,800,2
08039,2020-01-01,15418,15060,358,2.3
08041,2020-01-01,343516,332208,11308,3.3
08043,2020-01-01,14862,14131,731,4.9
08045,2020-01-01,33557,32496,1061,3.2
08047,2020-01-01,3854,3764,90,2.3
08049,2020-01-01,10470,10234,236,2.3
08051,2020-01-01,11766,11514,252,2.1
08053,2020-01-01,352,338,14,4
08055,2020-01-01,2414,2235,179,7.4
08057,2020-01-01,918,894,24,2.6
08059,2020-01-01,342203,333361,8842,2.6
08061,2020-01-01,936,923,13,1.4
08063,2020-01-01,4277,4197,80,1.9
08065,2020-01-01,5363,5257,106,2
08067,2020-01-01,31340,30448,892,2.8
08069,2020-01-01,207424,202150,5274,2.5
08071,2020-01-01,6434,6189,245,3.8
08073,2020-01-01,2317,2248,69,3
08075,2020-01-01,10851,10565,286,2.6
08077,2020-01-01,75380,72294,3086,4.1
08079,2020-01-01,566,553,13,2.3
08081,2020-01-01,7401,7105,296,4
08083,2020-01-01,12512,11834,678,5.4
08085,2020-01-01,21684,20951,733,3.4
08087,2020-01-01,16310,15879,431,2.6
08089,2020-01-01,8356,8010,346,4.1
08091,2020-01-01,2334,2258,76,3.3
08093,2020-01-01,11350,11065,285,2.5
08095,2020-01-01,2505,2462,43,1.7
08097,2020-01-01,11476,11198,278,2.4
08099,2020-01-01,6237,6074,163,2.6
08101,2020-01-01,76303,73071,3232,4.2
08103,2020-01-01,2940,2830,110,3.7
08105,2020-01-01,5330,5055,275,5.2
08107,2020-01-01,17397,17036,361,2.1
08109,2020-01-01,3539,3374,165,4.7
08111,2020-01-01,525,508,17,3.2
08113,2020-01-01,6613,6497,116,1.8
08115,2020-01-01,1240,1211,29,2.3
08117,2020-01-01,26192,25777,415,1.6
08119,2020-01-01,12831,12433,398,3.1
08121,2020-01-01,2814,2752,62,2.2
08123,2020-01-01,171078,166391,4687,2.7
08125,2020-01-01,5700,5593,107,1.9
09001,2020-01-01,482608,461524,21084,4.4
09003,2020-01-01,485367,463800,21567,4.4
09005,2020-01-01,105903,101206,4697,4.4
09007,2020-01-01,94519,90691,3828,4
09009,2020-01-01,463126,441901,21225,4.6
09011,2020-01-01,137222,131116,6106,4.4
09013,2020-01-01,87656,84116,3540,4
09015,2020-01-01,64413,61304,3109,4.8
10001,2020-01-01,80865,77207,3658,4.5
10003,2020-01-01,299783,287848,11935,4
10005,2020-01-01,105892,100843,5049,4.8
11001,2020-01-01,421801,400775,21026,5
12001,2020-01-01,141104,136947,4157,2.9
12003,2020-01-01,11981,11597,384,3.2
12005,2020-01-01,81787,78840,2947,3.6
12007,2020-01-01,11232,10870,362,3.2
12009,2020-01-01,286381,277148,9233,3.2
12011,2020-01-01,NA,NA,31507,3
12013,2020-01-01,4792,4607,185,3.9
12015,2020-01-01,73176,70541,2635,3.6
12017,2020-01-01,47294,44963,2331,4.9
12019,2020-01-01,108777,105444,3333,3.1
12021,2020-01-01,184804,179273,5531,3
12023,2020-01-01,30163,29202,961,3.2
12027,2020-01-01,15023,14503,520,3.5
12029,2020-01-01,5885,5653,232,3.9
12031,2020-01-01,496515,480562,15953,3.2
12033,2020-01-01,146089,141184,4905,3.4
12035,2020-01-01,47182,45380,1802,3.8
12037,2020-01-01,4479,4341,138,3.1
12039,2020-01-01,18874,18112,762,4
12041,2020-01-01,7232,6983,249,3.4
12043,2020-01-01,5569,5361,208,3.7
12045,2020-01-01,5587,5356,231,4.1
12047,2020-01-01,4208,4011,197,4.7
12049,2020-01-01,8992,8596,396,4.4
12051,2020-01-01,16087,15264,823,5.1
12053,2020-01-01,72560,69515,3045,4.2
12055,2020-01-01,36540,34884,1656,4.5
12057,2020-01-01,757966,734996,22970,3
12059,2020-01-01,6998,6733,265,3.8
12061,2020-01-01,66238,63779,2459,3.7
12063,2020-01-01,17117,16498,619,3.6
12065,2020-01-01,5643,5458,185,3.3
12067,2020-01-01,2885,2798,87,3
12069,2020-01-01,160209,154961,5248,3.3
12071,2020-01-01,354113,343111,11002,3.1
12073,2020-01-01,156161,151293,4868,3.1
12075,2020-01-01,16808,16192,616,3.7
12077,2020-01-01,2651,2561,90,3.4
12079,2020-01-01,7494,7225,269,3.6
12081,2020-01-01,182288,176612,5676,3.1
12083,2020-01-01,138389,133040,5349,3.9
12085,2020-01-01,74972,72636,2336,3.1
12086,2020-01-01,NA,NA,25413,1.8
12087,2020-01-01,47890,46897,993,2.1
12089,2020-01-01,41645,40389,1256,3
12091,2020-01-01,95461,92745,2716,2.8
12093,2020-01-01,18158,17592,566,3.1
12095,2020-01-01,767583,745197,22386,2.9
12097,2020-01-01,185467,179322,6145,3.3
12099,2020-01-01,737808,714271,23537,3.2
12101,2020-01-01,240208,231759,8449,3.5
12103,2020-01-01,498586,483666,14920,3
12105,2020-01-01,308117,296848,11269,3.7
12107,2020-01-01,26578,25368,1210,4.6
12109,2020-01-01,133919,130325,3594,2.7
12111,2020-01-01,146507,140839,5668,3.9
12113,2020-01-01,82993,80463,2530,3
12115,2020-01-01,191451,185521,5930,3.1
12117,2020-01-01,257223,249675,7548,2.9
12119,2020-01-01,33067,31530,1537,4.6
12121,2020-01-01,17961,17326,635,3.5
12123,2020-01-01,8125,7839,286,3.5
12125,2020-01-01,4680,4538,142,3
12127,2020-01-01,255325,246362,8963,3.5
12129,2020-01-01,14992,14552,440,2.9
12131,2020-01-01,31164,30229,935,3
12133,2020-01-01,9573,9226,347,3.6
13001,2020-01-01,9933,9556,377,3.8
13003,2020-01-01,5093,4954,139,2.7
13005,2020-01-01,5069,4880,189,3.7
13007,2020-01-01,1240,1188,52,4.2
13009,2020-01-01,17600,16795,805,4.6
13011,2020-01-01,9862,9577,285,2.9
13013,2020-01-01,40897,39719,1178,2.9
13015,2020-01-01,51285,49518,1767,3.4
13017,2020-01-01,5328,5021,307,5.8
13019,2020-01-01,7707,7354,353,4.6
13021,2020-01-01,68066,65486,2580,3.8
13023,2020-01-01,4514,4292,222,4.9
13025,2020-01-01,7230,6937,293,4.1
13027,2020-01-01,7163,6903,260,3.6
13029,2020-01-01,18213,17646,567,3.1
13031,2020-01-01,36430,35049,1381,3.8
13033,2020-01-01,9315,8819,496,5.3
13035,2020-01-01,10882,10518,364,3.3
13037,2020-01-01,2425,2338,87,3.6
13039,2020-01-01,20901,20132,769,3.7
13043,2020-01-01,5713,5554,159,2.8
13045,2020-01-01,55925,53953,1972,3.5
13047,2020-01-01,33725,32707,1018,3
13049,2020-01-01,4875,4689,186,3.8
13051,2020-01-01,138885,134229,4656,3.4
13053,2020-01-01,2009,1923,86,4.3
13055,2020-01-01,10320,9822,498,4.8
13057,2020-01-01,137076,133387,3689,2.7
13059,2020-01-01,59317,57259,2058,3.5
13061,2020-01-01,924,855,69,7.5
13063,2020-01-01,139442,133537,5905,4.2
13065,2020-01-01,2642,2536,106,4
13067,2020-01-01,429391,416642,12749,3
13069,2020-01-01,19155,18353,802,4.2
13071,2020-01-01,22076,21410,666,3
13073,2020-01-01,75359,73021,2338,3.1
13075,2020-01-01,8182,7902,280,3.4
13077,2020-01-01,75465,73252,2213,2.9
13079,2020-01-01,5652,5471,181,3.2
13081,2020-01-01,9632,9232,400,4.2
13083,2020-01-01,8229,7954,275,3.3
13085,2020-01-01,12452,12102,350,2.8
13087,2020-01-01,11921,11468,453,3.8
13089,2020-01-01,403372,389576,13796,3.4
13091,2020-01-01,7043,6646,397,5.6
13093,2020-01-01,5234,5035,199,3.8
13095,2020-01-01,38804,36948,1856,4.8
13097,2020-01-01,73950,71347,2603,3.5
13099,2020-01-01,4537,4345,192,4.2
13101,2020-01-01,2021,1962,59,2.9
13103,2020-01-01,30772,29864,908,3
13105,2020-01-01,7697,7367,330,4.3
13107,2020-01-01,8484,8051,433,5.1
13109,2020-01-01,4969,4797,172,3.5
13111,2020-01-01,11402,11013,389,3.4
13113,2020-01-01,58579,56872,1707,2.9
13115,2020-01-01,44580,42857,1723,3.9
13117,2020-01-01,123329,120053,3276,2.7
13119,2020-01-01,10054,9675,379,3.8
13121,2020-01-01,562727,543329,19398,3.4
13123,2020-01-01,11802,11383,419,3.6
13125,2020-01-01,1304,1252,52,4
13127,2020-01-01,38821,37499,1322,3.4
13129,2020-01-01,28449,27419,1030,3.6
13131,2020-01-01,10594,10234,360,3.4
13133,2020-01-01,6959,6684,275,4
13135,2020-01-01,494212,479378,14834,3
13137,2020-01-01,19171,18411,760,4
13139,2020-01-01,103144,100274,2870,2.8
13141,2020-01-01,2546,2398,148,5.8
13143,2020-01-01,12681,12255,426,3.4
13145,2020-01-01,16663,16147,516,3.1
13147,2020-01-01,11149,10690,459,4.1
13149,2020-01-01,5338,5146,192,3.6
13151,2020-01-01,116829,112777,4052,3.5
13153,2020-01-01,70799,68490,2309,3.3
13155,2020-01-01,3451,3279,172,5
13157,2020-01-01,36695,35700,995,2.7
13159,2020-01-01,7050,6829,221,3.1
13161,2020-01-01,6119,5831,288,4.7
13163,2020-01-01,6774,6430,344,5.1
13165,2020-01-01,3112,2967,145,4.7
13167,2020-01-01,4042,3881,161,4
13169,2020-01-01,13801,13362,439,3.2
13171,2020-01-01,8316,7983,333,4
13173,2020-01-01,3796,3641,155,4.1
13175,2020-01-01,19031,18083,948,5
13177,2020-01-01,14921,14449,472,3.2
13179,2020-01-01,26403,25393,1010,3.8
13181,2020-01-01,3649,3485,164,4.5
13183,2020-01-01,8295,8004,291,3.5
13185,2020-01-01,51677,49776,1901,3.7
13187,2020-01-01,16713,16204,509,3
13189,2020-01-01,8905,8442,463,5.2
13191,2020-01-01,6169,5964,205,3.3
13193,2020-01-01,4869,4650,219,4.5
13195,2020-01-01,13351,12928,423,3.2
13197,2020-01-01,3316,3171,145,4.4
13199,2020-01-01,9009,8636,373,4.1
13201,2020-01-01,2850,2752,98,3.4
13205,2020-01-01,8851,8431,420,4.7
13207,2020-01-01,13086,12659,427,3.3
13209,2020-01-01,3838,3659,179,4.7
13211,2020-01-01,9407,9116,291,3.1
13213,2020-01-01,15559,14696,863,5.5
13215,2020-01-01,77121,73701,3420,4.4
13217,2020-01-01,52779,50804,1975,3.7
13219,2020-01-01,19571,19088,483,2.5
13221,2020-01-01,7038,6809,229,3.3
13223,2020-01-01,87006,84398,2608,3
13225,2020-01-01,11986,11520,466,3.9
13227,2020-01-01,15440,14975,465,3
13229,2020-01-01,8835,8541,294,3.3
13231,2020-01-01,9024,8737,287,3.2
13233,2020-01-01,18602,17895,707,3.8
13235,2020-01-01,4120,3965,155,3.8
13237,2020-01-01,8253,7896,357,4.3
13239,2020-01-01,793,757,36,4.5
13241,2020-01-01,6893,6641,252,3.7
13243,2020-01-01,2612,2496,116,4.4
13245,2020-01-01,85540,81508,4032,4.7
13247,2020-01-01,45219,43508,1711,3.8
13249,2020-01-01,2243,2161,82,3.7
13251,2020-01-01,5090,4868,222,4.4
13253,2020-01-01,3092,2960,132,4.3
13255,2020-01-01,29018,27859,1159,4
13257,2020-01-01,10622,10199,423,4
13259,2020-01-01,2468,2369,99,4
13261,2020-01-01,13068,12401,667,5.1
13263,2020-01-01,2800,2691,109,3.9
13265,2020-01-01,571,537,34,6
13267,2020-01-01,9851,9461,390,4
13269,2020-01-01,3209,3099,110,3.4
13271,2020-01-01,4149,3746,403,9.7
13273,2020-01-01,3555,3390,165,4.6
13275,2020-01-01,16406,15748,658,4
13277,2020-01-01,20236,19563,673,3.3
13279,2020-01-01,11799,11215,584,4.9
13281,2020-01-01,3801,3609,192,5.1
13283,2020-01-01,2649,2501,148,5.6
13285,2020-01-01,37502,36360,1142,3
13287,2020-01-01,3242,3090,152,4.7
13289,2020-01-01,2925,2749,176,6
13291,2020-01-01,10360,10011,349,3.4
13293,2020-01-01,11501,11071,430,3.7
13295,2020-01-01,31544,30488,1056,3.3
13297,2020-01-01,46568,45135,1433,3.1
13299,2020-01-01,15816,15216,600,3.8
13301,2020-01-01,2890,2768,122,4.2
13303,2020-01-01,7052,6732,320,4.5
13305,2020-01-01,11311,10848,463,4.1
13307,2020-01-01,1047,998,49,4.7
13309,2020-01-01,1666,1541,125,7.5
13311,2020-01-01,16271,15842,429,2.6
13313,2020-01-01,43889,41408,2481,5.7
13315,2020-01-01,2782,2664,118,4.2
13317,2020-01-01,3871,3673,198,5.1
13319,2020-01-01,4022,3871,151,3.8
13321,2020-01-01,9089,8753,336,3.7
15001,2020-01-01,91811,88567,3244,3.5
15003,2020-01-01,457022,444395,12627,2.8
15007,2020-01-01,36927,35833,1094,3
15009,2020-01-01,87694,85215,2479,2.8
16001,2020-01-01,258097,250900,7197,2.8
16003,2020-01-01,1667,1542,125,7.5
16005,2020-01-01,42944,41477,1467,3.4
16007,2020-01-01,2901,2780,121,4.2
16009,2020-01-01,4132,3898,234,5.7
16011,2020-01-01,23329,22536,793,3.4
16013,2020-01-01,12656,12279,377,3
16015,2020-01-01,3600,3414,186,5.2
16017,2020-01-01,20433,19377,1056,5.2
16019,2020-01-01,58116,56412,1704,2.9
16021,2020-01-01,5245,4952,293,5.6
16023,2020-01-01,1396,1345,51,3.7
16025,2020-01-01,685,663,22,3.2
16027,2020-01-01,105469,101366,4103,3.9
16029,2020-01-01,4046,3897,149,3.7
16031,2020-01-01,12051,11707,344,2.9
16033,2020-01-01,357,338,19,5.3
16035,2020-01-01,2804,2621,183,6.5
16037,2020-01-01,1997,1884,113,5.7
16039,2020-01-01,11431,10995,436,3.8
16041,2020-01-01,6999,6815,184,2.6
16043,2020-01-01,7742,7453,289,3.7
16045,2020-01-01,8369,8033,336,4
16047,2020-01-01,8118,7837,281,3.5
16049,2020-01-01,6401,6046,355,5.5
16051,2020-01-01,14101,13676,425,3
16053,2020-01-01,12105,11708,397,3.3
16055,2020-01-01,80656,76901,3755,4.7
16057,2020-01-01,20908,20308,600,2.9
16059,2020-01-01,3459,3233,226,6.5
16061,2020-01-01,1570,1461,109,6.9
16063,2020-01-01,2718,2591,127,4.7
16065,2020-01-01,21741,21291,450,2.1
16067,2020-01-01,11236,10874,362,3.2
16069,2020-01-01,21446,20670,776,3.6
16071,2020-01-01,2286,2219,67,2.9
16073,2020-01-01,5196,4953,243,4.7
16075,2020-01-01,11497,11016,481,4.2
16077,2020-01-01,3802,3623,179,4.7
16079,2020-01-01,5153,4787,366,7.1
16081,2020-01-01,6318,6174,144,2.3
16083,2020-01-01,41560,40090,1470,3.5
16085,2020-01-01,5624,5371,253,4.5
16087,2020-01-01,4578,4368,210,4.6
17001,2020-01-01,31648,30590,1058,3.3
17003,2020-01-01,2036,1922,114,5.6
17005,2020-01-01,7666,7378,288,3.8
17007,2020-01-01,26142,23607,2535,9.7
17009,2020-01-01,2944,2878,66,2.2
17011,2020-01-01,16793,15862,931,5.5
17013,2020-01-01,2289,2182,107,4.7
17015,2020-01-01,7125,6788,337,4.7
17017,2020-01-01,6002,5751,251,4.2
17019,2020-01-01,105273,101731,3542,3.4
17021,2020-01-01,13963,13256,707,5.1
17023,2020-01-01,7441,7095,346,4.6
17025,2020-01-01,6309,5998,311,4.9
17027,2020-01-01,20280,19626,654,3.2
17029,2020-01-01,23909,23084,825,3.5
17031,2020-01-01,NA,NA,92517,3.6
17033,2020-01-01,8498,8136,362,4.3
17035,2020-01-01,6081,5872,209,3.4
17037,2020-01-01,54922,52458,2464,4.5
17039,2020-01-01,7250,6949,301,4.2
17041,2020-01-01,9936,9612,324,3.3
17043,2020-01-01,496735,482721,14014,2.8
17045,2020-01-01,8525,8179,346,4.1
17047,2020-01-01,2619,2503,116,4.4
17049,2020-01-01,19217,18595,622,3.2
17051,2020-01-01,9626,9175,451,4.7
17053,2020-01-01,6127,5847,280,4.6
17055,2020-01-01,15998,15167,831,5.2
17057,2020-01-01,14852,13962,890,6
17059,2020-01-01,2309,2193,116,5
17061,2020-01-01,5827,5581,246,4.2
17063,2020-01-01,24982,23719,1263,5.1
17065,2020-01-01,4335,4187,148,3.4
17067,2020-01-01,8063,7679,384,4.8
17069,2020-01-01,1287,1201,86,6.7
17071,2020-01-01,3465,3293,172,5
17073,2020-01-01,24574,23333,1241,5.1
17075,2020-01-01,13822,13132,690,5
17077,2020-01-01,27376,26425,951,3.5
17079,2020-01-01,4661,4460,201,4.3
17081,2020-01-01,17240,16521,719,4.2
17083,2020-01-01,10934,10457,477,4.4
17085,2020-01-01,10356,9790,566,5.5
17087,2020-01-01,4170,3927,243,5.8
17089,2020-01-01,272714,259845,12869,4.7
17091,2020-01-01,55939,52918,3021,5.4
17093,2020-01-01,67283,64940,2343,3.5
17095,2020-01-01,21038,20025,1013,4.8
17097,2020-01-01,371213,354917,16296,4.4
17099,2020-01-01,54389,51196,3193,5.9
17101,2020-01-01,5811,5520,291,5
17103,2020-01-01,17604,16886,718,4.1
17105,2020-01-01,16040,15342,698,4.4
17107,2020-01-01,12293,11792,501,4.1
17109,2020-01-01,12999,12492,507,3.9
17111,2020-01-01,162258,156451,5807,3.6
17113,2020-01-01,86598,83713,2885,3.3
17115,2020-01-01,47733,45306,2427,5.1
17117,2020-01-01,22780,21825,955,4.2
17119,2020-01-01,134051,129205,4846,3.6
17121,2020-01-01,17205,16473,732,4.3
17123,2020-01-01,5169,4893,276,5.3
17125,2020-01-01,6166,5811,355,5.8
17127,2020-01-01,5629,5328,301,5.3
17129,2020-01-01,6395,6124,271,4.2
17131,2020-01-01,7973,7486,487,6.1
17133,2020-01-01,18735,18205,530,2.8
17135,2020-01-01,11484,10792,692,6
17137,2020-01-01,16091,15416,675,4.2
17139,2020-01-01,7468,7240,228,3.1
17141,2020-01-01,24225,22772,1453,6
17143,2020-01-01,83643,79142,4501,5.4
17145,2020-01-01,8225,7854,371,4.5
17147,2020-01-01,8240,7947,293,3.6
17149,2020-01-01,6667,6343,324,4.9
17151,2020-01-01,1657,1570,87,5.3
17153,2020-01-01,1923,1803,120,6.2
17155,2020-01-01,3095,2901,194,6.3
17157,2020-01-01,14146,13629,517,3.7
17159,2020-01-01,7111,6836,275,3.9
17161,2020-01-01,70708,67171,3537,5
17163,2020-01-01,126396,121306,5090,4
17165,2020-01-01,9525,9004,521,5.5
17167,2020-01-01,99493,95679,3814,3.8
17169,2020-01-01,3105,2959,146,4.7
17171,2020-01-01,2462,2327,135,5.5
17173,2020-01-01,10371,9947,424,4.1
17175,2020-01-01,2421,2280,141,5.8
17177,2020-01-01,21225,20181,1044,4.9
17179,2020-01-01,62654,59675,2979,4.8
17181,2020-01-01,7371,6929,442,6
17183,2020-01-01,32407,30821,1586,4.9
17185,2020-01-01,5865,5681,184,3.1
17187,2020-01-01,8168,7850,318,3.9
17189,2020-01-01,9680,9447,233,2.4
17191,2020-01-01,6775,6480,295,4.4
17193,2020-01-01,6454,6219,235,3.6
17195,2020-01-01,28191,26936,1255,4.5
17197,2020-01-01,350497,336465,14032,4
17199,2020-01-01,31505,30172,1333,4.2
17201,2020-01-01,136441,125915,10526,7.7
17203,2020-01-01,18285,17601,684,3.7
18001,2020-01-01,16917,16413,504,3
18003,2020-01-01,186225,179876,6349,3.4
18005,2020-01-01,45195,43941,1254,2.8
18007,2020-01-01,4556,4408,148,3.2
18009,2020-01-01,4824,4600,224,4.6
18011,2020-01-01,36390,35421,969,2.7
18013,2020-01-01,7785,7509,276,3.5
18015,2020-01-01,10366,10013,353,3.4
18017,2020-01-01,17707,16983,724,4.1
18019,2020-01-01,62053,59922,2131,3.4
18021,2020-01-01,12010,11537,473,3.9
18023,2020-01-01,17016,16514,502,3
18025,2020-01-01,4901,4601,300,6.1
18027,2020-01-01,16749,16245,504,3
18029,2020-01-01,25884,24853,1031,4
18031,2020-01-01,14805,14319,486,3.3
18033,2020-01-01,22750,22054,696,3.1
18035,2020-01-01,54379,52115,2264,4.2
18037,2020-01-01,22959,22345,614,2.7
18039,2020-01-01,111926,108538,3388,3
18041,2020-01-01,8546,8115,431,5
18043,2020-01-01,41909,40511,1398,3.3
18045,2020-01-01,7905,7601,304,3.8
18047,2020-01-01,11161,10730,431,3.9
18049,2020-01-01,9555,9153,402,4.2
18051,2020-01-01,19652,19091,561,2.9
18053,2020-01-01,30661,29410,1251,4.1
18055,2020-01-01,13699,13061,638,4.7
18057,2020-01-01,184725,179840,4885,2.6
18059,2020-01-01,40457,39212,1245,3.1
18061,2020-01-01,20448,19729,719,3.5
18063,2020-01-01,90451,87898,2553,2.8
18065,2020-01-01,22040,21229,811,3.7
18067,2020-01-01,37113,35559,1554,4.2
18069,2020-01-01,18088,17447,641,3.5
18071,2020-01-01,22973,22323,650,2.8
18073,2020-01-01,16285,15495,790,4.9
18075,2020-01-01,9329,9003,326,3.5
18077,2020-01-01,14997,14427,570,3.8
18079,2020-01-01,13601,13075,526,3.9
18081,2020-01-01,83411,80968,2443,2.9
18083,2020-01-01,18274,17651,623,3.4
18085,2020-01-01,41858,40566,1292,3.1
18087,2020-01-01,19642,19104,538,2.7
18089,2020-01-01,230994,218654,12340,5.3
18091,2020-01-01,47539,45262,2277,4.8
18093,2020-01-01,21292,20397,895,4.2
18095,2020-01-01,59676,57103,2573,4.3
18097,2020-01-01,493512,476853,16659,3.4
18099,2020-01-01,22762,21956,806,3.5
18101,2020-01-01,5380,5223,157,2.9
18103,2020-01-01,15051,14401,650,4.3
18105,2020-01-01,71425,68947,2478,3.5
18107,2020-01-01,18662,18046,616,3.3
18109,2020-01-01,36615,35326,1289,3.5
18111,2020-01-01,6930,6596,334,4.8
18113,2020-01-01,23218,22415,803,3.5
18115,2020-01-01,3208,3078,130,4.1
18117,2020-01-01,8814,8476,338,3.8
18119,2020-01-01,9526,9113,413,4.3
18121,2020-01-01,6851,6556,295,4.3
18123,2020-01-01,9195,8861,334,3.6
18125,2020-01-01,6177,5927,250,4
18127,2020-01-01,87134,83349,3785,4.3
18129,2020-01-01,13546,13134,412,3
18131,2020-01-01,6410,6150,260,4.1
18133,2020-01-01,16834,16206,628,3.7
18135,2020-01-01,10917,10427,490,4.5
18137,2020-01-01,14163,13636,527,3.7
18139,2020-01-01,8763,8497,266,3
18141,2020-01-01,135921,130498,5423,4
18143,2020-01-01,10604,10224,380,3.6
18145,2020-01-01,23272,22523,749,3.2
18147,2020-01-01,10169,9772,397,3.9
18149,2020-01-01,9662,9169,493,5.1
18151,2020-01-01,20826,20221,605,2.9
18153,2020-01-01,8333,7934,399,4.8
18155,2020-01-01,4931,4748,183,3.7
18157,2020-01-01,101370,98217,3153,3.1
18159,2020-01-01,9069,8802,267,2.9
18161,2020-01-01,3540,3413,127,3.6
18163,2020-01-01,94529,91401,3128,3.3
18165,2020-01-01,6964,6561,403,5.8
18167,2020-01-01,48161,45958,2203,4.6
18169,2020-01-01,14820,14296,524,3.5
18171,2020-01-01,4164,4028,136,3.3
18173,2020-01-01,33074,32015,1059,3.2
18175,2020-01-01,13693,13175,518,3.8
18177,2020-01-01,30578,29403,1175,3.8
18179,2020-01-01,14393,13935,458,3.2
18181,2020-01-01,13298,12896,402,3
18183,2020-01-01,17750,17193,557,3.1
19001,2020-01-01,4253,4128,125,2.9
19003,2020-01-01,2190,2138,52,2.4
19005,2020-01-01,7600,7168,432,5.7
19007,2020-01-01,6047,5780,267,4.4
19009,2020-01-01,3153,3045,108,3.4
19011,2020-01-01,13785,13243,542,3.9
19013,2020-01-01,69649,66532,3117,4.5
19015,2020-01-01,15083,14604,479,3.2
19017,2020-01-01,13982,13523,459,3.3
19019,2020-01-01,11424,10956,468,4.1
19021,2020-01-01,12117,11807,310,2.6
19023,2020-01-01,8069,7697,372,4.6
19025,2020-01-01,4309,4166,143,3.3
19027,2020-01-01,11131,10875,256,2.3
19029,2020-01-01,6986,6720,266,3.8
19031,2020-01-01,11038,10631,407,3.7
19033,2020-01-01,23943,23114,829,3.5
19035,2020-01-01,6320,6088,232,3.7
19037,2020-01-01,6679,6373,306,4.6
19039,2020-01-01,5016,4799,217,4.3
19041,2020-01-01,8693,8352,341,3.9
19043,2020-01-01,10242,9535,707,6.9
19045,2020-01-01,23145,22006,1139,4.9
19047,2020-01-01,8430,7946,484,5.7
19049,2020-01-01,50286,49049,1237,2.5
19051,2020-01-01,4302,4151,151,3.5
19053,2020-01-01,4528,4393,135,3
19055,2020-01-01,10791,10419,372,3.4
19057,2020-01-01,19268,18235,1033,5.4
19059,2020-01-01,9788,9300,488,5
19061,2020-01-01,57536,55181,2355,4.1
19063,2020-01-01,5294,5115,179,3.4
19065,2020-01-01,10991,10410,581,5.3
19067,2020-01-01,8832,8367,465,5.3
19069,2020-01-01,5752,5542,210,3.7
19071,2020-01-01,3745,3652,93,2.5
19073,2020-01-01,5555,5414,141,2.5
19075,2020-01-01,6587,6353,234,3.6
19077,2020-01-01,5767,5531,236,4.1
19079,2020-01-01,6965,6725,240,3.4
19081,2020-01-01,6032,5840,192,3.2
19083,2020-01-01,8124,7772,352,4.3
19085,2020-01-01,7600,7361,239,3.1
19087,2020-01-01,9838,9463,375,3.8
19089,2020-01-01,5345,5122,223,4.2
19091,2020-01-01,5198,4997,201,3.9
19093,2020-01-01,4284,4146,138,3.2
19095,2020-01-01,10691,10325,366,3.4
19097,2020-01-01,11197,10635,562,5
19099,2020-01-01,20134,19348,786,3.9
19101,2020-01-01,10389,10089,300,2.9
19103,2020-01-01,86454,84375,2079,2.4
19105,2020-01-01,11049,10475,574,5.2
19107,2020-01-01,5302,5066,236,4.5
19109,2020-01-01,8532,8274,258,3
19111,2020-01-01,16341,15542,799,4.9
19113,2020-01-01,123949,119392,4557,3.7
19115,2020-01-01,6156,5884,272,4.4
19117,2020-01-01,4739,4617,122,2.6
19119,2020-01-01,7177,6984,193,2.7
19121,2020-01-01,8812,8363,449,5.1
19123,2020-01-01,11996,11603,393,3.3
19125,2020-01-01,18489,17931,558,3
19127,2020-01-01,18439,17032,1407,7.6
19129,2020-01-01,7602,7388,214,2.8
19131,2020-01-01,7231,7065,166,2.3
19133,2020-01-01,4523,4334,189,4.2
19135,2020-01-01,4157,3984,173,4.2
19137,2020-01-01,5105,4936,169,3.3
19139,2020-01-01,22208,21409,799,3.6
19141,2020-01-01,8457,8213,244,2.9
19143,2020-01-01,3592,3497,95,2.6
19145,2020-01-01,6477,6264,213,3.3
19147,2020-01-01,4839,4701,138,2.9
19149,2020-01-01,15095,14669,426,2.8
19151,2020-01-01,4601,4482,119,2.6
19153,2020-01-01,273739,263889,9850,3.6
19155,2020-01-01,49931,48375,1556,3.1
19157,2020-01-01,9769,9347,422,4.3
19159,2020-01-01,2501,2424,77,3.1
19161,2020-01-01,5323,5139,184,3.5
19163,2020-01-01,89821,85932,3889,4.3
19165,2020-01-01,6810,6606,204,3
19167,2020-01-01,21663,21035,628,2.9
19169,2020-01-01,59036,57712,1324,2.2
19171,2020-01-01,9641,9147,494,5.1
19173,2020-01-01,3266,3188,78,2.4
19175,2020-01-01,6429,6157,272,4.2
19177,2020-01-01,3713,3570,143,3.9
19179,2020-01-01,18044,17252,792,4.4
19181,2020-01-01,28853,27854,999,3.5
19183,2020-01-01,12231,11757,474,3.9
19185,2020-01-01,2878,2791,87,3
19187,2020-01-01,19753,19013,740,3.7
19189,2020-01-01,5258,5088,170,3.2
19191,2020-01-01,11888,11279,609,5.1
19193,2020-01-01,56694,54650,2044,3.6
19195,2020-01-01,4331,4147,184,4.2
19197,2020-01-01,7142,6924,218,3.1
20001,2020-01-01,6282,6045,237,3.8
20003,2020-01-01,4159,4003,156,3.8
20005,2020-01-01,6951,6583,368,5.3
20007,2020-01-01,2294,2225,69,3
20009,2020-01-01,13134,12633,501,3.8
20011,2020-01-01,6585,6282,303,4.6
20013,2020-01-01,5352,5176,176,3.3
20015,2020-01-01,32722,31559,1163,3.6
20017,2020-01-01,1536,1491,45,2.9
20019,2020-01-01,1425,1373,52,3.6
20021,2020-01-01,10107,9784,323,3.2
20023,2020-01-01,1301,1269,32,2.5
20025,2020-01-01,1080,1053,27,2.5
20027,2020-01-01,3747,3621,126,3.4
20029,2020-01-01,3735,3609,126,3.4
20031,2020-01-01,4161,3944,217,5.2
20033,2020-01-01,832,807,25,3
20035,2020-01-01,16109,15536,573,3.6
20037,2020-01-01,18582,17800,782,4.2
20039,2020-01-01,1178,1139,39,3.3
20041,2020-01-01,8759,8367,392,4.5
20043,2020-01-01,4118,3963,155,3.8
20045,2020-01-01,65869,63756,2113,3.2
20047,2020-01-01,1362,1327,35,2.6
20049,2020-01-01,1154,1117,37,3.2
20051,2020-01-01,16918,16530,388,2.3
20053,2020-01-01,2696,2622,74,2.7
20055,2020-01-01,20753,20292,461,2.2
20057,2020-01-01,16858,16431,427,2.5
20059,2020-01-01,14167,13644,523,3.7
20061,2020-01-01,11275,10741,534,4.7
20063,2020-01-01,1470,1435,35,2.4
20065,2020-01-01,1080,1046,34,3.1
20067,2020-01-01,3099,3020,79,2.5
20069,2020-01-01,3121,3049,72,2.3
20071,2020-01-01,767,752,15,2
20073,2020-01-01,3285,3162,123,3.7
20075,2020-01-01,1608,1578,30,1.9
20077,2020-01-01,2987,2905,82,2.7
20079,2020-01-01,17082,16541,541,3.2
20081,2020-01-01,2146,2101,45,2.1
20083,2020-01-01,974,942,32,3.3
20085,2020-01-01,7201,6937,264,3.7
20087,2020-01-01,10126,9746,380,3.8
20089,2020-01-01,1247,1213,34,2.7
20091,2020-01-01,341859,332373,9486,2.8
20093,2020-01-01,1994,1949,45,2.3
20095,2020-01-01,3424,3305,119,3.5
20097,2020-01-01,1268,1238,30,2.4
20099,2020-01-01,9861,9461,400,4.1
20101,2020-01-01,733,715,18,2.5
20103,2020-01-01,36973,35543,1430,3.9
20105,2020-01-01,1726,1677,49,2.8
20107,2020-01-01,4491,4190,301,6.7
20109,2020-01-01,1596,1562,34,2.1
20111,2020-01-01,16610,15997,613,3.7
20113,2020-01-01,17054,16642,412,2.4
20115,2020-01-01,5871,5705,166,2.8
20117,2020-01-01,5434,5274,160,2.9
20119,2020-01-01,2049,2000,49,2.4
20121,2020-01-01,17755,17042,713,4
20123,2020-01-01,3252,3178,74,2.3
20125,2020-01-01,14537,13814,723,5
20127,2020-01-01,3020,2917,103,3.4
20129,2020-01-01,1103,1071,32,2.9
20131,2020-01-01,5254,5103,151,2.9
20133,2020-01-01,6153,5864,289,4.7
20135,2020-01-01,1312,1277,35,2.7
20137,2020-01-01,2641,2587,54,2
20139,2020-01-01,7984,7646,338,4.2
20141,2020-01-01,2051,2009,42,2
20143,2020-01-01,2975,2888,87,2.9
20145,2020-01-01,2820,2721,99,3.5
20147,2020-01-01,2593,2524,69,2.7
20149,2020-01-01,12306,11913,393,3.2
20151,2020-01-01,4878,4738,140,2.9
20153,2020-01-01,1462,1428,34,2.3
20155,2020-01-01,29380,28383,997,3.4
20157,2020-01-01,2169,2110,59,2.7
20159,2020-01-01,5160,5017,143,2.8
20161,2020-01-01,34731,33723,1008,2.9
20163,2020-01-01,2464,2382,82,3.3
20165,2020-01-01,1604,1554,50,3.1
20167,2020-01-01,3214,3115,99,3.1
20169,2020-01-01,30169,29122,1047,3.5
20171,2020-01-01,2783,2728,55,2
20173,2020-01-01,253382,243656,9726,3.8
20175,2020-01-01,9184,8887,297,3.2
20177,2020-01-01,90603,87289,3314,3.7
20179,2020-01-01,1374,1337,37,2.7
20181,2020-01-01,2731,2654,77,2.8
20183,2020-01-01,1939,1887,52,2.7
20185,2020-01-01,2012,1948,64,3.2
20187,2020-01-01,959,929,30,3.1
20189,2020-01-01,2451,2379,72,2.9
20191,2020-01-01,10923,10552,371,3.4
20193,2020-01-01,4225,4128,97,2.3
20195,2020-01-01,1411,1364,47,3.3
20197,2020-01-01,3646,3501,145,4
20199,2020-01-01,775,753,22,2.8
20201,2020-01-01,2876,2797,79,2.7
20203,2020-01-01,1173,1144,29,2.5
20205,2020-01-01,3945,3770,175,4.4
20207,2020-01-01,1545,1479,66,4.3
20209,2020-01-01,78141,74623,3518,4.5
21001,2020-01-01,7060,6608,452,6.4
21003,2020-01-01,9011,8608,403,4.5
21005,2020-01-01,12152,11628,524,4.3
21007,2020-01-01,3530,3304,226,6.4
21009,2020-01-01,18811,17835,976,5.2
21011,2020-01-01,4702,4302,400,8.5
21013,2020-01-01,8522,7859,663,7.8
21015,2020-01-01,71203,68510,2693,3.8
21017,2020-01-01,9766,9338,428,4.4
21019,2020-01-01,17913,16699,1214,6.8
21021,2020-01-01,12409,11796,613,4.9
21023,2020-01-01,3892,3642,250,6.4
21025,2020-01-01,3524,3142,382,10.8
21027,2020-01-01,7979,7472,507,6.4
21029,2020-01-01,43132,41265,1867,4.3
21031,2020-01-01,5160,4863,297,5.8
21033,2020-01-01,5525,5221,304,5.5
21035,2020-01-01,18450,17632,818,4.4
21037,2020-01-01,50985,49018,1967,3.9
21039,2020-01-01,2324,2215,109,4.7
21041,2020-01-01,5261,5011,250,4.8
21043,2020-01-01,9909,8920,989,10
21045,2020-01-01,6760,6444,316,4.7
21047,2020-01-01,25328,23850,1478,5.8
21049,2020-01-01,17190,16393,797,4.6
21051,2020-01-01,5225,4828,397,7.6
21053,2020-01-01,4040,3796,244,6
21055,2020-01-01,3867,3663,204,5.3
21057,2020-01-01,3192,3031,161,5
21059,2020-01-01,47731,45639,2092,4.4
21061,2020-01-01,4829,4559,270,5.6
21063,2020-01-01,2129,1888,241,11.3
21065,2020-01-01,5442,5111,331,6.1
21067,2020-01-01,174100,167944,6156,3.5
21069,2020-01-01,6169,5779,390,6.3
21071,2020-01-01,11000,10136,864,7.9
21073,2020-01-01,25410,24373,1037,4.1
21075,2020-01-01,2045,1936,109,5.3
21077,2020-01-01,4105,3923,182,4.4
21079,2020-01-01,7640,7229,411,5.4
21081,2020-01-01,11831,11246,585,4.9
21083,2020-01-01,15954,15145,809,5.1
21085,2020-01-01,11113,10484,629,5.7
21087,2020-01-01,5064,4840,224,4.4
21089,2020-01-01,13539,12430,1109,8.2
21091,2020-01-01,3985,3831,154,3.9
21093,2020-01-01,49156,46920,2236,4.5
21095,2020-01-01,6711,5883,828,12.3
21097,2020-01-01,8853,8445,408,4.6
21099,2020-01-01,8060,7515,545,6.8
21101,2020-01-01,22023,21116,907,4.1
21103,2020-01-01,8310,7972,338,4.1
21105,2020-01-01,1767,1674,93,5.3
21107,2020-01-01,18514,17564,950,5.1
21109,2020-01-01,4087,3790,297,7.3
21111,2020-01-01,402833,386328,16505,4.1
21113,2020-01-01,26453,25418,1035,3.9
21115,2020-01-01,6732,6218,514,7.6
21117,2020-01-01,88149,84652,3497,4
21119,2020-01-01,4482,4123,359,8
21121,2020-01-01,9887,9267,620,6.3
21123,2020-01-01,6017,5719,298,5
21125,2020-01-01,24547,23273,1274,5.2
21127,2020-01-01,5301,4846,455,8.6
21129,2020-01-01,2107,1968,139,6.6
21131,2020-01-01,2780,2445,335,12.1
21133,2020-01-01,6439,5834,605,9.4
21135,2020-01-01,4761,4249,512,10.8
21137,2020-01-01,9231,8722,509,5.5
21139,2020-01-01,3671,3433,238,6.5
21141,2020-01-01,12659,12092,567,4.5
21143,2020-01-01,3037,2872,165,5.4
21145,2020-01-01,29263,27646,1617,5.5
21147,2020-01-01,4714,4370,344,7.3
21149,2020-01-01,4248,4038,210,4.9
21151,2020-01-01,47255,45321,1934,4.1
21153,2020-01-01,3360,2864,496,14.8
21155,2020-01-01,9718,9336,382,3.9
21157,2020-01-01,15022,14214,808,5.4
21159,2020-01-01,2791,2540,251,9
21161,2020-01-01,7102,6637,465,6.5
21163,2020-01-01,12324,11682,642,5.2
21165,2020-01-01,2352,2136,216,9.2
21167,2020-01-01,9931,9410,521,5.2
21169,2020-01-01,4136,3885,251,6.1
21171,2020-01-01,4748,4535,213,4.5
21173,2020-01-01,11677,10949,728,6.2
21175,2020-01-01,4656,4316,340,7.3
21177,2020-01-01,10419,9651,768,7.4
21179,2020-01-01,23346,22253,1093,4.7
21181,2020-01-01,3332,3152,180,5.4
21183,2020-01-01,9906,9293,613,6.2
21185,2020-01-01,33539,32406,1133,3.4
21187,2020-01-01,5120,4870,250,4.9
21189,2020-01-01,1147,1066,81,7.1
21191,2020-01-01,7065,6728,337,4.8
21193,2020-01-01,8367,7674,693,8.3
21195,2020-01-01,19892,18404,1488,7.5
21197,2020-01-01,5059,4715,344,6.8
21199,2020-01-01,26813,25418,1395,5.2
21201,2020-01-01,831,782,49,5.9
21203,2020-01-01,6702,6340,362,5.4
21205,2020-01-01,10525,9893,632,6
21207,2020-01-01,6247,5845,402,6.4
21209,2020-01-01,29015,27907,1108,3.8
21211,2020-01-01,25662,24779,883,3.4
21213,2020-01-01,8982,8548,434,4.8
21215,2020-01-01,10295,9907,388,3.8
21217,2020-01-01,12538,11971,567,4.5
21219,2020-01-01,5501,5248,253,4.6
21221,2020-01-01,6108,5774,334,5.5
21223,2020-01-01,3917,3731,186,4.7
21225,2020-01-01,6214,5911,303,4.9
21227,2020-01-01,64948,62173,2775,4.3
21229,2020-01-01,6314,6050,264,4.2
21231,2020-01-01,7509,7038,471,6.3
21233,2020-01-01,5608,5336,272,4.9
21235,2020-01-01,13640,12891,749,5.5
21237,2020-01-01,2013,1827,186,9.2
21239,2020-01-01,14862,14336,526,3.5
22001,2020-01-01,23619,22161,1458,6.2
22003,2020-01-01,8968,8322,646,7.2
22005,2020-01-01,64241,61136,3105,4.8
22007,2020-01-01,8921,8251,670,7.5
22009,2020-01-01,14984,13897,1087,7.3
22011,2020-01-01,14567,13630,937,6.4
22013,2020-01-01,5493,5112,381,6.9
22015,2020-01-01,57460,54562,2898,5
22017,2020-01-01,103314,96887,6427,6.2
22019,2020-01-01,103482,98016,5466,5.3
22021,2020-01-01,3781,3462,319,8.4
22023,2020-01-01,3832,3643,189,4.9
22025,2020-01-01,3355,3110,245,7.3
22027,2020-01-01,5863,5447,416,7.1
22029,2020-01-01,7099,6546,553,7.8
22031,2020-01-01,10880,10081,799,7.3
22033,2020-01-01,231590,219712,11878,5.1
22035,2020-01-01,1862,1627,235,12.6
22037,2020-01-01,7976,7563,413,5.2
22039,2020-01-01,11712,10890,822,7
22041,2020-01-01,7319,6675,644,8.8
22043,2020-01-01,8181,7602,579,7.1
22045,2020-01-01,27913,26100,1813,6.5
22047,2020-01-01,14119,13131,988,7
22049,2020-01-01,6782,6403,379,5.6
22051,2020-01-01,215328,205031,10297,4.8
22053,2020-01-01,13064,12310,754,5.8
22055,2020-01-01,113183,107282,5901,5.2
22057,2020-01-01,41763,39552,2211,5.3
22059,2020-01-01,6808,6468,340,5
22061,2020-01-01,21986,20617,1369,6.2
22063,2020-01-01,68910,65622,3288,4.8
22065,2020-01-01,3453,3121,332,9.6
22067,2020-01-01,10109,9028,1081,10.7
22069,2020-01-01,16000,14874,1126,7
22071,2020-01-01,180237,170249,9988,5.5
22073,2020-01-01,70168,65733,4435,6.3
22075,2020-01-01,10078,9564,514,5.1
22077,2020-01-01,9836,9233,603,6.1
22079,2020-01-01,55019,51708,3311,6
22081,2020-01-01,3722,3479,243,6.5
22083,2020-01-01,8142,7457,685,8.4
22085,2020-01-01,9067,8525,542,6
22087,2020-01-01,19997,18843,1154,5.8
22089,2020-01-01,25369,24079,1290,5.1
22091,2020-01-01,4285,3988,297,6.9
22093,2020-01-01,9363,8681,682,7.3
22095,2020-01-01,19928,18589,1339,6.7
22097,2020-01-01,31903,29464,2439,7.6
22099,2020-01-01,22096,20761,1335,6
22101,2020-01-01,19761,18426,1335,6.8
22103,2020-01-01,120112,114340,5772,4.8
22105,2020-01-01,54687,51077,3610,6.6
22107,2020-01-01,1327,1185,142,10.7
22109,2020-01-01,46005,43469,2536,5.5
22111,2020-01-01,9077,8429,648,7.1
22113,2020-01-01,23921,22472,1449,6.1
22115,2020-01-01,16167,15015,1152,7.1
22117,2020-01-01,16749,15629,1120,6.7
22119,2020-01-01,14518,13467,1051,7.2
22121,2020-01-01,13712,12999,713,5.2
22123,2020-01-01,3654,3090,564,15.4
22125,2020-01-01,5392,5121,271,5
22127,2020-01-01,4834,4468,366,7.6
23001,2020-01-01,55499,53497,2002,3.6
23003,2020-01-01,30171,28451,1720,5.7
23005,2020-01-01,162842,158060,4782,2.9
23007,2020-01-01,14359,13674,685,4.8
23009,2020-01-01,26972,25298,1674,6.2
23011,2020-01-01,61847,59451,2396,3.9
23013,2020-01-01,19449,18596,853,4.4
23015,2020-01-01,16030,15331,699,4.4
23017,2020-01-01,26841,25630,1211,4.5
23019,2020-01-01,76732,73411,3321,4.3
23021,2020-01-01,7259,6888,371,5.1
23023,2020-01-01,19174,18592,582,3
23025,2020-01-01,22186,20793,1393,6.3
23027,2020-01-01,20302,19362,940,4.6
23029,2020-01-01,13475,12470,1005,7.5
23031,2020-01-01,112147,107687,4460,4
24001,2020-01-01,32137,30343,1794,5.6
24003,2020-01-01,319375,309895,9480,3
24005,2020-01-01,459764,443134,16630,3.6
24009,2020-01-01,50608,49090,1518,3
24011,2020-01-01,18196,17508,688,3.8
24013,2020-01-01,97531,94656,2875,2.9
24015,2020-01-01,53675,51532,2143,4
24017,2020-01-01,88369,85264,3105,3.5
24019,2020-01-01,15310,14526,784,5.1
24021,2020-01-01,136187,131847,4340,3.2
24023,2020-01-01,15590,14757,833,5.3
24025,2020-01-01,143039,138293,4746,3.3
24027,2020-01-01,189856,184937,4919,2.6
24029,2020-01-01,10286,9756,530,5.2
24031,2020-01-01,564746,548671,16075,2.8
24033,2020-01-01,515346,496719,18627,3.6
24035,2020-01-01,28636,27693,943,3.3
24037,2020-01-01,57957,56104,1853,3.2
24039,2020-01-01,9301,8671,630,6.8
24041,2020-01-01,18927,18199,728,3.8
24043,2020-01-01,75898,72844,3054,4
24045,2020-01-01,50671,48052,2619,5.2
24047,2020-01-01,26225,23377,2848,10.9
24510,2020-01-01,291738,277376,14362,4.9
25001,2020-01-01,109469,102821,6648,6.1
25003,2020-01-01,64661,61830,2831,4.4
25005,2020-01-01,305670,291691,13979,4.6
25007,2020-01-01,8507,7891,616,7.2
25009,2020-01-01,428998,414612,14386,3.4
25011,2020-01-01,41258,39910,1348,3.3
25013,2020-01-01,229917,219537,10380,4.5
25015,2020-01-01,90770,87975,2795,3.1
25017,2020-01-01,928861,905023,23838,2.6
25019,2020-01-01,6217,5529,688,11.1
25021,2020-01-01,395637,384555,11082,2.8
25023,2020-01-01,286436,275988,10448,3.6
25025,2020-01-01,461085,448069,13016,2.8
25027,2020-01-01,451331,435049,16282,3.6
26001,2020-01-01,3826,3493,333,8.7
26003,2020-01-01,3080,2808,272,8.8
26005,2020-01-01,61851,59751,2100,3.4
26007,2020-01-01,13312,12602,710,5.3
26009,2020-01-01,10079,9442,637,6.3
26011,2020-01-01,5994,5477,517,8.6
26013,2020-01-01,3274,3036,238,7.3
26015,2020-01-01,31632,30494,1138,3.6
26017,2020-01-01,49693,46979,2714,5.5
26019,2020-01-01,8776,8173,603,6.9
26021,2020-01-01,73025,69728,3297,4.5
26023,2020-01-01,19104,18337,767,4
26025,2020-01-01,61929,59396,2533,4.1
26027,2020-01-01,24433,23297,1136,4.6
26029,2020-01-01,12510,11759,751,6
26031,2020-01-01,10201,8556,1645,16.1
26033,2020-01-01,16164,14922,1242,7.7
26035,2020-01-01,11714,10803,911,7.8
26037,2020-01-01,41046,39826,1220,3
26039,2020-01-01,5661,5261,400,7.1
26041,2020-01-01,17141,16064,1077,6.3
26043,2020-01-01,12349,11745,604,4.9
26045,2020-01-01,57338,55453,1885,3.3
26047,2020-01-01,17374,16122,1252,7.2
26049,2020-01-01,183289,174176,9113,5
26051,2020-01-01,9792,9108,684,7
26053,2020-01-01,6133,5733,400,6.5
26055,2020-01-01,48687,46722,1965,4
26057,2020-01-01,18104,17216,888,4.9
26059,2020-01-01,20245,19346,899,4.4
26061,2020-01-01,15530,14703,827,5.3
26063,2020-01-01,15140,14294,846,5.6
26065,2020-01-01,151209,146421,4788,3.2
26067,2020-01-01,30211,29098,1113,3.7
26069,2020-01-01,10199,9331,868,8.5
26071,2020-01-01,5177,4818,359,6.9
26073,2020-01-01,34862,33418,1444,4.1
26075,2020-01-01,74238,71341,2897,3.9
26077,2020-01-01,133818,129586,4232,3.2
26079,2020-01-01,7860,7275,585,7.4
26081,2020-01-01,359770,349608,10162,2.8
26083,2020-01-01,841,783,58,6.9
26085,2020-01-01,3850,3576,274,7.1
26087,2020-01-01,41673,38951,2722,6.5
26089,2020-01-01,10227,9778,449,4.4
26091,2020-01-01,46087,44121,1966,4.3
26093,2020-01-01,103408,100134,3274,3.2
26095,2020-01-01,2285,2126,159,7
26097,2020-01-01,4351,3469,882,20.3
26099,2020-01-01,451659,430494,21165,4.7
26101,2020-01-01,10259,9582,677,6.6
26103,2020-01-01,31983,30266,1717,5.4
26105,2020-01-01,13137,12321,816,6.2
26107,2020-01-01,18186,17184,1002,5.5
26109,2020-01-01,11017,10515,502,4.6
26111,2020-01-01,39919,38204,1715,4.3
26113,2020-01-01,6900,6471,429,6.2
26115,2020-01-01,75402,72192,3210,4.3
26117,2020-01-01,28325,27073,1252,4.4
26119,2020-01-01,3014,2652,362,12
26121,2020-01-01,77162,73795,3367,4.4
26123,2020-01-01,23410,22321,1089,4.7
26125,2020-01-01,675945,653907,22038,3.3
26127,2020-01-01,11574,10690,884,7.6
26129,2020-01-01,7867,7150,717,9.1
26131,2020-01-01,2096,1943,153,7.3
26133,2020-01-01,11379,10849,530,4.7
26135,2020-01-01,2936,2700,236,8
26137,2020-01-01,11627,10931,696,6
26139,2020-01-01,160556,156291,4265,2.7
26141,2020-01-01,4886,4328,558,11.4
26143,2020-01-01,7473,6741,732,9.8
26145,2020-01-01,86377,82014,4363,5.1
26147,2020-01-01,76163,72079,4084,5.4
26149,2020-01-01,27601,26409,1192,4.3
26151,2020-01-01,19426,18253,1173,6
26153,2020-01-01,3323,3013,310,9.3
26155,2020-01-01,33519,32030,1489,4.4
26157,2020-01-01,23985,22545,1440,6
26159,2020-01-01,35131,33258,1873,5.3
26161,2020-01-01,198766,193808,4958,2.5
26163,2020-01-01,810007,768869,41138,5.1
26165,2020-01-01,14914,14107,807,5.4
27001,2020-01-01,7280,6621,659,9.1
27003,2020-01-01,199485,192916,6569,3.3
27005,2020-01-01,18564,17506,1058,5.7
27007,2020-01-01,24503,23186,1317,5.4
27009,2020-01-01,22323,21131,1192,5.3
27011,2020-01-01,2409,2234,175,7.3
27013,2020-01-01,41307,40122,1185,2.9
27015,2020-01-01,14157,13444,713,5
27017,2020-01-01,17924,16911,1013,5.7
27019,2020-01-01,58814,57164,1650,2.8
27021,2020-01-01,14004,12846,1158,8.3
27023,2020-01-01,6916,6568,348,5
27025,2020-01-01,30552,28977,1575,5.2
27027,2020-01-01,36247,34927,1320,3.6
27029,2020-01-01,4682,4045,637,13.6
27031,2020-01-01,2908,2731,177,6.1
27033,2020-01-01,5873,5630,243,4.1
27035,2020-01-01,31920,29951,1969,6.2
27037,2020-01-01,243412,236340,7072,2.9
27039,2020-01-01,11877,11359,518,4.4
27041,2020-01-01,20895,20059,836,4
27043,2020-01-01,6867,6470,397,5.8
27045,2020-01-01,11480,10933,547,4.8
27047,2020-01-01,16130,15475,655,4.1
27049,2020-01-01,27162,26087,1075,4
27051,2020-01-01,3225,3014,211,6.5
27053,2020-01-01,709425,691948,17477,2.5
27055,2020-01-01,10282,9833,449,4.4
27057,2020-01-01,9789,9020,769,7.9
27059,2020-01-01,21783,20546,1237,5.7
27061,2020-01-01,22242,20595,1647,7.4
27063,2020-01-01,5636,5412,224,4
27065,2020-01-01,9407,8443,964,10.2
27067,2020-01-01,24028,22892,1136,4.7
27069,2020-01-01,2299,2197,102,4.4
27071,2020-01-01,5757,5359,398,6.9
27073,2020-01-01,3479,3289,190,5.5
27075,2020-01-01,5352,5096,256,4.8
27077,2020-01-01,2596,2494,102,3.9
27079,2020-01-01,16538,15395,1143,6.9
27081,2020-01-01,3165,2962,203,6.4
27083,2020-01-01,14160,13555,605,4.3
27085,2020-01-01,19237,18282,955,5
27087,2020-01-01,2295,2122,173,7.5
27089,2020-01-01,5383,4846,537,10
27091,2020-01-01,9708,9319,389,4
27093,2020-01-01,13403,12628,775,5.8
27095,2020-01-01,13366,12267,1099,8.2
27097,2020-01-01,17536,16081,1455,8.3
27099,2020-01-01,20200,19505,695,3.4
27101,2020-01-01,4652,4333,319,6.9
27103,2020-01-01,21240,20688,552,2.6
27105,2020-01-01,11068,10698,370,3.3
27107,2020-01-01,3129,2915,214,6.8
27109,2020-01-01,88745,86480,2265,2.6
27111,2020-01-01,31110,29230,1880,6
27113,2020-01-01,8863,8159,704,7.9
27115,2020-01-01,15281,14007,1274,8.3
27117,2020-01-01,4782,4541,241,5
27119,2020-01-01,16582,15831,751,4.5
27121,2020-01-01,6456,6201,255,3.9
27123,2020-01-01,291202,282944,8258,2.8
27125,2020-01-01,2230,2035,195,8.7
27127,2020-01-01,7402,7076,326,4.4
27129,2020-01-01,8253,7740,513,6.2
27131,2020-01-01,37319,35919,1400,3.8
27133,2020-01-01,5514,5367,147,2.7
27135,2020-01-01,7837,7469,368,4.7
27137,2020-01-01,101786,97240,4546,4.5
27139,2020-01-01,84197,81790,2407,2.9
27141,2020-01-01,53292,50888,2404,4.5
27143,2020-01-01,8475,8047,428,5.1
27145,2020-01-01,91052,87438,3614,4
27147,2020-01-01,21589,20813,776,3.6
27149,2020-01-01,5137,4958,179,3.5
27151,2020-01-01,4790,4493,297,6.2
27153,2020-01-01,13504,12724,780,5.8
27155,2020-01-01,1702,1607,95,5.6
27157,2020-01-01,12235,11691,544,4.4
27159,2020-01-01,6048,5512,536,8.9
27161,2020-01-01,8906,8401,505,5.7
27163,2020-01-01,144425,140187,4238,2.9
27165,2020-01-01,6309,5995,314,5
27167,2020-01-01,3329,3206,123,3.7
27169,2020-01-01,28475,27580,895,3.1
27171,2020-01-01,76692,73542,3150,4.1
27173,2020-01-01,5250,5025,225,4.3
28001,2020-01-01,11192,10420,772,6.9
28003,2020-01-01,16116,15365,751,4.7
28005,2020-01-01,4340,4019,321,7.4
28007,2020-01-01,6972,6509,463,6.6
28009,2020-01-01,3024,2841,183,6.1
28011,2020-01-01,11876,10949,927,7.8
28013,2020-01-01,5487,5166,321,5.9
28015,2020-01-01,3422,3202,220,6.4
28017,2020-01-01,6727,6376,351,5.2
28019,2020-01-01,3593,3393,200,5.6
28021,2020-01-01,2958,2649,309,10.4
28023,2020-01-01,5908,5522,386,6.5
28025,2020-01-01,7612,7031,581,7.6
28027,2020-01-01,8212,7505,707,8.6
28029,2020-01-01,11005,10303,702,6.4
28031,2020-01-01,8010,7610,400,5
28033,2020-01-01,90445,86625,3820,4.2
28035,2020-01-01,33196,31599,1597,4.8
28037,2020-01-01,2727,2529,198,7.3
28039,2020-01-01,8723,8003,720,8.3
28041,2020-01-01,4362,3951,411,9.4
28043,2020-01-01,9312,8845,467,5
28045,2020-01-01,18546,17532,1014,5.5
28047,2020-01-01,85452,81145,4307,5
28049,2020-01-01,105298,100102,5196,4.9
28051,2020-01-01,5639,5065,574,10.2
28053,2020-01-01,2207,1928,279,12.6
28055,2020-01-01,371,329,42,11.3
28057,2020-01-01,10423,9956,467,4.5
28059,2020-01-01,57905,54471,3434,5.9
28061,2020-01-01,6158,5646,512,8.3
28063,2020-01-01,2025,1674,351,17.3
28065,2020-01-01,4078,3806,272,6.7
28067,2020-01-01,25798,24403,1395,5.4
28069,2020-01-01,3496,3232,264,7.6
28071,2020-01-01,27426,26279,1147,4.2
28073,2020-01-01,30757,29481,1276,4.1
28075,2020-01-01,30329,28794,1535,5.1
28077,2020-01-01,4515,4214,301,6.7
28079,2020-01-01,7771,7341,430,5.5
28081,2020-01-01,40942,39221,1721,4.2
28083,2020-01-01,9918,9134,784,7.9
28085,2020-01-01,14403,13568,835,5.8
28087,2020-01-01,24925,23622,1303,5.2
28089,2020-01-01,52484,50286,2198,4.2
28091,2020-01-01,9905,9342,563,5.7
28093,2020-01-01,14334,13540,794,5.5
28095,2020-01-01,15511,14688,823,5.3
28097,2020-01-01,3873,3636,237,6.1
28099,2020-01-01,9997,9376,621,6.2
28101,2020-01-01,8803,8313,490,5.6
28103,2020-01-01,3707,3432,275,7.4
28105,2020-01-01,21544,20424,1120,5.2
28107,2020-01-01,12329,11536,793,6.4
28109,2020-01-01,23652,22492,1160,4.9
28111,2020-01-01,4307,3998,309,7.2
28113,2020-01-01,14265,13357,908,6.4
28115,2020-01-01,14659,14044,615,4.2
28117,2020-01-01,11144,10612,532,4.8
28119,2020-01-01,2298,2102,196,8.5
28121,2020-01-01,75102,72193,2909,3.9
28123,2020-01-01,12430,11874,556,4.5
28125,2020-01-01,1577,1426,151,9.6
28127,2020-01-01,10592,10033,559,5.3
28129,2020-01-01,6779,6403,376,5.5
28131,2020-01-01,6743,6316,427,6.3
28133,2020-01-01,7549,6775,774,10.3
28135,2020-01-01,5210,4844,366,7
28137,2020-01-01,12197,11554,643,5.3
28139,2020-01-01,9359,8917,442,4.7
28141,2020-01-01,8485,8011,474,5.6
28143,2020-01-01,4401,4112,289,6.6
28145,2020-01-01,14273,13680,593,4.2
28147,2020-01-01,4772,4436,336,7
28149,2020-01-01,19851,18754,1097,5.5
28151,2020-01-01,16706,15393,1313,7.9
28153,2020-01-01,7333,6853,480,6.5
28155,2020-01-01,3896,3666,230,5.9
28157,2020-01-01,2809,2503,306,10.9
28159,2020-01-01,7338,6900,438,6
28161,2020-01-01,4852,4597,255,5.3
28163,2020-01-01,9225,8636,589,6.4
29001,2020-01-01,10240,9794,446,4.4
29003,2020-01-01,9798,9452,346,3.5
29005,2020-01-01,2710,2610,100,3.7
29007,2020-01-01,10759,10308,451,4.2
29009,2020-01-01,15864,15056,808,5.1
29011,2020-01-01,5335,5126,209,3.9
29013,2020-01-01,7990,7605,385,4.8
29015,2020-01-01,7253,6818,435,6
29017,2020-01-01,5592,5318,274,4.9
29019,2020-01-01,97338,94248,3090,3.2
29021,2020-01-01,44618,42874,1744,3.9
29023,2020-01-01,18095,17170,925,5.1
29025,2020-01-01,4416,4243,173,3.9
29027,2020-01-01,21452,20634,818,3.8
29029,2020-01-01,17850,16492,1358,7.6
29031,2020-01-01,41213,39747,1466,3.6
29033,2020-01-01,4872,4684,188,3.9
29035,2020-01-01,2569,2411,158,6.2
29037,2020-01-01,55160,52948,2212,4
29039,2020-01-01,5875,5615,260,4.4
29041,2020-01-01,3802,3644,158,4.2
29043,2020-01-01,45496,43784,1712,3.8
29045,2020-01-01,3264,3103,161,4.9
29047,2020-01-01,136418,131679,4739,3.5
29049,2020-01-01,10783,10366,417,3.9
29051,2020-01-01,39126,37783,1343,3.4
29053,2020-01-01,7490,7173,317,4.2
29055,2020-01-01,11035,10501,534,4.8
29057,2020-01-01,3595,3447,148,4.1
29059,2020-01-01,7170,6787,383,5.3
29061,2020-01-01,4175,4002,173,4.1
29063,2020-01-01,4881,4671,210,4.3
29065,2020-01-01,6377,6067,310,4.9
29067,2020-01-01,5475,4859,616,11.3
29069,2020-01-01,11736,10959,777,6.6
29071,2020-01-01,53547,51246,2301,4.3
29073,2020-01-01,7699,7393,306,4
29075,2020-01-01,3548,3433,115,3.2
29077,2020-01-01,152665,147141,5524,3.6
29079,2020-01-01,4448,4258,190,4.3
29081,2020-01-01,3892,3700,192,4.9
29083,2020-01-01,9791,9306,485,5
29085,2020-01-01,3827,3610,217,5.7
29087,2020-01-01,2601,2505,96,3.7
29089,2020-01-01,4908,4709,199,4.1
29091,2020-01-01,16978,16021,957,5.6
29093,2020-01-01,3565,3348,217,6.1
29095,2020-01-01,363222,347539,15683,4.3
29097,2020-01-01,58193,56049,2144,3.7
29099,2020-01-01,118858,113892,4966,4.2
29101,2020-01-01,23487,22385,1102,4.7
29103,2020-01-01,1803,1734,69,3.8
29105,2020-01-01,17442,16174,1268,7.3
29107,2020-01-01,16961,16256,705,4.2
29109,2020-01-01,18343,17445,898,4.9
29111,2020-01-01,5011,4808,203,4.1
29113,2020-01-01,28983,27361,1622,5.6
29115,2020-01-01,5188,4877,311,6
29117,2020-01-01,7431,7161,270,3.6
29119,2020-01-01,10931,10500,431,3.9
29121,2020-01-01,7688,7352,336,4.4
29123,2020-01-01,5543,5288,255,4.6
29125,2020-01-01,3942,3774,168,4.3
29127,2020-01-01,14539,13982,557,3.8
29129,2020-01-01,1944,1858,86,4.4
29131,2020-01-01,12318,11595,723,5.9
29133,2020-01-01,5867,5587,280,4.8
29135,2020-01-01,7375,7083,292,4
29137,2020-01-01,3898,3693,205,5.3
29139,2020-01-01,5842,5575,267,4.6
29141,2020-01-01,8196,7670,526,6.4
29143,2020-01-01,8440,8005,435,5.2
29145,2020-01-01,27860,26753,1107,4
29147,2020-01-01,10999,10586,413,3.8
29149,2020-01-01,4129,3895,234,5.7
29151,2020-01-01,7155,6932,223,3.1
29153,2020-01-01,3439,3136,303,8.8
29155,2020-01-01,6455,6059,396,6.1
29157,2020-01-01,10077,9746,331,3.3
29159,2020-01-01,21245,20356,889,4.2
29161,2020-01-01,19922,19033,889,4.5
29163,2020-01-01,7428,7068,360,4.8
29165,2020-01-01,58694,56795,1899,3.2
29167,2020-01-01,14782,14191,591,4
29169,2020-01-01,14787,14056,731,4.9
29171,2020-01-01,2306,2195,111,4.8
29173,2020-01-01,5677,5451,226,4
29175,2020-01-01,10442,9939,503,4.8
29177,2020-01-01,11050,10572,478,4.3
29179,2020-01-01,3031,2883,148,4.9
29181,2020-01-01,5046,4768,278,5.5
29183,2020-01-01,228350,219683,8667,3.8
29185,2020-01-01,3831,3611,220,5.7
29186,2020-01-01,9200,8850,350,3.8
29187,2020-01-01,26833,25429,1404,5.2
29189,2020-01-01,534164,513607,20557,3.8
29195,2020-01-01,10731,10270,461,4.3
29197,2020-01-01,1965,1860,105,5.3
29199,2020-01-01,2451,2357,94,3.8
29201,2020-01-01,20122,19258,864,4.3
29203,2020-01-01,3251,3032,219,6.7
29205,2020-01-01,3173,3029,144,4.5
29207,2020-01-01,13263,12482,781,5.9
29209,2020-01-01,13335,11923,1412,10.6
29211,2020-01-01,2754,2616,138,5
29213,2020-01-01,26278,23059,3219,12.2
29215,2020-01-01,9218,8713,505,5.5
29217,2020-01-01,9610,9215,395,4.1
29219,2020-01-01,18251,17366,885,4.8
29221,2020-01-01,10348,9715,633,6.1
29223,2020-01-01,5296,5016,280,5.3
29225,2020-01-01,17530,16744,786,4.5
29227,2020-01-01,1188,1151,37,3.1
29229,2020-01-01,7800,7205,595,7.6
29510,2020-01-01,153083,146125,6958,4.5
30001,2020-01-01,4981,4798,183,3.7
30003,2020-01-01,4657,4318,339,7.3
30005,2020-01-01,2495,2376,119,4.8
30007,2020-01-01,2582,2442,140,5.4
30009,2020-01-01,5519,5245,274,5
30011,2020-01-01,614,599,15,2.4
30013,2020-01-01,38343,36720,1623,4.2
30015,2020-01-01,2401,2314,87,3.6
30017,2020-01-01,6094,5839,255,4.2
30019,2020-01-01,888,862,26,2.9
30021,2020-01-01,4548,4398,150,3.3
30023,2020-01-01,4989,4797,192,3.8
30025,2020-01-01,1672,1634,38,2.3
30027,2020-01-01,6040,5753,287,4.8
30029,2020-01-01,47869,44736,3133,6.5
30031,2020-01-01,69025,67266,1759,2.5
30033,2020-01-01,720,693,27,3.8
30035,2020-01-01,5445,4981,464,8.5
30037,2020-01-01,365,347,18,4.9
30039,2020-01-01,1747,1600,147,8.4
30041,2020-01-01,7584,7275,309,4.1
30043,2020-01-01,5700,5453,247,4.3
30045,2020-01-01,964,918,46,4.8
30047,2020-01-01,13195,12432,763,5.8
30049,2020-01-01,35798,34450,1348,3.8
30051,2020-01-01,933,902,31,3.3
30053,2020-01-01,8098,7260,838,10.3
30055,2020-01-01,930,908,22,2.4
30057,2020-01-01,5524,5324,200,3.6
30059,2020-01-01,995,955,40,4
30061,2020-01-01,1770,1577,193,10.9
30063,2020-01-01,64234,61591,2643,4.1
30065,2020-01-01,2296,2151,145,6.3
30067,2020-01-01,8618,8234,384,4.5
30069,2020-01-01,273,263,10,3.7
30071,2020-01-01,1866,1767,99,5.3
30073,2020-01-01,2602,2503,99,3.8
30075,2020-01-01,939,911,28,3
30077,2020-01-01,2891,2762,129,4.5
30079,2020-01-01,473,449,24,5.1
30081,2020-01-01,20261,19217,1044,5.2
30083,2020-01-01,5900,5712,188,3.2
30085,2020-01-01,4461,4245,216,4.8
30087,2020-01-01,3732,3546,186,5
30089,2020-01-01,4811,4405,406,8.4
30091,2020-01-01,1722,1666,56,3.3
30093,2020-01-01,17201,16390,811,4.7
30095,2020-01-01,5315,5114,201,3.8
30097,2020-01-01,1794,1729,65,3.6
30099,2020-01-01,2723,2586,137,5
30101,2020-01-01,2079,2011,68,3.3
30103,2020-01-01,331,323,8,2.4
30105,2020-01-01,4022,3852,170,4.2
30107,2020-01-01,775,728,47,6.1
30109,2020-01-01,451,437,14,3.1
30111,2020-01-01,81833,78700,3133,3.8
31001,2020-01-01,16719,16119,600,3.6
31003,2020-01-01,3611,3513,98,2.7
31005,2020-01-01,234,222,12,5.1
31007,2020-01-01,386,376,10,2.6
31009,2020-01-01,275,259,16,5.8
31011,2020-01-01,3019,2921,98,3.2
31013,2020-01-01,5326,5152,174,3.3
31015,2020-01-01,1108,1071,37,3.3
31017,2020-01-01,1411,1370,41,2.9
31019,2020-01-01,27716,26997,719,2.6
31021,2020-01-01,3481,3338,143,4.1
31023,2020-01-01,4495,4370,125,2.8
31025,2020-01-01,13670,13168,502,3.7
31027,2020-01-01,4507,4392,115,2.6
31029,2020-01-01,2309,2264,45,1.9
31031,2020-01-01,3407,3319,88,2.6
31033,2020-01-01,4305,4153,152,3.5
31035,2020-01-01,3310,3199,111,3.4
31037,2020-01-01,5569,5413,156,2.8
31039,2020-01-01,4730,4595,135,2.9
31041,2020-01-01,6473,6326,147,2.3
31043,2020-01-01,10799,10268,531,4.9
31045,2020-01-01,4888,4769,119,2.4
31047,2020-01-01,13131,12717,414,3.2
31049,2020-01-01,965,934,31,3.2
31051,2020-01-01,3058,2962,96,3.1
31053,2020-01-01,19411,18805,606,3.1
31055,2020-01-01,300008,289847,10161,3.4
31057,2020-01-01,1195,1168,27,2.3
31059,2020-01-01,3147,3067,80,2.5
31061,2020-01-01,1469,1424,45,3.1
31063,2020-01-01,1657,1594,63,3.8
31065,2020-01-01,2546,2478,68,2.7
31067,2020-01-01,10993,10591,402,3.7
31069,2020-01-01,1098,1057,41,3.7
31071,2020-01-01,1163,1134,29,2.5
31073,2020-01-01,1105,1082,23,2.1
31075,2020-01-01,440,430,10,2.3
31077,2020-01-01,1244,1205,39,3.1
31079,2020-01-01,32184,30500,1684,5.2
31081,2020-01-01,4825,4632,193,4
31083,2020-01-01,1770,1719,51,2.9
31085,2020-01-01,643,623,20,3.1
31087,2020-01-01,1268,1219,49,3.9
31089,2020-01-01,5848,5700,148,2.5
31091,2020-01-01,383,367,16,4.2
31093,2020-01-01,3440,3247,193,5.6
31095,2020-01-01,4172,4067,105,2.5
31097,2020-01-01,2070,2000,70,3.4
31099,2020-01-01,3814,3732,82,2.1
31101,2020-01-01,4491,4339,152,3.4
31103,2020-01-01,627,613,14,2.2
31105,2020-01-01,2021,1962,59,2.9
31107,2020-01-01,4671,4503,168,3.6
31109,2020-01-01,177911,173050,4861,2.7
31111,2020-01-01,18089,17446,643,3.6
31113,2020-01-01,482,470,12,2.5
31115,2020-01-01,420,400,20,4.8
31117,2020-01-01,446,430,16,3.6
31119,2020-01-01,19572,18976,596,3
31121,2020-01-01,4061,3889,172,4.2
31123,2020-01-01,2646,2552,94,3.6
31125,2020-01-01,1999,1938,61,3.1
31127,2020-01-01,3571,3440,131,3.7
31129,2020-01-01,2464,2378,86,3.5
31131,2020-01-01,8473,8209,264,3.1
31133,2020-01-01,1497,1458,39,2.6
31135,2020-01-01,1841,1802,39,2.1
31137,2020-01-01,5020,4899,121,2.4
31139,2020-01-01,4056,3945,111,2.7
31141,2020-01-01,17630,17116,514,2.9
31143,2020-01-01,2982,2894,88,3
31145,2020-01-01,5835,5677,158,2.7
31147,2020-01-01,4208,4061,147,3.5
31149,2020-01-01,898,875,23,2.6
31151,2020-01-01,7379,7125,254,3.4
31153,2020-01-01,96611,93772,2839,2.9
31155,2020-01-01,11272,10944,328,2.9
31157,2020-01-01,17919,17270,649,3.6
31159,2020-01-01,9064,8792,272,3
31161,2020-01-01,2705,2633,72,2.7
31163,2020-01-01,1701,1646,55,3.2
31165,2020-01-01,757,737,20,2.6
31167,2020-01-01,3512,3408,104,3
31169,2020-01-01,2777,2709,68,2.4
31171,2020-01-01,439,419,20,4.6
31173,2020-01-01,3088,2965,123,4
31175,2020-01-01,2138,2072,66,3.1
31177,2020-01-01,11339,10993,346,3.1
31179,2020-01-01,5810,5663,147,2.5
31181,2020-01-01,1704,1645,59,3.5
31183,2020-01-01,589,575,14,2.4
31185,2020-01-01,7201,7019,182,2.5
32001,2020-01-01,11385,10962,423,3.7
32003,2020-01-01,NA,NA,44782,3.9
32005,2020-01-01,23345,22409,936,4
32007,2020-01-01,27050,26160,890,3.3
32009,2020-01-01,473,455,18,3.8
32011,2020-01-01,1153,1128,25,2.2
32013,2020-01-01,8397,8130,267,3.2
32015,2020-01-01,3271,3144,127,3.9
32017,2020-01-01,2187,2105,82,3.7
32019,2020-01-01,23491,22320,1171,5
32021,2020-01-01,2010,1927,83,4.1
32023,2020-01-01,17843,16953,890,5
32027,2020-01-01,2630,2525,105,4
32029,2020-01-01,2053,1974,79,3.8
32031,2020-01-01,258405,249635,8770,3.4
32033,2020-01-01,4687,4547,140,3
32510,2020-01-01,26581,25490,1091,4.1
33001,2020-01-01,31233,30241,992,3.2
33003,2020-01-01,23990,23234,756,3.2
33005,2020-01-01,41022,39721,1301,3.2
33007,2020-01-01,14859,14245,614,4.1
33009,2020-01-01,50136,48854,1282,2.6
33011,2020-01-01,246879,239107,7772,3.1
33013,2020-01-01,84928,82668,2260,2.7
33015,2020-01-01,190571,184322,6249,3.3
33017,2020-01-01,74161,72140,2021,2.7
33019,2020-01-01,23212,22551,661,2.8
34001,2020-01-01,120234,112050,8184,6.8
34003,2020-01-01,490131,472964,17167,3.5
34005,2020-01-01,233388,224376,9012,3.9
34007,2020-01-01,257095,244660,12435,4.8
34009,2020-01-01,41701,36016,5685,13.6
34011,2020-01-01,65969,61178,4791,7.3
34013,2020-01-01,375637,355821,19816,5.3
34015,2020-01-01,152227,145250,6977,4.6
34017,2020-01-01,367370,353318,14052,3.8
34019,2020-01-01,65304,63030,2274,3.5
34021,2020-01-01,206303,198355,7948,3.9
34023,2020-01-01,444908,428529,16379,3.7
34025,2020-01-01,333155,320031,13124,3.9
34027,2020-01-01,260660,251812,8848,3.4
34029,2020-01-01,280055,266544,13511,4.8
34031,2020-01-01,247563,234262,13301,5.4
34033,2020-01-01,29369,27543,1826,6.2
34035,2020-01-01,174069,167772,6297,3.6
34037,2020-01-01,75368,71895,3473,4.6
34039,2020-01-01,281661,268896,12765,4.5
34041,2020-01-01,56768,54297,2471,4.4
35001,2020-01-01,335089,320161,14928,4.5
35003,2020-01-01,1151,1059,92,8
35005,2020-01-01,27445,26072,1373,5
35006,2020-01-01,9035,8449,586,6.5
35007,2020-01-01,5385,5141,244,4.5
35009,2020-01-01,21654,20757,897,4.1
35011,2020-01-01,708,676,32,4.5
35013,2020-01-01,97381,91429,5952,6.1
35015,2020-01-01,36339,35235,1104,3
35017,2020-01-01,12125,11513,612,5
35019,2020-01-01,1459,1385,74,5.1
35021,2020-01-01,284,272,12,4.2
35023,2020-01-01,2004,1912,92,4.6
35025,2020-01-01,32611,31270,1341,4.1
35027,2020-01-01,8739,8304,435,5
35028,2020-01-01,9471,9159,312,3.3
35029,2020-01-01,9691,8137,1554,16
35031,2020-01-01,24431,22704,1727,7.1
35033,2020-01-01,2094,1943,151,7.2
35035,2020-01-01,25124,23867,1257,5
35037,2020-01-01,3128,2965,163,5.2
35039,2020-01-01,16596,15665,931,5.6
35041,2020-01-01,7832,7479,353,4.5
35043,2020-01-01,66332,63159,3173,4.8
35045,2020-01-01,51455,48262,3193,6.2
35047,2020-01-01,10873,10228,645,5.9
35049,2020-01-01,76265,73235,3030,4
35051,2020-01-01,3783,3496,287,7.6
35053,2020-01-01,6309,5942,367,5.8
35055,2020-01-01,15748,14836,912,5.8
35057,2020-01-01,5427,5042,385,7.1
35059,2020-01-01,1666,1595,71,4.3
35061,2020-01-01,30658,29043,1615,5.3
36001,2020-01-01,159663,153480,6183,3.9
36003,2020-01-01,19797,18462,1335,6.7
36005,2020-01-01,591286,562402,28884,4.9
36007,2020-01-01,84055,79265,4790,5.7
36009,2020-01-01,35247,32951,2296,6.5
36011,2020-01-01,36114,34199,1915,5.3
36013,2020-01-01,54780,51554,3226,5.9
36015,2020-01-01,35748,33977,1771,5
36017,2020-01-01,22448,21206,1242,5.5
36019,2020-01-01,36754,34694,2060,5.6
36021,2020-01-01,31222,30031,1191,3.8
36023,2020-01-01,23144,21624,1520,6.6
36025,2020-01-01,19148,18079,1069,5.6
36027,2020-01-01,145436,139650,5786,4
36029,2020-01-01,445150,423222,21928,4.9
36031,2020-01-01,17719,16654,1065,6
36033,2020-01-01,19923,18746,1177,5.9
36035,2020-01-01,23037,21690,1347,5.8
36037,2020-01-01,29995,28475,1520,5.1
36039,2020-01-01,21318,20231,1087,5.1
36041,2020-01-01,2155,1965,190,8.8
36043,2020-01-01,28285,26547,1738,6.1
36045,2020-01-01,44224,40903,3321,7.5
36047,2020-01-01,NA,NA,42874,3.6
36049,2020-01-01,12160,11242,918,7.5
36051,2020-01-01,31246,29616,1630,5.2
36053,2020-01-01,33351,31513,1838,5.5
36055,2020-01-01,364121,347586,16535,4.5
36057,2020-01-01,22764,21343,1421,6.2
36059,2020-01-01,714487,688512,25975,3.6
36061,2020-01-01,902956,874458,28498,3.2
36063,2020-01-01,100143,94092,6051,6
36065,2020-01-01,101635,96682,4953,4.9
36067,2020-01-01,222687,212912,9775,4.4
36069,2020-01-01,56116,53489,2627,4.7
36071,2020-01-01,185860,178171,7689,4.1
36073,2020-01-01,17906,16869,1037,5.8
36075,2020-01-01,53988,50355,3633,6.7
36077,2020-01-01,27920,26376,1544,5.5
36079,2020-01-01,51691,49600,2091,4
36081,2020-01-01,NA,NA,34997,3.1
36083,2020-01-01,82456,78958,3498,4.2
36085,2020-01-01,220077,212504,7573,3.4
36087,2020-01-01,155635,149813,5822,3.7
36089,2020-01-01,43687,40810,2877,6.6
36091,2020-01-01,120821,116284,4537,3.8
36093,2020-01-01,77164,73967,3197,4.1
36095,2020-01-01,15076,14151,925,6.1
36097,2020-01-01,8073,7539,534,6.6
36099,2020-01-01,16313,15501,812,5
36101,2020-01-01,43375,40955,2420,5.6
36103,2020-01-01,787677,754715,32962,4.2
36105,2020-01-01,37082,35346,1736,4.7
36107,2020-01-01,22878,21698,1180,5.2
36109,2020-01-01,48698,46835,1863,3.8
36111,2020-01-01,88437,84706,3731,4.2
36113,2020-01-01,31369,29531,1838,5.9
36115,2020-01-01,27902,26483,1419,5.1
36117,2020-01-01,44597,42342,2255,5.1
36119,2020-01-01,485998,466524,19474,4
36121,2020-01-01,18455,17292,1163,6.3
36123,2020-01-01,12125,11529,596,4.9
37001,2020-01-01,82489,79307,3182,3.9
37003,2020-01-01,18185,17588,597,3.3
37005,2020-01-01,4351,4109,242,5.6
37007,2020-01-01,11061,10528,533,4.8
37009,2020-01-01,12889,12347,542,4.2
37011,2020-01-01,7242,6932,310,4.3
37013,2020-01-01,19445,18500,945,4.9
37015,2020-01-01,7888,7449,439,5.6
37017,2020-01-01,14806,14011,795,5.4
37019,2020-01-01,53137,49899,3238,6.1
37021,2020-01-01,141488,136976,4512,3.2
37023,2020-01-01,41396,39796,1600,3.9
37025,2020-01-01,110655,106548,4107,3.7
37027,2020-01-01,36828,35363,1465,4
37029,2020-01-01,4649,4449,200,4.3
37031,2020-01-01,31300,29835,1465,4.7
37033,2020-01-01,9979,9507,472,4.7
37035,2020-01-01,79609,76630,2979,3.7
37037,2020-01-01,36241,34980,1261,3.5
37039,2020-01-01,11028,10482,546,5
37041,2020-01-01,5563,5304,259,4.7
37043,2020-01-01,4117,3912,205,5
37045,2020-01-01,49145,46976,2169,4.4
37047,2020-01-01,23129,21851,1278,5.5
37049,2020-01-01,41953,40209,1744,4.2
37051,2020-01-01,128035,121164,6871,5.4
37053,2020-01-01,14038,13456,582,4.1
37055,2020-01-01,17690,16193,1497,8.5
37057,2020-01-01,81777,78545,3232,4
37059,2020-01-01,20888,20131,757,3.6
37061,2020-01-01,26004,24897,1107,4.3
37063,2020-01-01,173514,167530,5984,3.4
37065,2020-01-01,21472,20222,1250,5.8
37067,2020-01-01,189471,182136,7335,3.9
37069,2020-01-01,31784,30483,1301,4.1
37071,2020-01-01,112853,108128,4725,4.2
37073,2020-01-01,5332,5104,228,4.3
37075,2020-01-01,3116,2878,238,7.6
37077,2020-01-01,30368,29288,1080,3.6
37079,2020-01-01,9668,9299,369,3.8
37081,2020-01-01,264044,252825,11219,4.2
37083,2020-01-01,20563,19245,1318,6.4
37085,2020-01-01,53710,51269,2441,4.5
37087,2020-01-01,30249,29108,1141,3.8
37089,2020-01-01,55583,53643,1940,3.5
37091,2020-01-01,9187,8687,500,5.4
37093,2020-01-01,20230,19157,1073,5.3
37095,2020-01-01,1826,1563,263,14.4
37097,2020-01-01,90901,87420,3481,3.8
37099,2020-01-01,19219,18352,867,4.5
37101,2020-01-01,100749,97002,3747,3.7
37103,2020-01-01,4456,4287,169,3.8
37105,2020-01-01,26011,24839,1172,4.5
37107,2020-01-01,28040,26899,1141,4.1
37109,2020-01-01,44174,42510,1664,3.8
37111,2020-01-01,20489,19616,873,4.3
37113,2020-01-01,15181,14496,685,4.5
37115,2020-01-01,10253,9865,388,3.8
37117,2020-01-01,9099,8631,468,5.1
37119,2020-01-01,630139,606620,23519,3.7
37121,2020-01-01,5946,5625,321,5.4
37123,2020-01-01,11612,11127,485,4.2
37125,2020-01-01,42602,40907,1695,4
37127,2020-01-01,43687,41541,2146,4.9
37129,2020-01-01,124946,120316,4630,3.7
37131,2020-01-01,7867,7376,491,6.2
37133,2020-01-01,66118,63010,3108,4.7
37135,2020-01-01,79865,77276,2589,3.2
37137,2020-01-01,5399,5175,224,4.1
37139,2020-01-01,16691,15845,846,5.1
37141,2020-01-01,29248,28004,1244,4.3
37143,2020-01-01,4990,4722,268,5.4
37145,2020-01-01,18761,17937,824,4.4
37147,2020-01-01,90280,86417,3863,4.3
37149,2020-01-01,8975,8619,356,4
37151,2020-01-01,66775,64133,2642,4
37153,2020-01-01,16794,15845,949,5.7
37155,2020-01-01,50981,48109,2872,5.6
37157,2020-01-01,40509,38586,1923,4.7
37159,2020-01-01,67358,64425,2933,4.4
37161,2020-01-01,25439,24035,1404,5.5
37163,2020-01-01,30122,28884,1238,4.1
37165,2020-01-01,11764,10912,852,7.2
37167,2020-01-01,30524,29293,1231,4
37169,2020-01-01,21979,21104,875,4
37171,2020-01-01,34023,32650,1373,4
37173,2020-01-01,6649,6288,361,5.4
37175,2020-01-01,14456,13891,565,3.9
37177,2020-01-01,1342,1226,116,8.6
37179,2020-01-01,125629,121206,4423,3.5
37181,2020-01-01,17469,16394,1075,6.2
37183,2020-01-01,604293,583593,20700,3.4
37185,2020-01-01,6680,6267,413,6.2
37187,2020-01-01,4427,4115,312,7
37189,2020-01-01,29219,28226,993,3.4
37191,2020-01-01,52599,50326,2273,4.3
37193,2020-01-01,29280,27985,1295,4.4
37195,2020-01-01,35014,32954,2060,5.9
37197,2020-01-01,17989,17312,677,3.8
37199,2020-01-01,8431,8062,369,4.4
38001,2020-01-01,1046,1018,28,2.7
38003,2020-01-01,5095,4952,143,2.8
38005,2020-01-01,2301,2194,107,4.7
38007,2020-01-01,352,340,12,3.4
38009,2020-01-01,2828,2722,106,3.7
38011,2020-01-01,1675,1642,33,2
38013,2020-01-01,1039,1005,34,3.3
38015,2020-01-01,49079,47676,1403,2.9
38017,2020-01-01,102111,99549,2562,2.5
38019,2020-01-01,1837,1780,57,3.1
38021,2020-01-01,2230,2185,45,2
38023,2020-01-01,1344,1323,21,1.6
38025,2020-01-01,3123,3075,48,1.5
38027,2020-01-01,1179,1121,58,4.9
38029,2020-01-01,1417,1332,85,6
38031,2020-01-01,1448,1400,48,3.3
38033,2020-01-01,804,790,14,1.7
38035,2020-01-01,37330,36498,832,2.2
38037,2020-01-01,1181,1149,32,2.7
38039,2020-01-01,986,963,23,2.3
38041,2020-01-01,1333,1289,44,3.3
38043,2020-01-01,1240,1167,73,5.9
38045,2020-01-01,1973,1930,43,2.2
38047,2020-01-01,870,842,28,3.2
38049,2020-01-01,2988,2842,146,4.9
38051,2020-01-01,1083,1048,35,3.2
38053,2020-01-01,10274,10065,209,2
38055,2020-01-01,4530,4333,197,4.3
38057,2020-01-01,3330,3151,179,5.4
38059,2020-01-01,16216,15581,635,3.9
38061,2020-01-01,7343,7225,118,1.6
38063,2020-01-01,1342,1292,50,3.7
38065,2020-01-01,858,817,41,4.8
38067,2020-01-01,3213,3074,139,4.3
38069,2020-01-01,1658,1597,61,3.7
38071,2020-01-01,5401,5217,184,3.4
38073,2020-01-01,2787,2715,72,2.6
38075,2020-01-01,1203,1161,42,3.5
38077,2020-01-01,8333,8121,212,2.5
38079,2020-01-01,4530,4138,392,8.7
38081,2020-01-01,2623,2576,47,1.8
38083,2020-01-01,656,606,50,7.6
38085,2020-01-01,1201,1170,31,2.6
38087,2020-01-01,389,380,9,2.3
38089,2020-01-01,18103,17651,452,2.5
38091,2020-01-01,942,925,17,1.8
38093,2020-01-01,10049,9776,273,2.7
38095,2020-01-01,1030,1001,29,2.8
38097,2020-01-01,4304,4184,120,2.8
38099,2020-01-01,4940,4766,174,3.5
38101,2020-01-01,30849,29918,931,3
38103,2020-01-01,1837,1745,92,5
38105,2020-01-01,23747,23259,488,2.1
39001,2020-01-01,10707,9664,1043,9.7
39003,2020-01-01,47775,45264,2511,5.3
39005,2020-01-01,26690,25280,1410,5.3
39007,2020-01-01,44205,41303,2902,6.6
39009,2020-01-01,27326,25515,1811,6.6
39011,2020-01-01,24870,23945,925,3.7
39013,2020-01-01,29934,27393,2541,8.5
39015,2020-01-01,19814,18481,1333,6.7
39017,2020-01-01,195694,186889,8805,4.5
39019,2020-01-01,13012,12107,905,7
39021,2020-01-01,20002,19034,968,4.8
39023,2020-01-01,63519,59921,3598,5.7
39025,2020-01-01,107187,102288,4899,4.6
39027,2020-01-01,17940,16882,1058,5.9
39029,2020-01-01,47218,44229,2989,6.3
39031,2020-01-01,14189,13135,1054,7.4
39033,2020-01-01,18087,17030,1057,5.8
39035,2020-01-01,605754,577341,28413,4.7
39037,2020-01-01,25659,24405,1254,4.9
39039,2020-01-01,17934,17050,884,4.9
39041,2020-01-01,110856,106821,4035,3.6
39043,2020-01-01,35359,32914,2445,6.9
39045,2020-01-01,78719,75109,3610,4.6
39047,2020-01-01,13873,13199,674,4.9
39049,2020-01-01,701548,673237,28311,4
39051,2020-01-01,22470,21149,1321,5.9
39053,2020-01-01,12299,11362,937,7.6
39055,2020-01-01,48585,46517,2068,4.3
39057,2020-01-01,83528,79850,3678,4.4
39059,2020-01-01,18522,17040,1482,8
39061,2020-01-01,416541,398335,18206,4.4
39063,2020-01-01,41614,40027,1587,3.8
39065,2020-01-01,13555,12832,723,5.3
39067,2020-01-01,6642,6114,528,7.9
39069,2020-01-01,13129,12276,853,6.5
39071,2020-01-01,17037,15869,1168,6.9
39073,2020-01-01,13302,12472,830,6.2
39075,2020-01-01,20488,19699,789,3.9
39077,2020-01-01,27614,25215,2399,8.7
39079,2020-01-01,12741,11637,1104,8.7
39081,2020-01-01,27445,25359,2086,7.6
39083,2020-01-01,31228,29665,1563,5
39085,2020-01-01,125299,119656,5643,4.5
39087,2020-01-01,23842,22296,1546,6.5
39089,2020-01-01,91259,87071,4188,4.6
39091,2020-01-01,22883,21813,1070,4.7
39093,2020-01-01,152588,144713,7875,5.2
39095,2020-01-01,208653,197004,11649,5.6
39097,2020-01-01,20970,20082,888,4.2
39099,2020-01-01,101692,94675,7017,6.9
39101,2020-01-01,28179,26791,1388,4.9
39103,2020-01-01,96538,92638,3900,4
39105,2020-01-01,9000,8125,875,9.7
39107,2020-01-01,23036,22276,760,3.3
39109,2020-01-01,54479,51977,2502,4.6
39111,2020-01-01,5385,4724,661,12.3
39113,2020-01-01,253462,241186,12276,4.8
39115,2020-01-01,6763,6098,665,9.8
39117,2020-01-01,17071,16098,973,5.7
39119,2020-01-01,39501,36791,2710,6.9
39121,2020-01-01,4692,4247,445,9.5
39123,2020-01-01,20078,18271,1807,9
39125,2020-01-01,8492,8085,407,4.8
39127,2020-01-01,16261,15087,1174,7.2
39129,2020-01-01,26758,25386,1372,5.1
39131,2020-01-01,10796,9898,898,8.3
39133,2020-01-01,86648,81940,4708,5.4
39135,2020-01-01,21005,19976,1029,4.9
39137,2020-01-01,18546,17755,791,4.3
39139,2020-01-01,51680,48703,2977,5.8
39141,2020-01-01,35452,33406,2046,5.8
39143,2020-01-01,30158,28401,1757,5.8
39145,2020-01-01,28876,26506,2370,8.2
39147,2020-01-01,27080,25649,1431,5.3
39149,2020-01-01,23787,22727,1060,4.5
39151,2020-01-01,185229,174499,10730,5.8
39153,2020-01-01,269755,255532,14223,5.3
39155,2020-01-01,85736,79314,6422,7.5
39157,2020-01-01,44563,41931,2632,5.9
39159,2020-01-01,29107,27982,1125,3.9
39161,2020-01-01,15066,14421,645,4.3
39163,2020-01-01,5611,5134,477,8.5
39165,2020-01-01,119369,114422,4947,4.1
39167,2020-01-01,27425,25411,2014,7.3
39169,2020-01-01,62401,59855,2546,4.1
39171,2020-01-01,18803,18005,798,4.2
39173,2020-01-01,70591,67386,3205,4.5
39175,2020-01-01,12969,12441,528,4.1
40001,2020-01-01,8027,7680,347,4.3
40003,2020-01-01,2848,2786,62,2.2
40005,2020-01-01,4964,4714,250,5
40007,2020-01-01,2886,2833,53,1.8
40009,2020-01-01,9848,9403,445,4.5
40011,2020-01-01,4690,4579,111,2.4
40013,2020-01-01,21313,20679,634,3
40015,2020-01-01,11776,11337,439,3.7
40017,2020-01-01,73926,71743,2183,3
40019,2020-01-01,21260,20503,757,3.6
40021,2020-01-01,18692,17967,725,3.9
40023,2020-01-01,5478,5191,287,5.2
40025,2020-01-01,1342,1320,22,1.6
40027,2020-01-01,141807,138001,3806,2.7
40029,2020-01-01,2506,2400,106,4.2
40031,2020-01-01,48164,46595,1569,3.3
40033,2020-01-01,2727,2651,76,2.8
40035,2020-01-01,5851,5621,230,3.9
40037,2020-01-01,31378,30211,1167,3.7
40039,2020-01-01,15826,15363,463,2.9
40041,2020-01-01,17955,17282,673,3.7
40043,2020-01-01,2902,2839,63,2.2
40045,2020-01-01,2143,2083,60,2.8
40047,2020-01-01,26628,25778,850,3.2
40049,2020-01-01,12505,12038,467,3.7
40051,2020-01-01,26483,25567,916,3.5
40053,2020-01-01,2619,2557,62,2.4
40055,2020-01-01,1814,1740,74,4.1
40057,2020-01-01,1166,1135,31,2.7
40059,2020-01-01,1751,1702,49,2.8
40061,2020-01-01,4260,4013,247,5.8
40063,2020-01-01,5333,5046,287,5.4
40065,2020-01-01,10717,10404,313,2.9
40067,2020-01-01,2540,2448,92,3.6
40069,2020-01-01,3297,3120,177,5.4
40071,2020-01-01,17963,17245,718,4
40073,2020-01-01,9180,8985,195,2.1
40075,2020-01-01,3479,3365,114,3.3
40077,2020-01-01,3097,2872,225,7.3
40079,2020-01-01,18946,18075,871,4.6
40081,2020-01-01,15737,15177,560,3.6
40083,2020-01-01,21996,21353,643,2.9
40085,2020-01-01,6169,6023,146,2.4
40087,2020-01-01,19597,19042,555,2.8
40089,2020-01-01,14787,13926,861,5.8
40091,2020-01-01,7182,6701,481,6.7
40093,2020-01-01,3866,3781,85,2.2
40095,2020-01-01,6893,6652,241,3.5
40097,2020-01-01,19298,18701,597,3.1
40099,2020-01-01,6298,6092,206,3.3
40101,2020-01-01,29630,28520,1110,3.7
40103,2020-01-01,5604,5458,146,2.6
40105,2020-01-01,4577,4429,148,3.2
40107,2020-01-01,4609,4375,234,5.1
40109,2020-01-01,381970,370694,11276,3
40111,2020-01-01,15565,14823,742,4.8
40113,2020-01-01,20498,19747,751,3.7
40115,2020-01-01,13925,13491,434,3.1
40117,2020-01-01,7313,7028,285,3.9
40119,2020-01-01,37160,36103,1057,2.8
40121,2020-01-01,16970,16209,761,4.5
40123,2020-01-01,19305,18737,568,2.9
40125,2020-01-01,32241,31100,1141,3.5
40127,2020-01-01,4317,4079,238,5.5
40129,2020-01-01,1842,1782,60,3.3
40131,2020-01-01,44693,43322,1371,3.1
40133,2020-01-01,9481,9010,471,5
40135,2020-01-01,16148,15456,692,4.3
40137,2020-01-01,18458,17595,863,4.7
40139,2020-01-01,11618,11386,232,2
40141,2020-01-01,2961,2861,100,3.4
40143,2020-01-01,320546,310610,9936,3.1
40145,2020-01-01,37677,36473,1204,3.2
40147,2020-01-01,21969,21258,711,3.2
40149,2020-01-01,5176,4966,210,4.1
40151,2020-01-01,4575,4486,89,1.9
40153,2020-01-01,8816,8496,320,3.6
41001,2020-01-01,7010,6601,409,5.8
41003,2020-01-01,48517,47268,1249,2.6
41005,2020-01-01,218686,211458,7228,3.3
41007,2020-01-01,18656,17888,768,4.1
41009,2020-01-01,24516,23353,1163,4.7
41011,2020-01-01,25770,24517,1253,4.9
41013,2020-01-01,9516,8909,607,6.4
41015,2020-01-01,8617,8108,509,5.9
41017,2020-01-01,95424,91416,4008,4.2
41019,2020-01-01,46206,43840,2366,5.1
41021,2020-01-01,886,840,46,5.2
41023,2020-01-01,3062,2773,289,9.4
41025,2020-01-01,3453,3221,232,6.7
41027,2020-01-01,13683,13215,468,3.4
41029,2020-01-01,101275,96756,4519,4.5
41031,2020-01-01,9973,9373,600,6
41033,2020-01-01,35505,33639,1866,5.3
41035,2020-01-01,28671,26319,2352,8.2
41037,2020-01-01,3474,3282,192,5.5
41039,2020-01-01,181113,174094,7019,3.9
41041,2020-01-01,20081,19150,931,4.6
41043,2020-01-01,58702,56167,2535,4.3
41045,2020-01-01,12013,11461,552,4.6
41047,2020-01-01,159628,153121,6507,4.1
41049,2020-01-01,5518,5255,263,4.8
41051,2020-01-01,454571,440011,14560,3.2
41053,2020-01-01,39448,37867,1581,4
41055,2020-01-01,937,888,49,5.2
41057,2020-01-01,11572,11083,489,4.2
41059,2020-01-01,35585,33625,1960,5.5
41061,2020-01-01,11744,11053,691,5.9
41063,2020-01-01,3233,3011,222,6.9
41065,2020-01-01,12230,11634,596,4.9
41067,2020-01-01,324407,314939,9468,2.9
41069,2020-01-01,729,698,31,4.3
41071,2020-01-01,54483,52706,1777,3.3
42001,2020-01-01,54601,52465,2136,3.9
42003,2020-01-01,650897,620001,30896,4.7
42005,2020-01-01,32816,30423,2393,7.3
42007,2020-01-01,84680,79921,4759,5.6
42009,2020-01-01,23787,22234,1553,6.5
42011,2020-01-01,216819,205959,10860,5
42013,2020-01-01,59597,56394,3203,5.4
42015,2020-01-01,28876,27251,1625,5.6
42017,2020-01-01,346279,330948,15331,4.4
42019,2020-01-01,100402,95457,4945,4.9
42021,2020-01-01,58186,54389,3797,6.5
42023,2020-01-01,2032,1866,166,8.2
42025,2020-01-01,32470,30484,1986,6.1
42027,2020-01-01,81792,78700,3092,3.8
42029,2020-01-01,284708,274602,10106,3.5
42031,2020-01-01,17037,15865,1172,6.9
42033,2020-01-01,36694,34068,2626,7.2
42035,2020-01-01,18282,17012,1270,6.9
42037,2020-01-01,33490,31425,2065,6.2
42039,2020-01-01,38371,36064,2307,6
42041,2020-01-01,133181,128139,5042,3.8
42043,2020-01-01,145725,139224,6501,4.5
42045,2020-01-01,300975,287606,13369,4.4
42047,2020-01-01,15579,14507,1072,6.9
42049,2020-01-01,128958,121453,7505,5.8
42051,2020-01-01,58177,53511,4666,8
42053,2020-01-01,1805,1632,173,9.6
42055,2020-01-01,78824,75317,3507,4.4
42057,2020-01-01,8153,7631,522,6.4
42059,2020-01-01,16758,15653,1105,6.6
42061,2020-01-01,19859,18196,1663,8.4
42063,2020-01-01,38754,36162,2592,6.7
42065,2020-01-01,20703,19365,1338,6.5
42067,2020-01-01,12718,12022,696,5.5
42069,2020-01-01,105566,99496,6070,5.7
42071,2020-01-01,284386,273058,11328,4
42073,2020-01-01,40909,37869,3040,7.4
42075,2020-01-01,72389,69122,3267,4.5
42077,2020-01-01,194208,184652,9556,4.9
42079,2020-01-01,158558,147873,10685,6.7
42081,2020-01-01,57621,54151,3470,6
42083,2020-01-01,17424,16190,1234,7.1
42085,2020-01-01,48628,45707,2921,6
42087,2020-01-01,21184,19970,1214,5.7
42089,2020-01-01,84648,79346,5302,6.3
42091,2020-01-01,456960,439150,17810,3.9
42093,2020-01-01,9031,8647,384,4.3
42095,2020-01-01,162920,154629,8291,5.1
42097,2020-01-01,42319,39347,2972,7
42099,2020-01-01,24659,23530,1129,4.6
42101,2020-01-01,733945,690051,43894,6
42103,2020-01-01,25538,23820,1718,6.7
42105,2020-01-01,7257,6589,668,9.2
42107,2020-01-01,66954,62868,4086,6.1
42109,2020-01-01,19877,18661,1216,6.1
42111,2020-01-01,34382,31933,2449,7.1
42113,2020-01-01,2644,2442,202,7.6
42115,2020-01-01,20556,19338,1218,5.9
42117,2020-01-01,19092,17784,1308,6.9
42119,2020-01-01,19401,18498,903,4.7
42121,2020-01-01,22356,20940,1416,6.3
42123,2020-01-01,18898,17830,1068,5.7
42125,2020-01-01,107865,101857,6008,5.6
42127,2020-01-01,22222,20704,1518,6.8
42129,2020-01-01,182443,172285,10158,5.6
42131,2020-01-01,13686,12806,880,6.4
42133,2020-01-01,237799,227405,10394,4.4
44001,2020-01-01,26011,25123,888,3.4
44003,2020-01-01,90878,87458,3420,3.8
44005,2020-01-01,44548,42729,1819,4.1
44007,2020-01-01,325518,311654,13864,4.3
44009,2020-01-01,68922,66359,2563,3.7
45001,2020-01-01,10086,9721,365,3.6
45003,2020-01-01,75364,73133,2231,3
45005,2020-01-01,2698,2516,182,6.7
45007,2020-01-01,91579,89048,2531,2.8
45009,2020-01-01,4990,4711,279,5.6
45011,2020-01-01,8264,7887,377,4.6
45013,2020-01-01,78253,76187,2066,2.6
45015,2020-01-01,105018,102326,2692,2.6
45017,2020-01-01,6649,6419,230,3.5
45019,2020-01-01,213947,209054,4893,2.3
45021,2020-01-01,25115,24275,840,3.3
45023,2020-01-01,13575,12990,585,4.3
45025,2020-01-01,22192,21507,685,3.1
45027,2020-01-01,12759,12240,519,4.1
45029,2020-01-01,16847,16303,544,3.2
45031,2020-01-01,30322,29287,1035,3.4
45033,2020-01-01,13310,12757,553,4.2
45035,2020-01-01,78892,76922,1970,2.5
45037,2020-01-01,10821,10501,320,3
45039,2020-01-01,9710,9257,453,4.7
45041,2020-01-01,66852,64848,2004,3
45043,2020-01-01,25539,24456,1083,4.2
45045,2020-01-01,255817,249477,6340,2.5
45047,2020-01-01,31397,30366,1031,3.3
45049,2020-01-01,8426,8195,231,2.7
45051,2020-01-01,145671,139268,6403,4.4
45053,2020-01-01,12831,12518,313,2.4
45055,2020-01-01,29582,28625,957,3.2
45057,2020-01-01,41771,40323,1448,3.5
45059,2020-01-01,30354,29419,935,3.1
45061,2020-01-01,6701,6365,336,5
45063,2020-01-01,151226,147730,3496,2.3
45065,2020-01-01,3422,3287,135,3.9
45067,2020-01-01,12890,12333,557,4.3
45069,2020-01-01,9282,8869,413,4.4
45071,2020-01-01,19187,18654,533,2.8
45073,2020-01-01,35186,34203,983,2.8
45075,2020-01-01,35411,33662,1749,4.9
45077,2020-01-01,57714,56074,1640,2.8
45079,2020-01-01,200109,194552,5557,2.8
45081,2020-01-01,8998,8757,241,2.7
45083,2020-01-01,154278,150163,4115,2.7
45085,2020-01-01,44265,42694,1571,3.5
45087,2020-01-01,11742,11327,415,3.5
45089,2020-01-01,12081,11479,602,5
45091,2020-01-01,141827,137886,3941,2.8
46003,2020-01-01,1477,1431,46,3.1
46005,2020-01-01,9483,9151,332,3.5
46007,2020-01-01,1083,1020,63,5.8
46009,2020-01-01,2836,2728,108,3.8
46011,2020-01-01,19069,18351,718,3.8
46013,2020-01-01,20616,19886,730,3.5
46015,2020-01-01,2373,2287,86,3.6
46017,2020-01-01,665,624,41,6.2
46019,2020-01-01,4978,4776,202,4.1
46021,2020-01-01,763,731,32,4.2
46023,2020-01-01,3661,3517,144,3.9
46025,2020-01-01,1902,1807,95,5
46027,2020-01-01,7614,7355,259,3.4
46029,2020-01-01,15505,14963,542,3.5
46031,2020-01-01,1352,1281,71,5.3
46033,2020-01-01,3984,3764,220,5.5
46035,2020-01-01,10984,10608,376,3.4
46037,2020-01-01,2746,2570,176,6.4
46039,2020-01-01,2121,1950,171,8.1
46041,2020-01-01,2177,2026,151,6.9
46043,2020-01-01,1574,1518,56,3.6
46045,2020-01-01,2013,1944,69,3.4
46047,2020-01-01,2868,2721,147,5.1
46049,2020-01-01,1028,989,39,3.8
46051,2020-01-01,4428,4196,232,5.2
46053,2020-01-01,1984,1899,85,4.3
46055,2020-01-01,1036,1002,34,3.3
46057,2020-01-01,3285,3160,125,3.8
46059,2020-01-01,1756,1703,53,3
46061,2020-01-01,1745,1635,110,6.3
46063,2020-01-01,717,697,20,2.8
46065,2020-01-01,9984,9664,320,3.2
46067,2020-01-01,3622,3475,147,4.1
46069,2020-01-01,687,660,27,3.9
46071,2020-01-01,1134,1059,75,6.6
46073,2020-01-01,1084,1059,25,2.3
46075,2020-01-01,506,487,19,3.8
46077,2020-01-01,2598,2503,95,3.7
46079,2020-01-01,6585,6336,249,3.8
46081,2020-01-01,13270,12835,435,3.3
46083,2020-01-01,34643,33635,1008,2.9
46085,2020-01-01,1618,1532,86,5.3
46087,2020-01-01,3073,2966,107,3.5
46089,2020-01-01,1008,955,53,5.3
46091,2020-01-01,2322,2205,117,5
46093,2020-01-01,14010,13458,552,3.9
46095,2020-01-01,739,688,51,6.9
46097,2020-01-01,1168,1131,37,3.2
46099,2020-01-01,113605,109661,3944,3.5
46101,2020-01-01,3955,3806,149,3.8
46102,2020-01-01,3550,3225,325,9.2
46103,2020-01-01,56372,54234,2138,3.8
46105,2020-01-01,1393,1351,42,3
46107,2020-01-01,986,950,36,3.7
46109,2020-01-01,4873,4570,303,6.2
46111,2020-01-01,1144,1102,42,3.7
46115,2020-01-01,3137,2993,144,4.6
46117,2020-01-01,1847,1771,76,4.1
46119,2020-01-01,786,762,24,3.1
46121,2020-01-01,3149,2929,220,7
46123,2020-01-01,3005,2908,97,3.2
46125,2020-01-01,4708,4511,197,4.2
46127,2020-01-01,8541,8217,324,3.8
46129,2020-01-01,2109,1958,151,7.2
46135,2020-01-01,11875,11497,378,3.2
46137,2020-01-01,908,871,37,4.1
47001,2020-01-01,34642,33332,1310,3.8
47003,2020-01-01,21029,20197,832,4
47005,2020-01-01,6951,6566,385,5.5
47007,2020-01-01,4394,4135,259,5.9
47009,2020-01-01,63860,61444,2416,3.8
47011,2020-01-01,53419,51425,1994,3.7
47013,2020-01-01,14926,14144,782,5.2
47015,2020-01-01,6699,6486,213,3.2
47017,2020-01-01,12087,11390,697,5.8
47019,2020-01-01,23926,22840,1086,4.5
47021,2020-01-01,22195,21556,639,2.9
47023,2020-01-01,8547,8243,304,3.6
47025,2020-01-01,13041,12387,654,5
47027,2020-01-01,2763,2562,201,7.3
47029,2020-01-01,15111,14106,1005,6.7
47031,2020-01-01,25794,24789,1005,3.9
47033,2020-01-01,7106,6785,321,4.5
47035,2020-01-01,23906,22344,1562,6.5
47037,2020-01-01,409615,398635,10980,2.7
47039,2020-01-01,4646,4329,317,6.8
47041,2020-01-01,7758,7388,370,4.8
47043,2020-01-01,27450,26569,881,3.2
47045,2020-01-01,16506,15602,904,5.5
47047,2020-01-01,19240,18493,747,3.9
47049,2020-01-01,7604,7236,368,4.8
47051,2020-01-01,20276,19459,817,4
47053,2020-01-01,22294,21210,1084,4.9
47055,2020-01-01,15261,14469,792,5.2
47057,2020-01-01,9619,9147,472,4.9
47059,2020-01-01,29489,27960,1529,5.2
47061,2020-01-01,5069,4823,246,4.9
47063,2020-01-01,28456,27186,1270,4.5
47065,2020-01-01,184470,177711,6759,3.7
47067,2020-01-01,2144,2001,143,6.7
47069,2020-01-01,9603,9042,561,5.8
47071,2020-01-01,10546,10000,546,5.2
47073,2020-01-01,23856,22671,1185,5
47075,2020-01-01,7808,7394,414,5.3
47077,2020-01-01,12379,11742,637,5.1
47079,2020-01-01,14271,13518,753,5.3
47081,2020-01-01,11623,11232,391,3.4
47083,2020-01-01,3330,3131,199,6
47085,2020-01-01,9044,8591,453,5
47087,2020-01-01,4734,4469,265,5.6
47089,2020-01-01,24995,23787,1208,4.8
47091,2020-01-01,7780,7434,346,4.4
47093,2020-01-01,244003,236503,7500,3.1
47095,2020-01-01,1782,1656,126,7.1
47097,2020-01-01,9832,9263,569,5.8
47099,2020-01-01,19503,18653,850,4.4
47101,2020-01-01,5215,4998,217,4.2
47103,2020-01-01,16404,15175,1229,7.5
47105,2020-01-01,23647,22741,906,3.8
47107,2020-01-01,24053,23039,1014,4.2
47109,2020-01-01,8652,8120,532,6.1
47111,2020-01-01,11538,11157,381,3.3
47113,2020-01-01,48828,46974,1854,3.8
47115,2020-01-01,12582,11943,639,5.1
47117,2020-01-01,15772,15141,631,4
47119,2020-01-01,50146,48528,1618,3.2
47121,2020-01-01,5246,4960,286,5.5
47123,2020-01-01,20255,19388,867,4.3
47125,2020-01-01,85871,82329,3542,4.1
47127,2020-01-01,3560,3438,122,3.4
47129,2020-01-01,7957,7574,383,4.8
47131,2020-01-01,12576,11939,637,5.1
47133,2020-01-01,10194,9708,486,4.8
47135,2020-01-01,3100,2872,228,7.4
47137,2020-01-01,2381,2244,137,5.8
47139,2020-01-01,7749,7389,360,4.6
47141,2020-01-01,35178,33846,1332,3.8
47143,2020-01-01,13485,12688,797,5.9
47145,2020-01-01,23556,22447,1109,4.7
47147,2020-01-01,38702,37502,1200,3.1
47149,2020-01-01,186687,181653,5034,2.7
47151,2020-01-01,8280,7893,387,4.7
47153,2020-01-01,6208,5933,275,4.4
47155,2020-01-01,54369,50920,3449,6.3
47157,2020-01-01,445108,425617,19491,4.4
47159,2020-01-01,9627,9308,319,3.3
47161,2020-01-01,5551,5268,283,5.1
47163,2020-01-01,70246,67312,2934,4.2
47165,2020-01-01,103850,100827,3023,2.9
47167,2020-01-01,28280,27020,1260,4.5
47169,2020-01-01,5520,5338,182,3.3
47171,2020-01-01,7223,6741,482,6.7
47173,2020-01-01,7630,7305,325,4.3
47175,2020-01-01,2045,1950,95,4.6
47177,2020-01-01,16600,15839,761,4.6
47179,2020-01-01,60166,57834,2332,3.9
47181,2020-01-01,6276,5895,381,6.1
47183,2020-01-01,16128,15474,654,4.1
47185,2020-01-01,12294,11775,519,4.2
47187,2020-01-01,129991,126795,3196,2.5
47189,2020-01-01,77813,75589,2224,2.9
48001,2020-01-01,24080,23340,740,3.1
48003,2020-01-01,9956,9705,251,2.5
48005,2020-01-01,36033,34429,1604,4.5
48007,2020-01-01,9393,8961,432,4.6
48009,2020-01-01,4141,4016,125,3
48011,2020-01-01,931,902,29,3.1
48013,2020-01-01,21972,21135,837,3.8
48015,2020-01-01,14199,13670,529,3.7
48017,2020-01-01,2415,2319,96,4
48019,2020-01-01,10182,9837,345,3.4
48021,2020-01-01,43422,42083,1339,3.1
48023,2020-01-01,1781,1737,44,2.5
48025,2020-01-01,9777,9293,484,5
48027,2020-01-01,145694,140081,5613,3.9
48029,2020-01-01,962162,930924,31238,3.2
48031,2020-01-01,6591,6429,162,2.5
48033,2020-01-01,418,408,10,2.4
48035,2020-01-01,8366,8042,324,3.9
48037,2020-01-01,40092,38395,1697,4.2
48039,2020-01-01,181632,173088,8544,4.7
48041,2020-01-01,119724,116358,3366,2.8
48043,2020-01-01,4189,4071,118,2.8
48045,2020-01-01,563,539,24,4.3
48047,2020-01-01,2697,2550,147,5.5
48049,2020-01-01,15570,14930,640,4.1
48051,2020-01-01,8434,8127,307,3.6
48053,2020-01-01,23617,22949,668,2.8
48055,2020-01-01,19898,19232,666,3.3
48057,2020-01-01,12251,11803,448,3.7
48059,2020-01-01,6181,5970,211,3.4
48061,2020-01-01,169038,158331,10707,6.3
48063,2020-01-01,5001,4774,227,4.5
48065,2020-01-01,3015,2927,88,2.9
48067,2020-01-01,12439,11863,576,4.6
48069,2020-01-01,3366,3272,94,2.8
48071,2020-01-01,19722,18724,998,5.1
48073,2020-01-01,20910,20006,904,4.3
48075,2020-01-01,2919,2825,94,3.2
48077,2020-01-01,4925,4769,156,3.2
48079,2020-01-01,1104,1061,43,3.9
48081,2020-01-01,1459,1418,41,2.8
48083,2020-01-01,2859,2722,137,4.8
48085,2020-01-01,571454,553700,17754,3.1
48087,2020-01-01,1124,1081,43,3.8
48089,2020-01-01,9841,9502,339,3.4
48091,2020-01-01,74269,71976,2293,3.1
48093,2020-01-01,5582,5370,212,3.8
48095,2020-01-01,1329,1291,38,2.9
48097,2020-01-01,19723,19108,615,3.1
48099,2020-01-01,24422,23453,969,4
48101,2020-01-01,544,516,28,5.1
48103,2020-01-01,1547,1467,80,5.2
48105,2020-01-01,1621,1550,71,4.4
48107,2020-01-01,2466,2369,97,3.9
48109,2020-01-01,1056,1013,43,4.1
48111,2020-01-01,3845,3757,88,2.3
48113,2020-01-01,NA,NA,47891,3.5
48115,2020-01-01,4751,4540,211,4.4
48117,2020-01-01,8409,8173,236,2.8
48119,2020-01-01,2440,2352,88,3.6
48121,2020-01-01,501409,486523,14886,3
48123,2020-01-01,9922,9657,265,2.7
48125,2020-01-01,671,639,32,4.8
48127,2020-01-01,7345,7140,205,2.8
48129,2020-01-01,1381,1329,52,3.8
48131,2020-01-01,4929,4664,265,5.4
48133,2020-01-01,8120,7796,324,4
48135,2020-01-01,87996,85003,2993,3.4
48137,2020-01-01,1138,1114,24,2.1
48139,2020-01-01,93966,91001,2965,3.2
48141,2020-01-01,366807,352086,14721,4
48143,2020-01-01,20642,19886,756,3.7
48145,2020-01-01,6577,6344,233,3.5
48147,2020-01-01,17562,17075,487,2.8
48149,2020-01-01,12082,11746,336,2.8
48151,2020-01-01,1619,1570,49,3
48153,2020-01-01,2545,2406,139,5.5
48155,2020-01-01,580,564,16,2.8
48157,2020-01-01,395479,381076,14403,3.6
48159,2020-01-01,4619,4451,168,3.6
48161,2020-01-01,6402,6048,354,5.5
48163,2020-01-01,10452,10132,320,3.1
48165,2020-01-01,9879,9614,265,2.7
48167,2020-01-01,167082,159785,7297,4.4
48169,2020-01-01,2182,2107,75,3.4
48171,2020-01-01,13486,13134,352,2.6
48173,2020-01-01,773,757,16,2.1
48175,2020-01-01,3265,3135,130,4
48177,2020-01-01,9640,9341,299,3.1
48179,2020-01-01,8065,7724,341,4.2
48181,2020-01-01,63889,61756,2133,3.3
48183,2020-01-01,58144,55702,2442,4.2
48185,2020-01-01,11216,10706,510,4.5
48187,2020-01-01,82501,80029,2472,3
48189,2020-01-01,11932,11369,563,4.7
48191,2020-01-01,1042,996,46,4.4
48193,2020-01-01,3658,3543,115,3.1
48195,2020-01-01,2710,2642,68,2.5
48197,2020-01-01,1726,1673,53,3.1
48199,2020-01-01,25445,24190,1255,4.9
48201,2020-01-01,NA,NA,96350,4.1
48203,2020-01-01,29425,28125,1300,4.4
48205,2020-01-01,2765,2713,52,1.9
48207,2020-01-01,2265,2184,81,3.6
48209,2020-01-01,121491,118010,3481,2.9
48211,2020-01-01,1891,1823,68,3.6
48213,2020-01-01,36711,35307,1404,3.8
48215,2020-01-01,363350,335764,27586,7.6
48217,2020-01-01,16332,15742,590,3.6
48219,2020-01-01,11216,10839,377,3.4
48221,2020-01-01,27908,26885,1023,3.7
48223,2020-01-01,17543,16975,568,3.2
48225,2020-01-01,10279,9915,364,3.5
48227,2020-01-01,14202,13721,481,3.4
48229,2020-01-01,1828,1747,81,4.4
48231,2020-01-01,44014,42405,1609,3.7
48233,2020-01-01,8719,8287,432,5
48235,2020-01-01,756,737,19,2.5
48237,2020-01-01,3407,3264,143,4.2
48239,2020-01-01,7678,7414,264,3.4
48241,2020-01-01,12840,11910,930,7.2
48243,2020-01-01,982,950,32,3.3
48245,2020-01-01,107782,100867,6915,6.4
48247,2020-01-01,1859,1766,93,5
48249,2020-01-01,16834,15899,935,5.6
48251,2020-01-01,83206,80399,2807,3.4
48253,2020-01-01,5767,5519,248,4.3
48255,2020-01-01,7404,7217,187,2.5
48257,2020-01-01,65566,63326,2240,3.4
48259,2020-01-01,22363,21732,631,2.8
48261,2020-01-01,202,193,9,4.5
48263,2020-01-01,485,467,18,3.7
48265,2020-01-01,22166,21411,755,3.4
48267,2020-01-01,1811,1749,62,3.4
48269,2020-01-01,232,228,4,1.7
48271,2020-01-01,1407,1336,71,5
48273,2020-01-01,13331,12700,631,4.7
48275,2020-01-01,1415,1360,55,3.9
48277,2020-01-01,24252,23412,840,3.5
48279,2020-01-01,5338,5121,217,4.1
48281,2020-01-01,9322,9002,320,3.4
48283,2020-01-01,4384,4263,121,2.8
48285,2020-01-01,8413,8159,254,3
48287,2020-01-01,10004,9721,283,2.8
48289,2020-01-01,6320,6007,313,5
48291,2020-01-01,33604,31605,1999,5.9
48293,2020-01-01,8668,8304,364,4.2
48295,2020-01-01,1645,1598,47,2.9
48297,2020-01-01,5699,5504,195,3.4
48299,2020-01-01,8685,8375,310,3.6
48301,2020-01-01,663,659,4,0.6
48303,2020-01-01,157875,153285,4590,2.9
48305,2020-01-01,2756,2660,96,3.5
48307,2020-01-01,3320,3159,161,4.8
48309,2020-01-01,119993,115860,4133,3.4
48311,2020-01-01,896,883,13,1.5
48313,2020-01-01,4457,4262,195,4.4
48315,2020-01-01,4234,4013,221,5.2
48317,2020-01-01,2887,2801,86,3
48319,2020-01-01,1753,1690,63,3.6
48321,2020-01-01,16683,15558,1125,6.7
48323,2020-01-01,24614,22212,2402,9.8
48325,2020-01-01,22080,21347,733,3.3
48327,2020-01-01,858,829,29,3.4
48329,2020-01-01,107926,105377,2549,2.4
48331,2020-01-01,9670,9197,473,4.9
48333,2020-01-01,1900,1838,62,3.3
48335,2020-01-01,2318,2240,78,3.4
48337,2020-01-01,9355,9059,296,3.2
48339,2020-01-01,286578,276119,10459,3.6
48341,2020-01-01,10793,10520,273,2.5
48343,2020-01-01,4849,4569,280,5.8
48345,2020-01-01,468,450,18,3.8
48347,2020-01-01,28012,26915,1097,3.9
48349,2020-01-01,24195,23243,952,3.9
48351,2020-01-01,5246,4858,388,7.4
48353,2020-01-01,7354,7123,231,3.1
48355,2020-01-01,167148,159551,7597,4.5
48357,2020-01-01,4311,4171,140,3.2
48359,2020-01-01,916,887,29,3.2
48361,2020-01-01,36605,34573,2032,5.6
48363,2020-01-01,13498,13054,444,3.3
48365,2020-01-01,10050,9575,475,4.7
48367,2020-01-01,68197,66050,2147,3.1
48369,2020-01-01,4828,4712,116,2.4
48371,2020-01-01,6382,6130,252,3.9
48373,2020-01-01,18269,17274,995,5.4
48375,2020-01-01,55439,53866,1573,2.8
48377,2020-01-01,3193,2895,298,9.3
48379,2020-01-01,6166,5977,189,3.1
48381,2020-01-01,72383,70536,1847,2.6
48383,2020-01-01,1944,1881,63,3.2
48385,2020-01-01,1009,965,44,4.4
48387,2020-01-01,5142,4888,254,4.9
48389,2020-01-01,12406,12152,254,2
48391,2020-01-01,3137,3009,128,4.1
48393,2020-01-01,414,402,12,2.9
48395,2020-01-01,7691,7396,295,3.8
48397,2020-01-01,52817,51155,1662,3.1
48399,2020-01-01,4598,4455,143,3.1
48401,2020-01-01,23036,22051,985,4.3
48403,2020-01-01,3715,3423,292,7.9
48405,2020-01-01,3521,3326,195,5.5
48407,2020-01-01,11865,11259,606,5.1
48409,2020-01-01,29929,28079,1850,6.2
48411,2020-01-01,2570,2477,93,3.6
48413,2020-01-01,1308,1268,40,3.1
48415,2020-01-01,6735,6478,257,3.8
48417,2020-01-01,1896,1844,52,2.7
48419,2020-01-01,11141,10632,509,4.6
48421,2020-01-01,1367,1330,37,2.7
48423,2020-01-01,106713,102843,3870,3.6
48425,2020-01-01,4428,4253,175,4
48427,2020-01-01,26543,22882,3661,13.8
48429,2020-01-01,4063,3923,140,3.4
48431,2020-01-01,563,542,21,3.7
48433,2020-01-01,566,548,18,3.2
48435,2020-01-01,1346,1286,60,4.5
48437,2020-01-01,2577,2477,100,3.9
48439,2020-01-01,NA,NA,36471,3.3
48441,2020-01-01,67604,65569,2035,3
48443,2020-01-01,360,347,13,3.6
48445,2020-01-01,4876,4686,190,3.9
48447,2020-01-01,632,608,24,3.8
48449,2020-01-01,13096,12505,591,4.5
48451,2020-01-01,54544,52785,1759,3.2
48453,2020-01-01,750910,731017,19893,2.6
48455,2020-01-01,5329,5025,304,5.7
48457,2020-01-01,7191,6702,489,6.8
48459,2020-01-01,17883,17097,786,4.4
48461,2020-01-01,1698,1643,55,3.2
48463,2020-01-01,11367,10922,445,3.9
48465,2020-01-01,23292,22322,970,4.2
48467,2020-01-01,26143,25205,938,3.6
48469,2020-01-01,42759,41074,1685,3.9
48471,2020-01-01,24284,23315,969,4
48473,2020-01-01,23665,22705,960,4.1
48475,2020-01-01,7843,7634,209,2.7
48477,2020-01-01,15332,14810,522,3.4
48479,2020-01-01,119635,114720,4915,4.1
48481,2020-01-01,21620,20774,846,3.9
48483,2020-01-01,2276,2199,77,3.4
48485,2020-01-01,56473,54596,1877,3.3
48487,2020-01-01,4977,4779,198,4
48489,2020-01-01,6768,6205,563,8.3
48491,2020-01-01,318094,308981,9113,2.9
48493,2020-01-01,25200,24439,761,3
48495,2020-01-01,4054,3905,149,3.7
48497,2020-01-01,32280,31165,1115,3.5
48499,2020-01-01,17810,17052,758,4.3
48501,2020-01-01,3759,3626,133,3.5
48503,2020-01-01,7916,7664,252,3.2
48505,2020-01-01,4906,4585,321,6.5
48507,2020-01-01,3412,3099,313,9.2
49001,2020-01-01,2722,2634,88,3.2
49003,2020-01-01,25946,25196,750,2.9
49005,2020-01-01,64926,63468,1458,2.2
49007,2020-01-01,8487,8148,339,4
49009,2020-01-01,321,300,21,6.5
49011,2020-01-01,175148,170823,4325,2.5
49013,2020-01-01,7831,7453,378,4.8
49015,2020-01-01,4238,4025,213,5
49017,2020-01-01,2238,1934,304,13.6
49019,2020-01-01,5405,4849,556,10.3
49021,2020-01-01,24726,23985,741,3
49023,2020-01-01,5827,5654,173,3
49025,2020-01-01,3492,3354,138,4
49027,2020-01-01,5696,5526,170,3
49029,2020-01-01,5590,5451,139,2.5
49031,2020-01-01,472,446,26,5.5
49033,2020-01-01,927,880,47,5.1
49035,2020-01-01,644743,627767,16976,2.6
49037,2020-01-01,5472,5033,439,8
49039,2020-01-01,12438,11988,450,3.6
49041,2020-01-01,9614,9245,369,3.8
49043,2020-01-01,27724,27137,587,2.1
49045,2020-01-01,34539,33523,1016,2.9
49047,2020-01-01,13632,12896,736,5.4
49049,2020-01-01,312288,304402,7886,2.5
49051,2020-01-01,17052,16609,443,2.6
49053,2020-01-01,76741,74114,2627,3.4
49055,2020-01-01,1263,1115,148,11.7
49057,2020-01-01,128559,124643,3916,3
50001,2020-01-01,20207,19605,602,3
50003,2020-01-01,17952,17304,648,3.6
50005,2020-01-01,14264,13662,602,4.2
50007,2020-01-01,94012,92082,1930,2.1
50009,2020-01-01,2671,2540,131,4.9
50011,2020-01-01,26667,25892,775,2.9
50013,2020-01-01,3981,3817,164,4.1
50015,2020-01-01,13937,13354,583,4.2
50017,2020-01-01,15834,15229,605,3.8
50019,2020-01-01,13510,12669,841,6.2
50021,2020-01-01,30411,29433,978,3.2
50023,2020-01-01,34391,33294,1097,3.2
50025,2020-01-01,21966,21381,585,2.7
50027,2020-01-01,29017,28376,641,2.2
51001,2020-01-01,16471,15683,788,4.8
51003,2020-01-01,58100,56585,1515,2.6
51005,2020-01-01,7015,6685,330,4.7
51007,2020-01-01,6417,6187,230,3.6
51009,2020-01-01,15124,14587,537,3.6
51011,2020-01-01,7227,6929,298,4.1
51013,2020-01-01,157319,154118,3201,2
51015,2020-01-01,38242,37251,991,2.6
51017,2020-01-01,2562,2476,86,3.4
51019,2020-01-01,38664,37428,1236,3.2
51021,2020-01-01,2853,2774,79,2.8
51023,2020-01-01,17571,17070,501,2.9
51025,2020-01-01,6034,5720,314,5.2
51027,2020-01-01,6808,6272,536,7.9
51029,2020-01-01,6577,6243,334,5.1
51031,2020-01-01,26137,25234,903,3.5
51033,2020-01-01,15597,15041,556,3.6
51035,2020-01-01,13291,12763,528,4
51036,2020-01-01,3747,3606,141,3.8
51037,2020-01-01,5310,5093,217,4.1
51041,2020-01-01,191338,185840,5498,2.9
51043,2020-01-01,7735,7537,198,2.6
51045,2020-01-01,2318,2240,78,3.4
51047,2020-01-01,25102,24360,742,3
51049,2020-01-01,4687,4513,174,3.7
51051,2020-01-01,4828,4522,306,6.3
51053,2020-01-01,13945,13454,491,3.5
51057,2020-01-01,5544,5313,231,4.2
51059,2020-01-01,647069,631589,15480,2.4
51061,2020-01-01,37933,36960,973,2.6
51063,2020-01-01,8105,7839,266,3.3
51065,2020-01-01,14134,13779,355,2.5
51067,2020-01-01,26679,25768,911,3.4
51069,2020-01-01,48968,47700,1268,2.6
51071,2020-01-01,7767,7485,282,3.6
51073,2020-01-01,19711,19140,571,2.9
51075,2020-01-01,11434,11101,333,2.9
51077,2020-01-01,8201,7922,279,3.4
51079,2020-01-01,10658,10389,269,2.5
51081,2020-01-01,4290,4141,149,3.5
51083,2020-01-01,15641,14914,727,4.6
51085,2020-01-01,60459,58904,1555,2.6
51087,2020-01-01,185734,180352,5382,2.9
51089,2020-01-01,24023,23091,932,3.9
51091,2020-01-01,1227,1181,46,3.7
51093,2020-01-01,19556,18960,596,3
51095,2020-01-01,36895,35744,1151,3.1
51097,2020-01-01,3896,3783,113,2.9
51099,2020-01-01,13756,13358,398,2.9
51101,2020-01-01,9341,9065,276,3
51103,2020-01-01,5539,5168,371,6.7
51105,2020-01-01,8343,7942,401,4.8
51107,2020-01-01,226778,221331,5447,2.4
51109,2020-01-01,20173,19528,645,3.2
51111,2020-01-01,5359,5188,171,3.2
51113,2020-01-01,7516,7335,181,2.4
51115,2020-01-01,4170,4035,135,3.2
51117,2020-01-01,12378,11806,572,4.6
51119,2020-01-01,5296,5130,166,3.1
51121,2020-01-01,49186,47723,1463,3
51125,2020-01-01,7541,7333,208,2.8
51127,2020-01-01,12727,12408,319,2.5
51131,2020-01-01,5398,5103,295,5.5
51133,2020-01-01,5686,5301,385,6.8
51135,2020-01-01,7396,7179,217,2.9
51137,2020-01-01,17648,17089,559,3.2
51139,2020-01-01,12081,11376,705,5.8
51141,2020-01-01,7127,6839,288,4
51143,2020-01-01,30278,29096,1182,3.9
51145,2020-01-01,14462,14036,426,2.9
51147,2020-01-01,10379,9954,425,4.1
51149,2020-01-01,15419,14860,559,3.6
51153,2020-01-01,250393,243661,6732,2.7
51155,2020-01-01,15782,15208,574,3.6
51157,2020-01-01,3760,3657,103,2.7
51159,2020-01-01,4119,3973,146,3.5
51161,2020-01-01,49816,48398,1418,2.8
51163,2020-01-01,10789,10447,342,3.2
51165,2020-01-01,43037,41947,1090,2.5
51167,2020-01-01,11425,10829,596,5.2
51169,2020-01-01,9243,8904,339,3.7
51171,2020-01-01,22731,22110,621,2.7
51173,2020-01-01,13925,13321,604,4.3
51175,2020-01-01,9108,8831,277,3
51177,2020-01-01,68354,66262,2092,3.1
51179,2020-01-01,73480,71348,2132,2.9
51181,2020-01-01,3659,3518,141,3.9
51183,2020-01-01,3903,3702,201,5.1
51185,2020-01-01,15757,14912,845,5.4
51187,2020-01-01,20850,20194,656,3.1
51191,2020-01-01,27048,26040,1008,3.7
51193,2020-01-01,9547,9135,412,4.3
51195,2020-01-01,13411,12707,704,5.2
51197,2020-01-01,13659,13131,528,3.9
51199,2020-01-01,32980,32012,968,2.9
51510,2020-01-01,103294,100950,2344,2.3
51520,2020-01-01,7273,6972,301,4.1
51530,2020-01-01,3690,3587,103,2.8
51540,2020-01-01,26844,26175,669,2.5
51550,2020-01-01,123365,119606,3759,3
51570,2020-01-01,8983,8687,296,3.3
51580,2020-01-01,2436,2293,143,5.9
51590,2020-01-01,19303,18244,1059,5.5
51595,2020-01-01,2281,2168,113,5
51600,2020-01-01,13704,13392,312,2.3
51610,2020-01-01,8751,8569,182,2.1
51620,2020-01-01,3581,3426,155,4.3
51630,2020-01-01,14420,13926,494,3.4
51640,2020-01-01,2919,2819,100,3.4
51650,2020-01-01,64823,62170,2653,4.1
51660,2020-01-01,25641,24841,800,3.1
51670,2020-01-01,9909,9449,460,4.6
51678,2020-01-01,2107,2006,101,4.8
51680,2020-01-01,36495,35081,1414,3.9
51683,2020-01-01,22510,21879,631,2.8
51685,2020-01-01,9566,9303,263,2.7
51690,2020-01-01,5542,5268,274,4.9
51700,2020-01-01,89554,86056,3498,3.9
51710,2020-01-01,112273,108168,4105,3.7
51720,2020-01-01,1694,1613,81,4.8
51730,2020-01-01,13312,12535,777,5.8
51735,2020-01-01,6424,6253,171,2.7
51740,2020-01-01,44482,42702,1780,4
51750,2020-01-01,8492,8166,326,3.8
51760,2020-01-01,120799,116615,4184,3.5
51770,2020-01-01,49622,47947,1675,3.4
51775,2020-01-01,13088,12692,396,3
51790,2020-01-01,12497,12134,363,2.9
51800,2020-01-01,44885,43440,1445,3.2
51810,2020-01-01,234357,227555,6802,2.9
51820,2020-01-01,10904,10581,323,3
51830,2020-01-01,6736,6454,282,4.2
51840,2020-01-01,15069,14605,464,3.1
53001,2020-01-01,8521,7860,661,7.8
53003,2020-01-01,10636,10187,449,4.2
53005,2020-01-01,104938,98912,6026,5.7
53007,2020-01-01,43223,40638,2585,6
53009,2020-01-01,29854,27637,2217,7.4
53011,2020-01-01,247962,236675,11287,4.6
53013,2020-01-01,1757,1643,114,6.5
53015,2020-01-01,48962,46069,2893,5.9
53017,2020-01-01,20982,19514,1468,7
53019,2020-01-01,2472,2173,299,12.1
53021,2020-01-01,42102,38934,3168,7.5
53023,2020-01-01,838,775,63,7.5
53025,2020-01-01,44885,40834,4051,9
53027,2020-01-01,29736,27483,2253,7.6
53029,2020-01-01,37251,35364,1887,5.1
53031,2020-01-01,13500,12725,775,5.7
53033,2020-01-01,NA,NA,35036,2.7
53035,2020-01-01,132386,126528,5858,4.4
53037,2020-01-01,24354,22924,1430,5.9
53039,2020-01-01,9774,9125,649,6.6
53041,2020-01-01,35516,33159,2357,6.6
53043,2020-01-01,4729,4447,282,6
53045,2020-01-01,26592,24905,1687,6.3
53047,2020-01-01,18778,17048,1730,9.2
53049,2020-01-01,8587,8009,578,6.7
53051,2020-01-01,5178,4702,476,9.2
53053,2020-01-01,454960,431793,23167,5.1
53055,2020-01-01,8886,8480,406,4.6
53057,2020-01-01,63887,59954,3933,6.2
53059,2020-01-01,5668,5335,333,5.9
53061,2020-01-01,443958,430141,13817,3.1
53063,2020-01-01,261965,247355,14610,5.6
53065,2020-01-01,19266,17678,1588,8.2
53067,2020-01-01,147321,140249,7072,4.8
53069,2020-01-01,1383,1287,96,6.9
53071,2020-01-01,29704,28130,1574,5.3
53073,2020-01-01,118389,111841,6548,5.5
53075,2020-01-01,24258,23303,955,3.9
53077,2020-01-01,128105,117324,10781,8.4
54001,2020-01-01,7392,6918,474,6.4
54003,2020-01-01,59096,57159,1937,3.3
54005,2020-01-01,7516,7015,501,6.7
54007,2020-01-01,5321,4803,518,9.7
54009,2020-01-01,9916,9349,567,5.7
54011,2020-01-01,41726,40016,1710,4.1
54013,2020-01-01,2730,2201,529,19.4
54015,2020-01-01,3231,2860,371,11.5
54017,2020-01-01,3990,3786,204,5.1
54019,2020-01-01,16422,15276,1146,7
54021,2020-01-01,2401,2186,215,9
54023,2020-01-01,5936,5600,336,5.7
54025,2020-01-01,15835,14943,892,5.6
54027,2020-01-01,10891,10448,443,4.1
54029,2020-01-01,12995,12262,733,5.6
54031,2020-01-01,5850,5527,323,5.5
54033,2020-01-01,34921,33163,1758,5
54035,2020-01-01,13482,12669,813,6
54037,2020-01-01,30234,29333,901,3
54039,2020-01-01,82395,78398,3997,4.9
54041,2020-01-01,6609,6107,502,7.6
54043,2020-01-01,7322,6771,551,7.5
54045,2020-01-01,11520,10654,866,7.5
54047,2020-01-01,4651,4126,525,11.3
54049,2020-01-01,25793,24455,1338,5.2
54051,2020-01-01,14128,13035,1093,7.7
54053,2020-01-01,10303,9619,684,6.6
54055,2020-01-01,21010,19824,1186,5.6
54057,2020-01-01,12630,11898,732,5.8
54059,2020-01-01,7156,6478,678,9.5
54061,2020-01-01,54171,52236,1935,3.6
54063,2020-01-01,5971,5665,306,5.1
54065,2020-01-01,8173,7846,327,4
54067,2020-01-01,9740,8927,813,8.3
54069,2020-01-01,20943,19908,1035,4.9
54071,2020-01-01,3734,3572,162,4.3
54073,2020-01-01,2990,2732,258,8.6
54075,2020-01-01,4234,3999,235,5.6
54077,2020-01-01,15435,14642,793,5.1
54079,2020-01-01,26983,25744,1239,4.6
54081,2020-01-01,30595,28994,1601,5.2
54083,2020-01-01,12358,11505,853,6.9
54085,2020-01-01,4507,4186,321,7.1
54087,2020-01-01,5273,4674,599,11.4
54089,2020-01-01,4354,4066,288,6.6
54091,2020-01-01,7936,7521,415,5.2
54093,2020-01-01,3418,3203,215,6.3
54095,2020-01-01,3152,2875,277,8.8
54097,2020-01-01,9649,9017,632,6.5
54099,2020-01-01,16009,15048,961,6
54101,2020-01-01,3356,3099,257,7.7
54103,2020-01-01,6745,6150,595,8.8
54105,2020-01-01,2392,2140,252,10.5
54107,2020-01-01,37455,35327,2128,5.7
54109,2020-01-01,6778,6204,574,8.5
55001,2020-01-01,8018,7434,584,7.3
55003,2020-01-01,7654,7218,436,5.7
55005,2020-01-01,24250,22840,1410,5.8
55007,2020-01-01,7480,6891,589,7.9
55009,2020-01-01,141269,135978,5291,3.7
55011,2020-01-01,6416,6012,404,6.3
55013,2020-01-01,7007,6475,532,7.6
55015,2020-01-01,27491,26562,929,3.4
55017,2020-01-01,33231,31278,1953,5.9
55019,2020-01-01,17713,16847,866,4.9
55021,2020-01-01,31527,30220,1307,4.1
55023,2020-01-01,7627,7102,525,6.9
55025,2020-01-01,319001,309890,9111,2.9
55027,2020-01-01,47273,45334,1939,4.1
55029,2020-01-01,14035,13195,840,6
55031,2020-01-01,22972,21630,1342,5.8
55033,2020-01-01,23680,22496,1184,5
55035,2020-01-01,58156,55887,2269,3.9
55037,2020-01-01,2199,2069,130,5.9
55039,2020-01-01,56772,54650,2122,3.7
55041,2020-01-01,4017,3743,274,6.8
55043,2020-01-01,27154,25893,1261,4.6
55045,2020-01-01,21042,20202,840,4
55047,2020-01-01,9161,8608,553,6
55049,2020-01-01,13786,13192,594,4.3
55051,2020-01-01,2562,2375,187,7.3
55053,2020-01-01,10182,9544,638,6.3
55055,2020-01-01,45695,43806,1889,4.1
55057,2020-01-01,13360,12708,652,4.9
55059,2020-01-01,87602,83416,4186,4.8
55061,2020-01-01,11028,10581,447,4.1
55063,2020-01-01,65414,62967,2447,3.7
55065,2020-01-01,10101,9726,375,3.7
55067,2020-01-01,9288,8749,539,5.8
55069,2020-01-01,15167,14322,845,5.6
55071,2020-01-01,40626,38766,1860,4.6
55073,2020-01-01,74049,71390,2659,3.6
55075,2020-01-01,19337,18160,1177,6.1
55077,2020-01-01,7752,7302,450,5.8
55078,2020-01-01,1572,1461,111,7.1
55079,2020-01-01,465286,444357,20929,4.5
55081,2020-01-01,23248,22297,951,4.1
55083,2020-01-01,20828,19647,1181,5.7
55085,2020-01-01,17136,16084,1052,6.1
55087,2020-01-01,102918,99158,3760,3.7
55089,2020-01-01,48832,47294,1538,3.1
55091,2020-01-01,4068,3828,240,5.9
55093,2020-01-01,25465,24214,1251,4.9
55095,2020-01-01,24724,23117,1607,6.5
55097,2020-01-01,37861,36258,1603,4.2
55099,2020-01-01,6445,6077,368,5.7
55101,2020-01-01,98051,93085,4966,5.1
55103,2020-01-01,9131,8722,409,4.5
55105,2020-01-01,85466,81042,4424,5.2
55107,2020-01-01,6919,6440,479,6.9
55109,2020-01-01,50606,48179,2427,4.8
55111,2020-01-01,35168,33712,1456,4.1
55113,2020-01-01,7720,7217,503,6.5
55115,2020-01-01,20918,19915,1003,4.8
55117,2020-01-01,61175,59074,2101,3.4
55119,2020-01-01,11070,10416,654,5.9
55121,2020-01-01,15897,15084,813,5.1
55123,2020-01-01,15246,14481,765,5
55125,2020-01-01,9798,9201,597,6.1
55127,2020-01-01,56645,54152,2493,4.4
55129,2020-01-01,7786,7298,488,6.3
55131,2020-01-01,77001,74309,2692,3.5
55133,2020-01-01,224165,216361,7804,3.5
55135,2020-01-01,25726,24614,1112,4.3
55137,2020-01-01,11423,10745,678,5.9
55139,2020-01-01,91141,87953,3188,3.5
55141,2020-01-01,35111,33371,1740,5
56001,2020-01-01,20326,19665,661,3.3
56003,2020-01-01,5311,5024,287,5.4
56005,2020-01-01,23757,22841,916,3.9
56007,2020-01-01,7966,7628,338,4.2
56009,2020-01-01,9040,8767,273,3
56011,2020-01-01,3673,3558,115,3.1
56013,2020-01-01,18848,17800,1048,5.6
56015,2020-01-01,6639,6396,243,3.7
56017,2020-01-01,2145,2053,92,4.3
56019,2020-01-01,4090,3905,185,4.5
56021,2020-01-01,48858,46912,1946,4
56023,2020-01-01,8872,8501,371,4.2
56025,2020-01-01,39440,37589,1851,4.7
56027,2020-01-01,1223,1181,42,3.4
56029,2020-01-01,14780,14008,772,5.2
56031,2020-01-01,4533,4325,208,4.6
56033,2020-01-01,15647,14976,671,4.3
56035,2020-01-01,4234,3985,249,5.9
56037,2020-01-01,21362,20198,1164,5.4
56039,2020-01-01,15473,15056,417,2.7
56041,2020-01-01,8829,8416,413,4.7
56043,2020-01-01,3943,3761,182,4.6
56045,2020-01-01,3832,3712,120,3.1
72001,2020-01-01,4143,3353,790,19.1
72003,2020-01-01,11249,9939,1310,11.6
72005,2020-01-01,13706,12164,1542,11.3
72007,2020-01-01,6180,5526,654,10.6
72009,2020-01-01,6169,5402,767,12.4
72011,2020-01-01,8345,7499,846,10.1
72013,2020-01-01,23014,20360,2654,11.5
72015,2020-01-01,4438,3734,704,15.9
72017,2020-01-01,5590,4875,715,12.8
72019,2020-01-01,6965,6225,740,10.6
72021,2020-01-01,60984,56784,4200,6.9
72023,2020-01-01,12910,11500,1410,10.9
72025,2020-01-01,44739,41335,3404,7.6
72027,2020-01-01,9105,8144,961,10.6
72029,2020-01-01,14993,13909,1084,7.2
72031,2020-01-01,57337,53672,3665,6.4
72033,2020-01-01,7322,6745,577,7.9
72035,2020-01-01,15184,13912,1272,8.4
72037,2020-01-01,3456,3097,359,10.4
72039,2020-01-01,3551,3066,485,13.7
72041,2020-01-01,14473,13414,1059,7.3
72043,2020-01-01,9593,8235,1358,14.2
72045,2020-01-01,4665,4143,522,11.2
72047,2020-01-01,8388,7523,865,10.3
72049,2020-01-01,852,823,29,3.4
72051,2020-01-01,12354,11539,815,6.6
72053,2020-01-01,10201,9108,1093,10.7
72054,2020-01-01,3142,2751,391,12.4
72055,2020-01-01,4220,3328,892,21.1
72057,2020-01-01,10336,8982,1354,13.1
72059,2020-01-01,4687,3893,794,16.9
72061,2020-01-01,35087,33482,1605,4.6
72063,2020-01-01,16924,15802,1122,6.6
72065,2020-01-01,13241,11214,2027,15.3
72067,2020-01-01,5043,4529,514,10.2
72069,2020-01-01,16252,14384,1868,11.5
72071,2020-01-01,11093,9885,1208,10.9
72073,2020-01-01,4103,3491,612,14.9
72075,2020-01-01,14703,13159,1544,10.5
72077,2020-01-01,11539,10444,1095,9.5
72079,2020-01-01,5067,4240,827,16.3
72081,2020-01-01,6921,5688,1233,17.8
72083,2020-01-01,2581,2192,389,15.1
72085,2020-01-01,10636,9554,1082,10.2
72087,2020-01-01,7949,7218,731,9.2
72089,2020-01-01,5765,5209,556,9.6
72091,2020-01-01,10879,9901,978,9
72093,2020-01-01,1888,1579,309,16.4
72095,2020-01-01,2832,2326,506,17.9
72097,2020-01-01,20526,18017,2509,12.2
72099,2020-01-01,9937,8713,1224,12.3
72101,2020-01-01,7555,6728,827,10.9
72103,2020-01-01,7701,6909,792,10.3
72105,2020-01-01,6664,5989,675,10.1
72107,2020-01-01,4795,4097,698,14.6
72109,2020-01-01,4088,3363,725,17.7
72111,2020-01-01,5586,4708,878,15.7
72113,2020-01-01,42821,38279,4542,10.6
72115,2020-01-01,5854,5039,815,13.9
72117,2020-01-01,4654,3814,840,18
72119,2020-01-01,15825,14565,1260,8
72121,2020-01-01,5976,5017,959,16
72123,2020-01-01,6658,5630,1028,15.4
72125,2020-01-01,9294,7988,1306,14.1
72127,2020-01-01,125278,117602,7676,6.1
72129,2020-01-01,11011,9910,1101,10
72131,2020-01-01,9860,8274,1586,16.1
72133,2020-01-01,9573,8614,959,10
72135,2020-01-01,25318,23699,1619,6.4
72137,2020-01-01,27244,25510,1734,6.4
72139,2020-01-01,25296,23875,1421,5.6
72141,2020-01-01,6441,5515,926,14.4
72143,2020-01-01,9216,8284,932,10.1
72145,2020-01-01,12452,11123,1329,10.7
72147,2020-01-01,2452,2274,178,7.3
72149,2020-01-01,7311,5859,1452,19.9
72151,2020-01-01,8383,7142,1241,14.8
72153,2020-01-01,9918,7925,1993,20.1
01001,2020-02-01,25906,25196,710,2.7
01003,2020-02-01,95924,93418,2506,2.6
01005,2020-02-01,8532,8234,298,3.5
01007,2020-02-01,8628,8374,254,2.9
01009,2020-02-01,25179,24544,635,2.5
01011,2020-02-01,4784,4629,155,3.2
01013,2020-02-01,9251,8871,380,4.1
01015,2020-02-01,45942,44376,1566,3.4
01017,2020-02-01,15709,15264,445,2.8
01019,2020-02-01,11394,11072,322,2.8
01021,2020-02-01,19691,19212,479,2.4
01023,2020-02-01,4532,4308,224,4.9
01025,2020-02-01,7389,6975,414,5.6
01027,2020-02-01,6086,5924,162,2.7
01029,2020-02-01,5716,5549,167,2.9
01031,2020-02-01,21190,20631,559,2.6
01033,2020-02-01,23541,22664,877,3.7
01035,2020-02-01,4469,4299,170,3.8
01037,2020-02-01,4469,4339,130,2.9
01039,2020-02-01,15489,14993,496,3.2
01041,2020-02-01,6410,6226,184,2.9
01043,2020-02-01,38597,37624,973,2.5
01045,2020-02-01,20567,20007,560,2.7
01047,2020-02-01,14600,13852,748,5.1
01049,2020-02-01,30960,30135,825,2.7
01051,2020-02-01,37151,36183,968,2.6
01053,2020-02-01,14679,14175,504,3.4
01055,2020-02-01,42803,41123,1680,3.9
01057,2020-02-01,6539,6349,190,2.9
01059,2020-02-01,14744,14226,518,3.5
01061,2020-02-01,11021,10726,295,2.7
01063,2020-02-01,2870,2711,159,5.5
01065,2020-02-01,6225,5977,248,4
01067,2020-02-01,6896,6674,222,3.2
01069,2020-02-01,45901,44619,1282,2.8
01071,2020-02-01,23191,22421,770,3.3
01073,2020-02-01,316161,307682,8479,2.7
01075,2020-02-01,5844,5662,182,3.1
01077,2020-02-01,42242,40967,1275,3
01079,2020-02-01,14254,13841,413,2.9
01081,2020-02-01,77018,75143,1875,2.4
01083,2020-02-01,44106,43047,1059,2.4
01085,2020-02-01,3535,3357,178,5
01087,2020-02-01,7781,7479,302,3.9
01089,2020-02-01,186141,181831,4310,2.3
01091,2020-02-01,7650,7375,275,3.6
01093,2020-02-01,12850,12339,511,4
01095,2020-02-01,43832,42799,1033,2.4
01097,2020-02-01,188250,181148,7102,3.8
01099,2020-02-01,7455,7078,377,5.1
01101,2020-02-01,104530,101397,3133,3
01103,2020-02-01,58025,56631,1394,2.4
01105,2020-02-01,3403,3239,164,4.8
01107,2020-02-01,8012,7745,267,3.3
01109,2020-02-01,15439,14998,441,2.9
01111,2020-02-01,9633,9362,271,2.8
01113,2020-02-01,23665,23022,643,2.7
01115,2020-02-01,40212,39202,1010,2.5
01117,2020-02-01,115023,112687,2336,2
01119,2020-02-01,4764,4574,190,4
01121,2020-02-01,35358,34179,1179,3.3
01123,2020-02-01,18284,17764,520,2.8
01125,2020-02-01,105653,103138,2515,2.4
01127,2020-02-01,25189,24366,823,3.3
01129,2020-02-01,6798,6477,321,4.7
01131,2020-02-01,2802,2564,238,8.5
01133,2020-02-01,10071,9746,325,3.2
02013,2020-02-01,3104,3041,63,2
02016,2020-02-01,4625,4532,93,2
02020,2020-02-01,144632,138169,6463,4.5
02050,2020-02-01,6832,5973,859,12.6
02060,2020-02-01,236,200,36,15.3
02068,2020-02-01,561,459,102,18.2
02070,2020-02-01,1805,1676,129,7.1
02090,2020-02-01,43236,41081,2155,5
02100,2020-02-01,896,753,143,16
02105,2020-02-01,960,793,167,17.4
02110,2020-02-01,16178,15527,651,4
02122,2020-02-01,24616,22822,1794,7.3
02130,2020-02-01,6143,5690,453,7.4
02150,2020-02-01,5943,5681,262,4.4
02158,2020-02-01,2681,2165,516,19.2
02164,2020-02-01,585,519,66,11.3
02170,2020-02-01,46350,43247,3103,6.7
02180,2020-02-01,4095,3671,424,10.4
02185,2020-02-01,3723,3548,175,4.7
02188,2020-02-01,2925,2525,400,13.7
02195,2020-02-01,1248,1127,121,9.7
02198,2020-02-01,2688,2419,269,10
02220,2020-02-01,3951,3781,170,4.3
02230,2020-02-01,591,466,125,21.2
02240,2020-02-01,2692,2434,258,9.6
02261,2020-02-01,4102,3645,457,11.1
02275,2020-02-01,941,867,74,7.9
02282,2020-02-01,217,189,28,12.9
02290,2020-02-01,2394,2054,340,14.2
04001,2020-02-01,20710,18588,2122,10.2
04003,2020-02-01,52169,49345,2824,5.4
04005,2020-02-01,77685,73191,4494,5.8
04007,2020-02-01,21577,20418,1159,5.4
04009,2020-02-01,15909,15152,757,4.8
04011,2020-02-01,4628,4458,170,3.7
04012,2020-02-01,9774,9224,550,5.6
04013,2020-02-01,NA,NA,89812,3.8
04015,2020-02-01,89571,84668,4903,5.5
04017,2020-02-01,40941,37833,3108,7.6
04019,2020-02-01,507744,486239,21505,4.2
04021,2020-02-01,192715,183746,8969,4.7
04023,2020-02-01,19873,18442,1431,7.2
04025,2020-02-01,108048,103465,4583,4.2
04027,2020-02-01,98881,87010,11871,12
05001,2020-02-01,9345,9032,313,3.3
05003,2020-02-01,7758,7209,549,7.1
05005,2020-02-01,16097,15397,700,4.3
05007,2020-02-01,138984,135096,3888,2.8
05009,2020-02-01,16041,15466,575,3.6
05011,2020-02-01,4534,4338,196,4.3
05013,2020-02-01,2469,2343,126,5.1
05015,2020-02-01,12440,11938,502,4
05017,2020-02-01,3283,2997,286,8.7
05019,2020-02-01,9726,9362,364,3.7
05021,2020-02-01,5657,5324,333,5.9
05023,2020-02-01,9120,8611,509,5.6
05025,2020-02-01,3240,3083,157,4.8
05027,2020-02-01,9193,8764,429,4.7
05029,2020-02-01,8302,7907,395,4.8
05031,2020-02-01,56444,54756,1688,3
05033,2020-02-01,26862,25871,991,3.7
05035,2020-02-01,21419,20476,943,4.4
05037,2020-02-01,7405,7066,339,4.6
05039,2020-02-01,2833,2690,143,5
05041,2020-02-01,5361,5083,278,5.2
05043,2020-02-01,7955,7478,477,6
05045,2020-02-01,61827,59751,2076,3.4
05047,2020-02-01,7485,7196,289,3.9
05049,2020-02-01,4980,4763,217,4.4
05051,2020-02-01,41317,39648,1669,4
05053,2020-02-01,8378,8049,329,3.9
05055,2020-02-01,20317,19487,830,4.1
05057,2020-02-01,9925,9496,429,4.3
05059,2020-02-01,13988,13460,528,3.8
05061,2020-02-01,5795,5573,222,3.8
05063,2020-02-01,16639,15911,728,4.4
05065,2020-02-01,4891,4563,328,6.7
05067,2020-02-01,5886,5462,424,7.2
05069,2020-02-01,27625,25990,1635,5.9
05071,2020-02-01,10240,9776,464,4.5
05073,2020-02-01,2480,2352,128,5.2
05075,2020-02-01,6904,6582,322,4.7
05077,2020-02-01,2876,2698,178,6.2
05079,2020-02-01,3982,3771,211,5.3
05081,2020-02-01,5589,5304,285,5.1
05083,2020-02-01,8535,8126,409,4.8
05085,2020-02-01,34257,32994,1263,3.7
05087,2020-02-01,7570,7363,207,2.7
05089,2020-02-01,6654,6343,311,4.7
05091,2020-02-01,19881,19021,860,4.3
05093,2020-02-01,17244,16213,1031,6
05095,2020-02-01,2811,2675,136,4.8
05097,2020-02-01,2942,2772,170,5.8
05099,2020-02-01,3632,3479,153,4.2
05101,2020-02-01,3362,3217,145,4.3
05103,2020-02-01,9808,9266,542,5.5
05105,2020-02-01,4239,4056,183,4.3
05107,2020-02-01,6384,5925,459,7.2
05109,2020-02-01,4262,4067,195,4.6
05111,2020-02-01,10518,10091,427,4.1
05113,2020-02-01,8252,7785,467,5.7
05115,2020-02-01,28800,27531,1269,4.4
05117,2020-02-01,3589,3428,161,4.5
05119,2020-02-01,188399,181207,7192,3.8
05121,2020-02-01,7469,7130,339,4.5
05123,2020-02-01,8135,7686,449,5.5
05125,2020-02-01,58468,56649,1819,3.1
05127,2020-02-01,4355,4190,165,3.8
05129,2020-02-01,2828,2657,171,6
05131,2020-02-01,56513,54436,2077,3.7
05133,2020-02-01,5548,5248,300,5.4
05135,2020-02-01,5725,5387,338,5.9
05137,2020-02-01,4608,4347,261,5.7
05139,2020-02-01,15839,14889,950,6
05141,2020-02-01,5679,5347,332,5.8
05143,2020-02-01,126433,123250,3183,2.5
05145,2020-02-01,33857,32067,1790,5.3
05147,2020-02-01,2754,2611,143,5.2
05149,2020-02-01,8453,8103,350,4.1
06001,2020-02-01,840369,815376,24993,3
06003,2020-02-01,645,613,32,5
06005,2020-02-01,14857,14202,655,4.4
06007,2020-02-01,98511,93153,5358,5.4
06009,2020-02-01,21609,20704,905,4.2
06011,2020-02-01,11204,8986,2218,19.8
06013,2020-02-01,558771,541273,17498,3.1
06015,2020-02-01,9615,9015,600,6.2
06017,2020-02-01,92266,88884,3382,3.7
06019,2020-02-01,453973,415465,38508,8.5
06021,2020-02-01,13257,12322,935,7.1
06023,2020-02-01,62100,59691,2409,3.9
06025,2020-02-01,71651,59440,12211,17
06027,2020-02-01,8677,8335,342,3.9
06029,2020-02-01,395841,359859,35982,9.1
06031,2020-02-01,58494,52756,5738,9.8
06033,2020-02-01,29115,27429,1686,5.8
06035,2020-02-01,9786,9217,569,5.8
06037,2020-02-01,NA,NA,245988,4.7
06039,2020-02-01,63995,58857,5138,8
06041,2020-02-01,139759,136481,3278,2.3
06043,2020-02-01,7204,6753,451,6.3
06045,2020-02-01,38405,36598,1807,4.7
06047,2020-02-01,115543,103529,12014,10.4
06049,2020-02-01,3056,2756,300,9.8
06051,2020-02-01,8885,8550,335,3.8
06053,2020-02-01,217071,195316,21755,10
06055,2020-02-01,73598,71239,2359,3.2
06057,2020-02-01,48714,46939,1775,3.6
06059,2020-02-01,NA,NA,45543,2.8
06061,2020-02-01,188518,182518,6000,3.2
06063,2020-02-01,7437,6622,815,11
06065,2020-02-01,NA,NA,45727,4.1
06067,2020-02-01,714834,688034,26800,3.7
06069,2020-02-01,31605,29653,1952,6.2
06071,2020-02-01,969669,932642,37027,3.8
06073,2020-02-01,NA,NA,51075,3.2
06075,2020-02-01,587233,573934,13299,2.3
06077,2020-02-01,326471,304866,21605,6.6
06079,2020-02-01,142474,138201,4273,3
06081,2020-02-01,462905,453177,9728,2.1
06083,2020-02-01,215493,205612,9881,4.6
06085,2020-02-01,NA,NA,27181,2.6
06087,2020-02-01,141054,132050,9004,6.4
06089,2020-02-01,73409,69411,3998,5.4
06091,2020-02-01,1311,1220,91,6.9
06093,2020-02-01,17010,15563,1447,8.5
06095,2020-02-01,208513,200341,8172,3.9
06097,2020-02-01,258841,251495,7346,2.8
06099,2020-02-01,243980,227993,15987,6.6
06101,2020-02-01,46617,42462,4155,8.9
06103,2020-02-01,25754,24162,1592,6.2
06105,2020-02-01,4450,4126,324,7.3
06107,2020-02-01,205441,181823,23618,11.5
06109,2020-02-01,21572,20504,1068,5
06111,2020-02-01,424746,408975,15771,3.7
06113,2020-02-01,109234,103947,5287,4.8
06115,2020-02-01,30855,28712,2143,6.9
08001,2020-02-01,280046,270960,9086,3.2
08003,2020-02-01,8605,8244,361,4.2
08005,2020-02-01,374347,363908,10439,2.8
08007,2020-02-01,6636,6388,248,3.7
08009,2020-02-01,2072,2027,45,2.2
08011,2020-02-01,1820,1769,51,2.8
08013,2020-02-01,199780,194891,4889,2.4
08014,2020-02-01,41160,40085,1075,2.6
08015,2020-02-01,9564,9303,261,2.7
08017,2020-02-01,1162,1143,19,1.6
08019,2020-02-01,6206,6046,160,2.6
08021,2020-02-01,4093,3905,188,4.6
08023,2020-02-01,1873,1794,79,4.2
08025,2020-02-01,1505,1436,69,4.6
08027,2020-02-01,2003,1937,66,3.3
08029,2020-02-01,14193,13601,592,4.2
08031,2020-02-01,428190,416025,12165,2.8
08033,2020-02-01,1128,1087,41,3.6
08035,2020-02-01,199198,194365,4833,2.4
08037,2020-02-01,39182,38375,807,2.1
08039,2020-02-01,15501,15131,370,2.4
08041,2020-02-01,347369,335470,11899,3.4
08043,2020-02-01,14723,13965,758,5.1
08045,2020-02-01,33479,32365,1114,3.3
08047,2020-02-01,3874,3789,85,2.2
08049,2020-02-01,10365,10133,232,2.2
08051,2020-02-01,12014,11747,267,2.2
08053,2020-02-01,362,350,12,3.3
08055,2020-02-01,2403,2212,191,7.9
08057,2020-02-01,988,957,31,3.1
08059,2020-02-01,344089,335034,9055,2.6
08061,2020-02-01,927,914,13,1.4
08063,2020-02-01,4208,4124,84,2
08065,2020-02-01,5359,5250,109,2
08067,2020-02-01,31478,30517,961,3.1
08069,2020-02-01,209210,203683,5527,2.6
08071,2020-02-01,6531,6258,273,4.2
08073,2020-02-01,2289,2219,70,3.1
08075,2020-02-01,10814,10538,276,2.6
08077,2020-02-01,76746,73580,3166,4.1
08079,2020-02-01,534,519,15,2.8
08081,2020-02-01,7329,7014,315,4.3
08083,2020-02-01,12668,11955,713,5.6
08085,2020-02-01,21634,20860,774,3.6
08087,2020-02-01,16145,15692,453,2.8
08089,2020-02-01,8364,7990,374,4.5
08091,2020-02-01,2332,2248,84,3.6
08093,2020-02-01,11473,11178,295,2.6
08095,2020-02-01,2472,2431,41,1.7
08097,2020-02-01,11478,11195,283,2.5
08099,2020-02-01,6277,6111,166,2.6
08101,2020-02-01,76588,73284,3304,4.3
08103,2020-02-01,2976,2867,109,3.7
08105,2020-02-01,5321,5039,282,5.3
08107,2020-02-01,17311,16946,365,2.1
08109,2020-02-01,3538,3366,172,4.9
08111,2020-02-01,536,518,18,3.4
08113,2020-02-01,6617,6503,114,1.7
08115,2020-02-01,1216,1188,28,2.3
08117,2020-02-01,26002,25594,408,1.6
08119,2020-02-01,13018,12609,409,3.1
08121,2020-02-01,2792,2726,66,2.4
08123,2020-02-01,172414,167500,4914,2.9
08125,2020-02-01,5600,5494,106,1.9
09001,2020-02-01,477917,456971,20946,4.4
09003,2020-02-01,486620,465164,21456,4.4
09005,2020-02-01,104975,100261,4714,4.5
09007,2020-02-01,94654,90976,3678,3.9
09009,2020-02-01,464192,443182,21010,4.5
09011,2020-02-01,136918,130929,5989,4.4
09013,2020-02-01,87802,84338,3464,3.9
09015,2020-02-01,64454,61360,3094,4.8
10001,2020-02-01,80309,76804,3505,4.4
10003,2020-02-01,302963,291572,11391,3.8
10005,2020-02-01,105116,100249,4867,4.6
11001,2020-02-01,425308,404594,20714,4.9
12001,2020-02-01,142576,138750,3826,2.7
12003,2020-02-01,12043,11694,349,2.9
12005,2020-02-01,82157,79477,2680,3.3
12007,2020-02-01,11302,10961,341,3
12009,2020-02-01,286715,277830,8885,3.1
12011,2020-02-01,NA,NA,30394,2.9
12013,2020-02-01,4805,4641,164,3.4
12015,2020-02-01,73904,71305,2599,3.5
12017,2020-02-01,47719,45440,2279,4.8
12019,2020-02-01,109475,106274,3201,2.9
12021,2020-02-01,185284,180007,5277,2.8
12023,2020-02-01,30329,29393,936,3.1
12027,2020-02-01,15000,14498,502,3.3
12029,2020-02-01,5939,5714,225,3.8
12031,2020-02-01,499858,484354,15504,3.1
12033,2020-02-01,147161,142453,4708,3.2
12035,2020-02-01,47644,45906,1738,3.6
12037,2020-02-01,4521,4383,138,3.1
12039,2020-02-01,19075,18340,735,3.9
12041,2020-02-01,7303,7070,233,3.2
12043,2020-02-01,5714,5509,205,3.6
12045,2020-02-01,5606,5396,210,3.7
12047,2020-02-01,4207,4032,175,4.2
12049,2020-02-01,8805,8431,374,4.2
12051,2020-02-01,16166,15402,764,4.7
12053,2020-02-01,73102,70119,2983,4.1
12055,2020-02-01,36683,35056,1627,4.4
12057,2020-02-01,763917,741842,22075,2.9
12059,2020-02-01,7080,6832,248,3.5
12061,2020-02-01,66698,64327,2371,3.6
12063,2020-02-01,17222,16641,581,3.4
12065,2020-02-01,5670,5488,182,3.2
12067,2020-02-01,2899,2817,82,2.8
12069,2020-02-01,161182,156151,5031,3.1
12071,2020-02-01,356562,345949,10613,3
12073,2020-02-01,156781,152340,4441,2.8
12075,2020-02-01,16959,16367,592,3.5
12077,2020-02-01,2665,2573,92,3.5
12079,2020-02-01,7480,7223,257,3.4
12081,2020-02-01,184000,178565,5435,3
12083,2020-02-01,138944,133796,5148,3.7
12085,2020-02-01,75515,73258,2257,3
12086,2020-02-01,NA,NA,22521,1.6
12087,2020-02-01,48159,47198,961,2
12089,2020-02-01,41885,40696,1189,2.8
12091,2020-02-01,96013,93429,2584,2.7
12093,2020-02-01,18226,17691,535,2.9
12095,2020-02-01,772500,751168,21332,2.8
12097,2020-02-01,186590,180754,5836,3.1
12099,2020-02-01,742286,719637,22649,3.1
12101,2020-02-01,241993,233875,8118,3.4
12103,2020-02-01,502725,488163,14562,2.9
12105,2020-02-01,309082,298382,10700,3.5
12107,2020-02-01,26683,25532,1151,4.3
12109,2020-02-01,134707,131286,3421,2.5
12111,2020-02-01,147604,142099,5505,3.7
12113,2020-02-01,83470,81100,2370,2.8
12115,2020-02-01,193051,187336,5715,3
12117,2020-02-01,258810,251567,7243,2.8
12119,2020-02-01,33349,31816,1533,4.6
12121,2020-02-01,17980,17373,607,3.4
12123,2020-02-01,8161,7889,272,3.3
12125,2020-02-01,4703,4570,133,2.8
12127,2020-02-01,257750,249104,8646,3.4
12129,2020-02-01,15081,14658,423,2.8
12131,2020-02-01,31305,30429,876,2.8
12133,2020-02-01,9609,9274,335,3.5
13001,2020-02-01,9897,9534,363,3.7
13003,2020-02-01,5148,4994,154,3
13005,2020-02-01,5057,4867,190,3.8
13007,2020-02-01,1229,1172,57,4.6
13009,2020-02-01,17810,17013,797,4.5
13011,2020-02-01,9899,9617,282,2.8
13013,2020-02-01,41097,39891,1206,2.9
13015,2020-02-01,51489,49717,1772,3.4
13017,2020-02-01,5358,5060,298,5.6
13019,2020-02-01,7710,7365,345,4.5
13021,2020-02-01,68555,65858,2697,3.9
13023,2020-02-01,4579,4353,226,4.9
13025,2020-02-01,7252,6967,285,3.9
13027,2020-02-01,7131,6870,261,3.7
13029,2020-02-01,18388,17812,576,3.1
13031,2020-02-01,36953,35551,1402,3.8
13033,2020-02-01,9320,8853,467,5
13035,2020-02-01,10941,10559,382,3.5
13037,2020-02-01,2383,2300,83,3.5
13039,2020-02-01,21032,20245,787,3.7
13043,2020-02-01,5716,5561,155,2.7
13045,2020-02-01,56277,54174,2103,3.7
13047,2020-02-01,34225,33175,1050,3.1
13049,2020-02-01,4894,4710,184,3.8
13051,2020-02-01,140365,135554,4811,3.4
13053,2020-02-01,2023,1933,90,4.4
13055,2020-02-01,10376,9872,504,4.9
13057,2020-02-01,137887,134021,3866,2.8
13059,2020-02-01,59920,57803,2117,3.5
13061,2020-02-01,910,845,65,7.1
13063,2020-02-01,140224,134137,6087,4.3
13065,2020-02-01,2642,2539,103,3.9
13067,2020-02-01,431808,418630,13178,3.1
13069,2020-02-01,19289,18488,801,4.2
13071,2020-02-01,21989,21297,692,3.1
13073,2020-02-01,75894,73555,2339,3.1
13075,2020-02-01,8219,7932,287,3.5
13077,2020-02-01,75833,73576,2257,3
13079,2020-02-01,5691,5488,203,3.6
13081,2020-02-01,9654,9264,390,4
13083,2020-02-01,8345,8059,286,3.4
13085,2020-02-01,12502,12148,354,2.8
13087,2020-02-01,11912,11466,446,3.7
13089,2020-02-01,405645,391458,14187,3.5
13091,2020-02-01,7063,6680,383,5.4
13093,2020-02-01,5193,4996,197,3.8
13095,2020-02-01,38914,37043,1871,4.8
13097,2020-02-01,74398,71688,2710,3.6
13099,2020-02-01,4550,4351,199,4.4
13101,2020-02-01,2000,1943,57,2.9
13103,2020-02-01,31085,30150,935,3
13105,2020-02-01,7751,7416,335,4.3
13107,2020-02-01,8449,8054,395,4.7
13109,2020-02-01,4983,4804,179,3.6
13111,2020-02-01,11531,11110,421,3.7
13113,2020-02-01,58898,57137,1761,3
13115,2020-02-01,44830,43155,1675,3.7
13117,2020-02-01,124008,120589,3419,2.8
13119,2020-02-01,10092,9707,385,3.8
13121,2020-02-01,565766,545846,19920,3.5
13123,2020-02-01,11892,11446,446,3.8
13125,2020-02-01,1306,1252,54,4.1
13127,2020-02-01,39132,37820,1312,3.4
13129,2020-02-01,28517,27501,1016,3.6
13131,2020-02-01,10616,10252,364,3.4
13133,2020-02-01,7005,6719,286,4.1
13135,2020-02-01,497011,481670,15341,3.1
13137,2020-02-01,19224,18555,669,3.5
13139,2020-02-01,103806,100951,2855,2.8
13141,2020-02-01,2549,2408,141,5.5
13143,2020-02-01,12775,12312,463,3.6
13145,2020-02-01,16787,16259,528,3.1
13147,2020-02-01,11193,10711,482,4.3
13149,2020-02-01,5364,5164,200,3.7
13151,2020-02-01,117492,113291,4201,3.6
13153,2020-02-01,71387,68993,2394,3.4
13155,2020-02-01,3451,3288,163,4.7
13157,2020-02-01,37023,36010,1013,2.7
13159,2020-02-01,7058,6850,208,2.9
13161,2020-02-01,6135,5845,290,4.7
13163,2020-02-01,6759,6421,338,5
13165,2020-02-01,3132,2987,145,4.6
13167,2020-02-01,4060,3893,167,4.1
13169,2020-02-01,13885,13420,465,3.3
13171,2020-02-01,8414,8021,393,4.7
13173,2020-02-01,3803,3649,154,4
13175,2020-02-01,19144,18176,968,5.1
13177,2020-02-01,14952,14483,469,3.1
13179,2020-02-01,26720,25688,1032,3.9
13181,2020-02-01,3639,3492,147,4
13183,2020-02-01,8359,8066,293,3.5
13185,2020-02-01,51877,49959,1918,3.7
13187,2020-02-01,16908,16387,521,3.1
13189,2020-02-01,8972,8502,470,5.2
13191,2020-02-01,6207,5986,221,3.6
13193,2020-02-01,4837,4615,222,4.6
13195,2020-02-01,13479,13045,434,3.2
13197,2020-02-01,3339,3191,148,4.4
13199,2020-02-01,9053,8661,392,4.3
13201,2020-02-01,2846,2750,96,3.4
13205,2020-02-01,8790,8378,412,4.7
13207,2020-02-01,13177,12714,463,3.5
13209,2020-02-01,3857,3681,176,4.6
13211,2020-02-01,9430,9130,300,3.2
13213,2020-02-01,15630,14805,825,5.3
13215,2020-02-01,77764,74316,3448,4.4
13217,2020-02-01,53066,51018,2048,3.9
13219,2020-02-01,19754,19262,492,2.5
13221,2020-02-01,7081,6850,231,3.3
13223,2020-02-01,87450,84770,2680,3.1
13225,2020-02-01,12033,11568,465,3.9
13227,2020-02-01,15536,15045,491,3.2
13229,2020-02-01,8833,8553,280,3.2
13231,2020-02-01,9052,8769,283,3.1
13233,2020-02-01,18619,17928,691,3.7
13235,2020-02-01,4144,3979,165,4
13237,2020-02-01,8273,7922,351,4.2
13239,2020-02-01,797,761,36,4.5
13241,2020-02-01,6948,6694,254,3.7
13243,2020-02-01,2616,2490,126,4.8
13245,2020-02-01,85954,82116,3838,4.5
13247,2020-02-01,45477,43712,1765,3.9
13249,2020-02-01,2252,2169,83,3.7
13251,2020-02-01,5113,4888,225,4.4
13253,2020-02-01,3124,2990,134,4.3
13255,2020-02-01,29217,27976,1241,4.2
13257,2020-02-01,10717,10296,421,3.9
13259,2020-02-01,2457,2366,91,3.7
13261,2020-02-01,13062,12428,634,4.9
13263,2020-02-01,2827,2711,116,4.1
13265,2020-02-01,581,539,42,7.2
13267,2020-02-01,9806,9414,392,4
13269,2020-02-01,3257,3142,115,3.5
13271,2020-02-01,4204,3805,399,9.5
13273,2020-02-01,3547,3393,154,4.3
13275,2020-02-01,16594,15906,688,4.1
13277,2020-02-01,20336,19635,701,3.4
13279,2020-02-01,11839,11284,555,4.7
13281,2020-02-01,3867,3668,199,5.1
13283,2020-02-01,2679,2531,148,5.5
13285,2020-02-01,37828,36627,1201,3.2
13287,2020-02-01,3234,3076,158,4.9
13289,2020-02-01,2933,2762,171,5.8
13291,2020-02-01,10406,10046,360,3.5
13293,2020-02-01,11572,11107,465,4
13295,2020-02-01,31976,30902,1074,3.4
13297,2020-02-01,46807,45332,1475,3.2
13299,2020-02-01,15843,15245,598,3.8
13301,2020-02-01,2903,2780,123,4.2
13303,2020-02-01,7073,6739,334,4.7
13305,2020-02-01,11397,10948,449,3.9
13307,2020-02-01,1044,992,52,5
13309,2020-02-01,1665,1540,125,7.5
13311,2020-02-01,16471,16031,440,2.7
13313,2020-02-01,43521,41759,1762,4
13315,2020-02-01,2753,2637,116,4.2
13317,2020-02-01,3891,3678,213,5.5
13319,2020-02-01,4052,3900,152,3.8
13321,2020-02-01,9092,8747,345,3.8
15001,2020-02-01,91794,88760,3034,3.3
15003,2020-02-01,453659,442261,11398,2.5
15007,2020-02-01,36570,35549,1021,2.8
15009,2020-02-01,87084,84776,2308,2.7
16001,2020-02-01,260365,254134,6231,2.4
16003,2020-02-01,1658,1545,113,6.8
16005,2020-02-01,43600,42277,1323,3
16007,2020-02-01,2920,2814,106,3.6
16009,2020-02-01,4140,3881,259,6.3
16011,2020-02-01,23419,22723,696,3
16013,2020-02-01,12643,12245,398,3.1
16015,2020-02-01,3656,3461,195,5.3
16017,2020-02-01,20360,19362,998,4.9
16019,2020-02-01,58206,56704,1502,2.6
16021,2020-02-01,5238,4961,277,5.3
16023,2020-02-01,1384,1350,34,2.5
16025,2020-02-01,681,661,20,2.9
16027,2020-02-01,106260,102797,3463,3.3
16029,2020-02-01,4094,3954,140,3.4
16031,2020-02-01,12030,11744,286,2.4
16033,2020-02-01,358,342,16,4.5
16035,2020-02-01,2810,2623,187,6.7
16037,2020-02-01,1983,1894,89,4.5
16039,2020-02-01,11466,11050,416,3.6
16041,2020-02-01,6971,6815,156,2.2
16043,2020-02-01,7787,7555,232,3
16045,2020-02-01,8441,8143,298,3.5
16047,2020-02-01,8084,7830,254,3.1
16049,2020-02-01,6416,6090,326,5.1
16051,2020-02-01,14108,13751,357,2.5
16053,2020-02-01,12133,11758,375,3.1
16055,2020-02-01,80559,77242,3317,4.1
16057,2020-02-01,21143,20619,524,2.5
16059,2020-02-01,3460,3246,214,6.2
16061,2020-02-01,1570,1472,98,6.2
16063,2020-02-01,2725,2568,157,5.8
16065,2020-02-01,21984,21582,402,1.8
16067,2020-02-01,11264,10939,325,2.9
16069,2020-02-01,21338,20703,635,3
16071,2020-02-01,2281,2223,58,2.5
16073,2020-02-01,5268,5066,202,3.8
16075,2020-02-01,11643,11190,453,3.9
16077,2020-02-01,3815,3671,144,3.8
16079,2020-02-01,5084,4748,336,6.6
16081,2020-02-01,6289,6153,136,2.2
16083,2020-02-01,41444,40191,1253,3
16085,2020-02-01,5626,5379,247,4.4
16087,2020-02-01,4613,4402,211,4.6
17001,2020-02-01,31415,30545,870,2.8
17003,2020-02-01,2030,1927,103,5.1
17005,2020-02-01,7568,7327,241,3.2
17007,2020-02-01,25411,24024,1387,5.5
17009,2020-02-01,2929,2873,56,1.9
17011,2020-02-01,16496,15773,723,4.4
17013,2020-02-01,2260,2173,87,3.8
17015,2020-02-01,7020,6736,284,4
17017,2020-02-01,5917,5697,220,3.7
17019,2020-02-01,110763,107875,2888,2.6
17021,2020-02-01,13879,13280,599,4.3
17023,2020-02-01,7370,7074,296,4
17025,2020-02-01,6206,5939,267,4.3
17027,2020-02-01,20085,19532,553,2.8
17029,2020-02-01,23876,23204,672,2.8
17031,2020-02-01,NA,NA,88089,3.4
17033,2020-02-01,8432,8138,294,3.5
17035,2020-02-01,6029,5847,182,3
17037,2020-02-01,54265,52363,1902,3.5
17039,2020-02-01,7225,6980,245,3.4
17041,2020-02-01,10041,9785,256,2.5
17043,2020-02-01,502242,488992,13250,2.6
17045,2020-02-01,8399,8119,280,3.3
17047,2020-02-01,2639,2530,109,4.1
17049,2020-02-01,19083,18548,535,2.8
17051,2020-02-01,9550,9168,382,4
17053,2020-02-01,6359,6137,222,3.5
17055,2020-02-01,16079,15378,701,4.4
17057,2020-02-01,14759,13977,782,5.3
17059,2020-02-01,2291,2187,104,4.5
17061,2020-02-01,5796,5600,196,3.4
17063,2020-02-01,25176,23999,1177,4.7
17065,2020-02-01,4305,4167,138,3.2
17067,2020-02-01,7955,7614,341,4.3
17069,2020-02-01,1286,1214,72,5.6
17071,2020-02-01,3427,3264,163,4.8
17073,2020-02-01,24186,23139,1047,4.3
17075,2020-02-01,13680,13101,579,4.2
17077,2020-02-01,27776,27005,771,2.8
17079,2020-02-01,4614,4447,167,3.6
17081,2020-02-01,17171,16557,614,3.6
17083,2020-02-01,10838,10434,404,3.7
17085,2020-02-01,10243,9795,448,4.4
17087,2020-02-01,4220,4001,219,5.2
17089,2020-02-01,270431,259442,10989,4.1
17091,2020-02-01,55329,52822,2507,4.5
17093,2020-02-01,67885,65626,2259,3.3
17095,2020-02-01,20838,19961,877,4.2
17097,2020-02-01,368187,354390,13797,3.7
17099,2020-02-01,53486,50914,2572,4.8
17101,2020-02-01,5772,5536,236,4.1
17103,2020-02-01,17296,16732,564,3.3
17105,2020-02-01,15858,15292,566,3.6
17107,2020-02-01,12279,11862,417,3.4
17109,2020-02-01,13084,12664,420,3.2
17111,2020-02-01,164000,158432,5568,3.4
17113,2020-02-01,86658,84274,2384,2.8
17115,2020-02-01,47129,45087,2042,4.3
17117,2020-02-01,22534,21738,796,3.5
17119,2020-02-01,132902,128877,4025,3
17121,2020-02-01,17054,16447,607,3.6
17123,2020-02-01,5107,4872,235,4.6
17125,2020-02-01,6075,5788,287,4.7
17127,2020-02-01,5579,5335,244,4.4
17129,2020-02-01,6344,6116,228,3.6
17131,2020-02-01,7844,7414,430,5.5
17133,2020-02-01,18605,18143,462,2.5
17135,2020-02-01,11358,10774,584,5.1
17137,2020-02-01,15991,15440,551,3.4
17139,2020-02-01,7422,7235,187,2.5
17141,2020-02-01,23940,22891,1049,4.4
17143,2020-02-01,82684,78961,3723,4.5
17145,2020-02-01,8194,7883,311,3.8
17147,2020-02-01,8616,8385,231,2.7
17149,2020-02-01,6594,6315,279,4.2
17151,2020-02-01,1653,1582,71,4.3
17153,2020-02-01,1911,1795,116,6.1
17155,2020-02-01,3070,2910,160,5.2
17157,2020-02-01,14039,13625,414,2.9
17159,2020-02-01,7061,6831,230,3.3
17161,2020-02-01,69781,66798,2983,4.3
17163,2020-02-01,125252,121052,4200,3.4
17165,2020-02-01,9494,9067,427,4.5
17167,2020-02-01,98883,95694,3189,3.2
17169,2020-02-01,3048,2933,115,3.8
17171,2020-02-01,2442,2328,114,4.7
17173,2020-02-01,10253,9912,341,3.3
17175,2020-02-01,2380,2260,120,5
17177,2020-02-01,20950,20099,851,4.1
17179,2020-02-01,61930,59482,2448,4
17181,2020-02-01,7400,7018,382,5.2
17183,2020-02-01,32271,30960,1311,4.1
17185,2020-02-01,5862,5694,168,2.9
17187,2020-02-01,8127,7867,260,3.2
17189,2020-02-01,9769,9572,197,2
17191,2020-02-01,6728,6472,256,3.8
17193,2020-02-01,6389,6189,200,3.1
17195,2020-02-01,27781,26765,1016,3.7
17197,2020-02-01,353805,340211,13594,3.8
17199,2020-02-01,31949,30849,1100,3.4
17201,2020-02-01,134619,128307,6312,4.7
17203,2020-02-01,18104,17538,566,3.1
18001,2020-02-01,16925,16406,519,3.1
18003,2020-02-01,187748,181348,6400,3.4
18005,2020-02-01,45236,44108,1128,2.5
18007,2020-02-01,4660,4526,134,2.9
18009,2020-02-01,4816,4609,207,4.3
18011,2020-02-01,36326,35469,857,2.4
18013,2020-02-01,7746,7492,254,3.3
18015,2020-02-01,10634,10293,341,3.2
18017,2020-02-01,17807,17123,684,3.8
18019,2020-02-01,62203,60231,1972,3.2
18021,2020-02-01,12096,11638,458,3.8
18023,2020-02-01,17130,16675,455,2.7
18025,2020-02-01,4889,4613,276,5.6
18027,2020-02-01,16705,16244,461,2.8
18029,2020-02-01,25886,24881,1005,3.9
18031,2020-02-01,14797,14331,466,3.1
18033,2020-02-01,22819,22154,665,2.9
18035,2020-02-01,54905,52728,2177,4
18037,2020-02-01,22932,22373,559,2.4
18039,2020-02-01,112571,109482,3089,2.7
18041,2020-02-01,8498,8116,382,4.5
18043,2020-02-01,42027,40719,1308,3.1
18045,2020-02-01,7902,7625,277,3.5
18047,2020-02-01,11186,10748,438,3.9
18049,2020-02-01,9528,9160,368,3.9
18051,2020-02-01,19782,19263,519,2.6
18053,2020-02-01,32177,31012,1165,3.6
18055,2020-02-01,13756,13135,621,4.5
18057,2020-02-01,184920,180514,4406,2.4
18059,2020-02-01,40452,39318,1134,2.8
18061,2020-02-01,20502,19812,690,3.4
18063,2020-02-01,90613,88293,2320,2.6
18065,2020-02-01,22074,21322,752,3.4
18067,2020-02-01,37021,35596,1425,3.8
18069,2020-02-01,18231,17634,597,3.3
18071,2020-02-01,22990,22418,572,2.5
18073,2020-02-01,16326,15568,758,4.6
18075,2020-02-01,9306,9011,295,3.2
18077,2020-02-01,15036,14526,510,3.4
18079,2020-02-01,13658,13175,483,3.5
18081,2020-02-01,83466,81260,2206,2.6
18083,2020-02-01,18484,17895,589,3.2
18085,2020-02-01,42028,40831,1197,2.8
18087,2020-02-01,19687,19204,483,2.5
18089,2020-02-01,232192,220245,11947,5.1
18091,2020-02-01,47772,45523,2249,4.7
18093,2020-02-01,21342,20550,792,3.7
18095,2020-02-01,59703,57278,2425,4.1
18097,2020-02-01,494260,478724,15536,3.1
18099,2020-02-01,22783,22031,752,3.3
18101,2020-02-01,5363,5231,132,2.5
18103,2020-02-01,15122,14490,632,4.2
18105,2020-02-01,72352,70036,2316,3.2
18107,2020-02-01,18657,18100,557,3
18109,2020-02-01,36593,35387,1206,3.3
18111,2020-02-01,6950,6604,346,5
18113,2020-02-01,23270,22564,706,3
18115,2020-02-01,3188,3081,107,3.4
18117,2020-02-01,8839,8506,333,3.8
18119,2020-02-01,9615,9227,388,4
18121,2020-02-01,6818,6556,262,3.8
18123,2020-02-01,9231,8913,318,3.4
18125,2020-02-01,6186,5953,233,3.8
18127,2020-02-01,87518,83920,3598,4.1
18129,2020-02-01,13592,13213,379,2.8
18131,2020-02-01,6396,6152,244,3.8
18133,2020-02-01,16807,16233,574,3.4
18135,2020-02-01,10987,10523,464,4.2
18137,2020-02-01,14207,13680,527,3.7
18139,2020-02-01,8751,8510,241,2.8
18141,2020-02-01,137099,132156,4943,3.6
18143,2020-02-01,10624,10280,344,3.2
18145,2020-02-01,23264,22579,685,2.9
18147,2020-02-01,10255,9839,416,4.1
18149,2020-02-01,9655,9186,469,4.9
18151,2020-02-01,20945,20418,527,2.5
18153,2020-02-01,8410,8007,403,4.8
18155,2020-02-01,4919,4742,177,3.6
18157,2020-02-01,104764,101833,2931,2.8
18159,2020-02-01,9079,8822,257,2.8
18161,2020-02-01,3530,3414,116,3.3
18163,2020-02-01,95187,92264,2923,3.1
18165,2020-02-01,6994,6610,384,5.5
18167,2020-02-01,48495,46441,2054,4.2
18169,2020-02-01,15103,14613,490,3.2
18171,2020-02-01,4197,4072,125,3
18173,2020-02-01,33238,32265,973,2.9
18175,2020-02-01,13678,13173,505,3.7
18177,2020-02-01,30943,29844,1099,3.6
18179,2020-02-01,14440,14012,428,3
18181,2020-02-01,13434,13059,375,2.8
18183,2020-02-01,17852,17331,521,2.9
19001,2020-02-01,4293,4164,129,3
19003,2020-02-01,2183,2143,40,1.8
19005,2020-02-01,7604,7216,388,5.1
19007,2020-02-01,6012,5797,215,3.6
19009,2020-02-01,3132,3050,82,2.6
19011,2020-02-01,13697,13236,461,3.4
19013,2020-02-01,69446,67010,2436,3.5
19015,2020-02-01,15114,14701,413,2.7
19017,2020-02-01,14030,13658,372,2.7
19019,2020-02-01,11400,10997,403,3.5
19021,2020-02-01,12186,11923,263,2.2
19023,2020-02-01,8086,7743,343,4.2
19025,2020-02-01,4294,4178,116,2.7
19027,2020-02-01,11043,10823,220,2
19029,2020-02-01,6953,6721,232,3.3
19031,2020-02-01,11000,10653,347,3.2
19033,2020-02-01,23732,23036,696,2.9
19035,2020-02-01,6326,6124,202,3.2
19037,2020-02-01,6682,6422,260,3.9
19039,2020-02-01,4991,4805,186,3.7
19041,2020-02-01,8583,8304,279,3.3
19043,2020-02-01,10213,9571,642,6.3
19045,2020-02-01,22882,21935,947,4.1
19047,2020-02-01,8358,7956,402,4.8
19049,2020-02-01,50032,49047,985,2
19051,2020-02-01,4318,4198,120,2.8
19053,2020-02-01,4552,4452,100,2.2
19055,2020-02-01,10823,10493,330,3
19057,2020-02-01,19130,18169,961,5
19059,2020-02-01,9752,9351,401,4.1
19061,2020-02-01,57069,55128,1941,3.4
19063,2020-02-01,5310,5151,159,3
19065,2020-02-01,11047,10547,500,4.5
19067,2020-02-01,8786,8389,397,4.5
19069,2020-02-01,5772,5591,181,3.1
19071,2020-02-01,3726,3645,81,2.2
19073,2020-02-01,5542,5416,126,2.3
19075,2020-02-01,6655,6444,211,3.2
19077,2020-02-01,5802,5574,228,3.9
19079,2020-02-01,6998,6778,220,3.1
19081,2020-02-01,6022,5861,161,2.7
19083,2020-02-01,8145,7848,297,3.6
19085,2020-02-01,7589,7381,208,2.7
19087,2020-02-01,9930,9603,327,3.3
19089,2020-02-01,5339,5134,205,3.8
19091,2020-02-01,5161,4993,168,3.3
19093,2020-02-01,4283,4157,126,2.9
19095,2020-02-01,10699,10389,310,2.9
19097,2020-02-01,11167,10668,499,4.5
19099,2020-02-01,20053,19373,680,3.4
19101,2020-02-01,10446,10196,250,2.4
19103,2020-02-01,86546,84882,1664,1.9
19105,2020-02-01,11005,10495,510,4.6
19107,2020-02-01,5368,5134,234,4.4
19109,2020-02-01,8558,8332,226,2.6
19111,2020-02-01,16262,15582,680,4.2
19113,2020-02-01,122902,118899,4003,3.3
19115,2020-02-01,6205,5942,263,4.2
19117,2020-02-01,4708,4605,103,2.2
19119,2020-02-01,7180,7017,163,2.3
19121,2020-02-01,8777,8381,396,4.5
19123,2020-02-01,12037,11696,341,2.8
19125,2020-02-01,18583,18134,449,2.4
19127,2020-02-01,18299,17048,1251,6.8
19129,2020-02-01,7568,7392,176,2.3
19131,2020-02-01,7197,7056,141,2
19133,2020-02-01,4530,4374,156,3.4
19135,2020-02-01,4143,4009,134,3.2
19137,2020-02-01,5105,4960,145,2.8
19139,2020-02-01,22144,21446,698,3.2
19141,2020-02-01,8440,8236,204,2.4
19143,2020-02-01,3591,3506,85,2.4
19145,2020-02-01,6468,6298,170,2.6
19147,2020-02-01,4838,4702,136,2.8
19149,2020-02-01,15110,14767,343,2.3
19151,2020-02-01,4591,4492,99,2.2
19153,2020-02-01,271912,263581,8331,3.1
19155,2020-02-01,49581,48260,1321,2.7
19157,2020-02-01,10801,10437,364,3.4
19159,2020-02-01,2514,2444,70,2.8
19161,2020-02-01,5352,5188,164,3.1
19163,2020-02-01,88952,85691,3261,3.7
19165,2020-02-01,6795,6624,171,2.5
19167,2020-02-01,21850,21309,541,2.5
19169,2020-02-01,59598,58602,996,1.7
19171,2020-02-01,9607,9189,418,4.4
19173,2020-02-01,3265,3206,59,1.8
19175,2020-02-01,6457,6208,249,3.9
19177,2020-02-01,3702,3570,132,3.6
19179,2020-02-01,17947,17290,657,3.7
19181,2020-02-01,28708,27843,865,3
19183,2020-02-01,12292,11886,406,3.3
19185,2020-02-01,2890,2816,74,2.6
19187,2020-02-01,19663,18995,668,3.4
19189,2020-02-01,5266,5114,152,2.9
19191,2020-02-01,12616,12106,510,4
19193,2020-02-01,56524,54725,1799,3.2
19195,2020-02-01,4339,4186,153,3.5
19197,2020-02-01,7167,6959,208,2.9
20001,2020-02-01,6421,6193,228,3.6
20003,2020-02-01,4202,4059,143,3.4
20005,2020-02-01,7029,6641,388,5.5
20007,2020-02-01,2297,2236,61,2.7
20009,2020-02-01,13293,12794,499,3.8
20011,2020-02-01,6594,6277,317,4.8
20013,2020-02-01,5363,5203,160,3
20015,2020-02-01,33025,31904,1121,3.4
20017,2020-02-01,1552,1509,43,2.8
20019,2020-02-01,1424,1376,48,3.4
20021,2020-02-01,10162,9840,322,3.2
20023,2020-02-01,1317,1285,32,2.4
20025,2020-02-01,1080,1055,25,2.3
20027,2020-02-01,3769,3653,116,3.1
20029,2020-02-01,3749,3642,107,2.9
20031,2020-02-01,4182,3991,191,4.6
20033,2020-02-01,839,816,23,2.7
20035,2020-02-01,16329,15752,577,3.5
20037,2020-02-01,18625,17875,750,4
20039,2020-02-01,1178,1141,37,3.1
20041,2020-02-01,8764,8409,355,4.1
20043,2020-02-01,4129,3970,159,3.9
20045,2020-02-01,67075,65076,1999,3
20047,2020-02-01,1382,1352,30,2.2
20049,2020-02-01,1149,1113,36,3.1
20051,2020-02-01,17044,16682,362,2.1
20053,2020-02-01,2690,2621,69,2.6
20055,2020-02-01,20876,20441,435,2.1
20057,2020-02-01,16968,16556,412,2.4
20059,2020-02-01,14299,13784,515,3.6
20061,2020-02-01,11403,10888,515,4.5
20063,2020-02-01,1474,1447,27,1.8
20065,2020-02-01,1085,1056,29,2.7
20067,2020-02-01,3138,3058,80,2.5
20069,2020-02-01,3173,3102,71,2.2
20071,2020-02-01,778,764,14,1.8
20073,2020-02-01,3312,3187,125,3.8
20075,2020-02-01,1621,1592,29,1.8
20077,2020-02-01,2988,2913,75,2.5
20079,2020-02-01,17272,16732,540,3.1
20081,2020-02-01,2170,2124,46,2.1
20083,2020-02-01,978,949,29,3
20085,2020-02-01,7208,6969,239,3.3
20087,2020-02-01,10168,9801,367,3.6
20089,2020-02-01,1244,1212,32,2.6
20091,2020-02-01,342010,332840,9170,2.7
20093,2020-02-01,2021,1985,36,1.8
20095,2020-02-01,3462,3353,109,3.1
20097,2020-02-01,1267,1238,29,2.3
20099,2020-02-01,9943,9530,413,4.2
20101,2020-02-01,746,725,21,2.8
20103,2020-02-01,36966,35575,1391,3.8
20105,2020-02-01,1698,1659,39,2.3
20107,2020-02-01,4525,4208,317,7
20109,2020-02-01,1616,1580,36,2.2
20111,2020-02-01,16829,16243,586,3.5
20113,2020-02-01,17212,16804,408,2.4
20115,2020-02-01,5920,5765,155,2.6
20117,2020-02-01,5448,5291,157,2.9
20119,2020-02-01,2067,2021,46,2.2
20121,2020-02-01,17737,17065,672,3.8
20123,2020-02-01,3259,3184,75,2.3
20125,2020-02-01,14510,13842,668,4.6
20127,2020-02-01,3034,2936,98,3.2
20129,2020-02-01,1109,1080,29,2.6
20131,2020-02-01,5246,5109,137,2.6
20133,2020-02-01,6200,5927,273,4.4
20135,2020-02-01,1312,1278,34,2.6
20137,2020-02-01,2655,2600,55,2.1
20139,2020-02-01,8015,7700,315,3.9
20141,2020-02-01,2078,2021,57,2.7
20143,2020-02-01,2978,2898,80,2.7
20145,2020-02-01,2835,2742,93,3.3
20147,2020-02-01,2611,2549,62,2.4
20149,2020-02-01,12704,12321,383,3
20151,2020-02-01,4881,4765,116,2.4
20153,2020-02-01,1463,1434,29,2
20155,2020-02-01,29655,28686,969,3.3
20157,2020-02-01,2183,2128,55,2.5
20159,2020-02-01,5195,5065,130,2.5
20161,2020-02-01,35799,34851,948,2.6
20163,2020-02-01,2461,2384,77,3.1
20165,2020-02-01,1614,1571,43,2.7
20167,2020-02-01,3221,3123,98,3
20169,2020-02-01,30271,29257,1014,3.3
20171,2020-02-01,2809,2756,53,1.9
20173,2020-02-01,256380,246239,10141,4
20175,2020-02-01,9259,8976,283,3.1
20177,2020-02-01,90878,87620,3258,3.6
20179,2020-02-01,1390,1358,32,2.3
20181,2020-02-01,2760,2680,80,2.9
20183,2020-02-01,1961,1906,55,2.8
20185,2020-02-01,2035,1974,61,3
20187,2020-02-01,967,940,27,2.8
20189,2020-02-01,2478,2401,77,3.1
20191,2020-02-01,11068,10671,397,3.6
20193,2020-02-01,4267,4180,87,2
20195,2020-02-01,1419,1374,45,3.2
20197,2020-02-01,3665,3522,143,3.9
20199,2020-02-01,782,762,20,2.6
20201,2020-02-01,2893,2813,80,2.8
20203,2020-02-01,1183,1162,21,1.8
20205,2020-02-01,3991,3811,180,4.5
20207,2020-02-01,1575,1516,59,3.7
20209,2020-02-01,78140,74664,3476,4.4
21001,2020-02-01,7203,6786,417,5.8
21003,2020-02-01,8998,8645,353,3.9
21005,2020-02-01,12280,11798,482,3.9
21007,2020-02-01,3509,3305,204,5.8
21009,2020-02-01,18826,17935,891,4.7
21011,2020-02-01,4651,4272,379,8.1
21013,2020-02-01,8526,7919,607,7.1
21015,2020-02-01,71109,68686,2423,3.4
21017,2020-02-01,9508,9123,385,4
21019,2020-02-01,18023,16922,1101,6.1
21021,2020-02-01,12428,11877,551,4.4
21023,2020-02-01,3873,3640,233,6
21025,2020-02-01,3492,3128,364,10.4
21027,2020-02-01,7931,7440,491,6.2
21029,2020-02-01,43178,41471,1707,4
21031,2020-02-01,5230,4951,279,5.3
21033,2020-02-01,5504,5217,287,5.2
21035,2020-02-01,19133,18133,1000,5.2
21037,2020-02-01,50967,49199,1768,3.5
21039,2020-02-01,2298,2200,98,4.3
21041,2020-02-01,5221,4998,223,4.3
21043,2020-02-01,9928,9053,875,8.8
21045,2020-02-01,6686,6403,283,4.2
21047,2020-02-01,25598,24206,1392,5.4
21049,2020-02-01,17167,16436,731,4.3
21051,2020-02-01,5187,4824,363,7
21053,2020-02-01,4016,3783,233,5.8
21055,2020-02-01,3840,3657,183,4.8
21057,2020-02-01,3198,3023,175,5.5
21059,2020-02-01,47758,45857,1901,4
21061,2020-02-01,4886,4632,254,5.2
21063,2020-02-01,2113,1883,230,10.9
21065,2020-02-01,5474,5161,313,5.7
21067,2020-02-01,173810,168375,5435,3.1
21069,2020-02-01,6129,5736,393,6.4
21071,2020-02-01,11064,10232,832,7.5
21073,2020-02-01,25661,24735,926,3.6
21075,2020-02-01,2023,1928,95,4.7
21077,2020-02-01,4072,3910,162,4
21079,2020-02-01,7650,7290,360,4.7
21081,2020-02-01,11799,11260,539,4.6
21083,2020-02-01,15733,14994,739,4.7
21085,2020-02-01,11131,10530,601,5.4
21087,2020-02-01,5073,4859,214,4.2
21089,2020-02-01,13628,12571,1057,7.8
21091,2020-02-01,3980,3847,133,3.3
21093,2020-02-01,49322,47268,2054,4.2
21095,2020-02-01,6762,5961,801,11.8
21097,2020-02-01,8831,8463,368,4.2
21099,2020-02-01,8036,7525,511,6.4
21101,2020-02-01,22098,21255,843,3.8
21103,2020-02-01,8247,7950,297,3.6
21105,2020-02-01,1709,1622,87,5.1
21107,2020-02-01,18412,17539,873,4.7
21109,2020-02-01,4096,3821,275,6.7
21111,2020-02-01,403530,388684,14846,3.7
21113,2020-02-01,26446,25532,914,3.5
21115,2020-02-01,6734,6246,488,7.2
21117,2020-02-01,88041,84904,3137,3.6
21119,2020-02-01,4464,4132,332,7.4
21121,2020-02-01,9879,9338,541,5.5
21123,2020-02-01,6040,5754,286,4.7
21125,2020-02-01,24641,23461,1180,4.8
21127,2020-02-01,5275,4846,429,8.1
21129,2020-02-01,2120,1987,133,6.3
21131,2020-02-01,2760,2455,305,11.1
21133,2020-02-01,6486,5900,586,9
21135,2020-02-01,4726,4219,507,10.7
21137,2020-02-01,9234,8768,466,5
21139,2020-02-01,3672,3438,234,6.4
21141,2020-02-01,12636,12122,514,4.1
21143,2020-02-01,3031,2890,141,4.7
21145,2020-02-01,29289,27799,1490,5.1
21147,2020-02-01,4665,4358,307,6.6
21149,2020-02-01,4201,4018,183,4.4
21151,2020-02-01,47570,45804,1766,3.7
21153,2020-02-01,3443,2887,556,16.1
21155,2020-02-01,9670,9342,328,3.4
21157,2020-02-01,15180,14392,788,5.2
21159,2020-02-01,2833,2566,267,9.4
21161,2020-02-01,7008,6587,421,6
21163,2020-02-01,12344,11739,605,4.9
21165,2020-02-01,2355,2137,218,9.3
21167,2020-02-01,9991,9508,483,4.8
21169,2020-02-01,4086,3876,210,5.1
21171,2020-02-01,4712,4487,225,4.8
21173,2020-02-01,11640,10966,674,5.8
21175,2020-02-01,4638,4328,310,6.7
21177,2020-02-01,10491,9740,751,7.2
21179,2020-02-01,23322,22310,1012,4.3
21181,2020-02-01,3320,3150,170,5.1
21183,2020-02-01,9901,9302,599,6
21185,2020-02-01,33524,32545,979,2.9
21187,2020-02-01,5071,4851,220,4.3
21189,2020-02-01,1145,1062,83,7.2
21191,2020-02-01,7057,6741,316,4.5
21193,2020-02-01,8379,7721,658,7.9
21195,2020-02-01,19940,18541,1399,7
21197,2020-02-01,5025,4688,337,6.7
21199,2020-02-01,26787,25493,1294,4.8
21201,2020-02-01,822,775,47,5.7
21203,2020-02-01,6749,6402,347,5.1
21205,2020-02-01,10623,10019,604,5.7
21207,2020-02-01,6221,5861,360,5.8
21209,2020-02-01,28922,27952,970,3.4
21211,2020-02-01,25553,24771,782,3.1
21213,2020-02-01,8855,8466,389,4.4
21215,2020-02-01,10303,9956,347,3.4
21217,2020-02-01,12655,12138,517,4.1
21219,2020-02-01,5497,5267,230,4.2
21221,2020-02-01,6141,5813,328,5.3
21223,2020-02-01,3894,3729,165,4.2
21225,2020-02-01,6118,5839,279,4.6
21227,2020-02-01,65748,63301,2447,3.7
21229,2020-02-01,6250,6020,230,3.7
21231,2020-02-01,7371,6954,417,5.7
21233,2020-02-01,5538,5276,262,4.7
21235,2020-02-01,13665,12986,679,5
21237,2020-02-01,2024,1857,167,8.3
21239,2020-02-01,14554,14079,475,3.3
22001,2020-02-01,23574,22483,1091,4.6
22003,2020-02-01,8924,8425,499,5.6
22005,2020-02-01,64725,62402,2323,3.6
22007,2020-02-01,8869,8366,503,5.7
22009,2020-02-01,14913,14132,781,5.2
22011,2020-02-01,14582,13874,708,4.9
22013,2020-02-01,5514,5197,317,5.7
22015,2020-02-01,57407,55279,2128,3.7
22017,2020-02-01,103033,98110,4923,4.8
22019,2020-02-01,103480,99332,4148,4
22021,2020-02-01,3761,3510,251,6.7
22023,2020-02-01,3841,3697,144,3.7
22025,2020-02-01,3357,3171,186,5.5
22027,2020-02-01,5854,5508,346,5.9
22029,2020-02-01,7090,6648,442,6.2
22031,2020-02-01,10842,10230,612,5.6
22033,2020-02-01,232932,224223,8709,3.7
22035,2020-02-01,1866,1655,211,11.3
22037,2020-02-01,8030,7726,304,3.8
22039,2020-02-01,11639,11038,601,5.2
22041,2020-02-01,7300,6803,497,6.8
22043,2020-02-01,8150,7706,444,5.4
22045,2020-02-01,27889,26431,1458,5.2
22047,2020-02-01,14225,13446,779,5.5
22049,2020-02-01,6823,6515,308,4.5
22051,2020-02-01,215129,207311,7818,3.6
22053,2020-02-01,13044,12489,555,4.3
22055,2020-02-01,112611,108221,4390,3.9
22057,2020-02-01,41727,40139,1588,3.8
22059,2020-02-01,6754,6503,251,3.7
22061,2020-02-01,22095,21170,925,4.2
22063,2020-02-01,69409,67015,2394,3.4
22065,2020-02-01,3445,3196,249,7.2
22067,2020-02-01,10082,9201,881,8.7
22069,2020-02-01,16482,15705,777,4.7
22071,2020-02-01,179631,172117,7514,4.2
22073,2020-02-01,70222,66784,3438,4.9
22075,2020-02-01,10093,9731,362,3.6
22077,2020-02-01,9924,9478,446,4.5
22079,2020-02-01,54814,52398,2416,4.4
22081,2020-02-01,3735,3542,193,5.2
22083,2020-02-01,8133,7605,528,6.5
22085,2020-02-01,9075,8676,399,4.4
22087,2020-02-01,19971,19082,889,4.5
22089,2020-02-01,25300,24351,949,3.8
22091,2020-02-01,4307,4078,229,5.3
22093,2020-02-01,9311,8796,515,5.5
22095,2020-02-01,19800,18793,1007,5.1
22097,2020-02-01,31700,29870,1830,5.8
22099,2020-02-01,22025,21002,1023,4.6
22101,2020-02-01,19607,18587,1020,5.2
22103,2020-02-01,119820,115612,4208,3.5
22105,2020-02-01,54463,51887,2576,4.7
22107,2020-02-01,1361,1241,120,8.8
22109,2020-02-01,46027,44184,1843,4
22111,2020-02-01,9123,8619,504,5.5
22113,2020-02-01,23807,22729,1078,4.5
22115,2020-02-01,16129,15142,987,6.1
22117,2020-02-01,16680,15841,839,5
22119,2020-02-01,14470,13647,823,5.7
22121,2020-02-01,13786,13262,524,3.8
22123,2020-02-01,3591,3167,424,11.8
22125,2020-02-01,5443,5243,200,3.7
22127,2020-02-01,4831,4543,288,6
23001,2020-02-01,55457,53347,2110,3.8
23003,2020-02-01,30516,28642,1874,6.1
23005,2020-02-01,162457,157603,4854,3
23007,2020-02-01,14438,13752,686,4.8
23009,2020-02-01,27407,25553,1854,6.8
23011,2020-02-01,61905,59425,2480,4
23013,2020-02-01,19683,18731,952,4.8
23015,2020-02-01,16224,15450,774,4.8
23017,2020-02-01,26892,25605,1287,4.8
23019,2020-02-01,77471,73945,3526,4.6
23021,2020-02-01,7271,6864,407,5.6
23023,2020-02-01,19528,18934,594,3
23025,2020-02-01,22462,20979,1483,6.6
23027,2020-02-01,20213,19211,1002,5
23029,2020-02-01,13745,12685,1060,7.7
23031,2020-02-01,112216,107693,4523,4
24001,2020-02-01,32447,30695,1752,5.4
24003,2020-02-01,319049,309354,9695,3
24005,2020-02-01,458971,442375,16596,3.6
24009,2020-02-01,51007,49479,1528,3
24011,2020-02-01,18209,17519,690,3.8
24013,2020-02-01,97370,94403,2967,3
24015,2020-02-01,54090,51871,2219,4.1
24017,2020-02-01,89059,85922,3137,3.5
24019,2020-02-01,15283,14534,749,4.9
24021,2020-02-01,136219,131846,4373,3.2
24023,2020-02-01,15623,14775,848,5.4
24025,2020-02-01,142821,137987,4834,3.4
24027,2020-02-01,189709,184643,5066,2.7
24029,2020-02-01,10306,9797,509,4.9
24031,2020-02-01,566018,549538,16480,2.9
24033,2020-02-01,519266,500616,18650,3.6
24035,2020-02-01,28526,27587,939,3.3
24037,2020-02-01,58016,56132,1884,3.2
24039,2020-02-01,9257,8700,557,6
24041,2020-02-01,18919,18182,737,3.9
24043,2020-02-01,75128,72004,3124,4.2
24045,2020-02-01,51050,48497,2553,5
24047,2020-02-01,26012,23582,2430,9.3
24510,2020-02-01,290560,276865,13695,4.7
25001,2020-02-01,108982,102318,6664,6.1
25003,2020-02-01,64344,61568,2776,4.3
25005,2020-02-01,305873,291868,14005,4.6
25007,2020-02-01,8486,7867,619,7.3
25009,2020-02-01,429373,415131,14242,3.3
25011,2020-02-01,41467,40165,1302,3.1
25013,2020-02-01,232061,221863,10198,4.4
25015,2020-02-01,91662,88906,2756,3
25017,2020-02-01,929407,906588,22819,2.5
25019,2020-02-01,6286,5562,724,11.5
25021,2020-02-01,396348,385528,10820,2.7
25023,2020-02-01,286627,276322,10305,3.6
25025,2020-02-01,461523,449203,12320,2.7
25027,2020-02-01,452457,436372,16085,3.6
26001,2020-02-01,3839,3560,279,7.3
26003,2020-02-01,3102,2876,226,7.3
26005,2020-02-01,62631,60800,1831,2.9
26007,2020-02-01,13446,12831,615,4.6
26009,2020-02-01,10201,9632,569,5.6
26011,2020-02-01,5999,5566,433,7.2
26013,2020-02-01,3310,3110,200,6
26015,2020-02-01,32186,31185,1001,3.1
26017,2020-02-01,49951,47648,2303,4.6
26019,2020-02-01,8813,8297,516,5.9
26021,2020-02-01,74034,71250,2784,3.8
26023,2020-02-01,19411,18770,641,3.3
26025,2020-02-01,63089,60826,2263,3.6
26027,2020-02-01,24824,23856,968,3.9
26029,2020-02-01,12375,11737,638,5.2
26031,2020-02-01,10063,8627,1436,14.3
26033,2020-02-01,16261,15206,1055,6.5
26035,2020-02-01,11738,10975,763,6.5
26037,2020-02-01,42040,40988,1052,2.5
26039,2020-02-01,5677,5337,340,6
26041,2020-02-01,17151,16229,922,5.4
26043,2020-02-01,12320,11802,518,4.2
26045,2020-02-01,58688,57006,1682,2.9
26047,2020-02-01,17269,16186,1083,6.3
26049,2020-02-01,185753,178195,7558,4.1
26051,2020-02-01,9876,9301,575,5.8
26053,2020-02-01,6128,5798,330,5.4
26055,2020-02-01,49127,47397,1730,3.5
26057,2020-02-01,18363,17646,717,3.9
26059,2020-02-01,20451,19707,744,3.6
26061,2020-02-01,16946,16213,733,4.3
26063,2020-02-01,15252,14569,683,4.5
26065,2020-02-01,154734,150478,4256,2.8
26067,2020-02-01,30593,29704,889,2.9
26069,2020-02-01,10176,9472,704,6.9
26071,2020-02-01,5205,4893,312,6
26073,2020-02-01,35124,33859,1265,3.6
26075,2020-02-01,75042,72487,2555,3.4
26077,2020-02-01,135993,132295,3698,2.7
26079,2020-02-01,7885,7375,510,6.5
26081,2020-02-01,365532,356838,8694,2.4
26083,2020-02-01,911,862,49,5.4
26085,2020-02-01,3862,3629,233,6
26087,2020-02-01,41485,39125,2360,5.7
26089,2020-02-01,10353,9950,403,3.9
26091,2020-02-01,47006,45393,1613,3.4
26093,2020-02-01,103681,100570,3111,3
26095,2020-02-01,2301,2166,135,5.9
26097,2020-02-01,4324,3552,772,17.9
26099,2020-02-01,448162,431762,16400,3.7
26101,2020-02-01,10238,9642,596,5.8
26103,2020-02-01,33346,31783,1563,4.7
26105,2020-02-01,13145,12457,688,5.2
26107,2020-02-01,18528,17664,864,4.7
26109,2020-02-01,11051,10630,421,3.8
26111,2020-02-01,40307,38830,1477,3.7
26113,2020-02-01,6944,6584,360,5.2
26115,2020-02-01,75999,73431,2568,3.4
26117,2020-02-01,28711,27653,1058,3.7
26119,2020-02-01,2965,2686,279,9.4
26121,2020-02-01,77865,74944,2921,3.8
26123,2020-02-01,23547,22581,966,4.1
26125,2020-02-01,675949,656451,19498,2.9
26127,2020-02-01,11598,10826,772,6.7
26129,2020-02-01,7811,7202,609,7.8
26131,2020-02-01,2111,1977,134,6.3
26133,2020-02-01,11503,11062,441,3.8
26135,2020-02-01,2945,2755,190,6.5
26137,2020-02-01,11590,11019,571,4.9
26139,2020-02-01,163304,159581,3723,2.3
26141,2020-02-01,4842,4342,500,10.3
26143,2020-02-01,7493,6871,622,8.3
26145,2020-02-01,87086,83265,3821,4.4
26147,2020-02-01,75924,72389,3535,4.7
26149,2020-02-01,27692,26802,890,3.2
26151,2020-02-01,19442,18511,931,4.8
26153,2020-02-01,3275,3023,252,7.7
26155,2020-02-01,34031,32762,1269,3.7
26157,2020-02-01,24168,22938,1230,5.1
26159,2020-02-01,35615,34009,1606,4.5
26161,2020-02-01,203704,199256,4448,2.2
26163,2020-02-01,802802,767844,34958,4.4
26165,2020-02-01,14982,14300,682,4.6
27001,2020-02-01,7243,6667,576,8
27003,2020-02-01,199884,193322,6562,3.3
27005,2020-02-01,18624,17582,1042,5.6
27007,2020-02-01,24609,23375,1234,5
27009,2020-02-01,22396,21255,1141,5.1
27011,2020-02-01,2383,2236,147,6.2
27013,2020-02-01,41744,40520,1224,2.9
27015,2020-02-01,14156,13482,674,4.8
27017,2020-02-01,18100,17116,984,5.4
27019,2020-02-01,58954,57298,1656,2.8
27021,2020-02-01,13975,12895,1080,7.7
27023,2020-02-01,6907,6565,342,5
27025,2020-02-01,30555,29052,1503,4.9
27027,2020-02-01,36597,35372,1225,3.3
27029,2020-02-01,4605,4060,545,11.8
27031,2020-02-01,2908,2746,162,5.6
27033,2020-02-01,5886,5661,225,3.8
27035,2020-02-01,31795,30007,1788,5.6
27037,2020-02-01,243949,236827,7122,2.9
27039,2020-02-01,11886,11388,498,4.2
27041,2020-02-01,20944,20140,804,3.8
27043,2020-02-01,6804,6439,365,5.4
27045,2020-02-01,11508,10967,541,4.7
27047,2020-02-01,16102,15502,600,3.7
27049,2020-02-01,27124,26102,1022,3.8
27051,2020-02-01,3213,3024,189,5.9
27053,2020-02-01,711762,693607,18155,2.6
27055,2020-02-01,10484,10049,435,4.1
27057,2020-02-01,9778,9084,694,7.1
27059,2020-02-01,21750,20591,1159,5.3
27061,2020-02-01,22203,20657,1546,7
27063,2020-02-01,5644,5429,215,3.8
27065,2020-02-01,9218,8372,846,9.2
27067,2020-02-01,23966,22887,1079,4.5
27069,2020-02-01,2303,2198,105,4.6
27071,2020-02-01,5738,5386,352,6.1
27073,2020-02-01,3526,3323,203,5.8
27075,2020-02-01,5378,5153,225,4.2
27077,2020-02-01,2587,2489,98,3.8
27079,2020-02-01,16498,15438,1060,6.4
27081,2020-02-01,3163,2976,187,5.9
27083,2020-02-01,14171,13633,538,3.8
27085,2020-02-01,19163,18264,899,4.7
27087,2020-02-01,2291,2132,159,6.9
27089,2020-02-01,5320,4852,468,8.8
27091,2020-02-01,9729,9349,380,3.9
27093,2020-02-01,13352,12662,690,5.2
27095,2020-02-01,13341,12299,1042,7.8
27097,2020-02-01,17514,16176,1338,7.6
27099,2020-02-01,20258,19567,691,3.4
27101,2020-02-01,4625,4330,295,6.4
27103,2020-02-01,21463,20899,564,2.6
27105,2020-02-01,11078,10701,377,3.4
27107,2020-02-01,3124,2938,186,6
27109,2020-02-01,89019,86664,2355,2.6
27111,2020-02-01,31113,29368,1745,5.6
27113,2020-02-01,8757,8156,601,6.9
27115,2020-02-01,15241,14048,1193,7.8
27117,2020-02-01,4755,4517,238,5
27119,2020-02-01,16530,15777,753,4.6
27121,2020-02-01,6464,6222,242,3.7
27123,2020-02-01,291966,283591,8375,2.9
27125,2020-02-01,2221,2039,182,8.2
27127,2020-02-01,7427,7108,319,4.3
27129,2020-02-01,8226,7723,503,6.1
27131,2020-02-01,37401,36062,1339,3.6
27133,2020-02-01,5494,5354,140,2.5
27135,2020-02-01,7899,7502,397,5
27137,2020-02-01,102899,98398,4501,4.4
27139,2020-02-01,84398,81965,2433,2.9
27141,2020-02-01,53315,50993,2322,4.4
27143,2020-02-01,8486,8071,415,4.9
27145,2020-02-01,91396,87935,3461,3.8
27147,2020-02-01,21443,20706,737,3.4
27149,2020-02-01,5194,5026,168,3.2
27151,2020-02-01,4777,4517,260,5.4
27153,2020-02-01,13517,12788,729,5.4
27155,2020-02-01,1693,1603,90,5.3
27157,2020-02-01,12258,11729,529,4.3
27159,2020-02-01,6057,5550,507,8.4
27161,2020-02-01,8883,8432,451,5.1
27163,2020-02-01,144732,140470,4262,2.9
27165,2020-02-01,6251,5966,285,4.6
27167,2020-02-01,3351,3230,121,3.6
27169,2020-02-01,28703,27827,876,3.1
27171,2020-02-01,76776,73725,3051,4
27173,2020-02-01,5264,5035,229,4.4
28001,2020-02-01,11150,10420,730,6.5
28003,2020-02-01,16148,15422,726,4.5
28005,2020-02-01,4357,4056,301,6.9
28007,2020-02-01,6958,6513,445,6.4
28009,2020-02-01,3024,2845,179,5.9
28011,2020-02-01,11978,11133,845,7.1
28013,2020-02-01,5535,5228,307,5.5
28015,2020-02-01,3444,3232,212,6.2
28017,2020-02-01,6753,6413,340,5
28019,2020-02-01,3646,3449,197,5.4
28021,2020-02-01,2951,2669,282,9.6
28023,2020-02-01,5925,5559,366,6.2
28025,2020-02-01,7606,7066,540,7.1
28027,2020-02-01,8211,7549,662,8.1
28029,2020-02-01,11031,10366,665,6
28031,2020-02-01,8030,7634,396,4.9
28033,2020-02-01,90466,86751,3715,4.1
28035,2020-02-01,33277,31731,1546,4.6
28037,2020-02-01,2736,2560,176,6.4
28039,2020-02-01,8717,8091,626,7.2
28041,2020-02-01,4324,3978,346,8
28043,2020-02-01,9285,8840,445,4.8
28045,2020-02-01,18743,17755,988,5.3
28047,2020-02-01,86198,81992,4206,4.9
28049,2020-02-01,105551,100470,5081,4.8
28051,2020-02-01,5599,5081,518,9.3
28053,2020-02-01,2228,1970,258,11.6
28055,2020-02-01,365,335,30,8.2
28057,2020-02-01,10475,9985,490,4.7
28059,2020-02-01,58261,54990,3271,5.6
28061,2020-02-01,6139,5662,477,7.8
28063,2020-02-01,1948,1677,271,13.9
28065,2020-02-01,4122,3844,278,6.7
28067,2020-02-01,25806,24448,1358,5.3
28069,2020-02-01,3516,3260,256,7.3
28071,2020-02-01,28439,27355,1084,3.8
28073,2020-02-01,30837,29586,1251,4.1
28075,2020-02-01,30362,28875,1487,4.9
28077,2020-02-01,4506,4234,272,6
28079,2020-02-01,7820,7392,428,5.5
28081,2020-02-01,40947,39264,1683,4.1
28083,2020-02-01,9912,9194,718,7.2
28085,2020-02-01,14394,13637,757,5.3
28087,2020-02-01,25077,23811,1266,5
28089,2020-02-01,52612,50498,2114,4
28091,2020-02-01,9942,9404,538,5.4
28093,2020-02-01,14335,13582,753,5.3
28095,2020-02-01,15466,14684,782,5.1
28097,2020-02-01,3894,3658,236,6.1
28099,2020-02-01,9993,9410,583,5.8
28101,2020-02-01,8812,8350,462,5.2
28103,2020-02-01,3732,3470,262,7
28105,2020-02-01,22040,20970,1070,4.9
28107,2020-02-01,12301,11536,765,6.2
28109,2020-02-01,23773,22628,1145,4.8
28111,2020-02-01,4311,4020,291,6.8
28113,2020-02-01,14280,13436,844,5.9
28115,2020-02-01,14695,14096,599,4.1
28117,2020-02-01,11194,10654,540,4.8
28119,2020-02-01,2313,2133,180,7.8
28121,2020-02-01,75331,72456,2875,3.8
28123,2020-02-01,12496,11949,547,4.4
28125,2020-02-01,1588,1445,143,9
28127,2020-02-01,10662,10095,567,5.3
28129,2020-02-01,6806,6443,363,5.3
28131,2020-02-01,6846,6450,396,5.8
28133,2020-02-01,7587,6886,701,9.2
28135,2020-02-01,5205,4871,334,6.4
28137,2020-02-01,12236,11601,635,5.2
28139,2020-02-01,9354,8922,432,4.6
28141,2020-02-01,8546,8081,465,5.4
28143,2020-02-01,4401,4133,268,6.1
28145,2020-02-01,14286,13709,577,4
28147,2020-02-01,4748,4434,314,6.6
28149,2020-02-01,19905,18851,1054,5.3
28151,2020-02-01,16704,15469,1235,7.4
28153,2020-02-01,7383,6931,452,6.1
28155,2020-02-01,3937,3715,222,5.6
28157,2020-02-01,2779,2514,265,9.5
28159,2020-02-01,7357,6927,430,5.8
28161,2020-02-01,4943,4691,252,5.1
28163,2020-02-01,9272,8722,550,5.9
29001,2020-02-01,10246,9866,380,3.7
29003,2020-02-01,9778,9452,326,3.3
29005,2020-02-01,2716,2628,88,3.2
29007,2020-02-01,10737,10308,429,4
29009,2020-02-01,15829,15150,679,4.3
29011,2020-02-01,5273,5100,173,3.3
29013,2020-02-01,8009,7655,354,4.4
29015,2020-02-01,7290,6827,463,6.4
29017,2020-02-01,5580,5342,238,4.3
29019,2020-02-01,99179,96662,2517,2.5
29021,2020-02-01,44526,42935,1591,3.6
29023,2020-02-01,18123,17296,827,4.6
29025,2020-02-01,4442,4271,171,3.8
29027,2020-02-01,21433,20691,742,3.5
29029,2020-02-01,17790,16561,1229,6.9
29031,2020-02-01,41330,39999,1331,3.2
29033,2020-02-01,4897,4724,173,3.5
29035,2020-02-01,2554,2388,166,6.5
29037,2020-02-01,55265,53354,1911,3.5
29039,2020-02-01,5823,5599,224,3.8
29041,2020-02-01,3805,3658,147,3.9
29043,2020-02-01,45477,44015,1462,3.2
29045,2020-02-01,3256,3104,152,4.7
29047,2020-02-01,136876,132799,4077,3
29049,2020-02-01,10815,10454,361,3.3
29051,2020-02-01,39002,37870,1132,2.9
29053,2020-02-01,7541,7238,303,4
29055,2020-02-01,11056,10539,517,4.7
29057,2020-02-01,3611,3477,134,3.7
29059,2020-02-01,7155,6830,325,4.5
29061,2020-02-01,4169,4014,155,3.7
29063,2020-02-01,4877,4680,197,4
29065,2020-02-01,6298,6045,253,4
29067,2020-02-01,5122,4872,250,4.9
29069,2020-02-01,11764,10971,793,6.7
29071,2020-02-01,53448,51376,2072,3.9
29073,2020-02-01,7705,7429,276,3.6
29075,2020-02-01,3535,3435,100,2.8
29077,2020-02-01,152787,148135,4652,3
29079,2020-02-01,4453,4300,153,3.4
29081,2020-02-01,3889,3693,196,5
29083,2020-02-01,9790,9363,427,4.4
29085,2020-02-01,3829,3633,196,5.1
29087,2020-02-01,2589,2509,80,3.1
29089,2020-02-01,4911,4743,168,3.4
29091,2020-02-01,16677,16006,671,4
29093,2020-02-01,3568,3362,206,5.8
29095,2020-02-01,364637,350283,14354,3.9
29097,2020-02-01,57797,55993,1804,3.1
29099,2020-02-01,118591,114107,4484,3.8
29101,2020-02-01,23560,22539,1021,4.3
29103,2020-02-01,1808,1720,88,4.9
29105,2020-02-01,17273,16243,1030,6
29107,2020-02-01,17049,16401,648,3.8
29109,2020-02-01,18219,17460,759,4.2
29111,2020-02-01,5011,4828,183,3.7
29113,2020-02-01,28539,27439,1100,3.9
29115,2020-02-01,5157,4880,277,5.4
29117,2020-02-01,7443,7211,232,3.1
29119,2020-02-01,10925,10566,359,3.3
29121,2020-02-01,7645,7333,312,4.1
29123,2020-02-01,5535,5285,250,4.5
29125,2020-02-01,3934,3787,147,3.7
29127,2020-02-01,14415,13921,494,3.4
29129,2020-02-01,1942,1862,80,4.1
29131,2020-02-01,12300,11615,685,5.6
29133,2020-02-01,5855,5597,258,4.4
29135,2020-02-01,7375,7112,263,3.6
29137,2020-02-01,3894,3703,191,4.9
29139,2020-02-01,5803,5584,219,3.8
29141,2020-02-01,8170,7689,481,5.9
29143,2020-02-01,8457,8046,411,4.9
29145,2020-02-01,27666,26734,932,3.4
29147,2020-02-01,11100,10738,362,3.3
29149,2020-02-01,4098,3904,194,4.7
29151,2020-02-01,7125,6946,179,2.5
29153,2020-02-01,3363,3162,201,6
29155,2020-02-01,6451,6072,379,5.9
29157,2020-02-01,10011,9704,307,3.1
29159,2020-02-01,21799,20469,1330,6.1
29161,2020-02-01,19945,19181,764,3.8
29163,2020-02-01,7481,7181,300,4
29165,2020-02-01,58888,57286,1602,2.7
29167,2020-02-01,14727,14231,496,3.4
29169,2020-02-01,14809,14210,599,4
29171,2020-02-01,2306,2215,91,3.9
29173,2020-02-01,5639,5429,210,3.7
29175,2020-02-01,10623,10173,450,4.2
29177,2020-02-01,11073,10657,416,3.8
29179,2020-02-01,3010,2881,129,4.3
29181,2020-02-01,5017,4769,248,4.9
29183,2020-02-01,226899,220432,6467,2.9
29185,2020-02-01,3776,3593,183,4.8
29186,2020-02-01,9219,8852,367,4
29187,2020-02-01,26766,25428,1338,5
29189,2020-02-01,532080,514851,17229,3.2
29195,2020-02-01,10729,10287,442,4.1
29197,2020-02-01,1969,1871,98,5
29199,2020-02-01,2420,2347,73,3
29201,2020-02-01,20131,19317,814,4
29203,2020-02-01,3208,3006,202,6.3
29205,2020-02-01,3179,3035,144,4.5
29207,2020-02-01,13227,12540,687,5.2
29209,2020-02-01,12976,11561,1415,10.9
29211,2020-02-01,2751,2624,127,4.6
29213,2020-02-01,25552,22379,3173,12.4
29215,2020-02-01,9128,8691,437,4.8
29217,2020-02-01,9588,9237,351,3.7
29219,2020-02-01,18071,17410,661,3.7
29221,2020-02-01,10332,9704,628,6.1
29223,2020-02-01,5207,4944,263,5.1
29225,2020-02-01,17520,16840,680,3.9
29227,2020-02-01,1182,1153,29,2.5
29229,2020-02-01,7656,7250,406,5.3
29510,2020-02-01,152631,146529,6102,4
30001,2020-02-01,5024,4853,171,3.4
30003,2020-02-01,4657,4310,347,7.5
30005,2020-02-01,2530,2424,106,4.2
30007,2020-02-01,2595,2464,131,5
30009,2020-02-01,5516,5265,251,4.6
30011,2020-02-01,628,613,15,2.4
30013,2020-02-01,38088,36657,1431,3.8
30015,2020-02-01,2449,2367,82,3.3
30017,2020-02-01,6129,5874,255,4.2
30019,2020-02-01,896,869,27,3
30021,2020-02-01,4568,4432,136,3
30023,2020-02-01,4999,4806,193,3.9
30025,2020-02-01,1688,1654,34,2
30027,2020-02-01,6075,5796,279,4.6
30029,2020-02-01,47768,44807,2961,6.2
30031,2020-02-01,69563,67824,1739,2.5
30033,2020-02-01,730,708,22,3
30035,2020-02-01,5419,4972,447,8.2
30037,2020-02-01,369,351,18,4.9
30039,2020-02-01,1729,1609,120,6.9
30041,2020-02-01,7626,7354,272,3.6
30043,2020-02-01,5708,5479,229,4
30045,2020-02-01,985,943,42,4.3
30047,2020-02-01,13257,12528,729,5.5
30049,2020-02-01,35827,34548,1279,3.6
30051,2020-02-01,953,925,28,2.9
30053,2020-02-01,8042,7261,781,9.7
30055,2020-02-01,951,931,20,2.1
30057,2020-02-01,5554,5351,203,3.7
30059,2020-02-01,1008,970,38,3.8
30061,2020-02-01,1774,1590,184,10.4
30063,2020-02-01,64456,61886,2570,4
30065,2020-02-01,2293,2164,129,5.6
30067,2020-02-01,8694,8304,390,4.5
30069,2020-02-01,283,269,14,4.9
30071,2020-02-01,1876,1790,86,4.6
30073,2020-02-01,2641,2551,90,3.4
30075,2020-02-01,956,927,29,3
30077,2020-02-01,2921,2797,124,4.2
30079,2020-02-01,484,460,24,5
30081,2020-02-01,20338,19320,1018,5
30083,2020-02-01,5904,5723,181,3.1
30085,2020-02-01,4492,4270,222,4.9
30087,2020-02-01,3768,3580,188,5
30089,2020-02-01,4817,4434,383,8
30091,2020-02-01,1727,1680,47,2.7
30093,2020-02-01,17165,16386,779,4.5
30095,2020-02-01,5335,5151,184,3.4
30097,2020-02-01,1803,1750,53,2.9
30099,2020-02-01,2744,2629,115,4.2
30101,2020-02-01,2093,2023,70,3.3
30103,2020-02-01,335,327,8,2.4
30105,2020-02-01,4025,3870,155,3.9
30107,2020-02-01,785,747,38,4.8
30109,2020-02-01,452,438,14,3.1
30111,2020-02-01,81734,78737,2997,3.7
31001,2020-02-01,16816,16284,532,3.2
31003,2020-02-01,3599,3495,104,2.9
31005,2020-02-01,231,218,13,5.6
31007,2020-02-01,389,377,12,3.1
31009,2020-02-01,265,253,12,4.5
31011,2020-02-01,2977,2893,84,2.8
31013,2020-02-01,5359,5192,167,3.1
31015,2020-02-01,1103,1070,33,3
31017,2020-02-01,1403,1361,42,3
31019,2020-02-01,27792,27084,708,2.5
31021,2020-02-01,3493,3347,146,4.2
31023,2020-02-01,4511,4382,129,2.9
31025,2020-02-01,13685,13232,453,3.3
31027,2020-02-01,4507,4388,119,2.6
31029,2020-02-01,2304,2260,44,1.9
31031,2020-02-01,3356,3277,79,2.4
31033,2020-02-01,4276,4134,142,3.3
31035,2020-02-01,3309,3207,102,3.1
31037,2020-02-01,5571,5437,134,2.4
31039,2020-02-01,4694,4575,119,2.5
31041,2020-02-01,6438,6302,136,2.1
31043,2020-02-01,10861,10368,493,4.5
31045,2020-02-01,4906,4789,117,2.4
31047,2020-02-01,13176,12769,407,3.1
31049,2020-02-01,957,934,23,2.4
31051,2020-02-01,3070,2966,104,3.4
31053,2020-02-01,19534,18958,576,2.9
31055,2020-02-01,301739,291893,9846,3.3
31057,2020-02-01,1195,1168,27,2.3
31059,2020-02-01,3116,3047,69,2.2
31061,2020-02-01,1460,1418,42,2.9
31063,2020-02-01,1646,1586,60,3.6
31065,2020-02-01,2536,2475,61,2.4
31067,2020-02-01,11049,10667,382,3.5
31069,2020-02-01,1087,1049,38,3.5
31071,2020-02-01,1155,1128,27,2.3
31073,2020-02-01,1098,1075,23,2.1
31075,2020-02-01,438,428,10,2.3
31077,2020-02-01,1226,1191,35,2.9
31079,2020-02-01,31907,30713,1194,3.7
31081,2020-02-01,4775,4637,138,2.9
31083,2020-02-01,1773,1719,54,3
31085,2020-02-01,633,614,19,3
31087,2020-02-01,1267,1223,44,3.5
31089,2020-02-01,5817,5667,150,2.6
31091,2020-02-01,375,362,13,3.5
31093,2020-02-01,3354,3254,100,3
31095,2020-02-01,4190,4081,109,2.6
31097,2020-02-01,2086,2005,81,3.9
31099,2020-02-01,3831,3745,86,2.2
31101,2020-02-01,4463,4327,136,3
31103,2020-02-01,615,602,13,2.1
31105,2020-02-01,2022,1968,54,2.7
31107,2020-02-01,4657,4494,163,3.5
31109,2020-02-01,180252,175492,4760,2.6
31111,2020-02-01,18180,17569,611,3.4
31113,2020-02-01,479,467,12,2.5
31115,2020-02-01,415,398,17,4.1
31117,2020-02-01,447,430,17,3.8
31119,2020-02-01,19803,19212,591,3
31121,2020-02-01,4013,3896,117,2.9
31123,2020-02-01,2649,2549,100,3.8
31125,2020-02-01,1992,1936,56,2.8
31127,2020-02-01,3620,3516,104,2.9
31129,2020-02-01,2460,2379,81,3.3
31131,2020-02-01,8475,8237,238,2.8
31133,2020-02-01,1488,1452,36,2.4
31135,2020-02-01,1834,1798,36,2
31137,2020-02-01,5003,4888,115,2.3
31139,2020-02-01,4076,3968,108,2.6
31141,2020-02-01,17735,17240,495,2.8
31143,2020-02-01,2976,2876,100,3.4
31145,2020-02-01,5879,5714,165,2.8
31147,2020-02-01,4214,4087,127,3
31149,2020-02-01,892,871,21,2.4
31151,2020-02-01,7463,7196,267,3.6
31153,2020-02-01,97272,94467,2805,2.9
31155,2020-02-01,11278,10967,311,2.8
31157,2020-02-01,18034,17391,643,3.6
31159,2020-02-01,9110,8857,253,2.8
31161,2020-02-01,2689,2622,67,2.5
31163,2020-02-01,1698,1642,56,3.3
31165,2020-02-01,745,728,17,2.3
31167,2020-02-01,3531,3431,100,2.8
31169,2020-02-01,2767,2700,67,2.4
31171,2020-02-01,435,414,21,4.8
31173,2020-02-01,3099,2986,113,3.6
31175,2020-02-01,2126,2065,61,2.9
31177,2020-02-01,11381,11049,332,2.9
31179,2020-02-01,5922,5778,144,2.4
31181,2020-02-01,1698,1638,60,3.5
31183,2020-02-01,566,554,12,2.1
31185,2020-02-01,7208,7029,179,2.5
32001,2020-02-01,11350,10938,412,3.6
32003,2020-02-01,NA,NA,44754,3.9
32005,2020-02-01,23535,22595,940,4
32007,2020-02-01,27063,26176,887,3.3
32009,2020-02-01,461,443,18,3.9
32011,2020-02-01,1103,1077,26,2.4
32013,2020-02-01,8317,8043,274,3.3
32015,2020-02-01,3264,3143,121,3.7
32017,2020-02-01,2158,2075,83,3.8
32019,2020-02-01,23639,22464,1175,5
32021,2020-02-01,2024,1945,79,3.9
32023,2020-02-01,17934,17053,881,4.9
32027,2020-02-01,2594,2481,113,4.4
32029,2020-02-01,2087,2008,79,3.8
32031,2020-02-01,261747,253310,8437,3.2
32033,2020-02-01,4697,4540,157,3.3
32510,2020-02-01,26889,25783,1106,4.1
33001,2020-02-01,31038,30059,979,3.2
33003,2020-02-01,23727,22973,754,3.2
33005,2020-02-01,41511,40207,1304,3.1
33007,2020-02-01,14734,14116,618,4.2
33009,2020-02-01,51056,49761,1295,2.5
33011,2020-02-01,246147,238375,7772,3.2
33013,2020-02-01,84872,82642,2230,2.6
33015,2020-02-01,188911,182610,6301,3.3
33017,2020-02-01,75363,73281,2082,2.8
33019,2020-02-01,23065,22438,627,2.7
34001,2020-02-01,121288,113570,7718,6.4
34003,2020-02-01,493995,477262,16733,3.4
34005,2020-02-01,235262,226480,8782,3.7
34007,2020-02-01,258589,246814,11775,4.6
34009,2020-02-01,41867,36790,5077,12.1
34011,2020-02-01,66290,61756,4534,6.8
34013,2020-02-01,375825,357005,18820,5
34015,2020-02-01,153172,146539,6633,4.3
34017,2020-02-01,369783,356337,13446,3.6
34019,2020-02-01,65595,63361,2234,3.4
34021,2020-02-01,207301,199797,7504,3.6
34023,2020-02-01,447281,431391,15890,3.6
34025,2020-02-01,335263,322679,12584,3.8
34027,2020-02-01,261338,252699,8639,3.3
34029,2020-02-01,281663,268725,12938,4.6
34031,2020-02-01,248840,236273,12567,5.1
34033,2020-02-01,29831,28107,1724,5.8
34035,2020-02-01,174401,168315,6086,3.5
34037,2020-02-01,75572,72232,3340,4.4
34039,2020-02-01,281827,269659,12168,4.3
34041,2020-02-01,57182,54793,2389,4.2
35001,2020-02-01,336093,321028,15065,4.5
35003,2020-02-01,1134,1038,96,8.5
35005,2020-02-01,27326,25990,1336,4.9
35006,2020-02-01,9003,8420,583,6.5
35007,2020-02-01,5296,5046,250,4.7
35009,2020-02-01,21584,20708,876,4.1
35011,2020-02-01,702,672,30,4.3
35013,2020-02-01,98887,92693,6194,6.3
35015,2020-02-01,36399,35261,1138,3.1
35017,2020-02-01,12193,11594,599,4.9
35019,2020-02-01,1463,1391,72,4.9
35021,2020-02-01,287,274,13,4.5
35023,2020-02-01,2001,1907,94,4.7
35025,2020-02-01,32637,31288,1349,4.1
35027,2020-02-01,8681,8239,442,5.1
35028,2020-02-01,9468,9164,304,3.2
35029,2020-02-01,9915,8199,1716,17.3
35031,2020-02-01,24368,22653,1715,7
35033,2020-02-01,2071,1924,147,7.1
35035,2020-02-01,24977,23707,1270,5.1
35037,2020-02-01,3161,2995,166,5.3
35039,2020-02-01,16676,15722,954,5.7
35041,2020-02-01,7959,7612,347,4.4
35043,2020-02-01,66572,63357,3215,4.8
35045,2020-02-01,51597,48337,3260,6.3
35047,2020-02-01,11076,10431,645,5.8
35049,2020-02-01,77000,73938,3062,4
35051,2020-02-01,3791,3471,320,8.4
35053,2020-02-01,6301,5957,344,5.5
35055,2020-02-01,15607,14646,961,6.2
35057,2020-02-01,5443,5060,383,7
35059,2020-02-01,1669,1599,70,4.2
35061,2020-02-01,30801,29133,1668,5.4
36001,2020-02-01,159966,154090,5876,3.7
36003,2020-02-01,20223,18969,1254,6.2
36005,2020-02-01,597969,570240,27729,4.6
36007,2020-02-01,84313,79751,4562,5.4
36009,2020-02-01,34975,32857,2118,6.1
36011,2020-02-01,35707,33881,1826,5.1
36013,2020-02-01,54615,51546,3069,5.6
36015,2020-02-01,35369,33695,1674,4.7
36017,2020-02-01,22142,20921,1221,5.5
36019,2020-02-01,36529,34693,1836,5
36021,2020-02-01,31022,29859,1163,3.7
36023,2020-02-01,23590,22215,1375,5.8
36025,2020-02-01,19213,18170,1043,5.4
36027,2020-02-01,145225,139631,5594,3.9
36029,2020-02-01,443692,422871,20821,4.7
36031,2020-02-01,17501,16480,1021,5.8
36033,2020-02-01,19887,18766,1121,5.6
36035,2020-02-01,22944,21622,1322,5.8
36037,2020-02-01,29666,28220,1446,4.9
36039,2020-02-01,21004,19962,1042,5
36041,2020-02-01,2133,1948,185,8.7
36043,2020-02-01,28110,26476,1634,5.8
36045,2020-02-01,43773,40682,3091,7.1
36047,2020-02-01,NA,NA,41744,3.5
36049,2020-02-01,11869,10988,881,7.4
36051,2020-02-01,31062,29520,1542,5
36053,2020-02-01,33055,31344,1711,5.2
36055,2020-02-01,364822,349017,15805,4.3
36057,2020-02-01,22482,21117,1365,6.1
36059,2020-02-01,712029,687125,24904,3.5
36061,2020-02-01,915144,887541,27603,3
36063,2020-02-01,99656,93887,5769,5.8
36065,2020-02-01,101255,96649,4606,4.5
36067,2020-02-01,222463,213015,9448,4.2
36069,2020-02-01,56038,53540,2498,4.5
36071,2020-02-01,184812,177326,7486,4.1
36073,2020-02-01,17705,16738,967,5.5
36075,2020-02-01,53728,50310,3418,6.4
36077,2020-02-01,28222,26774,1448,5.1
36079,2020-02-01,51713,49669,2044,4
36081,2020-02-01,NA,NA,34120,3
36083,2020-02-01,82606,79250,3356,4.1
36085,2020-02-01,222822,215436,7386,3.3
36087,2020-02-01,155260,149590,5670,3.7
36089,2020-02-01,44009,41358,2651,6
36091,2020-02-01,121073,116700,4373,3.6
36093,2020-02-01,77324,74262,3062,4
36095,2020-02-01,14989,14105,884,5.9
36097,2020-02-01,8027,7515,512,6.4
36099,2020-02-01,16208,15437,771,4.8
36101,2020-02-01,42795,40462,2333,5.5
36103,2020-02-01,783945,752486,31459,4
36105,2020-02-01,37039,35341,1698,4.6
36107,2020-02-01,22934,21779,1155,5
36109,2020-02-01,50354,48573,1781,3.5
36111,2020-02-01,88527,84917,3610,4.1
36113,2020-02-01,31261,29593,1668,5.3
36115,2020-02-01,27667,26335,1332,4.8
36117,2020-02-01,44343,42176,2167,4.9
36119,2020-02-01,484949,466144,18805,3.9
36121,2020-02-01,18038,16962,1076,6
36123,2020-02-01,11955,11370,585,4.9
37001,2020-02-01,83276,80318,2958,3.6
37003,2020-02-01,18275,17728,547,3
37005,2020-02-01,4428,4199,229,5.2
37007,2020-02-01,11099,10606,493,4.4
37009,2020-02-01,13044,12540,504,3.9
37011,2020-02-01,7351,7061,290,3.9
37013,2020-02-01,19600,18733,867,4.4
37015,2020-02-01,7900,7484,416,5.3
37017,2020-02-01,14865,14147,718,4.8
37019,2020-02-01,53883,51078,2805,5.2
37021,2020-02-01,142495,138349,4146,2.9
37023,2020-02-01,41626,40167,1459,3.5
37025,2020-02-01,111342,107570,3772,3.4
37027,2020-02-01,37044,35700,1344,3.6
37029,2020-02-01,4660,4491,169,3.6
37031,2020-02-01,31816,30490,1326,4.2
37033,2020-02-01,10019,9587,432,4.3
37035,2020-02-01,80010,77273,2737,3.4
37037,2020-02-01,36696,35535,1161,3.2
37039,2020-02-01,11192,10699,493,4.4
37041,2020-02-01,5599,5356,243,4.3
37043,2020-02-01,4149,3973,176,4.2
37045,2020-02-01,49665,47721,1944,3.9
37047,2020-02-01,23266,22118,1148,4.9
37049,2020-02-01,42227,40643,1584,3.8
37051,2020-02-01,128711,122411,6300,4.9
37053,2020-02-01,14149,13598,551,3.9
37055,2020-02-01,17924,16526,1398,7.8
37057,2020-02-01,82222,79240,2982,3.6
37059,2020-02-01,20984,20295,689,3.3
37061,2020-02-01,26191,25201,990,3.8
37063,2020-02-01,175112,169663,5449,3.1
37065,2020-02-01,21477,20340,1137,5.3
37067,2020-02-01,190349,183667,6682,3.5
37069,2020-02-01,32101,30895,1206,3.8
37071,2020-02-01,113505,109177,4328,3.8
37073,2020-02-01,5357,5146,211,3.9
37075,2020-02-01,3091,2893,198,6.4
37077,2020-02-01,30494,29522,972,3.2
37079,2020-02-01,9708,9366,342,3.5
37081,2020-02-01,265470,255220,10250,3.9
37083,2020-02-01,20703,19483,1220,5.9
37085,2020-02-01,54311,52033,2278,4.2
37087,2020-02-01,30431,29378,1053,3.5
37089,2020-02-01,55896,54149,1747,3.1
37091,2020-02-01,9254,8784,470,5.1
37093,2020-02-01,20345,19362,983,4.8
37095,2020-02-01,1814,1573,241,13.3
37097,2020-02-01,91505,88282,3223,3.5
37099,2020-02-01,19682,18865,817,4.2
37101,2020-02-01,101739,98304,3435,3.4
37103,2020-02-01,4481,4321,160,3.6
37105,2020-02-01,26110,25043,1067,4.1
37107,2020-02-01,28183,27164,1019,3.6
37109,2020-02-01,44506,42978,1528,3.4
37111,2020-02-01,20799,20013,786,3.8
37113,2020-02-01,15374,14732,642,4.2
37115,2020-02-01,10330,9957,373,3.6
37117,2020-02-01,9102,8685,417,4.6
37119,2020-02-01,634601,612810,21791,3.4
37121,2020-02-01,6007,5708,299,5
37123,2020-02-01,11674,11235,439,3.8
37125,2020-02-01,43031,41489,1542,3.6
37127,2020-02-01,43782,41824,1958,4.5
37129,2020-02-01,126122,121823,4299,3.4
37131,2020-02-01,7899,7467,432,5.5
37133,2020-02-01,66639,63817,2822,4.2
37135,2020-02-01,80757,78387,2370,2.9
37137,2020-02-01,5412,5223,189,3.5
37139,2020-02-01,16778,16015,763,4.5
37141,2020-02-01,29435,28334,1101,3.7
37143,2020-02-01,5013,4777,236,4.7
37145,2020-02-01,18898,18153,745,3.9
37147,2020-02-01,90938,87423,3515,3.9
37149,2020-02-01,9044,8725,319,3.5
37151,2020-02-01,67120,64725,2395,3.6
37153,2020-02-01,16870,15981,889,5.3
37155,2020-02-01,51090,48495,2595,5.1
37157,2020-02-01,40690,38962,1728,4.2
37159,2020-02-01,67794,65100,2694,4
37161,2020-02-01,25678,24427,1251,4.9
37163,2020-02-01,30190,29060,1130,3.7
37165,2020-02-01,11793,11014,779,6.6
37167,2020-02-01,30741,29613,1128,3.7
37169,2020-02-01,22092,21313,779,3.5
37171,2020-02-01,34217,32972,1245,3.6
37173,2020-02-01,6729,6407,322,4.8
37175,2020-02-01,14661,14155,506,3.5
37177,2020-02-01,1335,1238,97,7.3
37179,2020-02-01,126622,122496,4126,3.3
37181,2020-02-01,17492,16536,956,5.5
37183,2020-02-01,610600,591633,18967,3.1
37185,2020-02-01,6738,6371,367,5.4
37187,2020-02-01,4448,4153,295,6.6
37189,2020-02-01,29831,28892,939,3.1
37191,2020-02-01,52632,50575,2057,3.9
37193,2020-02-01,29313,28140,1173,4
37195,2020-02-01,35138,33272,1866,5.3
37197,2020-02-01,18061,17446,615,3.4
37199,2020-02-01,8523,8181,342,4
38001,2020-02-01,1059,1027,32,3
38003,2020-02-01,5148,5013,135,2.6
38005,2020-02-01,2293,2187,106,4.6
38007,2020-02-01,351,341,10,2.8
38009,2020-02-01,2841,2721,120,4.2
38011,2020-02-01,1694,1661,33,1.9
38013,2020-02-01,1037,1007,30,2.9
38015,2020-02-01,49182,47770,1412,2.9
38017,2020-02-01,103043,100696,2347,2.3
38019,2020-02-01,1837,1774,63,3.4
38021,2020-02-01,2234,2190,44,2
38023,2020-02-01,1345,1326,19,1.4
38025,2020-02-01,3137,3083,54,1.7
38027,2020-02-01,1180,1125,55,4.7
38029,2020-02-01,1414,1332,82,5.8
38031,2020-02-01,1442,1399,43,3
38033,2020-02-01,811,794,17,2.1
38035,2020-02-01,37090,36228,862,2.3
38037,2020-02-01,1174,1143,31,2.6
38039,2020-02-01,988,966,22,2.2
38041,2020-02-01,1306,1271,35,2.7
38043,2020-02-01,1233,1167,66,5.4
38045,2020-02-01,1980,1931,49,2.5
38047,2020-02-01,866,835,31,3.6
38049,2020-02-01,3007,2853,154,5.1
38051,2020-02-01,1090,1054,36,3.3
38053,2020-02-01,10268,10063,205,2
38055,2020-02-01,4521,4321,200,4.4
38057,2020-02-01,3348,3159,189,5.6
38059,2020-02-01,16258,15638,620,3.8
38061,2020-02-01,7345,7223,122,1.7
38063,2020-02-01,1350,1298,52,3.9
38065,2020-02-01,867,817,50,5.8
38067,2020-02-01,3207,3072,135,4.2
38069,2020-02-01,1663,1599,64,3.8
38071,2020-02-01,5403,5220,183,3.4
38073,2020-02-01,2772,2710,62,2.2
38075,2020-02-01,1199,1158,41,3.4
38077,2020-02-01,8393,8185,208,2.5
38079,2020-02-01,4557,4162,395,8.7
38081,2020-02-01,2607,2565,42,1.6
38083,2020-02-01,659,606,53,8
38085,2020-02-01,1203,1167,36,3
38087,2020-02-01,387,378,9,2.3
38089,2020-02-01,18147,17695,452,2.5
38091,2020-02-01,938,921,17,1.8
38093,2020-02-01,10055,9788,267,2.7
38095,2020-02-01,1028,999,29,2.8
38097,2020-02-01,4311,4195,116,2.7
38099,2020-02-01,4928,4757,171,3.5
38101,2020-02-01,30940,29979,961,3.1
38103,2020-02-01,1830,1743,87,4.8
38105,2020-02-01,23774,23280,494,2.1
39001,2020-02-01,10945,10006,939,8.6
39003,2020-02-01,48093,45747,2346,4.9
39005,2020-02-01,27418,26111,1307,4.8
39007,2020-02-01,44752,42055,2697,6
39009,2020-02-01,29730,28130,1600,5.4
39011,2020-02-01,25205,24299,906,3.6
39013,2020-02-01,30043,27682,2361,7.9
39015,2020-02-01,19924,18680,1244,6.2
39017,2020-02-01,196234,188255,7979,4.1
39019,2020-02-01,13162,12319,843,6.4
39021,2020-02-01,20389,19537,852,4.2
39023,2020-02-01,63841,60657,3184,5
39025,2020-02-01,107616,103083,4533,4.2
39027,2020-02-01,18166,17207,959,5.3
39029,2020-02-01,47705,44910,2795,5.9
39031,2020-02-01,14292,13309,983,6.9
39033,2020-02-01,18383,17400,983,5.3
39035,2020-02-01,610234,578981,31253,5.1
39037,2020-02-01,26122,24955,1167,4.5
39039,2020-02-01,18107,17265,842,4.7
39041,2020-02-01,111969,108307,3662,3.3
39043,2020-02-01,35696,33540,2156,6
39045,2020-02-01,79520,76244,3276,4.1
39047,2020-02-01,14082,13476,606,4.3
39049,2020-02-01,707952,682088,25864,3.7
39051,2020-02-01,22801,21611,1190,5.2
39053,2020-02-01,12535,11662,873,7
39055,2020-02-01,49048,46796,2252,4.6
39057,2020-02-01,83707,80423,3284,3.9
39059,2020-02-01,18759,17336,1423,7.6
39061,2020-02-01,417841,401136,16705,4
39063,2020-02-01,42297,40850,1447,3.4
39065,2020-02-01,13964,13298,666,4.8
39067,2020-02-01,6711,6231,480,7.2
39069,2020-02-01,13321,12512,809,6.1
39071,2020-02-01,17348,16277,1071,6.2
39073,2020-02-01,13403,12642,761,5.7
39075,2020-02-01,20904,20211,693,3.3
39077,2020-02-01,28209,25985,2224,7.9
39079,2020-02-01,12919,11876,1043,8.1
39081,2020-02-01,27714,25756,1958,7.1
39083,2020-02-01,32123,30724,1399,4.4
39085,2020-02-01,126348,120078,6270,5
39087,2020-02-01,24087,22670,1417,5.9
39089,2020-02-01,92159,88399,3760,4.1
39091,2020-02-01,23192,22221,971,4.2
39093,2020-02-01,153900,145307,8593,5.6
39095,2020-02-01,210802,200235,10567,5
39097,2020-02-01,21269,20470,799,3.8
39099,2020-02-01,102618,96152,6466,6.3
39101,2020-02-01,28434,27206,1228,4.3
39103,2020-02-01,97322,93045,4277,4.4
39105,2020-02-01,9255,8437,818,8.8
39107,2020-02-01,23442,22711,731,3.1
39109,2020-02-01,54647,52354,2293,4.2
39111,2020-02-01,5468,4860,608,11.1
39113,2020-02-01,253881,242538,11343,4.5
39115,2020-02-01,6880,6256,624,9.1
39117,2020-02-01,17206,16354,852,5
39119,2020-02-01,40086,37561,2525,6.3
39121,2020-02-01,4724,4301,423,9
39123,2020-02-01,20373,18691,1682,8.3
39125,2020-02-01,8745,8273,472,5.4
39127,2020-02-01,16406,15326,1080,6.6
39129,2020-02-01,27073,25811,1262,4.7
39131,2020-02-01,10948,10093,855,7.8
39133,2020-02-01,87704,83354,4350,5
39135,2020-02-01,21283,20324,959,4.5
39137,2020-02-01,18957,18242,715,3.8
39139,2020-02-01,52506,49774,2732,5.2
39141,2020-02-01,35942,34017,1925,5.4
39143,2020-02-01,30603,29040,1563,5.1
39145,2020-02-01,29379,27104,2275,7.7
39147,2020-02-01,27514,26216,1298,4.7
39149,2020-02-01,24009,23026,983,4.1
39151,2020-02-01,186855,176954,9901,5.3
39153,2020-02-01,272981,259777,13204,4.8
39155,2020-02-01,86398,80543,5855,6.8
39157,2020-02-01,45014,42547,2467,5.5
39159,2020-02-01,29528,28506,1022,3.5
39161,2020-02-01,15350,14680,670,4.4
39163,2020-02-01,5726,5246,480,8.4
39165,2020-02-01,119764,115292,4472,3.7
39167,2020-02-01,27664,25787,1877,6.8
39169,2020-02-01,63490,61194,2296,3.6
39171,2020-02-01,19006,18283,723,3.8
39173,2020-02-01,71381,68561,2820,4
39175,2020-02-01,13226,12745,481,3.6
40001,2020-02-01,7994,7693,301,3.8
40003,2020-02-01,2824,2764,60,2.1
40005,2020-02-01,4962,4737,225,4.5
40007,2020-02-01,2885,2836,49,1.7
40009,2020-02-01,9710,9305,405,4.2
40011,2020-02-01,4695,4583,112,2.4
40013,2020-02-01,21564,20978,586,2.7
40015,2020-02-01,11708,11284,424,3.6
40017,2020-02-01,74419,72392,2027,2.7
40019,2020-02-01,21270,20563,707,3.3
40021,2020-02-01,18759,18093,666,3.6
40023,2020-02-01,5434,5173,261,4.8
40025,2020-02-01,1329,1309,20,1.5
40027,2020-02-01,142814,139343,3471,2.4
40029,2020-02-01,2520,2419,101,4
40031,2020-02-01,48066,46635,1431,3
40033,2020-02-01,2710,2642,68,2.5
40035,2020-02-01,5804,5598,206,3.5
40037,2020-02-01,31375,30316,1059,3.4
40039,2020-02-01,15864,15433,431,2.7
40041,2020-02-01,17970,17353,617,3.4
40043,2020-02-01,2904,2837,67,2.3
40045,2020-02-01,2120,2071,49,2.3
40047,2020-02-01,26518,25729,789,3
40049,2020-02-01,12503,12073,430,3.4
40051,2020-02-01,26592,25750,842,3.2
40053,2020-02-01,2595,2540,55,2.1
40055,2020-02-01,1789,1725,64,3.6
40057,2020-02-01,1152,1122,30,2.6
40059,2020-02-01,1737,1695,42,2.4
40061,2020-02-01,4230,3997,233,5.5
40063,2020-02-01,5339,5077,262,4.9
40065,2020-02-01,10691,10415,276,2.6
40067,2020-02-01,2529,2445,84,3.3
40069,2020-02-01,3294,3128,166,5
40071,2020-02-01,17971,17291,680,3.8
40073,2020-02-01,9158,8974,184,2
40075,2020-02-01,3439,3338,101,2.9
40077,2020-02-01,3119,2894,225,7.2
40079,2020-02-01,18940,18133,807,4.3
40081,2020-02-01,15786,15281,505,3.2
40083,2020-02-01,22119,21525,594,2.7
40085,2020-02-01,6167,6032,135,2.2
40087,2020-02-01,19662,19162,500,2.5
40089,2020-02-01,14699,13961,738,5
40091,2020-02-01,7153,6700,453,6.3
40093,2020-02-01,3829,3751,78,2
40095,2020-02-01,6905,6678,227,3.3
40097,2020-02-01,19340,18796,544,2.8
40099,2020-02-01,6302,6117,185,2.9
40101,2020-02-01,29710,28672,1038,3.5
40103,2020-02-01,5642,5508,134,2.4
40105,2020-02-01,4587,4452,135,2.9
40107,2020-02-01,4606,4384,222,4.8
40109,2020-02-01,384558,374178,10380,2.7
40111,2020-02-01,15556,14865,691,4.4
40113,2020-02-01,20525,19813,712,3.5
40115,2020-02-01,13979,13569,410,2.9
40117,2020-02-01,7296,7040,256,3.5
40119,2020-02-01,37706,36716,990,2.6
40121,2020-02-01,16936,16223,713,4.2
40123,2020-02-01,19453,18926,527,2.7
40125,2020-02-01,32398,31344,1054,3.3
40127,2020-02-01,4261,4039,222,5.2
40129,2020-02-01,1826,1768,58,3.2
40131,2020-02-01,44804,43518,1286,2.9
40133,2020-02-01,9481,9056,425,4.5
40135,2020-02-01,16154,15500,654,4
40137,2020-02-01,18400,17623,777,4.2
40139,2020-02-01,11634,11437,197,1.7
40141,2020-02-01,2943,2851,92,3.1
40143,2020-02-01,321153,311865,9288,2.9
40145,2020-02-01,37741,36618,1123,3
40147,2020-02-01,22021,21339,682,3.1
40149,2020-02-01,5127,4931,196,3.8
40151,2020-02-01,4602,4526,76,1.7
40153,2020-02-01,8736,8463,273,3.1
41001,2020-02-01,7007,6635,372,5.3
41003,2020-02-01,49214,47852,1362,2.8
41005,2020-02-01,219763,212442,7321,3.3
41007,2020-02-01,18847,18103,744,3.9
41009,2020-02-01,24589,23468,1121,4.6
41011,2020-02-01,26084,24866,1218,4.7
41013,2020-02-01,9502,8961,541,5.7
41015,2020-02-01,8698,8224,474,5.4
41017,2020-02-01,95628,91731,3897,4.1
41019,2020-02-01,46142,43890,2252,4.9
41021,2020-02-01,905,853,52,5.7
41023,2020-02-01,3064,2776,288,9.4
41025,2020-02-01,3435,3217,218,6.3
41027,2020-02-01,13366,12958,408,3.1
41029,2020-02-01,102301,97723,4578,4.5
41031,2020-02-01,9971,9398,573,5.7
41033,2020-02-01,35664,33851,1813,5.1
41035,2020-02-01,28512,26367,2145,7.5
41037,2020-02-01,3519,3336,183,5.2
41039,2020-02-01,182398,175338,7060,3.9
41041,2020-02-01,20298,19359,939,4.6
41043,2020-02-01,58878,56384,2494,4.2
41045,2020-02-01,12180,11633,547,4.5
41047,2020-02-01,161623,155199,6424,4
41049,2020-02-01,5588,5327,261,4.7
41051,2020-02-01,456615,441912,14703,3.2
41053,2020-02-01,39908,38317,1591,4
41055,2020-02-01,930,884,46,4.9
41057,2020-02-01,11650,11173,477,4.1
41059,2020-02-01,35698,33865,1833,5.1
41061,2020-02-01,11845,11193,652,5.5
41063,2020-02-01,3259,3017,242,7.4
41065,2020-02-01,12233,11650,583,4.8
41067,2020-02-01,325690,316144,9546,2.9
41069,2020-02-01,741,714,27,3.6
41071,2020-02-01,54781,52923,1858,3.4
42001,2020-02-01,55499,53395,2104,3.8
42003,2020-02-01,653882,623089,30793,4.7
42005,2020-02-01,33017,30645,2372,7.2
42007,2020-02-01,85281,80359,4922,5.8
42009,2020-02-01,23717,22105,1612,6.8
42011,2020-02-01,219323,208419,10904,5
42013,2020-02-01,59633,56430,3203,5.4
42015,2020-02-01,29102,27498,1604,5.5
42017,2020-02-01,347096,331592,15504,4.5
42019,2020-02-01,101030,96048,4982,4.9
42021,2020-02-01,58746,54989,3757,6.4
42023,2020-02-01,2052,1889,163,7.9
42025,2020-02-01,32563,30549,2014,6.2
42027,2020-02-01,82197,79056,3141,3.8
42029,2020-02-01,286517,276490,10027,3.5
42031,2020-02-01,17419,16298,1121,6.4
42033,2020-02-01,36741,34175,2566,7
42035,2020-02-01,18588,17317,1271,6.8
42037,2020-02-01,34305,32389,1916,5.6
42039,2020-02-01,38645,36312,2333,6
42041,2020-02-01,133303,128237,5066,3.8
42043,2020-02-01,145686,139157,6529,4.5
42045,2020-02-01,304527,291171,13356,4.4
42047,2020-02-01,15476,14440,1036,6.7
42049,2020-02-01,129859,122373,7486,5.8
42051,2020-02-01,58429,53843,4586,7.8
42053,2020-02-01,1821,1648,173,9.5
42055,2020-02-01,79274,75564,3710,4.7
42057,2020-02-01,8190,7550,640,7.8
42059,2020-02-01,16928,15809,1119,6.6
42061,2020-02-01,20293,18581,1712,8.4
42063,2020-02-01,39975,37502,2473,6.2
42065,2020-02-01,20731,19441,1290,6.2
42067,2020-02-01,12717,11997,720,5.7
42069,2020-02-01,106009,100068,5941,5.6
42071,2020-02-01,287319,276102,11217,3.9
42073,2020-02-01,41106,38003,3103,7.5
42075,2020-02-01,73307,69979,3328,4.5
42077,2020-02-01,194446,184902,9544,4.9
42079,2020-02-01,159323,148734,10589,6.6
42081,2020-02-01,57434,53937,3497,6.1
42083,2020-02-01,17524,16245,1279,7.3
42085,2020-02-01,49013,46096,2917,6
42087,2020-02-01,21419,20167,1252,5.8
42089,2020-02-01,84724,79473,5251,6.2
42091,2020-02-01,457680,439835,17845,3.9
42093,2020-02-01,9282,8916,366,3.9
42095,2020-02-01,163043,154841,8202,5
42097,2020-02-01,43012,40115,2897,6.7
42099,2020-02-01,24813,23647,1166,4.7
42101,2020-02-01,742078,698435,43643,5.9
42103,2020-02-01,25542,23830,1712,6.7
42105,2020-02-01,7303,6646,657,9
42107,2020-02-01,66875,62800,4075,6.1
42109,2020-02-01,20517,19353,1164,5.7
42111,2020-02-01,34436,32044,2392,6.9
42113,2020-02-01,2631,2450,181,6.9
42115,2020-02-01,20694,19455,1239,6
42117,2020-02-01,19425,18043,1382,7.1
42119,2020-02-01,20000,19134,866,4.3
42121,2020-02-01,22419,20925,1494,6.7
42123,2020-02-01,19034,17882,1152,6.1
42125,2020-02-01,108534,102444,6090,5.6
42127,2020-02-01,22255,20712,1543,6.9
42129,2020-02-01,183534,173263,10271,5.6
42131,2020-02-01,13781,12928,853,6.2
42133,2020-02-01,237650,227147,10503,4.4
44001,2020-02-01,26120,25268,852,3.3
44003,2020-02-01,91302,87961,3341,3.7
44005,2020-02-01,44698,42976,1722,3.9
44007,2020-02-01,327136,313444,13692,4.2
44009,2020-02-01,69175,66582,2593,3.7
45001,2020-02-01,10135,9761,374,3.7
45003,2020-02-01,75719,73387,2332,3.1
45005,2020-02-01,2705,2530,175,6.5
45007,2020-02-01,92313,89639,2674,2.9
45009,2020-02-01,5011,4723,288,5.7
45011,2020-02-01,8274,7890,384,4.6
45013,2020-02-01,78918,76709,2209,2.8
45015,2020-02-01,105429,102563,2866,2.7
45017,2020-02-01,6687,6453,234,3.5
45019,2020-02-01,214939,209712,5227,2.4
45021,2020-02-01,25323,24463,860,3.4
45023,2020-02-01,13625,13031,594,4.4
45025,2020-02-01,22305,21607,698,3.1
45027,2020-02-01,12797,12263,534,4.2
45029,2020-02-01,16920,16346,574,3.4
45031,2020-02-01,30392,29351,1041,3.4
45033,2020-02-01,13309,12732,577,4.3
45035,2020-02-01,79178,77110,2068,2.6
45037,2020-02-01,10872,10545,327,3
45039,2020-02-01,9750,9301,449,4.6
45041,2020-02-01,67084,65024,2060,3.1
45043,2020-02-01,25769,24686,1083,4.2
45045,2020-02-01,257896,251124,6772,2.6
45047,2020-02-01,31571,30468,1103,3.5
45049,2020-02-01,8467,8217,250,3
45051,2020-02-01,147606,141363,6243,4.2
45053,2020-02-01,12977,12630,347,2.7
45055,2020-02-01,29769,28765,1004,3.4
45057,2020-02-01,41982,40464,1518,3.6
45059,2020-02-01,30618,29624,994,3.2
45061,2020-02-01,6718,6363,355,5.3
45063,2020-02-01,152218,148460,3758,2.5
45065,2020-02-01,3446,3303,143,4.1
45067,2020-02-01,12950,12363,587,4.5
45069,2020-02-01,9223,8788,435,4.7
45071,2020-02-01,19364,18814,550,2.8
45073,2020-02-01,35400,34356,1044,2.9
45075,2020-02-01,35556,33862,1694,4.8
45077,2020-02-01,58179,56460,1719,3
45079,2020-02-01,201174,195433,5741,2.9
45081,2020-02-01,9059,8805,254,2.8
45083,2020-02-01,154756,150474,4282,2.8
45085,2020-02-01,44352,42722,1630,3.7
45087,2020-02-01,11811,11354,457,3.9
45089,2020-02-01,12128,11530,598,4.9
45091,2020-02-01,142455,138377,4078,2.9
46003,2020-02-01,1470,1428,42,2.9
46005,2020-02-01,9505,9191,314,3.3
46007,2020-02-01,1072,1012,60,5.6
46009,2020-02-01,2824,2722,102,3.6
46011,2020-02-01,19473,18870,603,3.1
46013,2020-02-01,20731,20040,691,3.3
46015,2020-02-01,2357,2278,79,3.4
46017,2020-02-01,665,621,44,6.6
46019,2020-02-01,4969,4780,189,3.8
46021,2020-02-01,768,736,32,4.2
46023,2020-02-01,3634,3507,127,3.5
46025,2020-02-01,1887,1797,90,4.8
46027,2020-02-01,7825,7614,211,2.7
46029,2020-02-01,15519,14996,523,3.4
46031,2020-02-01,1346,1274,72,5.3
46033,2020-02-01,3996,3785,211,5.3
46035,2020-02-01,10982,10617,365,3.3
46037,2020-02-01,2748,2574,174,6.3
46039,2020-02-01,2119,1957,162,7.6
46041,2020-02-01,2169,2030,139,6.4
46043,2020-02-01,1566,1506,60,3.8
46045,2020-02-01,2013,1951,62,3.1
46047,2020-02-01,2882,2745,137,4.8
46049,2020-02-01,1021,982,39,3.8
46051,2020-02-01,4423,4185,238,5.4
46053,2020-02-01,1978,1904,74,3.7
46055,2020-02-01,1029,996,33,3.2
46057,2020-02-01,3282,3167,115,3.5
46059,2020-02-01,1741,1693,48,2.8
46061,2020-02-01,1736,1628,108,6.2
46063,2020-02-01,706,688,18,2.5
46065,2020-02-01,9926,9611,315,3.2
46067,2020-02-01,3598,3446,152,4.2
46069,2020-02-01,683,658,25,3.7
46071,2020-02-01,1116,1047,69,6.2
46073,2020-02-01,1089,1063,26,2.4
46075,2020-02-01,502,483,19,3.8
46077,2020-02-01,2615,2516,99,3.8
46079,2020-02-01,6738,6507,231,3.4
46081,2020-02-01,13399,12997,402,3
46083,2020-02-01,34894,33933,961,2.8
46085,2020-02-01,1602,1519,83,5.2
46087,2020-02-01,3090,2984,106,3.4
46089,2020-02-01,989,938,51,5.2
46091,2020-02-01,2327,2198,129,5.5
46093,2020-02-01,14086,13568,518,3.7
46095,2020-02-01,727,683,44,6.1
46097,2020-02-01,1159,1124,35,3
46099,2020-02-01,114408,110654,3754,3.3
46101,2020-02-01,3979,3822,157,3.9
46102,2020-02-01,3543,3250,293,8.3
46103,2020-02-01,56748,54656,2092,3.7
46105,2020-02-01,1397,1351,46,3.3
46107,2020-02-01,983,950,33,3.4
46109,2020-02-01,4874,4566,308,6.3
46111,2020-02-01,1142,1100,42,3.7
46115,2020-02-01,3145,2995,150,4.8
46117,2020-02-01,1834,1756,78,4.3
46119,2020-02-01,775,754,21,2.7
46121,2020-02-01,3138,2939,199,6.3
46123,2020-02-01,2967,2877,90,3
46125,2020-02-01,4726,4544,182,3.9
46127,2020-02-01,8587,8268,319,3.7
46129,2020-02-01,2105,1953,152,7.2
46135,2020-02-01,11964,11590,374,3.1
46137,2020-02-01,902,869,33,3.7
47001,2020-02-01,34885,33554,1331,3.8
47003,2020-02-01,21271,20406,865,4.1
47005,2020-02-01,6989,6597,392,5.6
47007,2020-02-01,4441,4178,263,5.9
47009,2020-02-01,64320,61894,2426,3.8
47011,2020-02-01,53279,51327,1952,3.7
47013,2020-02-01,15036,14248,788,5.2
47015,2020-02-01,6752,6540,212,3.1
47017,2020-02-01,12148,11510,638,5.3
47019,2020-02-01,24202,23143,1059,4.4
47021,2020-02-01,22364,21717,647,2.9
47023,2020-02-01,8636,8323,313,3.6
47025,2020-02-01,13215,12587,628,4.8
47027,2020-02-01,2780,2576,204,7.3
47029,2020-02-01,15028,14068,960,6.4
47031,2020-02-01,25893,24857,1036,4
47033,2020-02-01,7204,6877,327,4.5
47035,2020-02-01,23910,22419,1491,6.2
47037,2020-02-01,412414,401318,11096,2.7
47039,2020-02-01,4587,4314,273,6
47041,2020-02-01,7815,7435,380,4.9
47043,2020-02-01,27648,26763,885,3.2
47045,2020-02-01,16658,15793,865,5.2
47047,2020-02-01,19358,18643,715,3.7
47049,2020-02-01,7634,7276,358,4.7
47051,2020-02-01,20717,19872,845,4.1
47053,2020-02-01,22383,21340,1043,4.7
47055,2020-02-01,15251,14510,741,4.9
47057,2020-02-01,9706,9229,477,4.9
47059,2020-02-01,29566,28018,1548,5.2
47061,2020-02-01,5107,4867,240,4.7
47063,2020-02-01,28703,27450,1253,4.4
47065,2020-02-01,186212,179561,6651,3.6
47067,2020-02-01,2165,2020,145,6.7
47069,2020-02-01,9621,9088,533,5.5
47071,2020-02-01,10585,10017,568,5.4
47073,2020-02-01,23845,22701,1144,4.8
47075,2020-02-01,7843,7449,394,5
47077,2020-02-01,12422,11788,634,5.1
47079,2020-02-01,14314,13540,774,5.4
47081,2020-02-01,11723,11325,398,3.4
47083,2020-02-01,3371,3161,210,6.2
47085,2020-02-01,9019,8589,430,4.8
47087,2020-02-01,4763,4496,267,5.6
47089,2020-02-01,25214,24018,1196,4.7
47091,2020-02-01,7775,7434,341,4.4
47093,2020-02-01,245805,238103,7702,3.1
47095,2020-02-01,1787,1672,115,6.4
47097,2020-02-01,9868,9306,562,5.7
47099,2020-02-01,19619,18783,836,4.3
47101,2020-02-01,5228,5016,212,4.1
47103,2020-02-01,16463,15277,1186,7.2
47105,2020-02-01,23839,22948,891,3.7
47107,2020-02-01,24213,23211,1002,4.1
47109,2020-02-01,8678,8149,529,6.1
47111,2020-02-01,11690,11296,394,3.4
47113,2020-02-01,49224,47345,1879,3.8
47115,2020-02-01,12674,12068,606,4.8
47117,2020-02-01,15813,15199,614,3.9
47119,2020-02-01,50506,48884,1622,3.2
47121,2020-02-01,5242,4975,267,5.1
47123,2020-02-01,20304,19464,840,4.1
47125,2020-02-01,87299,83735,3564,4.1
47127,2020-02-01,3704,3583,121,3.3
47129,2020-02-01,8029,7637,392,4.9
47131,2020-02-01,12685,12036,649,5.1
47133,2020-02-01,10281,9800,481,4.7
47135,2020-02-01,3125,2943,182,5.8
47137,2020-02-01,2376,2251,125,5.3
47139,2020-02-01,7729,7381,348,4.5
47141,2020-02-01,35450,34088,1362,3.8
47143,2020-02-01,13663,12869,794,5.8
47145,2020-02-01,23720,22613,1107,4.7
47147,2020-02-01,39037,37833,1204,3.1
47149,2020-02-01,188095,182903,5192,2.8
47151,2020-02-01,8300,7880,420,5.1
47153,2020-02-01,6294,5999,295,4.7
47155,2020-02-01,52964,49717,3247,6.1
47157,2020-02-01,447084,427614,19470,4.4
47159,2020-02-01,9713,9388,325,3.3
47161,2020-02-01,5627,5332,295,5.2
47163,2020-02-01,70302,67381,2921,4.2
47165,2020-02-01,104604,101533,3071,2.9
47167,2020-02-01,28421,27181,1240,4.4
47169,2020-02-01,5564,5382,182,3.3
47171,2020-02-01,7315,6854,461,6.3
47173,2020-02-01,7685,7358,327,4.3
47175,2020-02-01,2061,1952,109,5.3
47177,2020-02-01,16621,15863,758,4.6
47179,2020-02-01,60988,58610,2378,3.9
47181,2020-02-01,6294,5942,352,5.6
47183,2020-02-01,16328,15688,640,3.9
47185,2020-02-01,12342,11833,509,4.1
47187,2020-02-01,131059,127709,3350,2.6
47189,2020-02-01,78450,76155,2295,2.9
48001,2020-02-01,24194,23486,708,2.9
48003,2020-02-01,9998,9754,244,2.4
48005,2020-02-01,36084,34560,1524,4.2
48007,2020-02-01,9479,9065,414,4.4
48009,2020-02-01,4164,4040,124,3
48011,2020-02-01,945,916,29,3.1
48013,2020-02-01,22068,21253,815,3.7
48015,2020-02-01,14363,13854,509,3.5
48017,2020-02-01,2460,2368,92,3.7
48019,2020-02-01,10227,9895,332,3.2
48021,2020-02-01,43806,42528,1278,2.9
48023,2020-02-01,1784,1737,47,2.6
48025,2020-02-01,9936,9456,480,4.8
48027,2020-02-01,146316,140828,5488,3.8
48029,2020-02-01,964600,934452,30148,3.1
48031,2020-02-01,6651,6494,157,2.4
48033,2020-02-01,429,419,10,2.3
48035,2020-02-01,8406,8103,303,3.6
48037,2020-02-01,40269,38556,1713,4.3
48039,2020-02-01,183079,175160,7919,4.3
48041,2020-02-01,123365,120124,3241,2.6
48043,2020-02-01,4250,4126,124,2.9
48045,2020-02-01,570,548,22,3.9
48047,2020-02-01,2686,2540,146,5.4
48049,2020-02-01,15646,15035,611,3.9
48051,2020-02-01,8698,8393,305,3.5
48053,2020-02-01,23887,23225,662,2.8
48055,2020-02-01,20078,19433,645,3.2
48057,2020-02-01,12390,11979,411,3.3
48059,2020-02-01,6218,6025,193,3.1
48061,2020-02-01,169117,159293,9824,5.8
48063,2020-02-01,5029,4807,222,4.4
48065,2020-02-01,3061,2972,89,2.9
48067,2020-02-01,12461,11909,552,4.4
48069,2020-02-01,3431,3335,96,2.8
48071,2020-02-01,19867,18947,920,4.6
48073,2020-02-01,21016,20153,863,4.1
48075,2020-02-01,2915,2829,86,3
48077,2020-02-01,4946,4800,146,3
48079,2020-02-01,1128,1085,43,3.8
48081,2020-02-01,1465,1423,42,2.9
48083,2020-02-01,2877,2745,132,4.6
48085,2020-02-01,574807,557582,17225,3
48087,2020-02-01,1138,1098,40,3.5
48089,2020-02-01,9905,9570,335,3.4
48091,2020-02-01,74522,72296,2226,3
48093,2020-02-01,5640,5436,204,3.6
48095,2020-02-01,1351,1314,37,2.7
48097,2020-02-01,20000,19373,627,3.1
48099,2020-02-01,24525,23583,942,3.8
48101,2020-02-01,547,521,26,4.8
48103,2020-02-01,1559,1483,76,4.9
48105,2020-02-01,1646,1577,69,4.2
48107,2020-02-01,2501,2411,90,3.6
48109,2020-02-01,1048,1013,35,3.3
48111,2020-02-01,3882,3799,83,2.1
48113,2020-02-01,NA,NA,46274,3.3
48115,2020-02-01,4744,4539,205,4.3
48117,2020-02-01,8522,8283,239,2.8
48119,2020-02-01,2466,2376,90,3.6
48121,2020-02-01,504556,489893,14663,2.9
48123,2020-02-01,9948,9686,262,2.6
48125,2020-02-01,669,641,28,4.2
48127,2020-02-01,7498,7288,210,2.8
48129,2020-02-01,1393,1347,46,3.3
48131,2020-02-01,4934,4677,257,5.2
48133,2020-02-01,8168,7879,289,3.5
48135,2020-02-01,88372,85445,2927,3.3
48137,2020-02-01,1145,1121,24,2.1
48139,2020-02-01,94526,91667,2859,3
48141,2020-02-01,369182,354995,14187,3.8
48143,2020-02-01,21219,20511,708,3.3
48145,2020-02-01,6644,6414,230,3.5
48147,2020-02-01,17645,17170,475,2.7
48149,2020-02-01,12110,11788,322,2.7
48151,2020-02-01,1619,1575,44,2.7
48153,2020-02-01,2578,2443,135,5.2
48155,2020-02-01,589,572,17,2.9
48157,2020-02-01,399539,385635,13904,3.5
48159,2020-02-01,4674,4514,160,3.4
48161,2020-02-01,6436,6107,329,5.1
48163,2020-02-01,10484,10191,293,2.8
48165,2020-02-01,10000,9739,261,2.6
48167,2020-02-01,168474,161720,6754,4
48169,2020-02-01,2189,2121,68,3.1
48171,2020-02-01,13604,13256,348,2.6
48173,2020-02-01,790,773,17,2.2
48175,2020-02-01,3271,3146,125,3.8
48177,2020-02-01,9710,9425,285,2.9
48179,2020-02-01,8089,7766,323,4
48181,2020-02-01,64461,62386,2075,3.2
48183,2020-02-01,57990,55641,2349,4.1
48185,2020-02-01,11359,10888,471,4.1
48187,2020-02-01,82701,80336,2365,2.9
48189,2020-02-01,12005,11466,539,4.5
48191,2020-02-01,1054,1005,49,4.6
48193,2020-02-01,3677,3556,121,3.3
48195,2020-02-01,2733,2672,61,2.2
48197,2020-02-01,1735,1685,50,2.9
48199,2020-02-01,25485,24351,1134,4.4
48201,2020-02-01,NA,NA,91671,3.9
48203,2020-02-01,29523,28272,1251,4.2
48205,2020-02-01,2794,2745,49,1.8
48207,2020-02-01,2286,2211,75,3.3
48209,2020-02-01,122502,119193,3309,2.7
48211,2020-02-01,1881,1819,62,3.3
48213,2020-02-01,36922,35595,1327,3.6
48215,2020-02-01,362658,338312,24346,6.7
48217,2020-02-01,16560,15994,566,3.4
48219,2020-02-01,11292,10944,348,3.1
48221,2020-02-01,28104,27107,997,3.5
48223,2020-02-01,17646,17081,565,3.2
48225,2020-02-01,10356,10016,340,3.3
48227,2020-02-01,14190,13736,454,3.2
48229,2020-02-01,1851,1773,78,4.2
48231,2020-02-01,44296,42726,1570,3.5
48233,2020-02-01,8757,8343,414,4.7
48235,2020-02-01,768,749,19,2.5
48237,2020-02-01,3417,3271,146,4.3
48239,2020-02-01,7699,7455,244,3.2
48241,2020-02-01,12853,11995,858,6.7
48243,2020-02-01,1002,970,32,3.2
48245,2020-02-01,107841,101556,6285,5.8
48247,2020-02-01,1867,1780,87,4.7
48249,2020-02-01,16871,15987,884,5.2
48251,2020-02-01,83714,80978,2736,3.3
48253,2020-02-01,5806,5576,230,4
48255,2020-02-01,7435,7245,190,2.6
48257,2020-02-01,65958,63769,2189,3.3
48259,2020-02-01,22490,21868,622,2.8
48261,2020-02-01,204,197,7,3.4
48263,2020-02-01,486,471,15,3.1
48265,2020-02-01,22498,21775,723,3.2
48267,2020-02-01,1818,1757,61,3.4
48269,2020-02-01,238,232,6,2.5
48271,2020-02-01,1403,1339,64,4.6
48273,2020-02-01,13679,13060,619,4.5
48275,2020-02-01,1428,1377,51,3.6
48277,2020-02-01,24476,23678,798,3.3
48279,2020-02-01,5381,5178,203,3.8
48281,2020-02-01,9375,9063,312,3.3
48283,2020-02-01,4429,4293,136,3.1
48285,2020-02-01,8422,8178,244,2.9
48287,2020-02-01,10079,9801,278,2.8
48289,2020-02-01,6352,6055,297,4.7
48291,2020-02-01,33852,32002,1850,5.5
48293,2020-02-01,8726,8372,354,4.1
48295,2020-02-01,1644,1600,44,2.7
48297,2020-02-01,5705,5519,186,3.3
48299,2020-02-01,8742,8442,300,3.4
48301,2020-02-01,685,681,4,0.6
48303,2020-02-01,159088,154721,4367,2.7
48305,2020-02-01,2805,2705,100,3.6
48307,2020-02-01,3323,3168,155,4.7
48309,2020-02-01,120809,116871,3938,3.3
48311,2020-02-01,904,890,14,1.5
48313,2020-02-01,4499,4317,182,4
48315,2020-02-01,4215,4015,200,4.7
48317,2020-02-01,2906,2821,85,2.9
48319,2020-02-01,1782,1722,60,3.4
48321,2020-02-01,16751,15781,970,5.8
48323,2020-02-01,24547,22190,2357,9.6
48325,2020-02-01,22187,21465,722,3.3
48327,2020-02-01,865,836,29,3.4
48329,2020-02-01,108114,105606,2508,2.3
48331,2020-02-01,9704,9264,440,4.5
48333,2020-02-01,1908,1850,58,3
48335,2020-02-01,2346,2270,76,3.2
48337,2020-02-01,9458,9153,305,3.2
48339,2020-02-01,289593,279483,10110,3.5
48341,2020-02-01,10814,10546,268,2.5
48343,2020-02-01,4862,4594,268,5.5
48345,2020-02-01,470,453,17,3.6
48347,2020-02-01,28241,27171,1070,3.8
48349,2020-02-01,24462,23624,838,3.4
48351,2020-02-01,5225,4895,330,6.3
48353,2020-02-01,7316,7094,222,3
48355,2020-02-01,168231,161198,7033,4.2
48357,2020-02-01,4335,4188,147,3.4
48359,2020-02-01,929,900,29,3.1
48361,2020-02-01,36634,34803,1831,5
48363,2020-02-01,13583,13157,426,3.1
48365,2020-02-01,10225,9761,464,4.5
48367,2020-02-01,68650,66555,2095,3.1
48369,2020-02-01,4889,4772,117,2.4
48371,2020-02-01,6390,6153,237,3.7
48373,2020-02-01,18336,17409,927,5.1
48375,2020-02-01,55992,54492,1500,2.7
48377,2020-02-01,3195,2928,267,8.4
48379,2020-02-01,6225,6043,182,2.9
48381,2020-02-01,73157,71364,1793,2.5
48383,2020-02-01,1936,1882,54,2.8
48385,2020-02-01,1023,974,49,4.8
48387,2020-02-01,5159,4916,243,4.7
48389,2020-02-01,12555,12309,246,2
48391,2020-02-01,3156,3038,118,3.7
48393,2020-02-01,417,405,12,2.9
48395,2020-02-01,7930,7641,289,3.6
48397,2020-02-01,53118,51523,1595,3
48399,2020-02-01,4634,4487,147,3.2
48401,2020-02-01,22975,22051,924,4
48403,2020-02-01,3696,3438,258,7
48405,2020-02-01,3555,3376,179,5
48407,2020-02-01,11931,11374,557,4.7
48409,2020-02-01,30035,28379,1656,5.5
48411,2020-02-01,2597,2505,92,3.5
48413,2020-02-01,1317,1277,40,3
48415,2020-02-01,6770,6512,258,3.8
48417,2020-02-01,1903,1856,47,2.5
48419,2020-02-01,11188,10712,476,4.3
48421,2020-02-01,1387,1354,33,2.4
48423,2020-02-01,107438,103725,3713,3.5
48425,2020-02-01,4450,4286,164,3.7
48427,2020-02-01,26387,22978,3409,12.9
48429,2020-02-01,4083,3948,135,3.3
48431,2020-02-01,573,554,19,3.3
48433,2020-02-01,576,557,19,3.3
48435,2020-02-01,1351,1298,53,3.9
48437,2020-02-01,2613,2513,100,3.8
48439,2020-02-01,NA,NA,35328,3.2
48441,2020-02-01,68062,66092,1970,2.9
48443,2020-02-01,370,356,14,3.8
48445,2020-02-01,4899,4728,171,3.5
48447,2020-02-01,642,618,24,3.7
48449,2020-02-01,13192,12644,548,4.2
48451,2020-02-01,54948,53309,1639,3
48453,2020-02-01,757671,738329,19342,2.6
48455,2020-02-01,5342,5070,272,5.1
48457,2020-02-01,7205,6777,428,5.9
48459,2020-02-01,17852,17096,756,4.2
48461,2020-02-01,1715,1659,56,3.3
48463,2020-02-01,11432,11017,415,3.6
48465,2020-02-01,23292,22362,930,4
48467,2020-02-01,26325,25413,912,3.5
48469,2020-02-01,42777,41147,1630,3.8
48471,2020-02-01,24465,23535,930,3.8
48473,2020-02-01,23898,22999,899,3.8
48475,2020-02-01,8002,7795,207,2.6
48477,2020-02-01,15488,14986,502,3.2
48479,2020-02-01,120300,115563,4737,3.9
48481,2020-02-01,21858,21065,793,3.6
48483,2020-02-01,2293,2219,74,3.2
48485,2020-02-01,56590,54799,1791,3.2
48487,2020-02-01,4998,4797,201,4
48489,2020-02-01,6835,6273,562,8.2
48491,2020-02-01,320860,312002,8858,2.8
48493,2020-02-01,25315,24554,761,3
48495,2020-02-01,4044,3911,133,3.3
48497,2020-02-01,32532,31416,1116,3.4
48499,2020-02-01,17945,17209,736,4.1
48501,2020-02-01,3784,3651,133,3.5
48503,2020-02-01,7947,7708,239,3
48505,2020-02-01,4906,4601,305,6.2
48507,2020-02-01,3429,3119,310,9
49001,2020-02-01,2828,2743,85,3
49003,2020-02-01,26178,25424,754,2.9
49005,2020-02-01,65067,63587,1480,2.3
49007,2020-02-01,8556,8191,365,4.3
49009,2020-02-01,327,312,15,4.6
49011,2020-02-01,175982,171476,4506,2.6
49013,2020-02-01,7727,7350,377,4.9
49015,2020-02-01,4260,4031,229,5.4
49017,2020-02-01,2376,2084,292,12.3
49019,2020-02-01,5756,5297,459,8
49021,2020-02-01,25264,24479,785,3.1
49023,2020-02-01,5880,5714,166,2.8
49025,2020-02-01,3596,3461,135,3.8
49027,2020-02-01,5964,5784,180,3
49029,2020-02-01,5627,5480,147,2.6
49031,2020-02-01,479,450,29,6.1
49033,2020-02-01,959,911,48,5
49035,2020-02-01,645226,627701,17525,2.7
49037,2020-02-01,5594,5182,412,7.4
49039,2020-02-01,12457,12005,452,3.6
49041,2020-02-01,9699,9328,371,3.8
49043,2020-02-01,27281,26684,597,2.2
49045,2020-02-01,34536,33522,1014,2.9
49047,2020-02-01,13494,12728,766,5.7
49049,2020-02-01,315559,307596,7963,2.5
49051,2020-02-01,16670,16206,464,2.8
49053,2020-02-01,77990,75345,2645,3.4
49055,2020-02-01,1355,1211,144,10.6
49057,2020-02-01,129288,125196,4092,3.2
50001,2020-02-01,20084,19542,542,2.7
50003,2020-02-01,17785,17222,563,3.2
50005,2020-02-01,14159,13644,515,3.6
50007,2020-02-01,94628,92935,1693,1.8
50009,2020-02-01,2632,2517,115,4.4
50011,2020-02-01,26769,26053,716,2.7
50013,2020-02-01,3996,3853,143,3.6
50015,2020-02-01,13887,13370,517,3.7
50017,2020-02-01,15723,15211,512,3.3
50019,2020-02-01,13370,12602,768,5.7
50021,2020-02-01,30029,29180,849,2.8
50023,2020-02-01,34324,33458,866,2.5
50025,2020-02-01,21880,21360,520,2.4
50027,2020-02-01,28869,28279,590,2
51001,2020-02-01,16485,15771,714,4.3
51003,2020-02-01,59054,57745,1309,2.2
51005,2020-02-01,6973,6678,295,4.2
51007,2020-02-01,6439,6234,205,3.2
51009,2020-02-01,15189,14689,500,3.3
51011,2020-02-01,7253,6974,279,3.8
51013,2020-02-01,158455,155616,2839,1.8
51015,2020-02-01,38381,37502,879,2.3
51017,2020-02-01,2530,2459,71,2.8
51019,2020-02-01,38830,37702,1128,2.9
51021,2020-02-01,2912,2818,94,3.2
51023,2020-02-01,17659,17203,456,2.6
51025,2020-02-01,6044,5760,284,4.7
51027,2020-02-01,6733,6264,469,7
51029,2020-02-01,6671,6363,308,4.6
51031,2020-02-01,26275,25419,856,3.3
51033,2020-02-01,15701,15185,516,3.3
51035,2020-02-01,13561,12924,637,4.7
51036,2020-02-01,3757,3633,124,3.3
51037,2020-02-01,5319,5121,198,3.7
51041,2020-02-01,192727,187710,5017,2.6
51043,2020-02-01,7766,7590,176,2.3
51045,2020-02-01,2324,2258,66,2.8
51047,2020-02-01,25262,24566,696,2.8
51049,2020-02-01,4722,4572,150,3.2
51051,2020-02-01,4856,4556,300,6.2
51053,2020-02-01,14024,13574,450,3.2
51057,2020-02-01,5564,5337,227,4.1
51059,2020-02-01,651529,637718,13811,2.1
51061,2020-02-01,38135,37244,891,2.3
51063,2020-02-01,8417,8167,250,3
51065,2020-02-01,14396,14072,324,2.3
51067,2020-02-01,26795,25953,842,3.1
51069,2020-02-01,49266,48136,1130,2.3
51071,2020-02-01,8144,7844,300,3.7
51073,2020-02-01,19794,19268,526,2.7
51075,2020-02-01,11494,11204,290,2.5
51077,2020-02-01,8294,7999,295,3.6
51079,2020-02-01,10845,10603,242,2.2
51081,2020-02-01,4313,4168,145,3.4
51083,2020-02-01,15689,15015,674,4.3
51085,2020-02-01,60864,59473,1391,2.3
51087,2020-02-01,187065,182188,4877,2.6
51089,2020-02-01,24091,23287,804,3.3
51091,2020-02-01,1207,1170,37,3.1
51093,2020-02-01,19627,19082,545,2.8
51095,2020-02-01,37012,36008,1004,2.7
51097,2020-02-01,3934,3832,102,2.6
51099,2020-02-01,13853,13485,368,2.7
51101,2020-02-01,9407,9149,258,2.7
51103,2020-02-01,5498,5147,351,6.4
51105,2020-02-01,8377,7987,390,4.7
51107,2020-02-01,228327,223417,4910,2.2
51109,2020-02-01,20412,19833,579,2.8
51111,2020-02-01,5347,5184,163,3
51113,2020-02-01,7568,7408,160,2.1
51115,2020-02-01,4184,4063,121,2.9
51117,2020-02-01,12372,11861,511,4.1
51119,2020-02-01,5333,5175,158,3
51121,2020-02-01,51507,50146,1361,2.6
51125,2020-02-01,7662,7464,198,2.6
51127,2020-02-01,12816,12526,290,2.3
51131,2020-02-01,5366,5081,285,5.3
51133,2020-02-01,5719,5353,366,6.4
51135,2020-02-01,7412,7206,206,2.8
51137,2020-02-01,17724,17219,505,2.8
51139,2020-02-01,12107,11459,648,5.4
51141,2020-02-01,7153,6885,268,3.7
51143,2020-02-01,30283,29129,1154,3.8
51145,2020-02-01,14556,14174,382,2.6
51147,2020-02-01,10507,10125,382,3.6
51149,2020-02-01,15511,15006,505,3.3
51153,2020-02-01,252178,246012,6166,2.4
51155,2020-02-01,16787,15973,814,4.8
51157,2020-02-01,3771,3681,90,2.4
51159,2020-02-01,4129,4002,127,3.1
51161,2020-02-01,50126,48811,1315,2.6
51163,2020-02-01,10810,10517,293,2.7
51165,2020-02-01,43353,42389,964,2.2
51167,2020-02-01,11448,10876,572,5
51169,2020-02-01,9264,8940,324,3.5
51171,2020-02-01,22799,22232,567,2.5
51173,2020-02-01,13895,13328,567,4.1
51175,2020-02-01,9081,8836,245,2.7
51177,2020-02-01,68784,66883,1901,2.8
51179,2020-02-01,73950,72033,1917,2.6
51181,2020-02-01,3682,3551,131,3.6
51183,2020-02-01,3889,3712,177,4.6
51185,2020-02-01,15787,14987,800,5.1
51187,2020-02-01,20973,20380,593,2.8
51191,2020-02-01,27104,26153,951,3.5
51193,2020-02-01,9601,9217,384,4
51195,2020-02-01,13599,12940,659,4.8
51197,2020-02-01,13822,13195,627,4.5
51199,2020-02-01,33100,32254,846,2.6
51510,2020-02-01,104087,101927,2160,2.1
51520,2020-02-01,7290,7009,281,3.9
51530,2020-02-01,3709,3627,82,2.2
51540,2020-02-01,27327,26742,585,2.1
51550,2020-02-01,123894,120499,3395,2.7
51570,2020-02-01,9031,8776,255,2.8
51580,2020-02-01,2442,2299,143,5.9
51590,2020-02-01,19297,18238,1059,5.5
51595,2020-02-01,2287,2184,103,4.5
51600,2020-02-01,13805,13523,282,2
51610,2020-02-01,8810,8652,158,1.8
51620,2020-02-01,3585,3446,139,3.9
51630,2020-02-01,14500,14063,437,3
51640,2020-02-01,2952,2852,100,3.4
51650,2020-02-01,65091,62639,2452,3.8
51660,2020-02-01,25854,25158,696,2.7
51670,2020-02-01,9953,9544,409,4.1
51678,2020-02-01,2122,2040,82,3.9
51680,2020-02-01,36633,35350,1283,3.5
51683,2020-02-01,22666,22094,572,2.5
51685,2020-02-01,9627,9393,234,2.4
51690,2020-02-01,5563,5305,258,4.6
51700,2020-02-01,89933,86715,3218,3.6
51710,2020-02-01,112762,108996,3766,3.3
51720,2020-02-01,1713,1636,77,4.5
51730,2020-02-01,13453,12661,792,5.9
51735,2020-02-01,6439,6292,147,2.3
51740,2020-02-01,44737,43030,1707,3.8
51750,2020-02-01,8885,8592,293,3.3
51760,2020-02-01,121662,117795,3867,3.2
51770,2020-02-01,49913,48361,1552,3.1
51775,2020-02-01,13167,12803,364,2.8
51790,2020-02-01,12563,12233,330,2.6
51800,2020-02-01,45084,43760,1324,2.9
51810,2020-02-01,235430,229285,6145,2.6
51820,2020-02-01,10984,10671,313,2.8
51830,2020-02-01,6760,6504,256,3.8
51840,2020-02-01,15132,14726,406,2.7
53001,2020-02-01,8492,7877,615,7.2
53003,2020-02-01,10651,10212,439,4.1
53005,2020-02-01,105195,99430,5765,5.5
53007,2020-02-01,43045,40507,2538,5.9
53009,2020-02-01,29302,27410,1892,6.5
53011,2020-02-01,248872,237565,11307,4.5
53013,2020-02-01,1780,1673,107,6
53015,2020-02-01,49047,46176,2871,5.9
53017,2020-02-01,20992,19575,1417,6.8
53019,2020-02-01,2502,2170,332,13.3
53021,2020-02-01,42448,39385,3063,7.2
53023,2020-02-01,814,757,57,7
53025,2020-02-01,44955,41109,3846,8.6
53027,2020-02-01,29442,27366,2076,7.1
53029,2020-02-01,37080,35273,1807,4.9
53031,2020-02-01,13319,12582,737,5.5
53033,2020-02-01,NA,NA,31972,2.4
53035,2020-02-01,133434,127812,5622,4.2
53037,2020-02-01,24185,22819,1366,5.6
53039,2020-02-01,9839,9193,646,6.6
53041,2020-02-01,35364,33121,2243,6.3
53043,2020-02-01,4753,4465,288,6.1
53045,2020-02-01,26576,24931,1645,6.2
53047,2020-02-01,18929,17265,1664,8.8
53049,2020-02-01,8554,7988,566,6.6
53051,2020-02-01,5183,4711,472,9.1
53053,2020-02-01,456345,433701,22644,5
53055,2020-02-01,8485,8124,361,4.3
53057,2020-02-01,63484,59855,3629,5.7
53059,2020-02-01,5667,5355,312,5.5
53061,2020-02-01,446145,433844,12301,2.8
53063,2020-02-01,262904,248229,14675,5.6
53065,2020-02-01,19367,17706,1661,8.6
53067,2020-02-01,148241,141303,6938,4.7
53069,2020-02-01,1361,1268,93,6.8
53071,2020-02-01,30292,28821,1471,4.9
53073,2020-02-01,118175,112296,5879,5
53075,2020-02-01,24585,23645,940,3.8
53077,2020-02-01,130037,119652,10385,8
54001,2020-02-01,7483,6968,515,6.9
54003,2020-02-01,58805,56898,1907,3.2
54005,2020-02-01,7544,7044,500,6.6
54007,2020-02-01,5396,4835,561,10.4
54009,2020-02-01,10005,9446,559,5.6
54011,2020-02-01,42131,40407,1724,4.1
54013,2020-02-01,2756,2215,541,19.6
54015,2020-02-01,3291,2881,410,12.5
54017,2020-02-01,4054,3840,214,5.3
54019,2020-02-01,16450,15251,1199,7.3
54021,2020-02-01,2482,2266,216,8.7
54023,2020-02-01,6012,5662,350,5.8
54025,2020-02-01,15980,15094,886,5.5
54027,2020-02-01,11053,10627,426,3.9
54029,2020-02-01,13079,12364,715,5.5
54031,2020-02-01,5927,5606,321,5.4
54033,2020-02-01,35038,33227,1811,5.2
54035,2020-02-01,13470,12643,827,6.1
54037,2020-02-01,30488,29627,861,2.8
54039,2020-02-01,82690,78718,3972,4.8
54041,2020-02-01,6677,6143,534,8
54043,2020-02-01,7418,6838,580,7.8
54045,2020-02-01,11539,10674,865,7.5
54047,2020-02-01,4678,4158,520,11.1
54049,2020-02-01,26206,24859,1347,5.1
54051,2020-02-01,14204,13078,1126,7.9
54053,2020-02-01,10425,9729,696,6.7
54055,2020-02-01,21315,20111,1204,5.6
54057,2020-02-01,12857,12132,725,5.6
54059,2020-02-01,7195,6493,702,9.8
54061,2020-02-01,56224,54308,1916,3.4
54063,2020-02-01,6175,5831,344,5.6
54065,2020-02-01,8208,7888,320,3.9
54067,2020-02-01,9746,8900,846,8.7
54069,2020-02-01,20970,19971,999,4.8
54071,2020-02-01,3794,3637,157,4.1
54073,2020-02-01,2993,2733,260,8.7
54075,2020-02-01,4280,4045,235,5.5
54077,2020-02-01,16129,15292,837,5.2
54079,2020-02-01,27255,25994,1261,4.6
54081,2020-02-01,30533,28908,1625,5.3
54083,2020-02-01,12475,11621,854,6.8
54085,2020-02-01,4493,4158,335,7.5
54087,2020-02-01,5370,4739,631,11.8
54089,2020-02-01,4383,4091,292,6.7
54091,2020-02-01,8035,7595,440,5.5
54093,2020-02-01,3434,3210,224,6.5
54095,2020-02-01,3191,2900,291,9.1
54097,2020-02-01,9796,9114,682,7
54099,2020-02-01,16175,15188,987,6.1
54101,2020-02-01,3468,3153,315,9.1
54103,2020-02-01,6793,6178,615,9.1
54105,2020-02-01,2407,2152,255,10.6
54107,2020-02-01,37568,35393,2175,5.8
54109,2020-02-01,6808,6237,571,8.4
55001,2020-02-01,8031,7401,630,7.8
55003,2020-02-01,7614,7159,455,6
55005,2020-02-01,23992,22581,1411,5.9
55007,2020-02-01,7371,6785,586,8
55009,2020-02-01,141950,137028,4922,3.5
55011,2020-02-01,6290,5902,388,6.2
55013,2020-02-01,6959,6391,568,8.2
55015,2020-02-01,27281,26394,887,3.3
55017,2020-02-01,33595,31693,1902,5.7
55019,2020-02-01,17336,16521,815,4.7
55021,2020-02-01,31858,30522,1336,4.2
55023,2020-02-01,7453,6906,547,7.3
55025,2020-02-01,322376,314298,8078,2.5
55027,2020-02-01,46971,45192,1779,3.8
55029,2020-02-01,13773,12960,813,5.9
55031,2020-02-01,23291,21884,1407,6
55033,2020-02-01,24550,23387,1163,4.7
55035,2020-02-01,58971,56979,1992,3.4
55037,2020-02-01,2173,2048,125,5.8
55039,2020-02-01,57255,55297,1958,3.4
55041,2020-02-01,3958,3710,248,6.3
55043,2020-02-01,27896,26658,1238,4.4
55045,2020-02-01,21090,20261,829,3.9
55047,2020-02-01,9038,8503,535,5.9
55049,2020-02-01,13732,13140,592,4.3
55051,2020-02-01,2527,2338,189,7.5
55053,2020-02-01,10040,9402,638,6.4
55055,2020-02-01,45751,43894,1857,4.1
55057,2020-02-01,13317,12641,676,5.1
55059,2020-02-01,88212,84052,4160,4.7
55061,2020-02-01,10900,10491,409,3.8
55063,2020-02-01,66656,64483,2173,3.3
55065,2020-02-01,9979,9615,364,3.6
55067,2020-02-01,9209,8694,515,5.6
55069,2020-02-01,15088,14277,811,5.4
55071,2020-02-01,40567,38782,1785,4.4
55073,2020-02-01,73830,71417,2413,3.3
55075,2020-02-01,19187,18074,1113,5.8
55077,2020-02-01,7793,7292,501,6.4
55078,2020-02-01,1554,1453,101,6.5
55079,2020-02-01,468820,448726,20094,4.3
55081,2020-02-01,23071,22184,887,3.8
55083,2020-02-01,20723,19602,1121,5.4
55085,2020-02-01,17146,16037,1109,6.5
55087,2020-02-01,102506,99091,3415,3.3
55089,2020-02-01,48862,47465,1397,2.9
55091,2020-02-01,4009,3782,227,5.7
55093,2020-02-01,25402,24134,1268,5
55095,2020-02-01,24604,22936,1668,6.8
55097,2020-02-01,38493,36974,1519,3.9
55099,2020-02-01,6347,5953,394,6.2
55101,2020-02-01,98104,93236,4868,5
55103,2020-02-01,9006,8626,380,4.2
55105,2020-02-01,85480,81528,3952,4.6
55107,2020-02-01,6793,6320,473,7
55109,2020-02-01,50592,48161,2431,4.8
55111,2020-02-01,34779,33411,1368,3.9
55113,2020-02-01,7696,7130,566,7.4
55115,2020-02-01,20618,19684,934,4.5
55117,2020-02-01,61246,59298,1948,3.2
55119,2020-02-01,10906,10218,688,6.3
55121,2020-02-01,15736,14941,795,5.1
55123,2020-02-01,15031,14309,722,4.8
55125,2020-02-01,9584,8990,594,6.2
55127,2020-02-01,57230,54855,2375,4.1
55129,2020-02-01,7653,7206,447,5.8
55131,2020-02-01,77412,74870,2542,3.3
55133,2020-02-01,225357,218223,7134,3.2
55135,2020-02-01,25477,24475,1002,3.9
55137,2020-02-01,11213,10583,630,5.6
55139,2020-02-01,91287,88391,2896,3.2
55141,2020-02-01,34880,33250,1630,4.7
56001,2020-02-01,20673,20031,642,3.1
56003,2020-02-01,5303,5011,292,5.5
56005,2020-02-01,23789,22875,914,3.8
56007,2020-02-01,7959,7606,353,4.4
56009,2020-02-01,9061,8776,285,3.1
56011,2020-02-01,3673,3553,120,3.3
56013,2020-02-01,18958,17928,1030,5.4
56015,2020-02-01,6637,6400,237,3.6
56017,2020-02-01,2161,2064,97,4.5
56019,2020-02-01,4080,3908,172,4.2
56021,2020-02-01,49166,47167,1999,4.1
56023,2020-02-01,8856,8485,371,4.2
56025,2020-02-01,39532,37684,1848,4.7
56027,2020-02-01,1229,1185,44,3.6
56029,2020-02-01,14802,14069,733,5
56031,2020-02-01,4558,4343,215,4.7
56033,2020-02-01,15734,15055,679,4.3
56035,2020-02-01,4205,3950,255,6.1
56037,2020-02-01,21483,20317,1166,5.4
56039,2020-02-01,15358,14955,403,2.6
56041,2020-02-01,8789,8386,403,4.6
56043,2020-02-01,3917,3720,197,5
56045,2020-02-01,3829,3706,123,3.2
72001,2020-02-01,4138,3375,763,18.4
72003,2020-02-01,11296,10200,1096,9.7
72005,2020-02-01,13706,12474,1232,9
72007,2020-02-01,6230,5680,550,8.8
72009,2020-02-01,6102,5519,583,9.6
72011,2020-02-01,8382,7693,689,8.2
72013,2020-02-01,22874,20820,2054,9
72015,2020-02-01,4448,3832,616,13.8
72017,2020-02-01,5624,5017,607,10.8
72019,2020-02-01,6893,6355,538,7.8
72021,2020-02-01,61860,58410,3450,5.6
72023,2020-02-01,12874,11804,1070,8.3
72025,2020-02-01,45254,42525,2729,6
72027,2020-02-01,9061,8320,741,8.2
72029,2020-02-01,15243,14310,933,6.1
72031,2020-02-01,58224,55228,2996,5.1
72033,2020-02-01,7403,6940,463,6.3
72035,2020-02-01,15283,14306,977,6.4
72037,2020-02-01,3465,3186,279,8.1
72039,2020-02-01,3488,3134,354,10.1
72041,2020-02-01,14645,13797,848,5.8
72043,2020-02-01,9433,8340,1093,11.6
72045,2020-02-01,4679,4245,434,9.3
72047,2020-02-01,8388,7706,682,8.1
72049,2020-02-01,848,822,26,3.1
72051,2020-02-01,12499,11847,652,5.2
72053,2020-02-01,10216,9366,850,8.3
72054,2020-02-01,3159,2831,328,10.4
72055,2020-02-01,3996,3354,642,16.1
72057,2020-02-01,10300,9216,1084,10.5
72059,2020-02-01,4661,3972,689,14.8
72061,2020-02-01,35753,34421,1332,3.7
72063,2020-02-01,17192,16264,928,5.4
72065,2020-02-01,13373,11437,1936,14.5
72067,2020-02-01,5047,4655,392,7.8
72069,2020-02-01,16294,14766,1528,9.4
72071,2020-02-01,11115,10130,985,8.9
72073,2020-02-01,4046,3531,515,12.7
72075,2020-02-01,14663,13393,1270,8.7
72077,2020-02-01,11608,10737,871,7.5
72079,2020-02-01,4938,4334,604,12.2
72081,2020-02-01,6812,5683,1129,16.6
72083,2020-02-01,2531,2238,293,11.6
72085,2020-02-01,10668,9816,852,8
72087,2020-02-01,8035,7426,609,7.6
72089,2020-02-01,5824,5357,467,8
72091,2020-02-01,10898,10109,789,7.2
72093,2020-02-01,1873,1571,302,16.1
72095,2020-02-01,2900,2392,508,17.5
72097,2020-02-01,20461,18537,1924,9.4
72099,2020-02-01,9918,8917,1001,10.1
72101,2020-02-01,7531,6915,616,8.2
72103,2020-02-01,7699,7085,614,8
72105,2020-02-01,6687,6156,531,7.9
72107,2020-02-01,4718,4194,524,11.1
72109,2020-02-01,4119,3444,675,16.4
72111,2020-02-01,5532,4831,701,12.7
72113,2020-02-01,42952,39285,3667,8.5
72115,2020-02-01,5795,5158,637,11
72117,2020-02-01,4755,3917,838,17.6
72119,2020-02-01,15999,14977,1022,6.4
72121,2020-02-01,5847,5070,777,13.3
72123,2020-02-01,6565,5689,876,13.3
72125,2020-02-01,9185,8205,980,10.7
72127,2020-02-01,127103,120900,6203,4.9
72129,2020-02-01,11152,10186,966,8.7
72131,2020-02-01,9807,8376,1431,14.6
72133,2020-02-01,8832,8088,744,8.4
72135,2020-02-01,25688,24382,1306,5.1
72137,2020-02-01,27682,26249,1433,5.2
72139,2020-02-01,25673,24561,1112,4.3
72141,2020-02-01,6408,5619,789,12.3
72143,2020-02-01,9249,8524,725,7.8
72145,2020-02-01,12513,11443,1070,8.6
72147,2020-02-01,2481,2335,146,5.9
72149,2020-02-01,7332,6000,1332,18.2
72151,2020-02-01,8391,7331,1060,12.6
72153,2020-02-01,9745,8064,1681,17.2
01001,2020-03-01,25835,25114,721,2.8
01003,2020-03-01,96391,93782,2609,2.7
01005,2020-03-01,8537,8221,316,3.7
01007,2020-03-01,8617,8348,269,3.1
01009,2020-03-01,25103,24421,682,2.7
01011,2020-03-01,4610,4453,157,3.4
01013,2020-03-01,9030,8663,367,4.1
01015,2020-03-01,45630,44010,1620,3.6
01017,2020-03-01,15759,15284,475,3
01019,2020-03-01,11597,11263,334,2.9
01021,2020-03-01,19603,19083,520,2.7
01023,2020-03-01,4520,4295,225,5
01025,2020-03-01,7537,7090,447,5.9
01027,2020-03-01,6094,5915,179,2.9
01029,2020-03-01,5669,5479,190,3.4
01031,2020-03-01,21114,20505,609,2.9
01033,2020-03-01,23411,22562,849,3.6
01035,2020-03-01,4466,4294,172,3.9
01037,2020-03-01,4489,4350,139,3.1
01039,2020-03-01,15204,14685,519,3.4
01041,2020-03-01,6311,6120,191,3
01043,2020-03-01,38585,37585,1000,2.6
01045,2020-03-01,20443,19853,590,2.9
01047,2020-03-01,14496,13739,757,5.2
01049,2020-03-01,30906,30025,881,2.9
01051,2020-03-01,37109,36117,992,2.7
01053,2020-03-01,14553,14021,532,3.7
01055,2020-03-01,42791,41082,1709,4
01057,2020-03-01,6564,6373,191,2.9
01059,2020-03-01,14540,14133,407,2.8
01061,2020-03-01,10885,10573,312,2.9
01063,2020-03-01,2917,2758,159,5.5
01065,2020-03-01,6105,5845,260,4.3
01067,2020-03-01,6864,6628,236,3.4
01069,2020-03-01,45850,44491,1359,3
01071,2020-03-01,22904,22133,771,3.4
01073,2020-03-01,316460,307479,8981,2.8
01075,2020-03-01,5810,5634,176,3
01077,2020-03-01,42107,40810,1297,3.1
01079,2020-03-01,14150,13731,419,3
01081,2020-03-01,76676,74584,2092,2.7
01083,2020-03-01,43808,42674,1134,2.6
01085,2020-03-01,3509,3328,181,5.2
01087,2020-03-01,7904,7578,326,4.1
01089,2020-03-01,185227,180617,4610,2.5
01091,2020-03-01,7545,7259,286,3.8
01093,2020-03-01,13005,12564,441,3.4
01095,2020-03-01,44162,43071,1091,2.5
01097,2020-03-01,187625,180494,7131,3.8
01099,2020-03-01,7357,6991,366,5
01101,2020-03-01,104519,101200,3319,3.2
01103,2020-03-01,57806,56341,1465,2.5
01105,2020-03-01,3287,3122,165,5
01107,2020-03-01,7973,7648,325,4.1
01109,2020-03-01,15542,15052,490,3.2
01111,2020-03-01,9611,9330,281,2.9
01113,2020-03-01,23592,22905,687,2.9
01115,2020-03-01,40203,39141,1062,2.6
01117,2020-03-01,115142,112608,2534,2.2
01119,2020-03-01,4786,4590,196,4.1
01121,2020-03-01,35536,34317,1219,3.4
01123,2020-03-01,18551,17962,589,3.2
01125,2020-03-01,105365,102665,2700,2.6
01127,2020-03-01,25182,24327,855,3.4
01129,2020-03-01,6681,6377,304,4.6
01131,2020-03-01,2736,2499,237,8.7
01133,2020-03-01,10211,9874,337,3.3
02013,2020-03-01,2870,2805,65,2.3
02016,2020-03-01,4571,4478,93,2
02020,2020-03-01,144897,138052,6845,4.7
02050,2020-03-01,6863,6071,792,11.5
02060,2020-03-01,238,208,30,12.6
02068,2020-03-01,576,479,97,16.8
02070,2020-03-01,1801,1671,130,7.2
02090,2020-03-01,43731,41555,2176,5
02100,2020-03-01,925,791,134,14.5
02105,2020-03-01,967,825,142,14.7
02110,2020-03-01,16505,15836,669,4.1
02122,2020-03-01,24947,23154,1793,7.2
02130,2020-03-01,6226,5774,452,7.3
02150,2020-03-01,5983,5733,250,4.2
02158,2020-03-01,2680,2214,466,17.4
02164,2020-03-01,615,551,64,10.4
02170,2020-03-01,46363,43181,3182,6.9
02180,2020-03-01,4105,3713,392,9.5
02185,2020-03-01,3724,3562,162,4.4
02188,2020-03-01,2882,2534,348,12.1
02195,2020-03-01,1303,1179,124,9.5
02198,2020-03-01,2735,2473,262,9.6
02220,2020-03-01,4133,3961,172,4.2
02230,2020-03-01,589,489,100,17
02240,2020-03-01,2682,2461,221,8.2
02261,2020-03-01,4213,3809,404,9.6
02275,2020-03-01,935,866,69,7.4
02282,2020-03-01,213,190,23,10.8
02290,2020-03-01,2382,2086,296,12.4
04001,2020-03-01,21128,18198,2930,13.9
04003,2020-03-01,52093,48245,3848,7.4
04005,2020-03-01,77165,70937,6228,8.1
04007,2020-03-01,21547,19937,1610,7.5
04009,2020-03-01,15865,14825,1040,6.6
04011,2020-03-01,4578,4339,239,5.2
04012,2020-03-01,9978,9215,763,7.6
04013,2020-03-01,NA,NA,124733,5.3
04015,2020-03-01,88261,81466,6795,7.7
04017,2020-03-01,41510,37205,4305,10.4
04019,2020-03-01,500658,470843,29815,6
04021,2020-03-01,191117,178628,12489,6.5
04023,2020-03-01,20149,18038,2111,10.5
04025,2020-03-01,106535,100271,6264,5.9
04027,2020-03-01,103472,86192,17280,16.7
05001,2020-03-01,9608,9223,385,4
05003,2020-03-01,7644,6951,693,9.1
05005,2020-03-01,16509,15643,866,5.2
05007,2020-03-01,140012,135081,4931,3.5
05009,2020-03-01,16427,15700,727,4.4
05011,2020-03-01,4547,4304,243,5.3
05013,2020-03-01,2506,2351,155,6.2
05015,2020-03-01,12844,12284,560,4.4
05017,2020-03-01,3263,2924,339,10.4
05019,2020-03-01,9780,9326,454,4.6
05021,2020-03-01,5759,5342,417,7.2
05023,2020-03-01,9320,8685,635,6.8
05025,2020-03-01,3265,3062,203,6.2
05027,2020-03-01,9488,8938,550,5.8
05029,2020-03-01,8425,7943,482,5.7
05031,2020-03-01,57073,54886,2187,3.8
05033,2020-03-01,26947,25752,1195,4.4
05035,2020-03-01,21617,20465,1152,5.3
05037,2020-03-01,7524,7131,393,5.2
05039,2020-03-01,2834,2669,165,5.8
05041,2020-03-01,5427,5095,332,6.1
05043,2020-03-01,7960,7398,562,7.1
05045,2020-03-01,62110,59495,2615,4.2
05047,2020-03-01,7612,7244,368,4.8
05049,2020-03-01,5140,4881,259,5
05051,2020-03-01,42119,40049,2070,4.9
05053,2020-03-01,8389,7984,405,4.8
05055,2020-03-01,20503,19504,999,4.9
05057,2020-03-01,9993,9459,534,5.3
05059,2020-03-01,14185,13518,667,4.7
05061,2020-03-01,5711,5428,283,5
05063,2020-03-01,17125,16245,880,5.1
05065,2020-03-01,5027,4613,414,8.2
05067,2020-03-01,5854,5362,492,8.4
05069,2020-03-01,27917,25883,2034,7.3
05071,2020-03-01,10401,9836,565,5.4
05073,2020-03-01,2492,2332,160,6.4
05075,2020-03-01,7061,6683,378,5.4
05077,2020-03-01,2841,2625,216,7.6
05079,2020-03-01,3995,3743,252,6.3
05081,2020-03-01,5627,5292,335,6
05083,2020-03-01,8486,8003,483,5.7
05085,2020-03-01,34512,32776,1736,5
05087,2020-03-01,7592,7321,271,3.6
05089,2020-03-01,6748,6377,371,5.5
05091,2020-03-01,20133,19016,1117,5.5
05093,2020-03-01,17667,16375,1292,7.3
05095,2020-03-01,2807,2637,170,6.1
05097,2020-03-01,3010,2797,213,7.1
05099,2020-03-01,3671,3475,196,5.3
05101,2020-03-01,3429,3259,170,5
05103,2020-03-01,9998,9353,645,6.5
05105,2020-03-01,4260,4037,223,5.2
05107,2020-03-01,6404,5878,526,8.2
05109,2020-03-01,4318,4083,235,5.4
05111,2020-03-01,10585,10069,516,4.9
05113,2020-03-01,8327,7755,572,6.9
05115,2020-03-01,29388,27938,1450,4.9
05117,2020-03-01,3674,3449,225,6.1
05119,2020-03-01,189472,180437,9035,4.8
05121,2020-03-01,7607,7190,417,5.5
05123,2020-03-01,8310,7752,558,6.7
05125,2020-03-01,58736,56419,2317,3.9
05127,2020-03-01,4463,4267,196,4.4
05129,2020-03-01,2946,2747,199,6.8
05131,2020-03-01,56856,54255,2601,4.6
05133,2020-03-01,5718,5342,376,6.6
05135,2020-03-01,5914,5512,402,6.8
05137,2020-03-01,4746,4445,301,6.3
05139,2020-03-01,16029,14843,1186,7.4
05141,2020-03-01,5875,5480,395,6.7
05143,2020-03-01,127460,123300,4160,3.3
05145,2020-03-01,34629,32391,2238,6.5
05147,2020-03-01,2793,2604,189,6.8
05149,2020-03-01,8580,8170,410,4.8
06001,2020-03-01,835440,802729,32711,3.9
06003,2020-03-01,530,491,39,7.4
06005,2020-03-01,14790,13980,810,5.5
06007,2020-03-01,99081,92305,6776,6.8
06009,2020-03-01,21505,20323,1182,5.5
06011,2020-03-01,11471,8775,2696,23.5
06013,2020-03-01,555491,532826,22665,4.1
06015,2020-03-01,9483,8744,739,7.8
06017,2020-03-01,91743,87418,4325,4.7
06019,2020-03-01,457046,406881,50165,11
06021,2020-03-01,13156,11976,1180,9
06023,2020-03-01,61791,58706,3085,5
06025,2020-03-01,73121,57905,15216,20.8
06027,2020-03-01,8639,8215,424,4.9
06029,2020-03-01,391631,344173,47458,12.1
06031,2020-03-01,59193,51848,7345,12.4
06033,2020-03-01,29029,26924,2105,7.3
06035,2020-03-01,9311,8606,705,7.6
06037,2020-03-01,NA,NA,276380,5.6
06039,2020-03-01,63367,56618,6749,10.7
06041,2020-03-01,137710,133428,4282,3.1
06043,2020-03-01,7217,6648,569,7.9
06045,2020-03-01,38643,36342,2301,6
06047,2020-03-01,116614,101265,15349,13.2
06049,2020-03-01,3128,2763,365,11.7
06051,2020-03-01,8790,8358,432,4.9
06053,2020-03-01,219166,192418,26748,12.2
06055,2020-03-01,73265,70272,2993,4.1
06057,2020-03-01,47519,45253,2266,4.8
06059,2020-03-01,NA,NA,59017,3.7
06061,2020-03-01,187175,179515,7660,4.1
06063,2020-03-01,7504,6485,1019,13.6
06065,2020-03-01,NA,NA,59131,5.4
06067,2020-03-01,711060,676781,34279,4.8
06069,2020-03-01,31678,29163,2515,7.9
06071,2020-03-01,964069,915887,48182,5
06073,2020-03-01,NA,NA,66121,4.2
06075,2020-03-01,579275,561210,18065,3.1
06077,2020-03-01,328619,301050,27569,8.4
06079,2020-03-01,141756,136309,5447,3.8
06081,2020-03-01,455940,443115,12825,2.8
06083,2020-03-01,214100,201811,12289,5.7
06085,2020-03-01,NA,NA,35170,3.4
06087,2020-03-01,141468,130040,11428,8.1
06089,2020-03-01,73439,68383,5056,6.9
06091,2020-03-01,1302,1190,112,8.6
06093,2020-03-01,16615,14855,1760,10.6
06095,2020-03-01,209032,198441,10591,5.1
06097,2020-03-01,257131,247585,9546,3.7
06099,2020-03-01,245619,224930,20689,8.4
06101,2020-03-01,47419,42067,5352,11.3
06103,2020-03-01,25045,23059,1986,7.9
06105,2020-03-01,4501,4087,414,9.2
06107,2020-03-01,207334,176912,30422,14.7
06109,2020-03-01,20942,19588,1354,6.5
06111,2020-03-01,422108,402081,20027,4.7
06113,2020-03-01,108875,102368,6507,6
06115,2020-03-01,31192,28502,2690,8.6
08001,2020-03-01,274513,258575,15938,5.8
08003,2020-03-01,8292,7682,610,7.4
08005,2020-03-01,366875,347814,19061,5.2
08007,2020-03-01,6451,6006,445,6.9
08009,2020-03-01,1873,1795,78,4.2
08011,2020-03-01,1681,1581,100,5.9
08013,2020-03-01,195614,186944,8670,4.4
08014,2020-03-01,40273,38311,1962,4.9
08015,2020-03-01,9229,8778,451,4.9
08017,2020-03-01,1031,995,36,3.5
08019,2020-03-01,6067,5775,292,4.8
08021,2020-03-01,3926,3584,342,8.7
08023,2020-03-01,1768,1646,122,6.9
08025,2020-03-01,1457,1337,120,8.2
08027,2020-03-01,1932,1807,125,6.5
08029,2020-03-01,13571,12494,1077,7.9
08031,2020-03-01,419778,397597,22181,5.3
08033,2020-03-01,1056,978,78,7.4
08035,2020-03-01,194435,185731,8704,4.5
08037,2020-03-01,37336,35908,1428,3.8
08039,2020-03-01,14979,14289,690,4.6
08041,2020-03-01,344111,322757,21354,6.2
08043,2020-03-01,14611,13297,1314,9
08045,2020-03-01,32461,30504,1957,6
08047,2020-03-01,3771,3618,153,4.1
08049,2020-03-01,9823,9414,409,4.2
08051,2020-03-01,11441,10979,462,4
08053,2020-03-01,354,329,25,7.1
08055,2020-03-01,2394,2074,320,13.4
08057,2020-03-01,905,849,56,6.2
08059,2020-03-01,336565,320104,16461,4.9
08061,2020-03-01,841,816,25,3
08063,2020-03-01,3811,3666,145,3.8
08065,2020-03-01,5080,4894,186,3.7
08067,2020-03-01,30298,28595,1703,5.6
08069,2020-03-01,204452,194807,9645,4.7
08071,2020-03-01,6347,5863,484,7.6
08073,2020-03-01,2143,2023,120,5.6
08075,2020-03-01,10235,9756,479,4.7
08077,2020-03-01,76111,70786,5325,7
08079,2020-03-01,519,500,19,3.7
08081,2020-03-01,7173,6594,579,8.1
08083,2020-03-01,12364,11131,1233,10
08085,2020-03-01,20922,19344,1578,7.5
08087,2020-03-01,15269,14484,785,5.1
08089,2020-03-01,7966,7365,601,7.5
08091,2020-03-01,2251,2095,156,6.9
08093,2020-03-01,11157,10642,515,4.6
08095,2020-03-01,2197,2127,70,3.2
08097,2020-03-01,11069,10579,490,4.4
08099,2020-03-01,5872,5583,289,4.9
08101,2020-03-01,76817,70952,5865,7.6
08103,2020-03-01,2900,2686,214,7.4
08105,2020-03-01,5063,4579,484,9.6
08107,2020-03-01,16423,15758,665,4
08109,2020-03-01,3346,3043,303,9.1
08111,2020-03-01,520,487,33,6.3
08113,2020-03-01,6323,6100,223,3.5
08115,2020-03-01,1135,1088,47,4.1
08117,2020-03-01,24690,23952,738,3
08119,2020-03-01,12884,12141,743,5.8
08121,2020-03-01,2541,2438,103,4.1
08123,2020-03-01,167757,159140,8617,5.1
08125,2020-03-01,5077,4896,181,3.6
09001,2020-03-01,479809,462891,16918,3.5
09003,2020-03-01,487675,469994,17681,3.6
09005,2020-03-01,105491,101715,3776,3.6
09007,2020-03-01,94700,91716,2984,3.2
09009,2020-03-01,463598,446089,17509,3.8
09011,2020-03-01,136964,132017,4947,3.6
09013,2020-03-01,87945,85220,2725,3.1
09015,2020-03-01,64788,62280,2508,3.9
10001,2020-03-01,78164,73760,4404,5.6
10003,2020-03-01,295841,281765,14076,4.8
10005,2020-03-01,103150,97545,5605,5.4
11001,2020-03-01,420428,397484,22944,5.5
12001,2020-03-01,141879,136429,5450,3.8
12003,2020-03-01,11902,11409,493,4.1
12005,2020-03-01,83136,79467,3669,4.4
12007,2020-03-01,11275,10779,496,4.4
12009,2020-03-01,285109,272443,12666,4.4
12011,2020-03-01,NA,992514,43881,4.2
12013,2020-03-01,4843,4596,247,5.1
12015,2020-03-01,73987,70383,3604,4.9
12017,2020-03-01,47894,44706,3188,6.7
12019,2020-03-01,108226,103708,4518,4.2
12021,2020-03-01,185559,178151,7408,4
12023,2020-03-01,30183,28858,1325,4.4
12027,2020-03-01,15184,14479,705,4.6
12029,2020-03-01,5953,5642,311,5.2
12031,2020-03-01,495193,472798,22395,4.5
12033,2020-03-01,147562,140877,6685,4.5
12035,2020-03-01,47382,44931,2451,5.2
12037,2020-03-01,4585,4396,189,4.1
12039,2020-03-01,19157,18086,1071,5.6
12041,2020-03-01,7276,6945,331,4.5
12043,2020-03-01,5614,5333,281,5
12045,2020-03-01,5685,5391,294,5.2
12047,2020-03-01,4283,4026,257,6
12049,2020-03-01,8982,8456,526,5.9
12051,2020-03-01,16441,15338,1103,6.7
12053,2020-03-01,72838,68584,4254,5.8
12055,2020-03-01,36776,34522,2254,6.1
12057,2020-03-01,756495,724801,31694,4.2
12059,2020-03-01,7105,6759,346,4.9
12061,2020-03-01,66369,62962,3407,5.1
12063,2020-03-01,17326,16499,827,4.8
12065,2020-03-01,5643,5389,254,4.5
12067,2020-03-01,2870,2750,120,4.2
12069,2020-03-01,159144,151913,7231,4.5
12071,2020-03-01,350463,335311,15152,4.3
12073,2020-03-01,155857,149493,6364,4.1
12075,2020-03-01,16933,16106,827,4.9
12077,2020-03-01,2645,2518,127,4.8
12079,2020-03-01,7499,7138,361,4.8
12081,2020-03-01,182283,174524,7759,4.3
12083,2020-03-01,138960,131682,7278,5.2
12085,2020-03-01,75312,72151,3161,4.2
12086,2020-03-01,NA,NA,29164,2.2
12087,2020-03-01,48214,46881,1333,2.8
12089,2020-03-01,41434,39733,1701,4.1
12091,2020-03-01,97635,94036,3599,3.7
12093,2020-03-01,18274,17504,770,4.2
12095,2020-03-01,761283,730180,31103,4.1
12097,2020-03-01,184155,175674,8481,4.6
12099,2020-03-01,733058,700784,32274,4.4
12101,2020-03-01,240209,228629,11580,4.8
12103,2020-03-01,497772,477195,20577,4.1
12105,2020-03-01,308409,293192,15217,4.9
12107,2020-03-01,26883,25259,1624,6
12109,2020-03-01,133173,128229,4944,3.7
12111,2020-03-01,147809,139878,7931,5.4
12113,2020-03-01,83466,80116,3350,4
12115,2020-03-01,191497,183377,8120,4.2
12117,2020-03-01,255068,244619,10449,4.1
12119,2020-03-01,33413,31303,2110,6.3
12121,2020-03-01,18010,17166,844,4.7
12123,2020-03-01,8262,7876,386,4.7
12125,2020-03-01,4661,4479,182,3.9
12127,2020-03-01,256287,243763,12524,4.9
12129,2020-03-01,14968,14380,588,3.9
12131,2020-03-01,31866,30643,1223,3.8
12133,2020-03-01,9692,9246,446,4.6
13001,2020-03-01,9805,9359,446,4.5
13003,2020-03-01,4511,4324,187,4.1
13005,2020-03-01,5016,4766,250,5
13007,2020-03-01,1200,1138,62,5.2
13009,2020-03-01,17914,16905,1009,5.6
13011,2020-03-01,9946,9566,380,3.8
13013,2020-03-01,40754,39256,1498,3.7
13015,2020-03-01,51088,48912,2176,4.3
13017,2020-03-01,5457,5063,394,7.2
13019,2020-03-01,7618,7200,418,5.5
13021,2020-03-01,68109,64833,3276,4.8
13023,2020-03-01,4573,4289,284,6.2
13025,2020-03-01,7192,6853,339,4.7
13027,2020-03-01,7030,6685,345,4.9
13029,2020-03-01,18342,17589,753,4.1
13031,2020-03-01,37219,35257,1962,5.3
13033,2020-03-01,9278,8755,523,5.6
13035,2020-03-01,10878,10387,491,4.5
13037,2020-03-01,2403,2287,116,4.8
13039,2020-03-01,21059,20138,921,4.4
13043,2020-03-01,5707,5498,209,3.7
13045,2020-03-01,55870,53298,2572,4.6
13047,2020-03-01,33959,32751,1208,3.6
13049,2020-03-01,4936,4725,211,4.3
13051,2020-03-01,140403,133907,6496,4.6
13053,2020-03-01,2020,1900,120,5.9
13055,2020-03-01,10178,9603,575,5.6
13057,2020-03-01,136789,131930,4859,3.6
13059,2020-03-01,58994,56209,2785,4.7
13061,2020-03-01,924,856,68,7.4
13063,2020-03-01,140670,132018,8652,6.2
13065,2020-03-01,2647,2515,132,5
13067,2020-03-01,429199,412109,17090,4
13069,2020-03-01,19514,18484,1030,5.3
13071,2020-03-01,21885,20941,944,4.3
13073,2020-03-01,75779,72964,2815,3.7
13075,2020-03-01,8244,7914,330,4
13077,2020-03-01,75371,72408,2963,3.9
13079,2020-03-01,5623,5389,234,4.2
13081,2020-03-01,9659,9198,461,4.8
13083,2020-03-01,8268,7950,318,3.8
13085,2020-03-01,12391,11948,443,3.6
13087,2020-03-01,11802,11279,523,4.4
13089,2020-03-01,404856,385386,19470,4.8
13091,2020-03-01,7046,6589,457,6.5
13093,2020-03-01,5126,4894,232,4.5
13095,2020-03-01,38894,36572,2322,6
13097,2020-03-01,74107,70573,3534,4.8
13099,2020-03-01,4537,4310,227,5
13101,2020-03-01,1956,1883,73,3.7
13103,2020-03-01,30956,29778,1178,3.8
13105,2020-03-01,7921,7482,439,5.5
13107,2020-03-01,8418,7882,536,6.4
13109,2020-03-01,5049,4817,232,4.6
13111,2020-03-01,12461,11963,498,4
13113,2020-03-01,58605,56242,2363,4
13115,2020-03-01,44435,42457,1978,4.5
13117,2020-03-01,123004,118677,4327,3.5
13119,2020-03-01,10238,9719,519,5.1
13121,2020-03-01,565140,537282,27858,4.9
13123,2020-03-01,11735,11217,518,4.4
13125,2020-03-01,1291,1229,62,4.8
13127,2020-03-01,38975,37342,1633,4.2
13129,2020-03-01,28602,27476,1126,3.9
13131,2020-03-01,10549,10122,427,4
13133,2020-03-01,7207,6850,357,5
13135,2020-03-01,493978,474164,19814,4
13137,2020-03-01,18909,18013,896,4.7
13139,2020-03-01,102986,99428,3558,3.5
13141,2020-03-01,2553,2369,184,7.2
13143,2020-03-01,12680,12119,561,4.4
13145,2020-03-01,16652,16018,634,3.8
13147,2020-03-01,11247,10665,582,5.2
13149,2020-03-01,5323,5078,245,4.6
13151,2020-03-01,117048,111511,5537,4.7
13153,2020-03-01,70926,68031,2895,4.1
13155,2020-03-01,3461,3259,202,5.8
13157,2020-03-01,37235,35916,1319,3.5
13159,2020-03-01,7012,6730,282,4
13161,2020-03-01,6143,5800,343,5.6
13163,2020-03-01,6718,6320,398,5.9
13165,2020-03-01,3200,2998,202,6.3
13167,2020-03-01,4051,3862,189,4.7
13169,2020-03-01,13738,13195,543,4
13171,2020-03-01,8337,7896,441,5.3
13173,2020-03-01,3751,3572,179,4.8
13175,2020-03-01,19292,18080,1212,6.3
13177,2020-03-01,14870,14295,575,3.9
13179,2020-03-01,26606,25337,1269,4.8
13181,2020-03-01,3627,3447,180,5
13183,2020-03-01,8296,7928,368,4.4
13185,2020-03-01,51286,48981,2305,4.5
13187,2020-03-01,16856,16190,666,4
13189,2020-03-01,8990,8431,559,6.2
13191,2020-03-01,6153,5885,268,4.4
13193,2020-03-01,4806,4529,277,5.8
13195,2020-03-01,13219,12687,532,4
13197,2020-03-01,3322,3140,182,5.5
13199,2020-03-01,8999,8512,487,5.4
13201,2020-03-01,2844,2723,121,4.3
13205,2020-03-01,8737,8232,505,5.8
13207,2020-03-01,13051,12499,552,4.2
13209,2020-03-01,3913,3706,207,5.3
13211,2020-03-01,9334,8961,373,4
13213,2020-03-01,15418,14540,878,5.7
13215,2020-03-01,77482,73309,4173,5.4
13217,2020-03-01,52914,50199,2715,5.1
13219,2020-03-01,19369,18732,637,3.3
13221,2020-03-01,6911,6647,264,3.8
13223,2020-03-01,86815,83423,3392,3.9
13225,2020-03-01,11937,11375,562,4.7
13227,2020-03-01,15437,14809,628,4.1
13229,2020-03-01,8677,8332,345,4
13231,2020-03-01,8993,8625,368,4.1
13233,2020-03-01,18564,17682,882,4.8
13235,2020-03-01,4096,3909,187,4.6
13237,2020-03-01,8193,7740,453,5.5
13239,2020-03-01,818,770,48,5.9
13241,2020-03-01,7032,6693,339,4.8
13243,2020-03-01,2659,2514,145,5.5
13245,2020-03-01,86091,81482,4609,5.4
13247,2020-03-01,45319,43029,2290,5.1
13249,2020-03-01,2279,2183,96,4.2
13251,2020-03-01,5125,4813,312,6.1
13253,2020-03-01,3166,3000,166,5.2
13255,2020-03-01,29063,27528,1535,5.3
13257,2020-03-01,10867,10346,521,4.8
13259,2020-03-01,2648,2527,121,4.6
13261,2020-03-01,13293,12508,785,5.9
13263,2020-03-01,2797,2660,137,4.9
13265,2020-03-01,587,548,39,6.6
13267,2020-03-01,9736,9234,502,5.2
13269,2020-03-01,2910,2778,132,4.5
13271,2020-03-01,3947,3499,448,11.4
13273,2020-03-01,3530,3344,186,5.3
13275,2020-03-01,16797,15976,821,4.9
13277,2020-03-01,20259,19399,860,4.2
13279,2020-03-01,12058,11360,698,5.8
13281,2020-03-01,3765,3522,243,6.5
13283,2020-03-01,2681,2519,162,6
13285,2020-03-01,37860,36364,1496,4
13287,2020-03-01,3251,3069,182,5.6
13289,2020-03-01,2915,2715,200,6.9
13291,2020-03-01,10423,10007,416,4
13293,2020-03-01,11458,10947,511,4.5
13295,2020-03-01,31745,30488,1257,4
13297,2020-03-01,46497,44610,1887,4.1
13299,2020-03-01,15604,14858,746,4.8
13301,2020-03-01,2888,2743,145,5
13303,2020-03-01,6929,6561,368,5.3
13305,2020-03-01,11502,10856,646,5.6
13307,2020-03-01,1060,998,62,5.8
13309,2020-03-01,1694,1546,148,8.7
13311,2020-03-01,16699,16122,577,3.5
13313,2020-03-01,43194,41052,2142,5
13315,2020-03-01,2758,2597,161,5.8
13317,2020-03-01,3972,3726,246,6.2
13319,2020-03-01,4040,3856,184,4.6
13321,2020-03-01,9087,8607,480,5.3
15001,2020-03-01,91563,88915,2648,2.9
15003,2020-03-01,453211,443533,9678,2.1
15007,2020-03-01,36504,35649,855,2.3
15009,2020-03-01,86267,84398,1869,2.2
16001,2020-03-01,258487,252439,6048,2.3
16003,2020-03-01,1695,1540,155,9.1
16005,2020-03-01,43505,42246,1259,2.9
16007,2020-03-01,2976,2876,100,3.4
16009,2020-03-01,4129,3808,321,7.8
16011,2020-03-01,23739,23083,656,2.8
16013,2020-03-01,12649,12244,405,3.2
16015,2020-03-01,3630,3436,194,5.3
16017,2020-03-01,20510,19397,1113,5.4
16019,2020-03-01,58307,56820,1487,2.6
16021,2020-03-01,5338,5020,318,6
16023,2020-03-01,1388,1359,29,2.1
16025,2020-03-01,694,673,21,3
16027,2020-03-01,105693,102476,3217,3
16029,2020-03-01,4088,3963,125,3.1
16031,2020-03-01,12012,11726,286,2.4
16033,2020-03-01,359,341,18,5
16035,2020-03-01,2911,2631,280,9.6
16037,2020-03-01,1988,1896,92,4.6
16039,2020-03-01,11803,11410,393,3.3
16041,2020-03-01,7088,6918,170,2.4
16043,2020-03-01,7961,7731,230,2.9
16045,2020-03-01,8408,8118,290,3.4
16047,2020-03-01,8213,7993,220,2.7
16049,2020-03-01,6631,6273,358,5.4
16051,2020-03-01,14153,13811,342,2.4
16053,2020-03-01,12068,11734,334,2.8
16055,2020-03-01,80041,76787,3254,4.1
16057,2020-03-01,20864,20279,585,2.8
16059,2020-03-01,3494,3272,222,6.4
16061,2020-03-01,1637,1530,107,6.5
16063,2020-03-01,2695,2578,117,4.3
16065,2020-03-01,22406,22006,400,1.8
16067,2020-03-01,11327,11032,295,2.6
16069,2020-03-01,20923,20279,644,3.1
16071,2020-03-01,2370,2295,75,3.2
16073,2020-03-01,5514,5317,197,3.6
16075,2020-03-01,11839,11443,396,3.3
16077,2020-03-01,3926,3809,117,3
16079,2020-03-01,5185,4824,361,7
16081,2020-03-01,6150,6014,136,2.2
16083,2020-03-01,40884,39666,1218,3
16085,2020-03-01,5553,5305,248,4.5
16087,2020-03-01,4670,4475,195,4.2
17001,2020-03-01,29968,29227,741,2.5
17003,2020-03-01,1920,1825,95,4.9
17005,2020-03-01,7185,6989,196,2.7
17007,2020-03-01,23910,22770,1140,4.8
17009,2020-03-01,2820,2770,50,1.8
17011,2020-03-01,15905,15282,623,3.9
17013,2020-03-01,2152,2079,73,3.4
17015,2020-03-01,6770,6535,235,3.5
17017,2020-03-01,5625,5447,178,3.2
17019,2020-03-01,104582,102067,2515,2.4
17021,2020-03-01,13265,12758,507,3.8
17023,2020-03-01,7130,6872,258,3.6
17025,2020-03-01,5892,5669,223,3.8
17027,2020-03-01,19034,18607,427,2.2
17029,2020-03-01,22614,22015,599,2.6
17031,2020-03-01,NA,NA,126715,4.8
17033,2020-03-01,8084,7822,262,3.2
17035,2020-03-01,5760,5614,146,2.5
17037,2020-03-01,51532,49881,1651,3.2
17039,2020-03-01,6862,6653,209,3
17041,2020-03-01,9588,9361,227,2.4
17043,2020-03-01,510213,491122,19091,3.7
17045,2020-03-01,7955,7717,238,3
17047,2020-03-01,2520,2427,93,3.7
17049,2020-03-01,18207,17779,428,2.4
17051,2020-03-01,9144,8836,308,3.4
17053,2020-03-01,6070,5884,186,3.1
17055,2020-03-01,15325,14702,623,4.1
17057,2020-03-01,14040,13366,674,4.8
17059,2020-03-01,2185,2096,89,4.1
17061,2020-03-01,5612,5443,169,3
17063,2020-03-01,25646,24119,1527,6
17065,2020-03-01,4120,4000,120,2.9
17067,2020-03-01,7695,7395,300,3.9
17069,2020-03-01,1227,1166,61,5
17071,2020-03-01,3372,3239,133,3.9
17073,2020-03-01,23075,22197,878,3.8
17075,2020-03-01,13272,12816,456,3.4
17077,2020-03-01,26348,25665,683,2.6
17079,2020-03-01,4514,4377,137,3
17081,2020-03-01,16270,15765,505,3.1
17083,2020-03-01,10256,9942,314,3.1
17085,2020-03-01,9780,9380,400,4.1
17087,2020-03-01,4011,3833,178,4.4
17089,2020-03-01,256167,246640,9527,3.7
17091,2020-03-01,52708,50603,2105,4
17093,2020-03-01,68854,65736,3118,4.5
17095,2020-03-01,19874,19083,791,4
17097,2020-03-01,347558,335435,12123,3.5
17099,2020-03-01,50927,48722,2205,4.3
17101,2020-03-01,5483,5285,198,3.6
17103,2020-03-01,16423,15952,471,2.9
17105,2020-03-01,15152,14662,490,3.2
17107,2020-03-01,11707,11343,364,3.1
17109,2020-03-01,12416,11932,484,3.9
17111,2020-03-01,166916,159254,7662,4.6
17113,2020-03-01,81858,79735,2123,2.6
17115,2020-03-01,44958,43083,1875,4.2
17117,2020-03-01,21410,20729,681,3.2
17119,2020-03-01,125727,122309,3418,2.7
17121,2020-03-01,16234,15713,521,3.2
17123,2020-03-01,4819,4617,202,4.2
17125,2020-03-01,5808,5566,242,4.2
17127,2020-03-01,5322,5113,209,3.9
17129,2020-03-01,6045,5866,179,3
17131,2020-03-01,7472,7136,336,4.5
17133,2020-03-01,17591,17223,368,2.1
17135,2020-03-01,10890,10419,471,4.3
17137,2020-03-01,15310,14831,479,3.1
17139,2020-03-01,7100,6942,158,2.2
17141,2020-03-01,22871,22007,864,3.8
17143,2020-03-01,77054,73895,3159,4.1
17145,2020-03-01,7783,7519,264,3.4
17147,2020-03-01,8173,7984,189,2.3
17149,2020-03-01,6426,6198,228,3.5
17151,2020-03-01,1594,1529,65,4.1
17153,2020-03-01,1822,1715,107,5.9
17155,2020-03-01,2946,2819,127,4.3
17157,2020-03-01,13350,13019,331,2.5
17159,2020-03-01,6764,6561,203,3
17161,2020-03-01,66355,63842,2513,3.8
17163,2020-03-01,118499,114893,3606,3
17165,2020-03-01,9081,8687,394,4.3
17167,2020-03-01,94239,91497,2742,2.9
17169,2020-03-01,2960,2857,103,3.5
17171,2020-03-01,2354,2261,93,4
17173,2020-03-01,9822,9546,276,2.8
17175,2020-03-01,2246,2147,99,4.4
17177,2020-03-01,20134,19441,693,3.4
17179,2020-03-01,57796,55731,2065,3.6
17181,2020-03-01,7058,6723,335,4.7
17183,2020-03-01,30564,29465,1099,3.6
17185,2020-03-01,5654,5496,158,2.8
17187,2020-03-01,7815,7574,241,3.1
17189,2020-03-01,9297,9138,159,1.7
17191,2020-03-01,6526,6301,225,3.4
17193,2020-03-01,6136,5955,181,2.9
17195,2020-03-01,26427,25587,840,3.2
17197,2020-03-01,359755,340890,18865,5.2
17199,2020-03-01,30290,29282,1008,3.3
17201,2020-03-01,126954,121480,5474,4.3
17203,2020-03-01,16962,16473,489,2.9
18001,2020-03-01,16288,15858,430,2.6
18003,2020-03-01,180077,174567,5510,3.1
18005,2020-03-01,43594,42562,1032,2.4
18007,2020-03-01,4417,4297,120,2.7
18009,2020-03-01,4696,4500,196,4.2
18011,2020-03-01,35084,34271,813,2.3
18013,2020-03-01,7466,7234,232,3.1
18015,2020-03-01,10120,9799,321,3.2
18017,2020-03-01,17007,16368,639,3.8
18019,2020-03-01,59999,58167,1832,3.1
18021,2020-03-01,11649,11227,422,3.6
18023,2020-03-01,16682,16263,419,2.5
18025,2020-03-01,4704,4494,210,4.5
18027,2020-03-01,16234,15818,416,2.6
18029,2020-03-01,24773,23885,888,3.6
18031,2020-03-01,14691,14278,413,2.8
18033,2020-03-01,21909,21299,610,2.8
18035,2020-03-01,52957,50960,1997,3.8
18037,2020-03-01,22288,21787,501,2.2
18039,2020-03-01,108468,105585,2883,2.7
18041,2020-03-01,8216,7841,375,4.6
18043,2020-03-01,40508,39316,1192,2.9
18045,2020-03-01,7588,7335,253,3.3
18047,2020-03-01,10886,10498,388,3.6
18049,2020-03-01,9141,8805,336,3.7
18051,2020-03-01,19350,18870,480,2.5
18053,2020-03-01,31282,30177,1105,3.5
18055,2020-03-01,13161,12602,559,4.2
18057,2020-03-01,178797,174723,4074,2.3
18059,2020-03-01,39091,38023,1068,2.7
18061,2020-03-01,19736,19119,617,3.1
18063,2020-03-01,87649,85487,2162,2.5
18065,2020-03-01,21442,20755,687,3.2
18067,2020-03-01,35710,34323,1387,3.9
18069,2020-03-01,17579,17018,561,3.2
18071,2020-03-01,22092,21548,544,2.5
18073,2020-03-01,15696,15014,682,4.3
18075,2020-03-01,8855,8577,278,3.1
18077,2020-03-01,14636,14160,476,3.3
18079,2020-03-01,13213,12768,445,3.4
18081,2020-03-01,80675,78623,2052,2.5
18083,2020-03-01,17720,17204,516,2.9
18085,2020-03-01,40980,39874,1106,2.7
18087,2020-03-01,18714,18265,449,2.4
18089,2020-03-01,224502,213299,11203,5
18091,2020-03-01,46104,44110,1994,4.3
18093,2020-03-01,20641,19932,709,3.4
18095,2020-03-01,57621,55395,2226,3.9
18097,2020-03-01,478180,463519,14661,3.1
18099,2020-03-01,22122,21459,663,3
18101,2020-03-01,5194,5063,131,2.5
18103,2020-03-01,14675,14071,604,4.1
18105,2020-03-01,68913,66784,2129,3.1
18107,2020-03-01,18176,17656,520,2.9
18109,2020-03-01,35247,34214,1033,2.9
18111,2020-03-01,6666,6358,308,4.6
18113,2020-03-01,22418,21736,682,3
18115,2020-03-01,3063,2960,103,3.4
18117,2020-03-01,8497,8204,293,3.4
18119,2020-03-01,9127,8781,346,3.8
18121,2020-03-01,6535,6305,230,3.5
18123,2020-03-01,8787,8522,265,3
18125,2020-03-01,5898,5700,198,3.4
18127,2020-03-01,84555,81253,3302,3.9
18129,2020-03-01,13042,12705,337,2.6
18131,2020-03-01,6103,5890,213,3.5
18133,2020-03-01,16214,15683,531,3.3
18135,2020-03-01,10693,10278,415,3.9
18137,2020-03-01,13866,13416,450,3.2
18139,2020-03-01,8457,8225,232,2.7
18141,2020-03-01,132105,127395,4710,3.6
18143,2020-03-01,10257,9924,333,3.2
18145,2020-03-01,22531,21828,703,3.1
18147,2020-03-01,10122,9802,320,3.2
18149,2020-03-01,9390,8951,439,4.7
18151,2020-03-01,20016,19533,483,2.4
18153,2020-03-01,8056,7714,342,4.2
18155,2020-03-01,4703,4544,159,3.4
18157,2020-03-01,100229,97473,2756,2.7
18159,2020-03-01,8823,8588,235,2.7
18161,2020-03-01,3374,3270,104,3.1
18163,2020-03-01,91647,88984,2663,2.9
18165,2020-03-01,6694,6367,327,4.9
18167,2020-03-01,46683,44880,1803,3.9
18169,2020-03-01,14486,14046,440,3
18171,2020-03-01,3997,3877,120,3
18173,2020-03-01,31944,31101,843,2.6
18175,2020-03-01,13111,12655,456,3.5
18177,2020-03-01,30076,29025,1051,3.5
18179,2020-03-01,13835,13447,388,2.8
18181,2020-03-01,13114,12763,351,2.7
18183,2020-03-01,17145,16665,480,2.8
19001,2020-03-01,4213,4074,139,3.3
19003,2020-03-01,2148,2097,51,2.4
19005,2020-03-01,7530,7097,433,5.8
19007,2020-03-01,5978,5723,255,4.3
19009,2020-03-01,3076,2980,96,3.1
19011,2020-03-01,13496,13001,495,3.7
19013,2020-03-01,68936,66048,2888,4.2
19015,2020-03-01,14899,14470,429,2.9
19017,2020-03-01,13833,13393,440,3.2
19019,2020-03-01,11201,10756,445,4
19021,2020-03-01,12059,11730,329,2.7
19023,2020-03-01,7949,7582,367,4.6
19025,2020-03-01,4222,4091,131,3.1
19027,2020-03-01,10821,10565,256,2.4
19029,2020-03-01,6888,6636,252,3.7
19031,2020-03-01,10897,10508,389,3.6
19033,2020-03-01,23471,22646,825,3.5
19035,2020-03-01,6189,5975,214,3.5
19037,2020-03-01,6577,6288,289,4.4
19039,2020-03-01,4910,4710,200,4.1
19041,2020-03-01,8491,8174,317,3.7
19043,2020-03-01,10129,9469,660,6.5
19045,2020-03-01,22735,21703,1032,4.5
19047,2020-03-01,8291,7832,459,5.5
19049,2020-03-01,49504,48315,1189,2.4
19051,2020-03-01,4273,4135,138,3.2
19053,2020-03-01,4464,4334,130,2.9
19055,2020-03-01,10640,10271,369,3.5
19057,2020-03-01,19185,18083,1102,5.7
19059,2020-03-01,9695,9254,441,4.5
19061,2020-03-01,55959,53808,2151,3.8
19063,2020-03-01,5262,5073,189,3.6
19065,2020-03-01,10915,10349,566,5.2
19067,2020-03-01,8711,8197,514,5.9
19069,2020-03-01,5684,5479,205,3.6
19071,2020-03-01,3663,3572,91,2.5
19073,2020-03-01,5448,5313,135,2.5
19075,2020-03-01,6518,6275,243,3.7
19077,2020-03-01,5661,5427,234,4.1
19079,2020-03-01,6912,6645,267,3.9
19081,2020-03-01,5923,5727,196,3.3
19083,2020-03-01,7998,7704,294,3.7
19085,2020-03-01,7458,7221,237,3.2
19087,2020-03-01,9914,9558,356,3.6
19089,2020-03-01,5261,5034,227,4.3
19091,2020-03-01,5121,4923,198,3.9
19093,2020-03-01,4199,4064,135,3.2
19095,2020-03-01,10518,10167,351,3.3
19097,2020-03-01,11017,10488,529,4.8
19099,2020-03-01,19867,19134,733,3.7
19101,2020-03-01,10388,10093,295,2.8
19103,2020-03-01,85525,83414,2111,2.5
19105,2020-03-01,10838,10276,562,5.2
19107,2020-03-01,5294,5053,241,4.6
19109,2020-03-01,8415,8148,267,3.2
19111,2020-03-01,16148,15390,758,4.7
19113,2020-03-01,122148,117479,4669,3.8
19115,2020-03-01,6144,5886,258,4.2
19117,2020-03-01,4693,4550,143,3
19119,2020-03-01,7033,6848,185,2.6
19121,2020-03-01,8611,8229,382,4.4
19123,2020-03-01,11923,11529,394,3.3
19125,2020-03-01,18524,18011,513,2.8
19127,2020-03-01,18237,16853,1384,7.6
19129,2020-03-01,7453,7255,198,2.7
19131,2020-03-01,7125,6962,163,2.3
19133,2020-03-01,4477,4291,186,4.2
19135,2020-03-01,4084,3930,154,3.8
19137,2020-03-01,5020,4859,161,3.2
19139,2020-03-01,22014,21224,790,3.6
19141,2020-03-01,8322,8089,233,2.8
19143,2020-03-01,3505,3417,88,2.5
19145,2020-03-01,6423,6216,207,3.2
19147,2020-03-01,4796,4625,171,3.6
19149,2020-03-01,14787,14411,376,2.5
19151,2020-03-01,4506,4396,110,2.4
19153,2020-03-01,269581,260093,9488,3.5
19155,2020-03-01,49092,47575,1517,3.1
19157,2020-03-01,10774,10372,402,3.7
19159,2020-03-01,2452,2372,80,3.3
19161,2020-03-01,5269,5108,161,3.1
19163,2020-03-01,88548,84910,3638,4.1
19165,2020-03-01,6699,6505,194,2.9
19167,2020-03-01,21440,20816,624,2.9
19169,2020-03-01,59076,57851,1225,2.1
19171,2020-03-01,9573,9100,473,4.9
19173,2020-03-01,3202,3128,74,2.3
19175,2020-03-01,6373,6106,267,4.2
19177,2020-03-01,3625,3495,130,3.6
19179,2020-03-01,17950,17200,750,4.2
19181,2020-03-01,28382,27449,933,3.3
19183,2020-03-01,11995,11587,408,3.4
19185,2020-03-01,2847,2764,83,2.9
19187,2020-03-01,19530,18789,741,3.8
19189,2020-03-01,5217,5036,181,3.5
19191,2020-03-01,12547,11990,557,4.4
19193,2020-03-01,55799,53835,1964,3.5
19195,2020-03-01,4258,4091,167,3.9
19197,2020-03-01,7145,6904,241,3.4
20001,2020-03-01,6677,6475,202,3
20003,2020-03-01,4291,4169,122,2.8
20005,2020-03-01,7173,6844,329,4.6
20007,2020-03-01,2355,2303,52,2.2
20009,2020-03-01,14164,13757,407,2.9
20011,2020-03-01,6766,6523,243,3.6
20013,2020-03-01,5487,5341,146,2.7
20015,2020-03-01,32811,31839,972,3
20017,2020-03-01,1637,1592,45,2.7
20019,2020-03-01,1491,1445,46,3.1
20021,2020-03-01,10257,9969,288,2.8
20023,2020-03-01,1301,1271,30,2.3
20025,2020-03-01,1080,1056,24,2.2
20027,2020-03-01,3819,3719,100,2.6
20029,2020-03-01,3876,3777,99,2.6
20031,2020-03-01,4084,3931,153,3.7
20033,2020-03-01,876,855,21,2.4
20035,2020-03-01,16732,16212,520,3.1
20037,2020-03-01,19446,18813,633,3.3
20039,2020-03-01,1235,1202,33,2.7
20041,2020-03-01,9089,8723,366,4
20043,2020-03-01,4088,3958,130,3.2
20045,2020-03-01,66172,64399,1773,2.7
20047,2020-03-01,1307,1277,30,2.3
20049,2020-03-01,1189,1157,32,2.7
20051,2020-03-01,17395,17080,315,1.8
20053,2020-03-01,2736,2671,65,2.4
20055,2020-03-01,21106,20710,396,1.9
20057,2020-03-01,17416,17050,366,2.1
20059,2020-03-01,14497,14068,429,3
20061,2020-03-01,11649,11151,498,4.3
20063,2020-03-01,1515,1485,30,2
20065,2020-03-01,1117,1090,27,2.4
20067,2020-03-01,3138,3063,75,2.4
20069,2020-03-01,3281,3217,64,2
20071,2020-03-01,822,809,13,1.6
20073,2020-03-01,3304,3197,107,3.2
20075,2020-03-01,1608,1581,27,1.7
20077,2020-03-01,3006,2933,73,2.4
20079,2020-03-01,17158,16694,464,2.7
20081,2020-03-01,2235,2195,40,1.8
20083,2020-03-01,1012,987,25,2.5
20085,2020-03-01,7207,6994,213,3
20087,2020-03-01,10127,9831,296,2.9
20089,2020-03-01,1272,1242,30,2.4
20091,2020-03-01,338736,330309,8427,2.5
20093,2020-03-01,2056,2023,33,1.6
20095,2020-03-01,3434,3342,92,2.7
20097,2020-03-01,1273,1246,27,2.1
20099,2020-03-01,10221,9843,378,3.7
20101,2020-03-01,753,732,21,2.8
20103,2020-03-01,36538,35310,1228,3.4
20105,2020-03-01,1722,1687,35,2
20107,2020-03-01,4441,4175,266,6
20109,2020-03-01,1694,1667,27,1.6
20111,2020-03-01,17521,17023,498,2.8
20113,2020-03-01,17611,17252,359,2
20115,2020-03-01,6135,5982,153,2.5
20117,2020-03-01,5562,5433,129,2.3
20119,2020-03-01,2163,2120,43,2
20121,2020-03-01,17499,16936,563,3.2
20123,2020-03-01,3409,3344,65,1.9
20125,2020-03-01,14912,14319,593,4
20127,2020-03-01,3047,2960,87,2.9
20129,2020-03-01,1123,1096,27,2.4
20131,2020-03-01,5294,5167,127,2.4
20133,2020-03-01,6190,5947,243,3.9
20135,2020-03-01,1351,1316,35,2.6
20137,2020-03-01,2684,2632,52,1.9
20139,2020-03-01,7981,7719,262,3.3
20141,2020-03-01,2032,1986,46,2.3
20143,2020-03-01,3086,3010,76,2.5
20145,2020-03-01,2826,2737,89,3.1
20147,2020-03-01,2675,2615,60,2.2
20149,2020-03-01,12452,12132,320,2.6
20151,2020-03-01,5046,4933,113,2.2
20153,2020-03-01,1517,1488,29,1.9
20155,2020-03-01,30738,29890,848,2.8
20157,2020-03-01,2268,2216,52,2.3
20159,2020-03-01,5449,5322,127,2.3
20161,2020-03-01,35146,34317,829,2.4
20163,2020-03-01,2528,2458,70,2.8
20165,2020-03-01,1633,1582,51,3.1
20167,2020-03-01,3294,3213,81,2.5
20169,2020-03-01,31028,30126,902,2.9
20171,2020-03-01,2829,2783,46,1.6
20173,2020-03-01,254263,245749,8514,3.3
20175,2020-03-01,9579,9334,245,2.6
20177,2020-03-01,90711,87960,2751,3
20179,2020-03-01,1428,1404,24,1.7
20181,2020-03-01,2851,2779,72,2.5
20183,2020-03-01,2031,1982,49,2.4
20185,2020-03-01,2027,1970,57,2.8
20187,2020-03-01,983,959,24,2.4
20189,2020-03-01,2806,2741,65,2.3
20191,2020-03-01,11007,10649,358,3.3
20193,2020-03-01,4320,4234,86,2
20195,2020-03-01,1388,1343,45,3.2
20197,2020-03-01,3647,3534,113,3.1
20199,2020-03-01,984,968,16,1.6
20201,2020-03-01,3006,2949,57,1.9
20203,2020-03-01,1290,1268,22,1.7
20205,2020-03-01,4060,3887,173,4.3
20207,2020-03-01,1657,1600,57,3.4
20209,2020-03-01,77021,74112,2909,3.8
21001,2020-03-01,7213,6732,481,6.7
21003,2020-03-01,8982,8540,442,4.9
21005,2020-03-01,12117,11521,596,4.9
21007,2020-03-01,3523,3292,231,6.6
21009,2020-03-01,18932,17880,1052,5.6
21011,2020-03-01,4674,4265,409,8.8
21013,2020-03-01,8595,7892,703,8.2
21015,2020-03-01,70337,67393,2944,4.2
21017,2020-03-01,9475,9004,471,5
21019,2020-03-01,17990,16762,1228,6.8
21021,2020-03-01,12518,11832,686,5.5
21023,2020-03-01,3830,3580,250,6.5
21025,2020-03-01,3542,3123,419,11.8
21027,2020-03-01,7980,7391,589,7.4
21029,2020-03-01,42931,40889,2042,4.8
21031,2020-03-01,5198,4888,310,6
21033,2020-03-01,5565,5194,371,6.7
21035,2020-03-01,19250,18106,1144,5.9
21037,2020-03-01,50492,48281,2211,4.4
21039,2020-03-01,2275,2163,112,4.9
21041,2020-03-01,5238,4980,258,4.9
21043,2020-03-01,9927,9040,887,8.9
21045,2020-03-01,6825,6351,474,6.9
21047,2020-03-01,25696,24038,1658,6.5
21049,2020-03-01,17020,16135,885,5.2
21051,2020-03-01,5259,4806,453,8.6
21053,2020-03-01,4023,3767,256,6.4
21055,2020-03-01,3850,3635,215,5.6
21057,2020-03-01,3246,3044,202,6.2
21059,2020-03-01,46917,44658,2259,4.8
21061,2020-03-01,4882,4564,318,6.5
21063,2020-03-01,2105,1874,231,11
21065,2020-03-01,5486,5117,369,6.7
21067,2020-03-01,172236,165183,7053,4.1
21069,2020-03-01,6130,5720,410,6.7
21071,2020-03-01,11156,10174,982,8.8
21073,2020-03-01,25303,24160,1143,4.5
21075,2020-03-01,2047,1922,125,6.1
21077,2020-03-01,4043,3844,199,4.9
21079,2020-03-01,7668,7225,443,5.8
21081,2020-03-01,11664,11058,606,5.2
21083,2020-03-01,16105,15227,878,5.5
21085,2020-03-01,11215,10489,726,6.5
21087,2020-03-01,5081,4833,248,4.9
21089,2020-03-01,13613,12456,1157,8.5
21091,2020-03-01,3926,3745,181,4.6
21093,2020-03-01,49173,46607,2566,5.2
21095,2020-03-01,6873,5954,919,13.4
21097,2020-03-01,8797,8360,437,5
21099,2020-03-01,8081,7524,557,6.9
21101,2020-03-01,22005,20953,1052,4.8
21103,2020-03-01,8228,7855,373,4.5
21105,2020-03-01,1709,1609,100,5.9
21107,2020-03-01,18640,17453,1187,6.4
21109,2020-03-01,4124,3799,325,7.9
21111,2020-03-01,402015,383268,18747,4.7
21113,2020-03-01,26208,25059,1149,4.4
21115,2020-03-01,6821,6227,594,8.7
21117,2020-03-01,87150,83302,3848,4.4
21119,2020-03-01,4551,4121,430,9.4
21121,2020-03-01,9860,9207,653,6.6
21123,2020-03-01,6025,5687,338,5.6
21125,2020-03-01,24615,23129,1486,6
21127,2020-03-01,5395,4902,493,9.1
21129,2020-03-01,2134,1971,163,7.6
21131,2020-03-01,2794,2448,346,12.4
21133,2020-03-01,6563,5877,686,10.5
21135,2020-03-01,4707,4201,506,10.7
21137,2020-03-01,9329,8733,596,6.4
21139,2020-03-01,3683,3422,261,7.1
21141,2020-03-01,12681,12054,627,4.9
21143,2020-03-01,3058,2881,177,5.8
21145,2020-03-01,29374,27668,1706,5.8
21147,2020-03-01,4730,4356,374,7.9
21149,2020-03-01,4146,3924,222,5.4
21151,2020-03-01,47482,45213,2269,4.8
21153,2020-03-01,3458,2864,594,17.2
21155,2020-03-01,9646,9240,406,4.2
21157,2020-03-01,15378,14505,873,5.7
21159,2020-03-01,2861,2538,323,11.3
21161,2020-03-01,6993,6537,456,6.5
21163,2020-03-01,12307,11578,729,5.9
21165,2020-03-01,2355,2130,225,9.6
21167,2020-03-01,10048,9478,570,5.7
21169,2020-03-01,4129,3871,258,6.2
21171,2020-03-01,4687,4451,236,5
21173,2020-03-01,11704,10927,777,6.6
21175,2020-03-01,4671,4318,353,7.6
21177,2020-03-01,10642,9787,855,8
21179,2020-03-01,23340,22166,1174,5
21181,2020-03-01,3302,3110,192,5.8
21183,2020-03-01,9844,9163,681,6.9
21185,2020-03-01,33365,32107,1258,3.8
21187,2020-03-01,5080,4827,253,5
21189,2020-03-01,1155,1056,99,8.6
21191,2020-03-01,6999,6625,374,5.3
21193,2020-03-01,8458,7700,758,9
21195,2020-03-01,19990,18319,1671,8.4
21197,2020-03-01,5025,4654,371,7.4
21199,2020-03-01,26801,25220,1581,5.9
21201,2020-03-01,821,768,53,6.5
21203,2020-03-01,6728,6321,407,6
21205,2020-03-01,10926,10230,696,6.4
21207,2020-03-01,6260,5830,430,6.9
21209,2020-03-01,28659,27426,1233,4.3
21211,2020-03-01,25505,24459,1046,4.1
21213,2020-03-01,9010,8545,465,5.2
21215,2020-03-01,10260,9823,437,4.3
21217,2020-03-01,12670,12053,617,4.9
21219,2020-03-01,5476,5212,264,4.8
21221,2020-03-01,6161,5777,384,6.2
21223,2020-03-01,3876,3682,194,5
21225,2020-03-01,6145,5792,353,5.7
21227,2020-03-01,65553,62325,3228,4.9
21229,2020-03-01,6270,5988,282,4.5
21231,2020-03-01,7405,6898,507,6.8
21233,2020-03-01,5543,5203,340,6.1
21235,2020-03-01,13633,12794,839,6.2
21237,2020-03-01,2054,1868,186,9.1
21239,2020-03-01,14487,13886,601,4.1
22001,2020-03-01,24036,22364,1672,7
22003,2020-03-01,9076,8376,700,7.7
22005,2020-03-01,66163,62681,3482,5.3
22007,2020-03-01,9122,8412,710,7.8
22009,2020-03-01,15532,14340,1192,7.7
22011,2020-03-01,14961,13851,1110,7.4
22013,2020-03-01,5697,5225,472,8.3
22015,2020-03-01,58383,55121,3262,5.6
22017,2020-03-01,105143,97807,7336,7
22019,2020-03-01,103917,97696,6221,6
22021,2020-03-01,3894,3535,359,9.2
22023,2020-03-01,3844,3639,205,5.3
22025,2020-03-01,3484,3217,267,7.7
22027,2020-03-01,6017,5537,480,8
22029,2020-03-01,7357,6719,638,8.7
22031,2020-03-01,11101,10211,890,8
22033,2020-03-01,238382,225204,13178,5.5
22035,2020-03-01,1953,1666,287,14.7
22037,2020-03-01,8236,7767,469,5.7
22039,2020-03-01,12061,11158,903,7.5
22041,2020-03-01,7629,6908,721,9.5
22043,2020-03-01,8341,7695,646,7.7
22045,2020-03-01,28430,26271,2159,7.6
22047,2020-03-01,14654,13528,1126,7.7
22049,2020-03-01,7043,6584,459,6.5
22051,2020-03-01,214778,202921,11857,5.5
22053,2020-03-01,13302,12461,841,6.3
22055,2020-03-01,113977,107302,6675,5.9
22057,2020-03-01,42141,39684,2457,5.8
22059,2020-03-01,6935,6548,387,5.6
22061,2020-03-01,22835,21355,1480,6.5
22063,2020-03-01,71038,67338,3700,5.2
22065,2020-03-01,3609,3245,364,10.1
22067,2020-03-01,10502,9289,1213,11.6
22069,2020-03-01,17148,15943,1205,7
22071,2020-03-01,179911,168498,11413,6.3
22073,2020-03-01,71948,66873,5075,7.1
22075,2020-03-01,10115,9564,551,5.4
22077,2020-03-01,10225,9551,674,6.6
22079,2020-03-01,55880,52305,3575,6.4
22081,2020-03-01,3877,3592,285,7.4
22083,2020-03-01,8437,7683,754,8.9
22085,2020-03-01,9432,8829,603,6.4
22087,2020-03-01,19991,18709,1282,6.4
22089,2020-03-01,25269,23836,1433,5.7
22091,2020-03-01,4428,4102,326,7.4
22093,2020-03-01,9343,8615,728,7.8
22095,2020-03-01,19852,18388,1464,7.4
22097,2020-03-01,32771,30079,2692,8.2
22099,2020-03-01,22375,20849,1526,6.8
22101,2020-03-01,20320,18758,1562,7.7
22103,2020-03-01,119673,113214,6459,5.4
22105,2020-03-01,55524,51596,3928,7.1
22107,2020-03-01,1449,1267,182,12.6
22109,2020-03-01,46567,43716,2851,6.1
22111,2020-03-01,9418,8662,756,8
22113,2020-03-01,24246,22582,1664,6.9
22115,2020-03-01,16808,15236,1572,9.4
22117,2020-03-01,17093,15824,1269,7.4
22119,2020-03-01,14838,13610,1228,8.3
22121,2020-03-01,14113,13318,795,5.6
22123,2020-03-01,3851,3233,618,16
22125,2020-03-01,5566,5274,292,5.2
22127,2020-03-01,5036,4603,433,8.6
23001,2020-03-01,55762,53981,1781,3.2
23003,2020-03-01,30201,28610,1591,5.3
23005,2020-03-01,163068,158847,4221,2.6
23007,2020-03-01,14494,13919,575,4
23009,2020-03-01,27341,25797,1544,5.6
23011,2020-03-01,62038,59921,2117,3.4
23013,2020-03-01,19382,18582,800,4.1
23015,2020-03-01,16066,15436,630,3.9
23017,2020-03-01,26690,25567,1123,4.2
23019,2020-03-01,78000,74969,3031,3.9
23021,2020-03-01,7257,6913,344,4.7
23023,2020-03-01,19414,18869,545,2.8
23025,2020-03-01,22186,20950,1236,5.6
23027,2020-03-01,20390,19548,842,4.1
23029,2020-03-01,13459,12557,902,6.7
23031,2020-03-01,112529,108751,3778,3.4
24001,2020-03-01,32475,30742,1733,5.3
24003,2020-03-01,318746,309357,9389,2.9
24005,2020-03-01,458919,442393,16526,3.6
24009,2020-03-01,51201,49735,1466,2.9
24011,2020-03-01,18214,17558,656,3.6
24013,2020-03-01,97057,94356,2701,2.8
24015,2020-03-01,54082,51957,2125,3.9
24017,2020-03-01,89557,86377,3180,3.6
24019,2020-03-01,15362,14561,801,5.2
24021,2020-03-01,135947,131823,4124,3
24023,2020-03-01,15729,14901,828,5.3
24025,2020-03-01,142684,137980,4704,3.3
24027,2020-03-01,189491,184655,4836,2.6
24029,2020-03-01,10285,9846,439,4.3
24031,2020-03-01,565509,549604,15905,2.8
24033,2020-03-01,522403,503225,19178,3.7
24035,2020-03-01,28410,27552,858,3
24037,2020-03-01,58117,56298,1819,3.1
24039,2020-03-01,9277,8731,546,5.9
24041,2020-03-01,18971,18276,695,3.7
24043,2020-03-01,75220,72199,3021,4
24045,2020-03-01,51252,48795,2457,4.8
24047,2020-03-01,26161,23712,2449,9.4
24510,2020-03-01,291181,276898,14283,4.9
25001,2020-03-01,106531,100918,5613,5.3
25003,2020-03-01,62705,60273,2432,3.9
25005,2020-03-01,300557,288609,11948,4
25007,2020-03-01,8367,7866,501,6
25009,2020-03-01,423430,410676,12754,3
25011,2020-03-01,41048,39856,1192,2.9
25013,2020-03-01,227623,219078,8545,3.8
25015,2020-03-01,90104,87769,2335,2.6
25017,2020-03-01,918161,897428,20733,2.3
25019,2020-03-01,6323,5750,573,9.1
25021,2020-03-01,391253,381324,9929,2.5
25023,2020-03-01,282819,273540,9279,3.3
25025,2020-03-01,455982,444404,11578,2.5
25027,2020-03-01,448648,434624,14024,3.1
26001,2020-03-01,3732,3477,255,6.8
26003,2020-03-01,2996,2773,223,7.4
26005,2020-03-01,61305,59521,1784,2.9
26007,2020-03-01,13130,12548,582,4.4
26009,2020-03-01,9916,9381,535,5.4
26011,2020-03-01,5862,5456,406,6.9
26013,2020-03-01,3186,2990,196,6.2
26015,2020-03-01,31453,30442,1011,3.2
26017,2020-03-01,48492,46287,2205,4.5
26019,2020-03-01,8577,8095,482,5.6
26021,2020-03-01,72699,70099,2600,3.6
26023,2020-03-01,18997,18387,610,3.2
26025,2020-03-01,61451,59257,2194,3.6
26027,2020-03-01,24153,23262,891,3.7
26029,2020-03-01,12048,11440,608,5
26031,2020-03-01,9746,8468,1278,13.1
26033,2020-03-01,15793,14839,954,6
26035,2020-03-01,11424,10693,731,6.4
26037,2020-03-01,41000,39942,1058,2.6
26039,2020-03-01,5483,5159,324,5.9
26041,2020-03-01,16721,15868,853,5.1
26043,2020-03-01,11972,11460,512,4.3
26045,2020-03-01,57190,55470,1720,3
26047,2020-03-01,16726,15736,990,5.9
26049,2020-03-01,180757,173256,7501,4.1
26051,2020-03-01,9621,9079,542,5.6
26053,2020-03-01,5922,5670,252,4.3
26055,2020-03-01,47905,46210,1695,3.5
26057,2020-03-01,17954,17278,676,3.8
26059,2020-03-01,20022,19255,767,3.8
26061,2020-03-01,16301,15574,727,4.5
26063,2020-03-01,14943,14281,662,4.4
26065,2020-03-01,150764,146426,4338,2.9
26067,2020-03-01,29970,29086,884,2.9
26069,2020-03-01,9958,9297,661,6.6
26071,2020-03-01,5020,4718,302,6
26073,2020-03-01,34263,32997,1266,3.7
26075,2020-03-01,73061,70591,2470,3.4
26077,2020-03-01,131892,128173,3719,2.8
26079,2020-03-01,7653,7192,461,6
26081,2020-03-01,356891,348007,8884,2.5
26083,2020-03-01,881,830,51,5.8
26085,2020-03-01,3776,3566,210,5.6
26087,2020-03-01,41900,39147,2753,6.6
26089,2020-03-01,10138,9721,417,4.1
26091,2020-03-01,45671,44101,1570,3.4
26093,2020-03-01,104406,100542,3864,3.7
26095,2020-03-01,2254,2123,131,5.8
26097,2020-03-01,4190,3484,706,16.8
26099,2020-03-01,452204,431443,20761,4.6
26101,2020-03-01,9949,9383,566,5.7
26103,2020-03-01,32374,30899,1475,4.6
26105,2020-03-01,12956,12309,647,5
26107,2020-03-01,18105,17283,822,4.5
26109,2020-03-01,10799,10394,405,3.8
26111,2020-03-01,39617,38137,1480,3.7
26113,2020-03-01,6817,6480,337,4.9
26115,2020-03-01,73674,71280,2394,3.2
26117,2020-03-01,28037,27008,1029,3.7
26119,2020-03-01,2885,2636,249,8.6
26121,2020-03-01,75550,72568,2982,3.9
26123,2020-03-01,23088,22205,883,3.8
26125,2020-03-01,680858,655986,24872,3.7
26127,2020-03-01,11370,10662,708,6.2
26129,2020-03-01,7668,7106,562,7.3
26131,2020-03-01,2035,1895,140,6.9
26133,2020-03-01,11251,10828,423,3.8
26135,2020-03-01,2888,2702,186,6.4
26137,2020-03-01,11301,10735,566,5
26139,2020-03-01,159582,155773,3809,2.4
26141,2020-03-01,4765,4332,433,9.1
26143,2020-03-01,7297,6718,579,7.9
26145,2020-03-01,85165,81504,3661,4.3
26147,2020-03-01,76716,72377,4339,5.7
26149,2020-03-01,27046,26128,918,3.4
26151,2020-03-01,19046,18164,882,4.6
26153,2020-03-01,3188,2943,245,7.7
26155,2020-03-01,33173,31913,1260,3.8
26157,2020-03-01,23625,22494,1131,4.8
26159,2020-03-01,34541,33086,1455,4.2
26161,2020-03-01,198310,193724,4586,2.3
26163,2020-03-01,808989,765197,43792,5.4
26165,2020-03-01,14651,13982,669,4.6
27001,2020-03-01,7189,6670,519,7.2
27003,2020-03-01,198612,192116,6496,3.3
27005,2020-03-01,18391,17513,878,4.8
27007,2020-03-01,24569,23433,1136,4.6
27009,2020-03-01,22230,21198,1032,4.6
27011,2020-03-01,2361,2226,135,5.7
27013,2020-03-01,41446,40245,1201,2.9
27015,2020-03-01,14129,13487,642,4.5
27017,2020-03-01,17844,16953,891,5
27019,2020-03-01,58556,56882,1674,2.9
27021,2020-03-01,13837,12865,972,7
27023,2020-03-01,6868,6596,272,4
27025,2020-03-01,30272,28821,1451,4.8
27027,2020-03-01,36571,35357,1214,3.3
27029,2020-03-01,4492,4024,468,10.4
27031,2020-03-01,2878,2728,150,5.2
27033,2020-03-01,5952,5740,212,3.6
27035,2020-03-01,31712,30057,1655,5.2
27037,2020-03-01,242629,235387,7242,3
27039,2020-03-01,11816,11353,463,3.9
27041,2020-03-01,20918,20164,754,3.6
27043,2020-03-01,6775,6445,330,4.9
27045,2020-03-01,11371,10897,474,4.2
27047,2020-03-01,16110,15521,589,3.7
27049,2020-03-01,26992,26075,917,3.4
27051,2020-03-01,3184,3023,161,5.1
27053,2020-03-01,707798,688721,19077,2.7
27055,2020-03-01,10355,9958,397,3.8
27057,2020-03-01,9720,9109,611,6.3
27059,2020-03-01,21554,20450,1104,5.1
27061,2020-03-01,22216,20763,1453,6.5
27063,2020-03-01,5598,5406,192,3.4
27065,2020-03-01,9083,8366,717,7.9
27067,2020-03-01,23934,22973,961,4
27069,2020-03-01,2287,2198,89,3.9
27071,2020-03-01,5766,5401,365,6.3
27073,2020-03-01,3472,3315,157,4.5
27075,2020-03-01,5349,5140,209,3.9
27077,2020-03-01,2553,2462,91,3.6
27079,2020-03-01,16248,15299,949,5.8
27081,2020-03-01,3108,2951,157,5.1
27083,2020-03-01,14192,13686,506,3.6
27085,2020-03-01,19042,18241,801,4.2
27087,2020-03-01,2282,2146,136,6
27089,2020-03-01,5258,4866,392,7.5
27091,2020-03-01,9676,9320,356,3.7
27093,2020-03-01,13281,12666,615,4.6
27095,2020-03-01,13098,12201,897,6.8
27097,2020-03-01,17317,16203,1114,6.4
27099,2020-03-01,20288,19618,670,3.3
27101,2020-03-01,4611,4355,256,5.6
27103,2020-03-01,21282,20722,560,2.6
27105,2020-03-01,11031,10707,324,2.9
27107,2020-03-01,3109,2930,179,5.8
27109,2020-03-01,89006,86619,2387,2.7
27111,2020-03-01,31063,29520,1543,5
27113,2020-03-01,8667,8197,470,5.4
27115,2020-03-01,15078,14044,1034,6.9
27117,2020-03-01,4744,4540,204,4.3
27119,2020-03-01,16413,15660,753,4.6
27121,2020-03-01,6442,6224,218,3.4
27123,2020-03-01,290494,281678,8816,3
27125,2020-03-01,2170,2035,135,6.2
27127,2020-03-01,7443,7135,308,4.1
27129,2020-03-01,8207,7745,462,5.6
27131,2020-03-01,37454,36129,1325,3.5
27133,2020-03-01,5485,5362,123,2.2
27135,2020-03-01,7802,7512,290,3.7
27137,2020-03-01,101889,97555,4334,4.3
27139,2020-03-01,83845,81443,2402,2.9
27141,2020-03-01,52824,50674,2150,4.1
27143,2020-03-01,8339,7975,364,4.4
27145,2020-03-01,90963,87727,3236,3.6
27147,2020-03-01,21474,20752,722,3.4
27149,2020-03-01,5217,5047,170,3.3
27151,2020-03-01,4729,4499,230,4.9
27153,2020-03-01,13459,12795,664,4.9
27155,2020-03-01,1680,1596,84,5
27157,2020-03-01,12139,11656,483,4
27159,2020-03-01,6013,5568,445,7.4
27161,2020-03-01,8842,8413,429,4.9
27163,2020-03-01,143937,139623,4314,3
27165,2020-03-01,6240,5975,265,4.2
27167,2020-03-01,3342,3230,112,3.4
27169,2020-03-01,28753,27870,883,3.1
27171,2020-03-01,76026,73169,2857,3.8
27173,2020-03-01,5210,5014,196,3.8
28001,2020-03-01,11240,10527,713,6.3
28003,2020-03-01,16167,15496,671,4.2
28005,2020-03-01,4473,4197,276,6.2
28007,2020-03-01,7049,6650,399,5.7
28009,2020-03-01,3013,2854,159,5.3
28011,2020-03-01,12206,11432,774,6.3
28013,2020-03-01,5744,5451,293,5.1
28015,2020-03-01,3514,3315,199,5.7
28017,2020-03-01,6847,6515,332,4.8
28019,2020-03-01,3727,3544,183,4.9
28021,2020-03-01,2974,2710,264,8.9
28023,2020-03-01,5935,5599,336,5.7
28025,2020-03-01,7774,7254,520,6.7
28027,2020-03-01,8332,7748,584,7
28029,2020-03-01,11073,10463,610,5.5
28031,2020-03-01,8112,7748,364,4.5
28033,2020-03-01,90323,86881,3442,3.8
28035,2020-03-01,33359,31907,1452,4.4
28037,2020-03-01,2788,2621,167,6
28039,2020-03-01,8836,8294,542,6.1
28041,2020-03-01,4390,4094,296,6.7
28043,2020-03-01,9380,8963,417,4.4
28045,2020-03-01,18728,17814,914,4.9
28047,2020-03-01,86077,82136,3941,4.6
28049,2020-03-01,105526,100501,5025,4.8
28051,2020-03-01,5696,5204,492,8.6
28053,2020-03-01,2311,2088,223,9.6
28055,2020-03-01,389,358,31,8
28057,2020-03-01,10536,10091,445,4.2
28059,2020-03-01,58106,55052,3054,5.3
28061,2020-03-01,6188,5766,422,6.8
28063,2020-03-01,1950,1716,234,12
28065,2020-03-01,4140,3886,254,6.1
28067,2020-03-01,26021,24761,1260,4.8
28069,2020-03-01,3587,3325,262,7.3
28071,2020-03-01,28542,27465,1077,3.8
28073,2020-03-01,30877,29699,1178,3.8
28075,2020-03-01,30257,28858,1399,4.6
28077,2020-03-01,4572,4293,279,6.1
28079,2020-03-01,7976,7593,383,4.8
28081,2020-03-01,41009,39413,1596,3.9
28083,2020-03-01,10039,9383,656,6.5
28085,2020-03-01,14482,13782,700,4.8
28087,2020-03-01,25184,23995,1189,4.7
28089,2020-03-01,52626,50539,2087,4
28091,2020-03-01,9975,9500,475,4.8
28093,2020-03-01,14321,13640,681,4.8
28095,2020-03-01,15529,14804,725,4.7
28097,2020-03-01,3934,3719,215,5.5
28099,2020-03-01,10250,9703,547,5.3
28101,2020-03-01,8877,8441,436,4.9
28103,2020-03-01,3838,3589,249,6.5
28105,2020-03-01,22027,20969,1058,4.8
28107,2020-03-01,12382,11666,716,5.8
28109,2020-03-01,23674,22604,1070,4.5
28111,2020-03-01,4326,4065,261,6
28113,2020-03-01,14537,13722,815,5.6
28115,2020-03-01,14762,14203,559,3.8
28117,2020-03-01,11326,10819,507,4.5
28119,2020-03-01,2399,2246,153,6.4
28121,2020-03-01,75138,72492,2646,3.5
28123,2020-03-01,12723,12229,494,3.9
28125,2020-03-01,1635,1513,122,7.5
28127,2020-03-01,10688,10175,513,4.8
28129,2020-03-01,6930,6607,323,4.7
28131,2020-03-01,6946,6557,389,5.6
28133,2020-03-01,7814,7192,622,8
28135,2020-03-01,5329,5042,287,5.4
28137,2020-03-01,12297,11715,582,4.7
28139,2020-03-01,9394,8981,413,4.4
28141,2020-03-01,8590,8177,413,4.8
28143,2020-03-01,4455,4212,243,5.5
28145,2020-03-01,14376,13835,541,3.8
28147,2020-03-01,4823,4512,311,6.4
28149,2020-03-01,20031,19039,992,5
28151,2020-03-01,16951,15832,1119,6.6
28153,2020-03-01,7553,7143,410,5.4
28155,2020-03-01,3981,3764,217,5.5
28157,2020-03-01,2788,2546,242,8.7
28159,2020-03-01,7440,7038,402,5.4
28161,2020-03-01,4932,4699,233,4.7
28163,2020-03-01,9403,8889,514,5.5
29001,2020-03-01,10400,9989,411,4
29003,2020-03-01,9865,9538,327,3.3
29005,2020-03-01,2769,2681,88,3.2
29007,2020-03-01,10844,10444,400,3.7
29009,2020-03-01,16255,15401,854,5.3
29011,2020-03-01,5308,5102,206,3.9
29013,2020-03-01,8028,7650,378,4.7
29015,2020-03-01,7371,6944,427,5.8
29017,2020-03-01,5576,5339,237,4.3
29019,2020-03-01,100786,98180,2606,2.6
29021,2020-03-01,45170,43501,1669,3.7
29023,2020-03-01,18699,17755,944,5
29025,2020-03-01,4452,4266,186,4.2
29027,2020-03-01,21597,20853,744,3.4
29029,2020-03-01,18536,17384,1152,6.2
29031,2020-03-01,41710,40172,1538,3.7
29033,2020-03-01,4847,4657,190,3.9
29035,2020-03-01,2627,2464,163,6.2
29037,2020-03-01,55668,53607,2061,3.7
29039,2020-03-01,5940,5707,233,3.9
29041,2020-03-01,3874,3719,155,4
29043,2020-03-01,46073,44563,1510,3.3
29045,2020-03-01,3269,3124,145,4.4
29047,2020-03-01,138243,133639,4604,3.3
29049,2020-03-01,10871,10497,374,3.4
29051,2020-03-01,39443,38191,1252,3.2
29053,2020-03-01,7542,7252,290,3.8
29055,2020-03-01,11307,10739,568,5
29057,2020-03-01,3669,3526,143,3.9
29059,2020-03-01,7214,6891,323,4.5
29061,2020-03-01,4239,4084,155,3.7
29063,2020-03-01,4912,4720,192,3.9
29065,2020-03-01,6552,6280,272,4.2
29067,2020-03-01,5220,4950,270,5.2
29069,2020-03-01,11937,11075,862,7.2
29071,2020-03-01,54195,51948,2247,4.1
29073,2020-03-01,7865,7589,276,3.5
29075,2020-03-01,3567,3461,106,3
29077,2020-03-01,155382,150267,5115,3.3
29079,2020-03-01,4470,4317,153,3.4
29081,2020-03-01,3978,3802,176,4.4
29083,2020-03-01,9999,9603,396,4
29085,2020-03-01,3900,3708,192,4.9
29087,2020-03-01,2602,2533,69,2.7
29089,2020-03-01,4975,4818,157,3.2
29091,2020-03-01,16961,16213,748,4.4
29093,2020-03-01,3680,3443,237,6.4
29095,2020-03-01,368459,352353,16106,4.4
29097,2020-03-01,58158,56138,2020,3.5
29099,2020-03-01,120251,115406,4845,4
29101,2020-03-01,24103,23063,1040,4.3
29103,2020-03-01,1806,1739,67,3.7
29105,2020-03-01,17551,16493,1058,6
29107,2020-03-01,17116,16464,652,3.8
29109,2020-03-01,18677,17813,864,4.6
29111,2020-03-01,5117,4935,182,3.6
29113,2020-03-01,28895,27739,1156,4
29115,2020-03-01,5268,4980,288,5.5
29117,2020-03-01,7599,7374,225,3
29119,2020-03-01,11123,10670,453,4.1
29121,2020-03-01,7745,7406,339,4.4
29123,2020-03-01,5757,5461,296,5.1
29125,2020-03-01,3983,3834,149,3.7
29127,2020-03-01,14820,14260,560,3.8
29129,2020-03-01,1956,1887,69,3.5
29131,2020-03-01,12516,11779,737,5.9
29133,2020-03-01,5975,5660,315,5.3
29135,2020-03-01,7425,7145,280,3.8
29137,2020-03-01,3852,3666,186,4.8
29139,2020-03-01,5906,5685,221,3.7
29141,2020-03-01,8209,7760,449,5.5
29143,2020-03-01,8675,8226,449,5.2
29145,2020-03-01,27824,26770,1054,3.8
29147,2020-03-01,11435,11051,384,3.4
29149,2020-03-01,4180,3943,237,5.7
29151,2020-03-01,7191,6972,219,3
29153,2020-03-01,3520,3332,188,5.3
29155,2020-03-01,6622,6230,392,5.9
29157,2020-03-01,10160,9845,315,3.1
29159,2020-03-01,21910,20742,1168,5.3
29161,2020-03-01,20383,19595,788,3.9
29163,2020-03-01,7738,7428,310,4
29165,2020-03-01,59422,57649,1773,3
29167,2020-03-01,14836,14319,517,3.5
29169,2020-03-01,15090,14453,637,4.2
29171,2020-03-01,2316,2226,90,3.9
29173,2020-03-01,5746,5548,198,3.4
29175,2020-03-01,10694,10234,460,4.3
29177,2020-03-01,11136,10711,425,3.8
29179,2020-03-01,3051,2908,143,4.7
29181,2020-03-01,5093,4840,253,5
29183,2020-03-01,230397,223260,7137,3.1
29185,2020-03-01,3839,3669,170,4.4
29186,2020-03-01,9407,9045,362,3.8
29187,2020-03-01,27443,26044,1399,5.1
29189,2020-03-01,540304,520981,19323,3.6
29195,2020-03-01,11194,10788,406,3.6
29197,2020-03-01,1971,1873,98,5
29199,2020-03-01,2428,2350,78,3.2
29201,2020-03-01,20446,19545,901,4.4
29203,2020-03-01,3339,3106,233,7
29205,2020-03-01,3237,3080,157,4.9
29207,2020-03-01,13651,12885,766,5.6
29209,2020-03-01,13867,12899,968,7
29211,2020-03-01,2816,2679,137,4.9
29213,2020-03-01,27293,25189,2104,7.7
29215,2020-03-01,9131,8643,488,5.3
29217,2020-03-01,9743,9365,378,3.9
29219,2020-03-01,18290,17596,694,3.8
29221,2020-03-01,10623,9980,643,6.1
29223,2020-03-01,5236,4964,272,5.2
29225,2020-03-01,17714,17001,713,4
29227,2020-03-01,1187,1152,35,2.9
29229,2020-03-01,7630,7193,437,5.7
29510,2020-03-01,155432,148348,7084,4.6
30001,2020-03-01,5095,4920,175,3.4
30003,2020-03-01,4755,4391,364,7.7
30005,2020-03-01,2549,2441,108,4.2
30007,2020-03-01,2597,2468,129,5
30009,2020-03-01,5515,5266,249,4.5
30011,2020-03-01,651,634,17,2.6
30013,2020-03-01,37866,36434,1432,3.8
30015,2020-03-01,2479,2395,84,3.4
30017,2020-03-01,6062,5825,237,3.9
30019,2020-03-01,898,870,28,3.1
30021,2020-03-01,4558,4415,143,3.1
30023,2020-03-01,5053,4845,208,4.1
30025,2020-03-01,1685,1645,40,2.4
30027,2020-03-01,5898,5634,264,4.5
30029,2020-03-01,48195,45236,2959,6.1
30031,2020-03-01,69133,67345,1788,2.6
30033,2020-03-01,747,723,24,3.2
30035,2020-03-01,5538,5090,448,8.1
30037,2020-03-01,371,352,19,5.1
30039,2020-03-01,1771,1644,127,7.2
30041,2020-03-01,7618,7335,283,3.7
30043,2020-03-01,5753,5512,241,4.2
30045,2020-03-01,1072,1029,43,4
30047,2020-03-01,13364,12669,695,5.2
30049,2020-03-01,35991,34750,1241,3.4
30051,2020-03-01,994,967,27,2.7
30053,2020-03-01,8088,7212,876,10.8
30055,2020-03-01,950,930,20,2.1
30057,2020-03-01,5397,5201,196,3.6
30059,2020-03-01,993,961,32,3.2
30061,2020-03-01,1785,1594,191,10.7
30063,2020-03-01,64332,61734,2598,4
30065,2020-03-01,2263,2148,115,5.1
30067,2020-03-01,8801,8382,419,4.8
30069,2020-03-01,280,269,11,3.9
30071,2020-03-01,1900,1816,84,4.4
30073,2020-03-01,2664,2561,103,3.9
30075,2020-03-01,971,939,32,3.3
30077,2020-03-01,2874,2734,140,4.9
30079,2020-03-01,477,454,23,4.8
30081,2020-03-01,20403,19408,995,4.9
30083,2020-03-01,5749,5557,192,3.3
30085,2020-03-01,4427,4202,225,5.1
30087,2020-03-01,3754,3573,181,4.8
30089,2020-03-01,4870,4507,363,7.5
30091,2020-03-01,1779,1722,57,3.2
30093,2020-03-01,17067,16266,801,4.7
30095,2020-03-01,5401,5224,177,3.3
30097,2020-03-01,1806,1750,56,3.1
30099,2020-03-01,2758,2647,111,4
30101,2020-03-01,2100,2027,73,3.5
30103,2020-03-01,341,333,8,2.3
30105,2020-03-01,4069,3914,155,3.8
30107,2020-03-01,796,756,40,5
30109,2020-03-01,444,427,17,3.8
30111,2020-03-01,81396,78417,2979,3.7
31001,2020-03-01,16954,16223,731,4.3
31003,2020-03-01,3705,3578,127,3.4
31005,2020-03-01,243,227,16,6.6
31007,2020-03-01,403,385,18,4.5
31009,2020-03-01,285,267,18,6.3
31011,2020-03-01,3082,2973,109,3.5
31013,2020-03-01,5445,5190,255,4.7
31015,2020-03-01,1147,1103,44,3.8
31017,2020-03-01,1436,1376,60,4.2
31019,2020-03-01,27863,26859,1004,3.6
31021,2020-03-01,3559,3372,187,5.3
31023,2020-03-01,4636,4443,193,4.2
31025,2020-03-01,13966,13280,686,4.9
31027,2020-03-01,4643,4474,169,3.6
31029,2020-03-01,2389,2318,71,3
31031,2020-03-01,3499,3384,115,3.3
31033,2020-03-01,4368,4153,215,4.9
31035,2020-03-01,3402,3255,147,4.3
31037,2020-03-01,5676,5476,200,3.5
31039,2020-03-01,4826,4646,180,3.7
31041,2020-03-01,6627,6414,213,3.2
31043,2020-03-01,10995,10384,611,5.6
31045,2020-03-01,5052,4865,187,3.7
31047,2020-03-01,13425,12899,526,3.9
31049,2020-03-01,983,941,42,4.3
31051,2020-03-01,3151,3007,144,4.6
31053,2020-03-01,19899,19057,842,4.2
31055,2020-03-01,306479,292228,14251,4.6
31057,2020-03-01,1238,1198,40,3.2
31059,2020-03-01,3222,3104,118,3.7
31061,2020-03-01,1511,1451,60,4
31063,2020-03-01,1706,1628,78,4.6
31065,2020-03-01,2642,2542,100,3.8
31067,2020-03-01,11271,10749,522,4.6
31069,2020-03-01,1131,1069,62,5.5
31071,2020-03-01,1180,1140,40,3.4
31073,2020-03-01,1127,1089,38,3.4
31075,2020-03-01,452,439,13,2.9
31077,2020-03-01,1284,1231,53,4.1
31079,2020-03-01,32165,30601,1564,4.9
31081,2020-03-01,4870,4663,207,4.3
31083,2020-03-01,1838,1760,78,4.2
31085,2020-03-01,659,635,24,3.6
31087,2020-03-01,1304,1244,60,4.6
31089,2020-03-01,5991,5793,198,3.3
31091,2020-03-01,403,385,18,4.5
31093,2020-03-01,3410,3270,140,4.1
31095,2020-03-01,4273,4126,147,3.4
31097,2020-03-01,2126,2026,100,4.7
31099,2020-03-01,3899,3772,127,3.3
31101,2020-03-01,4577,4393,184,4
31103,2020-03-01,648,628,20,3.1
31105,2020-03-01,2061,1974,87,4.2
31107,2020-03-01,4789,4589,200,4.2
31109,2020-03-01,182330,175602,6728,3.7
31111,2020-03-01,18580,17756,824,4.4
31113,2020-03-01,497,479,18,3.6
31115,2020-03-01,433,413,20,4.6
31117,2020-03-01,465,445,20,4.3
31119,2020-03-01,20095,19289,806,4
31121,2020-03-01,4067,3918,149,3.7
31123,2020-03-01,2722,2598,124,4.6
31125,2020-03-01,2051,1967,84,4.1
31127,2020-03-01,3713,3555,158,4.3
31129,2020-03-01,2520,2413,107,4.2
31131,2020-03-01,8674,8319,355,4.1
31133,2020-03-01,1528,1475,53,3.5
31135,2020-03-01,1885,1829,56,3
31137,2020-03-01,5134,4970,164,3.2
31139,2020-03-01,4179,4024,155,3.7
31141,2020-03-01,17991,17307,684,3.8
31143,2020-03-01,3048,2933,115,3.8
31145,2020-03-01,5985,5765,220,3.7
31147,2020-03-01,4350,4175,175,4
31149,2020-03-01,922,891,31,3.4
31151,2020-03-01,7627,7263,364,4.8
31153,2020-03-01,98595,94579,4016,4.1
31155,2020-03-01,11475,11024,451,3.9
31157,2020-03-01,18321,17426,895,4.9
31159,2020-03-01,9300,8922,378,4.1
31161,2020-03-01,2775,2673,102,3.7
31163,2020-03-01,1726,1664,62,3.6
31165,2020-03-01,772,745,27,3.5
31167,2020-03-01,3607,3463,144,4
31169,2020-03-01,2848,2748,100,3.5
31171,2020-03-01,460,427,33,7.2
31173,2020-03-01,3178,3023,155,4.9
31175,2020-03-01,2182,2098,84,3.8
31177,2020-03-01,11588,11102,486,4.2
31179,2020-03-01,6047,5820,227,3.8
31181,2020-03-01,1742,1658,84,4.8
31183,2020-03-01,607,589,18,3
31185,2020-03-01,7376,7107,269,3.6
32001,2020-03-01,11478,10783,695,6.1
32003,2020-03-01,NA,NA,82102,7.2
32005,2020-03-01,23445,21847,1598,6.8
32007,2020-03-01,27343,25942,1401,5.1
32009,2020-03-01,461,434,27,5.9
32011,2020-03-01,1177,1130,47,4
32013,2020-03-01,8501,8062,439,5.2
32015,2020-03-01,3284,3092,192,5.8
32017,2020-03-01,2203,2068,135,6.1
32019,2020-03-01,23918,21967,1951,8.2
32021,2020-03-01,2104,1969,135,6.4
32023,2020-03-01,18014,16509,1505,8.4
32027,2020-03-01,2709,2527,182,6.7
32029,2020-03-01,2065,1933,132,6.4
32031,2020-03-01,259454,244886,14568,5.6
32033,2020-03-01,4725,4478,247,5.2
32510,2020-03-01,26797,24900,1897,7.1
33001,2020-03-01,30332,29447,885,2.9
33003,2020-03-01,23041,22362,679,2.9
33005,2020-03-01,40444,39326,1118,2.8
33007,2020-03-01,14255,13745,510,3.6
33009,2020-03-01,49741,48605,1136,2.3
33011,2020-03-01,241765,234897,6868,2.8
33013,2020-03-01,82924,80949,1975,2.4
33015,2020-03-01,185243,179699,5544,3
33017,2020-03-01,73866,72052,1814,2.5
33019,2020-03-01,22595,22049,546,2.4
34001,2020-03-01,120344,113532,6812,5.7
34003,2020-03-01,494799,480046,14753,3
34005,2020-03-01,236872,229286,7586,3.2
34007,2020-03-01,260261,249933,10328,4
34009,2020-03-01,41426,36903,4523,10.9
34011,2020-03-01,66372,62405,3967,6
34013,2020-03-01,373831,356621,17210,4.6
34015,2020-03-01,154124,148401,5723,3.7
34017,2020-03-01,370880,358576,12304,3.3
34019,2020-03-01,65151,63250,1901,2.9
34021,2020-03-01,208308,201768,6540,3.1
34023,2020-03-01,441081,427153,13928,3.2
34025,2020-03-01,330098,319208,10890,3.3
34027,2020-03-01,259899,252406,7493,2.9
34029,2020-03-01,276776,265826,10950,4
34031,2020-03-01,249188,237780,11408,4.6
34033,2020-03-01,29909,28389,1520,5.1
34035,2020-03-01,173473,168167,5306,3.1
34037,2020-03-01,75027,72114,2913,3.9
34039,2020-03-01,280328,269468,10860,3.9
34041,2020-03-01,57388,55337,2051,3.6
35001,2020-03-01,335193,316658,18535,5.5
35003,2020-03-01,1105,1002,103,9.3
35005,2020-03-01,27446,25764,1682,6.1
35006,2020-03-01,9070,8365,705,7.8
35007,2020-03-01,5289,4987,302,5.7
35009,2020-03-01,21650,20599,1051,4.9
35011,2020-03-01,704,666,38,5.4
35013,2020-03-01,99588,91727,7861,7.9
35015,2020-03-01,36485,35071,1414,3.9
35017,2020-03-01,12228,11519,709,5.8
35019,2020-03-01,1477,1390,87,5.9
35021,2020-03-01,283,269,14,4.9
35023,2020-03-01,2021,1904,117,5.8
35025,2020-03-01,32632,30906,1726,5.3
35027,2020-03-01,8738,8204,534,6.1
35028,2020-03-01,9481,9114,367,3.9
35029,2020-03-01,10809,8547,2262,20.9
35031,2020-03-01,24580,22459,2121,8.6
35033,2020-03-01,2091,1910,181,8.7
35035,2020-03-01,24979,23479,1500,6
35037,2020-03-01,3161,2962,199,6.3
35039,2020-03-01,16771,15607,1164,6.9
35041,2020-03-01,8034,7561,473,5.9
35043,2020-03-01,66413,62490,3923,5.9
35045,2020-03-01,51977,47965,4012,7.7
35047,2020-03-01,11132,10343,789,7.1
35049,2020-03-01,75958,72309,3649,4.8
35051,2020-03-01,3824,3433,391,10.2
35053,2020-03-01,6341,5922,419,6.6
35055,2020-03-01,15655,14501,1154,7.4
35057,2020-03-01,5458,5005,453,8.3
35059,2020-03-01,1681,1596,85,5.1
35061,2020-03-01,30744,28718,2026,6.6
36001,2020-03-01,159471,153548,5923,3.7
36003,2020-03-01,19963,18700,1263,6.3
36005,2020-03-01,583312,551402,31910,5.5
36007,2020-03-01,84103,79559,4544,5.4
36009,2020-03-01,34580,32397,2183,6.3
36011,2020-03-01,35218,33411,1807,5.1
36013,2020-03-01,54544,51368,3176,5.8
36015,2020-03-01,35286,33612,1674,4.7
36017,2020-03-01,21873,20651,1222,5.6
36019,2020-03-01,36224,34330,1894,5.2
36021,2020-03-01,30547,29375,1172,3.8
36023,2020-03-01,23175,21836,1339,5.8
36025,2020-03-01,18724,17694,1030,5.5
36027,2020-03-01,144688,139125,5563,3.8
36029,2020-03-01,442848,421689,21159,4.8
36031,2020-03-01,17211,16138,1073,6.2
36033,2020-03-01,19640,18493,1147,5.8
36035,2020-03-01,22861,21526,1335,5.8
36037,2020-03-01,29251,27807,1444,4.9
36039,2020-03-01,20602,19578,1024,5
36041,2020-03-01,2112,1917,195,9.2
36043,2020-03-01,27882,26235,1647,5.9
36045,2020-03-01,43619,40495,3124,7.2
36047,2020-03-01,NA,NA,48755,4.2
36049,2020-03-01,11599,10724,875,7.5
36051,2020-03-01,30558,29063,1495,4.9
36053,2020-03-01,32704,30963,1741,5.3
36055,2020-03-01,363028,346904,16124,4.4
36057,2020-03-01,22243,20864,1379,6.2
36059,2020-03-01,707360,682024,25336,3.6
36061,2020-03-01,892124,859612,32512,3.6
36063,2020-03-01,99331,93454,5877,5.9
36065,2020-03-01,100750,96046,4704,4.7
36067,2020-03-01,221594,212063,9531,4.3
36069,2020-03-01,55555,53009,2546,4.6
36071,2020-03-01,183813,176253,7560,4.1
36073,2020-03-01,17311,16376,935,5.4
36075,2020-03-01,53297,49999,3298,6.2
36077,2020-03-01,27972,26523,1449,5.2
36079,2020-03-01,51666,49594,2072,4
36081,2020-03-01,NA,NA,39482,3.5
36083,2020-03-01,82364,78948,3416,4.1
36085,2020-03-01,216525,208215,8310,3.8
36087,2020-03-01,155070,149347,5723,3.7
36089,2020-03-01,43664,40898,2766,6.3
36091,2020-03-01,120700,116249,4451,3.7
36093,2020-03-01,77148,74008,3140,4.1
36095,2020-03-01,14780,13928,852,5.8
36097,2020-03-01,7935,7425,510,6.4
36099,2020-03-01,15950,15179,771,4.8
36101,2020-03-01,42076,39827,2249,5.3
36103,2020-03-01,777487,745919,31568,4.1
36105,2020-03-01,36917,35214,1703,4.6
36107,2020-03-01,22817,21654,1163,5.1
36109,2020-03-01,49865,48118,1747,3.5
36111,2020-03-01,88609,84988,3621,4.1
36113,2020-03-01,31146,29370,1776,5.7
36115,2020-03-01,27205,25872,1333,4.9
36117,2020-03-01,43643,41478,2165,5
36119,2020-03-01,485174,465825,19349,4
36121,2020-03-01,17600,16531,1069,6.1
36123,2020-03-01,11625,11044,581,5
37001,2020-03-01,81202,77849,3353,4.1
37003,2020-03-01,17731,17109,622,3.5
37005,2020-03-01,4304,4047,257,6
37007,2020-03-01,10728,10190,538,5
37009,2020-03-01,12562,12001,561,4.5
37011,2020-03-01,7337,7014,323,4.4
37013,2020-03-01,19231,18269,962,5
37015,2020-03-01,7669,7222,447,5.8
37017,2020-03-01,14566,13781,785,5.4
37019,2020-03-01,52764,49706,3058,5.8
37021,2020-03-01,137859,133117,4742,3.4
37023,2020-03-01,40394,38733,1661,4.1
37025,2020-03-01,108115,103871,4244,3.9
37027,2020-03-01,35955,34432,1523,4.2
37029,2020-03-01,4574,4380,194,4.2
37031,2020-03-01,31105,29645,1460,4.7
37033,2020-03-01,9790,9292,498,5.1
37035,2020-03-01,77841,74739,3102,4
37037,2020-03-01,35286,33969,1317,3.7
37039,2020-03-01,11216,10672,544,4.9
37041,2020-03-01,5477,5224,253,4.6
37043,2020-03-01,4155,3950,205,4.9
37045,2020-03-01,48269,46037,2232,4.6
37047,2020-03-01,22986,21747,1239,5.4
37049,2020-03-01,40896,39126,1770,4.3
37051,2020-03-01,125807,118757,7050,5.6
37053,2020-03-01,13770,13192,578,4.2
37055,2020-03-01,17684,16346,1338,7.6
37057,2020-03-01,79795,76406,3389,4.2
37059,2020-03-01,20343,19571,772,3.8
37061,2020-03-01,24978,23868,1110,4.4
37063,2020-03-01,169900,163679,6221,3.7
37065,2020-03-01,20806,19506,1300,6.2
37067,2020-03-01,184933,177364,7569,4.1
37069,2020-03-01,31215,29837,1378,4.4
37071,2020-03-01,110369,105467,4902,4.4
37073,2020-03-01,5237,4994,243,4.6
37075,2020-03-01,3167,2969,198,6.3
37077,2020-03-01,29948,28851,1097,3.7
37079,2020-03-01,9495,9115,380,4
37081,2020-03-01,258519,246928,11591,4.5
37083,2020-03-01,20239,18926,1313,6.5
37085,2020-03-01,52972,50400,2572,4.9
37087,2020-03-01,29449,28291,1158,3.9
37089,2020-03-01,54101,52080,2021,3.7
37091,2020-03-01,9063,8550,513,5.7
37093,2020-03-01,19802,18732,1070,5.4
37095,2020-03-01,1844,1614,230,12.5
37097,2020-03-01,88762,85183,3579,4
37099,2020-03-01,20247,19337,910,4.5
37101,2020-03-01,98716,94814,3902,4
37103,2020-03-01,4305,4128,177,4.1
37105,2020-03-01,25911,24704,1207,4.7
37107,2020-03-01,27627,26487,1140,4.1
37109,2020-03-01,43074,41367,1707,4
37111,2020-03-01,20270,19386,884,4.4
37113,2020-03-01,15132,14453,679,4.5
37115,2020-03-01,9990,9581,409,4.1
37117,2020-03-01,8996,8515,481,5.3
37119,2020-03-01,616239,591550,24689,4
37121,2020-03-01,5927,5611,316,5.3
37123,2020-03-01,11271,10781,490,4.3
37125,2020-03-01,41880,40164,1716,4.1
37127,2020-03-01,42279,40101,2178,5.2
37129,2020-03-01,121467,116687,4780,3.9
37131,2020-03-01,7699,7228,471,6.1
37133,2020-03-01,64589,61434,3155,4.9
37135,2020-03-01,78075,75355,2720,3.5
37137,2020-03-01,5241,5022,219,4.2
37139,2020-03-01,16489,15655,834,5.1
37141,2020-03-01,28314,27080,1234,4.4
37143,2020-03-01,4890,4620,270,5.5
37145,2020-03-01,18297,17493,804,4.4
37147,2020-03-01,88929,84979,3950,4.4
37149,2020-03-01,8779,8418,361,4.1
37151,2020-03-01,65274,62529,2745,4.2
37153,2020-03-01,16352,15385,967,5.9
37155,2020-03-01,49308,46369,2939,6
37157,2020-03-01,39546,37619,1927,4.9
37159,2020-03-01,65662,62723,2939,4.5
37161,2020-03-01,24872,23456,1416,5.7
37163,2020-03-01,29077,27824,1253,4.3
37165,2020-03-01,11514,10647,867,7.5
37167,2020-03-01,29893,28597,1296,4.3
37169,2020-03-01,21377,20501,876,4.1
37171,2020-03-01,33133,31711,1422,4.3
37173,2020-03-01,6893,6545,348,5
37175,2020-03-01,14262,13669,593,4.2
37177,2020-03-01,1315,1214,101,7.7
37179,2020-03-01,122685,117954,4731,3.9
37181,2020-03-01,17338,16275,1063,6.1
37183,2020-03-01,593306,571732,21574,3.6
37185,2020-03-01,6535,6124,411,6.3
37187,2020-03-01,4400,4083,317,7.2
37189,2020-03-01,28390,27308,1082,3.8
37191,2020-03-01,50874,48568,2306,4.5
37193,2020-03-01,28687,27345,1342,4.7
37195,2020-03-01,34068,31977,2091,6.1
37197,2020-03-01,17488,16802,686,3.9
37199,2020-03-01,8327,7954,373,4.5
38001,2020-03-01,1059,1033,26,2.5
38003,2020-03-01,5152,5024,128,2.5
38005,2020-03-01,2340,2227,113,4.8
38007,2020-03-01,370,359,11,3
38009,2020-03-01,2878,2757,121,4.2
38011,2020-03-01,1616,1585,31,1.9
38013,2020-03-01,1040,1006,34,3.3
38015,2020-03-01,49057,47748,1309,2.7
38017,2020-03-01,102982,100654,2328,2.3
38019,2020-03-01,1892,1834,58,3.1
38021,2020-03-01,2287,2246,41,1.8
38023,2020-03-01,1381,1364,17,1.2
38025,2020-03-01,3352,3300,52,1.6
38027,2020-03-01,1222,1169,53,4.3
38029,2020-03-01,1452,1370,82,5.6
38031,2020-03-01,1491,1446,45,3
38033,2020-03-01,837,823,14,1.7
38035,2020-03-01,37068,36169,899,2.4
38037,2020-03-01,1208,1188,20,1.7
38039,2020-03-01,1034,1008,26,2.5
38041,2020-03-01,1388,1347,41,3
38043,2020-03-01,1273,1217,56,4.4
38045,2020-03-01,2046,2007,39,1.9
38047,2020-03-01,886,864,22,2.5
38049,2020-03-01,3106,2961,145,4.7
38051,2020-03-01,1116,1081,35,3.1
38053,2020-03-01,9844,9605,239,2.4
38055,2020-03-01,4681,4498,183,3.9
38057,2020-03-01,3480,3328,152,4.4
38059,2020-03-01,16225,15672,553,3.4
38061,2020-03-01,7340,7228,112,1.5
38063,2020-03-01,1372,1320,52,3.8
38065,2020-03-01,872,832,40,4.6
38067,2020-03-01,3294,3161,133,4
38069,2020-03-01,1672,1609,63,3.8
38071,2020-03-01,5517,5345,172,3.1
38073,2020-03-01,2797,2745,52,1.9
38075,2020-03-01,1211,1171,40,3.3
38077,2020-03-01,8534,8341,193,2.3
38079,2020-03-01,4570,4171,399,8.7
38081,2020-03-01,2710,2665,45,1.7
38083,2020-03-01,677,633,44,6.5
38085,2020-03-01,1217,1183,34,2.8
38087,2020-03-01,390,383,7,1.8
38089,2020-03-01,18438,17999,439,2.4
38091,2020-03-01,984,969,15,1.5
38093,2020-03-01,10316,10074,242,2.3
38095,2020-03-01,1093,1071,22,2
38097,2020-03-01,4401,4252,149,3.4
38099,2020-03-01,5082,4912,170,3.3
38101,2020-03-01,31329,30414,915,2.9
38103,2020-03-01,1927,1839,88,4.6
38105,2020-03-01,23212,22705,507,2.2
39001,2020-03-01,10801,9813,988,9.1
39003,2020-03-01,47532,44944,2588,5.4
39005,2020-03-01,27043,25670,1373,5.1
39007,2020-03-01,44063,41266,2797,6.3
39009,2020-03-01,29178,27446,1732,5.9
39011,2020-03-01,24861,23906,955,3.8
39013,2020-03-01,29740,27287,2453,8.2
39015,2020-03-01,19598,18306,1292,6.6
39017,2020-03-01,193121,184551,8570,4.4
39019,2020-03-01,13001,12087,914,7
39021,2020-03-01,20128,19211,917,4.6
39023,2020-03-01,63706,60324,3382,5.3
39025,2020-03-01,105793,101013,4780,4.5
39027,2020-03-01,17932,16910,1022,5.7
39029,2020-03-01,47059,44018,3041,6.5
39031,2020-03-01,14142,13050,1092,7.7
39033,2020-03-01,18131,17073,1058,5.8
39035,2020-03-01,589480,546884,42596,7.2
39037,2020-03-01,25844,24598,1246,4.8
39039,2020-03-01,17817,16939,878,4.9
39041,2020-03-01,109842,105935,3907,3.6
39043,2020-03-01,35147,32836,2311,6.6
39045,2020-03-01,78080,74635,3445,4.4
39047,2020-03-01,13912,13238,674,4.8
39049,2020-03-01,695289,667221,28068,4
39051,2020-03-01,22513,21240,1273,5.7
39053,2020-03-01,12331,11426,905,7.3
39055,2020-03-01,47256,44181,3075,6.5
39057,2020-03-01,83048,79551,3497,4.2
39059,2020-03-01,18524,17088,1436,7.8
39061,2020-03-01,411045,393058,17987,4.4
39063,2020-03-01,41576,40003,1573,3.8
39065,2020-03-01,13793,13081,712,5.2
39067,2020-03-01,6659,6116,543,8.2
39069,2020-03-01,13181,12313,868,6.6
39071,2020-03-01,17138,15995,1143,6.7
39073,2020-03-01,13141,12361,780,5.9
39075,2020-03-01,20637,19889,748,3.6
39077,2020-03-01,27932,25561,2371,8.5
39079,2020-03-01,12806,11690,1116,8.7
39081,2020-03-01,27447,25362,2085,7.6
39083,2020-03-01,31521,29999,1522,4.8
39085,2020-03-01,121865,113460,8405,6.9
39087,2020-03-01,23840,22416,1424,6
39089,2020-03-01,90564,86499,4065,4.5
39091,2020-03-01,22864,21830,1034,4.5
39093,2020-03-01,148866,137342,11524,7.7
39095,2020-03-01,208122,196422,11700,5.6
39097,2020-03-01,20909,20072,837,4
39099,2020-03-01,101167,94134,7033,7
39101,2020-03-01,27961,26689,1272,4.5
39103,2020-03-01,93681,87932,5749,6.1
39105,2020-03-01,9170,8309,861,9.4
39107,2020-03-01,23136,22368,768,3.3
39109,2020-03-01,54235,51815,2420,4.5
39111,2020-03-01,5420,4778,642,11.8
39113,2020-03-01,251917,239835,12082,4.8
39115,2020-03-01,6812,6150,662,9.7
39117,2020-03-01,16891,16003,888,5.3
39119,2020-03-01,39536,36873,2663,6.7
39121,2020-03-01,4692,4240,452,9.6
39123,2020-03-01,20117,18373,1744,8.7
39125,2020-03-01,8533,8136,397,4.7
39127,2020-03-01,16149,15009,1140,7.1
39129,2020-03-01,26608,25278,1330,5
39131,2020-03-01,10854,9943,911,8.4
39133,2020-03-01,86216,81485,4731,5.5
39135,2020-03-01,21017,19997,1020,4.9
39137,2020-03-01,18692,17959,733,3.9
39139,2020-03-01,51428,48498,2930,5.7
39141,2020-03-01,35481,33431,2050,5.8
39143,2020-03-01,30141,28512,1629,5.4
39145,2020-03-01,29010,26720,2290,7.9
39147,2020-03-01,27103,25734,1369,5.1
39149,2020-03-01,23695,22644,1051,4.4
39151,2020-03-01,184139,173495,10644,5.8
39153,2020-03-01,268292,253944,14348,5.3
39155,2020-03-01,85070,78828,6242,7.3
39157,2020-03-01,44389,41763,2626,5.9
39159,2020-03-01,28973,27922,1051,3.6
39161,2020-03-01,15060,14434,626,4.2
39163,2020-03-01,5688,5181,507,8.9
39165,2020-03-01,117783,112996,4787,4.1
39167,2020-03-01,27274,25350,1924,7.1
39169,2020-03-01,62625,60219,2406,3.8
39171,2020-03-01,18716,17922,794,4.2
39173,2020-03-01,70331,67283,3048,4.3
39175,2020-03-01,13049,12541,508,3.9
40001,2020-03-01,8057,7753,304,3.8
40003,2020-03-01,2698,2643,55,2
40005,2020-03-01,4940,4729,211,4.3
40007,2020-03-01,2786,2736,50,1.8
40009,2020-03-01,9524,9127,397,4.2
40011,2020-03-01,4579,4468,111,2.4
40013,2020-03-01,21600,21015,585,2.7
40015,2020-03-01,11733,11335,398,3.4
40017,2020-03-01,73832,71856,1976,2.7
40019,2020-03-01,21031,20377,654,3.1
40021,2020-03-01,18823,18166,657,3.5
40023,2020-03-01,5391,5136,255,4.7
40025,2020-03-01,1327,1306,21,1.6
40027,2020-03-01,141716,138239,3477,2.5
40029,2020-03-01,2409,2304,105,4.4
40031,2020-03-01,47990,46572,1418,3
40033,2020-03-01,2713,2638,75,2.8
40035,2020-03-01,5770,5579,191,3.3
40037,2020-03-01,31298,30277,1021,3.3
40039,2020-03-01,15610,15193,417,2.7
40041,2020-03-01,18313,17709,604,3.3
40043,2020-03-01,2914,2852,62,2.1
40045,2020-03-01,2057,2005,52,2.5
40047,2020-03-01,26378,25581,797,3
40049,2020-03-01,12392,11974,418,3.4
40051,2020-03-01,26355,25552,803,3
40053,2020-03-01,2591,2534,57,2.2
40055,2020-03-01,1792,1730,62,3.5
40057,2020-03-01,1192,1162,30,2.5
40059,2020-03-01,1730,1687,43,2.5
40061,2020-03-01,4205,3987,218,5.2
40063,2020-03-01,5350,5099,251,4.7
40065,2020-03-01,10782,10509,273,2.5
40067,2020-03-01,2474,2395,79,3.2
40069,2020-03-01,3232,3070,162,5
40071,2020-03-01,17901,17220,681,3.8
40073,2020-03-01,8831,8644,187,2.1
40075,2020-03-01,3337,3240,97,2.9
40077,2020-03-01,3090,2884,206,6.7
40079,2020-03-01,18765,18018,747,4
40081,2020-03-01,15647,15149,498,3.2
40083,2020-03-01,21948,21360,588,2.7
40085,2020-03-01,6096,5967,129,2.1
40087,2020-03-01,19506,19009,497,2.5
40089,2020-03-01,14812,14180,632,4.3
40091,2020-03-01,7260,6869,391,5.4
40093,2020-03-01,3737,3659,78,2.1
40095,2020-03-01,6940,6701,239,3.4
40097,2020-03-01,19393,18874,519,2.7
40099,2020-03-01,6334,6154,180,2.8
40101,2020-03-01,29851,28845,1006,3.4
40103,2020-03-01,5587,5455,132,2.4
40105,2020-03-01,4589,4459,130,2.8
40107,2020-03-01,4535,4324,211,4.7
40109,2020-03-01,381427,371135,10292,2.7
40111,2020-03-01,15523,14855,668,4.3
40113,2020-03-01,20531,19809,722,3.5
40115,2020-03-01,14407,14002,405,2.8
40117,2020-03-01,7279,7029,250,3.4
40119,2020-03-01,38184,37199,985,2.6
40121,2020-03-01,16898,16203,695,4.1
40123,2020-03-01,19173,18674,499,2.6
40125,2020-03-01,32278,31281,997,3.1
40127,2020-03-01,4242,4037,205,4.8
40129,2020-03-01,1800,1745,55,3.1
40131,2020-03-01,44750,43518,1232,2.8
40133,2020-03-01,9484,9080,404,4.3
40135,2020-03-01,15998,15392,606,3.8
40137,2020-03-01,18501,17773,728,3.9
40139,2020-03-01,11843,11635,208,1.8
40141,2020-03-01,2978,2886,92,3.1
40143,2020-03-01,320615,311483,9132,2.8
40145,2020-03-01,37678,36588,1090,2.9
40147,2020-03-01,22020,21344,676,3.1
40149,2020-03-01,4999,4815,184,3.7
40151,2020-03-01,4623,4537,86,1.9
40153,2020-03-01,8667,8389,278,3.2
41001,2020-03-01,7045,6672,373,5.3
41003,2020-03-01,49525,48072,1453,2.9
41005,2020-03-01,220069,212263,7806,3.5
41007,2020-03-01,19071,18294,777,4.1
41009,2020-03-01,24552,23441,1111,4.5
41011,2020-03-01,26068,24794,1274,4.9
41013,2020-03-01,9499,8956,543,5.7
41015,2020-03-01,8679,8184,495,5.7
41017,2020-03-01,95746,91919,3827,4
41019,2020-03-01,46322,44000,2322,5
41021,2020-03-01,898,853,45,5
41023,2020-03-01,3112,2833,279,9
41025,2020-03-01,3466,3265,201,5.8
41027,2020-03-01,13673,13250,423,3.1
41029,2020-03-01,101891,97103,4788,4.7
41031,2020-03-01,9900,9368,532,5.4
41033,2020-03-01,35824,33969,1855,5.2
41035,2020-03-01,28632,26581,2051,7.2
41037,2020-03-01,3512,3333,179,5.1
41039,2020-03-01,182681,175268,7413,4.1
41041,2020-03-01,20298,19338,960,4.7
41043,2020-03-01,59180,56490,2690,4.5
41045,2020-03-01,12285,11802,483,3.9
41047,2020-03-01,162222,155653,6569,4
41049,2020-03-01,5603,5359,244,4.4
41051,2020-03-01,456871,441066,15805,3.5
41053,2020-03-01,39965,38336,1629,4.1
41055,2020-03-01,946,897,49,5.2
41057,2020-03-01,11767,11286,481,4.1
41059,2020-03-01,35953,34273,1680,4.7
41061,2020-03-01,11917,11265,652,5.5
41063,2020-03-01,3272,3032,240,7.3
41065,2020-03-01,12281,11687,594,4.8
41067,2020-03-01,325863,315696,10167,3.1
41069,2020-03-01,724,699,25,3.5
41071,2020-03-01,54828,52878,1950,3.6
42001,2020-03-01,54765,52544,2221,4.1
42003,2020-03-01,647292,611231,36061,5.6
42005,2020-03-01,32671,30025,2646,8.1
42007,2020-03-01,84413,78820,5593,6.6
42009,2020-03-01,23540,21868,1672,7.1
42011,2020-03-01,217276,204809,12467,5.7
42013,2020-03-01,59126,55555,3571,6
42015,2020-03-01,28924,27131,1793,6.2
42017,2020-03-01,343365,325858,17507,5.1
42019,2020-03-01,99808,94157,5651,5.7
42021,2020-03-01,58314,53933,4381,7.5
42023,2020-03-01,2079,1883,196,9.4
42025,2020-03-01,32435,30041,2394,7.4
42027,2020-03-01,80846,77344,3502,4.3
42029,2020-03-01,282616,271295,11321,4
42031,2020-03-01,17394,16130,1264,7.3
42033,2020-03-01,36596,33783,2813,7.7
42035,2020-03-01,18543,17093,1450,7.8
42037,2020-03-01,34123,31894,2229,6.5
42039,2020-03-01,38546,35947,2599,6.7
42041,2020-03-01,132005,126445,5560,4.2
42043,2020-03-01,144772,137326,7446,5.1
42045,2020-03-01,302209,286927,15282,5.1
42047,2020-03-01,15632,14403,1229,7.9
42049,2020-03-01,128613,120024,8589,6.7
42051,2020-03-01,58071,52783,5288,9.1
42053,2020-03-01,1812,1630,182,10
42055,2020-03-01,78212,74097,4115,5.3
42057,2020-03-01,8012,7443,569,7.1
42059,2020-03-01,16923,15598,1325,7.8
42061,2020-03-01,20251,18413,1838,9.1
42063,2020-03-01,39630,36855,2775,7
42065,2020-03-01,20651,19244,1407,6.8
42067,2020-03-01,12657,11874,783,6.2
42069,2020-03-01,105755,98863,6892,6.5
42071,2020-03-01,283179,270919,12260,4.3
42073,2020-03-01,41166,37586,3580,8.7
42075,2020-03-01,72414,68766,3648,5
42077,2020-03-01,193193,181839,11354,5.9
42079,2020-03-01,159210,146925,12285,7.7
42081,2020-03-01,56890,52804,4086,7.2
42083,2020-03-01,17493,16027,1466,8.4
42085,2020-03-01,48372,45059,3313,6.8
42087,2020-03-01,21302,19890,1412,6.6
42089,2020-03-01,83514,77486,6028,7.2
42091,2020-03-01,452939,432390,20549,4.5
42093,2020-03-01,9231,8781,450,4.9
42095,2020-03-01,161692,152282,9410,5.8
42097,2020-03-01,43128,39731,3397,7.9
42099,2020-03-01,24476,23270,1206,4.9
42101,2020-03-01,736461,685164,51297,7
42103,2020-03-01,25109,23117,1992,7.9
42105,2020-03-01,7286,6551,735,10.1
42107,2020-03-01,66728,62127,4601,6.9
42109,2020-03-01,20474,19149,1325,6.5
42111,2020-03-01,34110,31375,2735,8
42113,2020-03-01,2634,2423,211,8
42115,2020-03-01,20508,19144,1364,6.7
42117,2020-03-01,19355,17764,1591,8.2
42119,2020-03-01,19961,18972,989,5
42121,2020-03-01,22381,20712,1669,7.5
42123,2020-03-01,19019,17682,1337,7
42125,2020-03-01,107511,100445,7066,6.6
42127,2020-03-01,22078,20351,1727,7.8
42129,2020-03-01,181428,169847,11581,6.4
42131,2020-03-01,13719,12742,977,7.1
42133,2020-03-01,235902,224485,11417,4.8
44001,2020-03-01,26182,25110,1072,4.1
44003,2020-03-01,91626,87412,4214,4.6
44005,2020-03-01,44825,42707,2118,4.7
44007,2020-03-01,328967,311492,17475,5.3
44009,2020-03-01,69244,66198,3046,4.4
45001,2020-03-01,10150,9763,387,3.8
45003,2020-03-01,76160,73880,2280,3
45005,2020-03-01,2639,2464,175,6.6
45007,2020-03-01,92571,89906,2665,2.9
45009,2020-03-01,4986,4665,321,6.4
45011,2020-03-01,8160,7761,399,4.9
45013,2020-03-01,79536,77362,2174,2.7
45015,2020-03-01,104833,101948,2885,2.8
45017,2020-03-01,6679,6438,241,3.6
45019,2020-03-01,212870,207646,5224,2.5
45021,2020-03-01,25818,24931,887,3.4
45023,2020-03-01,13691,13055,636,4.6
45025,2020-03-01,22238,21549,689,3.1
45027,2020-03-01,12729,12202,527,4.1
45029,2020-03-01,16934,16360,574,3.4
45031,2020-03-01,30646,29617,1029,3.4
45033,2020-03-01,13306,12755,551,4.1
45035,2020-03-01,78655,76584,2071,2.6
45037,2020-03-01,10848,10520,328,3
45039,2020-03-01,9757,9319,438,4.5
45041,2020-03-01,67814,65697,2117,3.1
45043,2020-03-01,25996,24919,1077,4.1
45045,2020-03-01,258732,252042,6690,2.6
45047,2020-03-01,31597,30499,1098,3.5
45049,2020-03-01,8431,8190,241,2.9
45051,2020-03-01,149105,143233,5872,3.9
45053,2020-03-01,12911,12576,335,2.6
45055,2020-03-01,29817,28830,987,3.3
45057,2020-03-01,42034,40501,1533,3.6
45059,2020-03-01,30624,29624,1000,3.3
45061,2020-03-01,6722,6377,345,5.1
45063,2020-03-01,152742,149016,3726,2.4
45065,2020-03-01,3393,3256,137,4
45067,2020-03-01,13012,12425,587,4.5
45069,2020-03-01,9246,8798,448,4.8
45071,2020-03-01,19038,18502,536,2.8
45073,2020-03-01,35468,34454,1014,2.9
45075,2020-03-01,35459,33742,1717,4.8
45077,2020-03-01,58314,56594,1720,2.9
45079,2020-03-01,202793,197020,5773,2.8
45081,2020-03-01,8903,8647,256,2.9
45083,2020-03-01,156207,151913,4294,2.7
45085,2020-03-01,44621,42953,1668,3.7
45087,2020-03-01,11921,11447,474,4
45089,2020-03-01,12115,11515,600,5
45091,2020-03-01,142802,138675,4127,2.9
46003,2020-03-01,1506,1466,40,2.7
46005,2020-03-01,9522,9221,301,3.2
46007,2020-03-01,1077,1027,50,4.6
46009,2020-03-01,2901,2814,87,3
46011,2020-03-01,19542,18959,583,3
46013,2020-03-01,20842,20196,646,3.1
46015,2020-03-01,2419,2344,75,3.1
46017,2020-03-01,646,614,32,5
46019,2020-03-01,5073,4894,179,3.5
46021,2020-03-01,802,765,37,4.6
46023,2020-03-01,3749,3622,127,3.4
46025,2020-03-01,1929,1835,94,4.9
46027,2020-03-01,7825,7606,219,2.8
46029,2020-03-01,15680,15182,498,3.2
46031,2020-03-01,1380,1313,67,4.9
46033,2020-03-01,4047,3847,200,4.9
46035,2020-03-01,11066,10704,362,3.3
46037,2020-03-01,2763,2599,164,5.9
46039,2020-03-01,2173,2031,142,6.5
46041,2020-03-01,2232,2092,140,6.3
46043,2020-03-01,1584,1534,50,3.2
46045,2020-03-01,2067,2007,60,2.9
46047,2020-03-01,2979,2835,144,4.8
46049,2020-03-01,1077,1040,37,3.4
46051,2020-03-01,4504,4294,210,4.7
46053,2020-03-01,2015,1945,70,3.5
46055,2020-03-01,1070,1038,32,3
46057,2020-03-01,3359,3247,112,3.3
46059,2020-03-01,1781,1736,45,2.5
46061,2020-03-01,1766,1666,100,5.7
46063,2020-03-01,739,721,18,2.4
46065,2020-03-01,9874,9590,284,2.9
46067,2020-03-01,3737,3592,145,3.9
46069,2020-03-01,705,685,20,2.8
46071,2020-03-01,1172,1110,62,5.3
46073,2020-03-01,1159,1132,27,2.3
46075,2020-03-01,520,503,17,3.3
46077,2020-03-01,2691,2599,92,3.4
46079,2020-03-01,6732,6518,214,3.2
46081,2020-03-01,13665,13276,389,2.8
46083,2020-03-01,34646,33758,888,2.6
46085,2020-03-01,1648,1570,78,4.7
46087,2020-03-01,3120,3020,100,3.2
46089,2020-03-01,1013,965,48,4.7
46091,2020-03-01,2388,2271,117,4.9
46093,2020-03-01,14028,13545,483,3.4
46095,2020-03-01,759,717,42,5.5
46097,2020-03-01,1184,1152,32,2.7
46099,2020-03-01,113477,109947,3530,3.1
46101,2020-03-01,4092,3945,147,3.6
46102,2020-03-01,3521,3252,269,7.6
46103,2020-03-01,56328,54369,1959,3.5
46105,2020-03-01,1450,1410,40,2.8
46107,2020-03-01,1014,981,33,3.3
46109,2020-03-01,4969,4683,286,5.8
46111,2020-03-01,1198,1153,45,3.8
46115,2020-03-01,3222,3082,140,4.3
46117,2020-03-01,1850,1782,68,3.7
46119,2020-03-01,810,787,23,2.8
46121,2020-03-01,3177,2992,185,5.8
46123,2020-03-01,3098,3015,83,2.7
46125,2020-03-01,4771,4606,165,3.5
46127,2020-03-01,8503,8232,271,3.2
46129,2020-03-01,2158,2016,142,6.6
46135,2020-03-01,11852,11505,347,2.9
46137,2020-03-01,936,903,33,3.5
47001,2020-03-01,35136,34002,1134,3.2
47003,2020-03-01,21276,20528,748,3.5
47005,2020-03-01,7126,6780,346,4.9
47007,2020-03-01,4422,4188,234,5.3
47009,2020-03-01,64527,62539,1988,3.1
47011,2020-03-01,53492,51723,1769,3.3
47013,2020-03-01,15047,14396,651,4.3
47015,2020-03-01,6785,6593,192,2.8
47017,2020-03-01,12202,11653,549,4.5
47019,2020-03-01,24489,23575,914,3.7
47021,2020-03-01,22551,21989,562,2.5
47023,2020-03-01,8647,8389,258,3
47025,2020-03-01,13279,12744,535,4
47027,2020-03-01,2790,2618,172,6.2
47029,2020-03-01,15094,14385,709,4.7
47031,2020-03-01,26106,25223,883,3.4
47033,2020-03-01,7096,6815,281,4
47035,2020-03-01,23806,22675,1131,4.8
47037,2020-03-01,417697,407562,10135,2.4
47039,2020-03-01,4650,4399,251,5.4
47041,2020-03-01,7774,7463,311,4
47043,2020-03-01,27874,27104,770,2.8
47045,2020-03-01,16728,15992,736,4.4
47047,2020-03-01,19342,18711,631,3.3
47049,2020-03-01,7546,7246,300,4
47051,2020-03-01,20784,20073,711,3.4
47053,2020-03-01,22488,21640,848,3.8
47055,2020-03-01,15305,14669,636,4.2
47057,2020-03-01,9659,9261,398,4.1
47059,2020-03-01,29635,28375,1260,4.3
47061,2020-03-01,5065,4854,211,4.2
47063,2020-03-01,28629,27587,1042,3.6
47065,2020-03-01,188600,182767,5833,3.1
47067,2020-03-01,2119,2010,109,5.1
47069,2020-03-01,9574,9144,430,4.5
47071,2020-03-01,10696,10217,479,4.5
47073,2020-03-01,24076,23090,986,4.1
47075,2020-03-01,7773,7433,340,4.4
47077,2020-03-01,12482,11965,517,4.1
47079,2020-03-01,14306,13685,621,4.3
47081,2020-03-01,11782,11431,351,3
47083,2020-03-01,3389,3207,182,5.4
47085,2020-03-01,9166,8811,355,3.9
47087,2020-03-01,4780,4567,213,4.5
47089,2020-03-01,25031,24137,894,3.6
47091,2020-03-01,7808,7527,281,3.6
47093,2020-03-01,247852,241139,6713,2.7
47095,2020-03-01,1752,1655,97,5.5
47097,2020-03-01,9851,9361,490,5
47099,2020-03-01,19545,18825,720,3.7
47101,2020-03-01,5179,5007,172,3.3
47103,2020-03-01,16477,15468,1009,6.1
47105,2020-03-01,23810,23003,807,3.4
47107,2020-03-01,24347,23465,882,3.6
47109,2020-03-01,8599,8166,433,5
47111,2020-03-01,11529,11188,341,3
47113,2020-03-01,49714,48136,1578,3.2
47115,2020-03-01,12765,12278,487,3.8
47117,2020-03-01,15967,15433,534,3.3
47119,2020-03-01,50930,49506,1424,2.8
47121,2020-03-01,5299,5058,241,4.5
47123,2020-03-01,20495,19749,746,3.6
47125,2020-03-01,88641,85479,3162,3.6
47127,2020-03-01,3677,3572,105,2.9
47129,2020-03-01,8014,7683,331,4.1
47131,2020-03-01,12731,12187,544,4.3
47133,2020-03-01,10216,9826,390,3.8
47135,2020-03-01,3080,2941,139,4.5
47137,2020-03-01,2394,2299,95,4
47139,2020-03-01,7695,7416,279,3.6
47141,2020-03-01,35858,34707,1151,3.2
47143,2020-03-01,13739,13033,706,5.1
47145,2020-03-01,23767,22838,929,3.9
47147,2020-03-01,39108,38067,1041,2.7
47149,2020-03-01,190119,185613,4506,2.4
47151,2020-03-01,8465,7993,472,5.6
47153,2020-03-01,6333,6084,249,3.9
47155,2020-03-01,54645,52732,1913,3.5
47157,2020-03-01,452253,435368,16885,3.7
47159,2020-03-01,9757,9454,303,3.1
47161,2020-03-01,5639,5400,239,4.2
47163,2020-03-01,71150,68648,2502,3.5
47165,2020-03-01,105724,102998,2726,2.6
47167,2020-03-01,28601,27525,1076,3.8
47169,2020-03-01,5591,5429,162,2.9
47171,2020-03-01,7237,6872,365,5
47173,2020-03-01,7714,7436,278,3.6
47175,2020-03-01,2095,1996,99,4.7
47177,2020-03-01,16562,15923,639,3.9
47179,2020-03-01,61724,59724,2000,3.2
47181,2020-03-01,6272,5991,281,4.5
47183,2020-03-01,16238,15716,522,3.2
47185,2020-03-01,12455,12012,443,3.6
47187,2020-03-01,132632,129439,3193,2.4
47189,2020-03-01,79110,77085,2025,2.6
48001,2020-03-01,23894,22884,1010,4.2
48003,2020-03-01,9784,9443,341,3.5
48005,2020-03-01,35766,33639,2127,5.9
48007,2020-03-01,9378,8781,597,6.4
48009,2020-03-01,4066,3899,167,4.1
48011,2020-03-01,933,894,39,4.2
48013,2020-03-01,21693,20531,1162,5.4
48015,2020-03-01,14134,13400,734,5.2
48017,2020-03-01,2468,2336,132,5.3
48019,2020-03-01,10025,9552,473,4.7
48021,2020-03-01,42881,41081,1800,4.2
48023,2020-03-01,1769,1702,67,3.8
48025,2020-03-01,9926,9255,671,6.8
48027,2020-03-01,144059,136459,7600,5.3
48029,2020-03-01,944253,901508,42745,4.5
48031,2020-03-01,6508,6289,219,3.4
48033,2020-03-01,434,417,17,3.9
48035,2020-03-01,8302,7874,428,5.2
48037,2020-03-01,39607,37308,2299,5.8
48039,2020-03-01,180324,169216,11108,6.2
48041,2020-03-01,120912,116323,4589,3.8
48043,2020-03-01,4248,4068,180,4.2
48045,2020-03-01,580,547,33,5.7
48047,2020-03-01,2714,2484,230,8.5
48049,2020-03-01,15595,14674,921,5.9
48051,2020-03-01,8558,8133,425,5
48053,2020-03-01,23521,22600,921,3.9
48055,2020-03-01,19677,18769,908,4.6
48057,2020-03-01,12280,11716,564,4.6
48059,2020-03-01,6068,5792,276,4.5
48061,2020-03-01,168821,155303,13518,8
48063,2020-03-01,4996,4697,299,6
48065,2020-03-01,3015,2898,117,3.9
48067,2020-03-01,12528,11733,795,6.3
48069,2020-03-01,3434,3299,135,3.9
48071,2020-03-01,19619,18297,1322,6.7
48073,2020-03-01,20819,19632,1187,5.7
48075,2020-03-01,2886,2767,119,4.1
48077,2020-03-01,4853,4638,215,4.4
48079,2020-03-01,1133,1076,57,5
48081,2020-03-01,1441,1382,59,4.1
48083,2020-03-01,2876,2676,200,7
48085,2020-03-01,563411,538583,24828,4.4
48087,2020-03-01,1138,1081,57,5
48089,2020-03-01,9792,9325,467,4.8
48091,2020-03-01,73050,69711,3339,4.6
48093,2020-03-01,5639,5333,306,5.4
48095,2020-03-01,1354,1300,54,4
48097,2020-03-01,19810,18927,883,4.5
48099,2020-03-01,24174,22854,1320,5.5
48101,2020-03-01,552,517,35,6.3
48103,2020-03-01,1559,1446,113,7.2
48105,2020-03-01,1641,1541,100,6.1
48107,2020-03-01,2486,2367,119,4.8
48109,2020-03-01,1040,992,48,4.6
48111,2020-03-01,3860,3743,117,3
48113,2020-03-01,NA,NA,65281,4.8
48115,2020-03-01,4711,4431,280,5.9
48117,2020-03-01,8483,8151,332,3.9
48119,2020-03-01,2440,2319,121,5
48121,2020-03-01,494392,473282,21110,4.3
48123,2020-03-01,9830,9454,376,3.8
48125,2020-03-01,670,631,39,5.8
48127,2020-03-01,7438,7156,282,3.8
48129,2020-03-01,1385,1318,67,4.8
48131,2020-03-01,4922,4562,360,7.3
48133,2020-03-01,8118,7710,408,5
48135,2020-03-01,86622,82541,4081,4.7
48137,2020-03-01,1140,1105,35,3.1
48139,2020-03-01,92707,88547,4160,4.5
48141,2020-03-01,363872,344345,19527,5.4
48143,2020-03-01,21024,20047,977,4.6
48145,2020-03-01,6560,6237,323,4.9
48147,2020-03-01,17391,16718,673,3.9
48149,2020-03-01,11989,11514,475,4
48151,2020-03-01,1610,1547,63,3.9
48153,2020-03-01,2595,2404,191,7.4
48155,2020-03-01,583,561,22,3.8
48157,2020-03-01,392075,372374,19701,5
48159,2020-03-01,4637,4416,221,4.8
48161,2020-03-01,6424,5951,473,7.4
48163,2020-03-01,10350,9940,410,4
48165,2020-03-01,9826,9451,375,3.8
48167,2020-03-01,165687,156198,9489,5.7
48169,2020-03-01,2162,2064,98,4.5
48171,2020-03-01,13462,12974,488,3.6
48173,2020-03-01,790,766,24,3
48175,2020-03-01,3220,3040,180,5.6
48177,2020-03-01,9644,9242,402,4.2
48179,2020-03-01,8030,7576,454,5.7
48181,2020-03-01,64022,61063,2959,4.6
48183,2020-03-01,56963,53704,3259,5.7
48185,2020-03-01,11345,10622,723,6.4
48187,2020-03-01,80927,77547,3380,4.2
48189,2020-03-01,11926,11179,747,6.3
48191,2020-03-01,1063,993,70,6.6
48193,2020-03-01,3641,3474,167,4.6
48195,2020-03-01,2703,2616,87,3.2
48197,2020-03-01,1722,1650,72,4.2
48199,2020-03-01,25077,23388,1689,6.7
48201,2020-03-01,NA,NA,129747,5.6
48203,2020-03-01,29220,27449,1771,6.1
48205,2020-03-01,2765,2698,67,2.4
48207,2020-03-01,2273,2167,106,4.7
48209,2020-03-01,119743,115065,4678,3.9
48211,2020-03-01,1858,1778,80,4.3
48213,2020-03-01,36557,34647,1910,5.2
48215,2020-03-01,359346,325686,33660,9.4
48217,2020-03-01,16382,15581,801,4.9
48219,2020-03-01,11177,10684,493,4.4
48221,2020-03-01,27445,26056,1389,5.1
48223,2020-03-01,17508,16724,784,4.5
48225,2020-03-01,10320,9799,521,5
48227,2020-03-01,14086,13420,666,4.7
48229,2020-03-01,1837,1735,102,5.6
48231,2020-03-01,43535,41279,2256,5.2
48233,2020-03-01,8705,8152,553,6.4
48235,2020-03-01,755,725,30,4
48237,2020-03-01,3360,3165,195,5.8
48239,2020-03-01,7614,7275,339,4.5
48241,2020-03-01,12932,11708,1224,9.5
48243,2020-03-01,1018,972,46,4.5
48245,2020-03-01,106763,97534,9229,8.6
48247,2020-03-01,1838,1721,117,6.4
48249,2020-03-01,16797,15458,1339,8
48251,2020-03-01,81681,77832,3849,4.7
48253,2020-03-01,5735,5386,349,6.1
48255,2020-03-01,7347,7076,271,3.7
48257,2020-03-01,64650,61617,3033,4.7
48259,2020-03-01,21998,21117,881,4
48261,2020-03-01,208,197,11,5.3
48263,2020-03-01,486,460,26,5.3
48265,2020-03-01,22147,21148,999,4.5
48267,2020-03-01,1819,1732,87,4.8
48269,2020-03-01,238,231,7,2.9
48271,2020-03-01,1417,1328,89,6.3
48273,2020-03-01,13679,12798,881,6.4
48275,2020-03-01,1437,1359,78,5.4
48277,2020-03-01,24216,23133,1083,4.5
48279,2020-03-01,5372,5081,291,5.4
48281,2020-03-01,9223,8787,436,4.7
48283,2020-03-01,4383,4194,189,4.3
48285,2020-03-01,8319,7963,356,4.3
48287,2020-03-01,9967,9550,417,4.2
48289,2020-03-01,6322,5907,415,6.6
48291,2020-03-01,33566,30924,2642,7.9
48293,2020-03-01,8629,8143,486,5.6
48295,2020-03-01,1634,1575,59,3.6
48297,2020-03-01,5643,5380,263,4.7
48299,2020-03-01,8721,8285,436,5
48301,2020-03-01,711,705,6,0.8
48303,2020-03-01,156202,150119,6083,3.9
48305,2020-03-01,2789,2650,139,5
48307,2020-03-01,3317,3107,210,6.3
48309,2020-03-01,118957,113167,5790,4.9
48311,2020-03-01,898,881,17,1.9
48313,2020-03-01,4486,4226,260,5.8
48315,2020-03-01,4196,3907,289,6.9
48317,2020-03-01,2850,2737,113,4
48319,2020-03-01,1768,1681,87,4.9
48321,2020-03-01,16970,15648,1322,7.8
48323,2020-03-01,24809,21696,3113,12.5
48325,2020-03-01,21785,20750,1035,4.8
48327,2020-03-01,859,820,39,4.5
48329,2020-03-01,105392,101854,3538,3.4
48331,2020-03-01,9630,9027,603,6.3
48333,2020-03-01,1902,1820,82,4.3
48335,2020-03-01,2308,2202,106,4.6
48337,2020-03-01,9278,8852,426,4.6
48339,2020-03-01,284136,269808,14328,5
48341,2020-03-01,10672,10294,378,3.5
48343,2020-03-01,4830,4480,350,7.2
48345,2020-03-01,479,451,28,5.8
48347,2020-03-01,27972,26418,1554,5.6
48349,2020-03-01,23888,22674,1214,5.1
48351,2020-03-01,5211,4707,504,9.7
48353,2020-03-01,7248,6933,315,4.3
48355,2020-03-01,165989,156151,9838,5.9
48357,2020-03-01,4277,4067,210,4.9
48359,2020-03-01,916,881,35,3.8
48361,2020-03-01,36154,33412,2742,7.6
48363,2020-03-01,13399,12789,610,4.6
48365,2020-03-01,10208,9554,654,6.4
48367,2020-03-01,66960,63981,2979,4.4
48369,2020-03-01,4817,4658,159,3.3
48371,2020-03-01,6341,6000,341,5.4
48373,2020-03-01,18256,16973,1283,7
48375,2020-03-01,54939,52857,2082,3.8
48377,2020-03-01,3212,2863,349,10.9
48379,2020-03-01,6108,5848,260,4.3
48381,2020-03-01,71851,69324,2527,3.5
48383,2020-03-01,1913,1833,80,4.2
48385,2020-03-01,1030,958,72,7
48387,2020-03-01,5119,4793,326,6.4
48389,2020-03-01,12358,11976,382,3.1
48391,2020-03-01,3138,2971,167,5.3
48393,2020-03-01,419,399,20,4.8
48395,2020-03-01,7822,7418,404,5.2
48397,2020-03-01,51985,49756,2229,4.3
48399,2020-03-01,4601,4386,215,4.7
48401,2020-03-01,22561,21297,1264,5.6
48403,2020-03-01,3728,3363,365,9.8
48405,2020-03-01,3545,3295,250,7.1
48407,2020-03-01,11794,11038,756,6.4
48409,2020-03-01,29831,27530,2301,7.7
48411,2020-03-01,2551,2421,130,5.1
48413,2020-03-01,1303,1242,61,4.7
48415,2020-03-01,6690,6332,358,5.4
48417,2020-03-01,1880,1806,74,3.9
48419,2020-03-01,11105,10458,647,5.8
48421,2020-03-01,1383,1333,50,3.6
48423,2020-03-01,105512,100345,5167,4.9
48425,2020-03-01,4340,4118,222,5.1
48427,2020-03-01,27069,22393,4676,17.3
48429,2020-03-01,4052,3861,191,4.7
48431,2020-03-01,578,550,28,4.8
48433,2020-03-01,567,543,24,4.2
48435,2020-03-01,1336,1260,76,5.7
48437,2020-03-01,2591,2459,132,5.1
48439,2020-03-01,NA,NA,50864,4.7
48441,2020-03-01,66326,63554,2772,4.2
48443,2020-03-01,370,348,22,5.9
48445,2020-03-01,4901,4640,261,5.3
48447,2020-03-01,641,609,32,5
48449,2020-03-01,13091,12320,771,5.9
48451,2020-03-01,53699,51381,2318,4.3
48453,2020-03-01,739887,712454,27433,3.7
48455,2020-03-01,5331,4960,371,7
48457,2020-03-01,7217,6611,606,8.4
48459,2020-03-01,17534,16512,1022,5.8
48461,2020-03-01,1696,1624,72,4.2
48463,2020-03-01,11417,10837,580,5.1
48465,2020-03-01,23184,21882,1302,5.6
48467,2020-03-01,25988,24733,1255,4.8
48469,2020-03-01,42016,39719,2297,5.5
48471,2020-03-01,24192,22844,1348,5.6
48473,2020-03-01,23541,22243,1298,5.5
48475,2020-03-01,7879,7577,302,3.8
48477,2020-03-01,15314,14533,781,5.1
48479,2020-03-01,118469,111869,6600,5.6
48481,2020-03-01,21770,20628,1142,5.2
48483,2020-03-01,2261,2153,108,4.8
48485,2020-03-01,55223,52703,2520,4.6
48487,2020-03-01,4968,4697,271,5.5
48489,2020-03-01,6959,6190,769,11.1
48491,2020-03-01,313796,301244,12552,4
48493,2020-03-01,24770,23704,1066,4.3
48495,2020-03-01,3986,3795,191,4.8
48497,2020-03-01,31965,30218,1747,5.5
48499,2020-03-01,17817,16777,1040,5.8
48501,2020-03-01,3765,3580,185,4.9
48503,2020-03-01,7874,7520,354,4.5
48505,2020-03-01,4874,4455,419,8.6
48507,2020-03-01,3478,3055,423,12.2
49001,2020-03-01,2919,2801,118,4
49003,2020-03-01,26045,24991,1054,4
49005,2020-03-01,64488,62431,2057,3.2
49007,2020-03-01,8571,8071,500,5.8
49009,2020-03-01,353,331,22,6.2
49011,2020-03-01,174132,167640,6492,3.7
49013,2020-03-01,7777,7221,556,7.1
49015,2020-03-01,4380,4082,298,6.8
49017,2020-03-01,2618,2271,347,13.3
49019,2020-03-01,6299,5859,440,7
49021,2020-03-01,25180,24108,1072,4.3
49023,2020-03-01,5812,5592,220,3.8
49025,2020-03-01,3690,3497,193,5.2
49027,2020-03-01,6124,5879,245,4
49029,2020-03-01,5568,5368,200,3.6
49031,2020-03-01,485,447,38,7.8
49033,2020-03-01,1004,944,60,6
49035,2020-03-01,637855,612450,25405,4
49037,2020-03-01,5778,5229,549,9.5
49039,2020-03-01,12561,11945,616,4.9
49041,2020-03-01,9776,9260,516,5.3
49043,2020-03-01,26701,25785,916,3.4
49045,2020-03-01,34190,32711,1479,4.3
49047,2020-03-01,13571,12506,1065,7.8
49049,2020-03-01,312307,300919,11388,3.6
49051,2020-03-01,16453,15762,691,4.2
49053,2020-03-01,77664,74169,3495,4.5
49055,2020-03-01,1452,1279,173,11.9
49057,2020-03-01,128251,122477,5774,4.5
50001,2020-03-01,20591,19883,708,3.4
50003,2020-03-01,17743,17005,738,4.2
50005,2020-03-01,14345,13713,632,4.4
50007,2020-03-01,95057,92688,2369,2.5
50009,2020-03-01,2667,2517,150,5.6
50011,2020-03-01,26893,25997,896,3.3
50013,2020-03-01,4030,3841,189,4.7
50015,2020-03-01,13742,13068,674,4.9
50017,2020-03-01,15912,15272,640,4
50019,2020-03-01,13145,12191,954,7.3
50021,2020-03-01,30267,29175,1092,3.6
50023,2020-03-01,34870,33742,1128,3.2
50025,2020-03-01,21949,21282,667,3
50027,2020-03-01,28674,27898,776,2.7
51001,2020-03-01,16332,15545,787,4.8
51003,2020-03-01,58584,56943,1641,2.8
51005,2020-03-01,6983,6673,310,4.4
51007,2020-03-01,6290,6063,227,3.6
51009,2020-03-01,15202,14611,591,3.9
51011,2020-03-01,7226,6914,312,4.3
51013,2020-03-01,157198,153757,3441,2.2
51015,2020-03-01,37479,36391,1088,2.9
51017,2020-03-01,2485,2407,78,3.1
51019,2020-03-01,38859,37505,1354,3.5
51021,2020-03-01,2914,2796,118,4
51023,2020-03-01,17584,17047,537,3.1
51025,2020-03-01,5997,5674,323,5.4
51027,2020-03-01,6763,6208,555,8.2
51029,2020-03-01,6592,6248,344,5.2
51031,2020-03-01,26327,25326,1001,3.8
51033,2020-03-01,15484,14902,582,3.8
51035,2020-03-01,13531,12719,812,6
51036,2020-03-01,3682,3539,143,3.9
51037,2020-03-01,5307,5066,241,4.5
51041,2020-03-01,190718,184639,6079,3.2
51043,2020-03-01,7618,7404,214,2.8
51045,2020-03-01,2312,2232,80,3.5
51047,2020-03-01,24880,24079,801,3.2
51049,2020-03-01,4656,4495,161,3.5
51051,2020-03-01,4901,4542,359,7.3
51053,2020-03-01,13795,13264,531,3.8
51057,2020-03-01,5524,5270,254,4.6
51059,2020-03-01,646716,629555,17161,2.7
51061,2020-03-01,37510,36440,1070,2.9
51063,2020-03-01,8155,7870,285,3.5
51065,2020-03-01,14323,13917,406,2.8
51067,2020-03-01,26592,25620,972,3.7
51069,2020-03-01,48695,47341,1354,2.8
51071,2020-03-01,8031,7663,368,4.6
51073,2020-03-01,19713,19109,604,3.1
51075,2020-03-01,11306,10960,346,3.1
51077,2020-03-01,8368,7927,441,5.3
51079,2020-03-01,10743,10455,288,2.7
51081,2020-03-01,4290,4121,169,3.9
51083,2020-03-01,15735,14965,770,4.9
51085,2020-03-01,60104,58402,1702,2.8
51087,2020-03-01,185290,179338,5952,3.2
51089,2020-03-01,24020,23048,972,4
51091,2020-03-01,1123,1079,44,3.9
51093,2020-03-01,19541,18906,635,3.2
51095,2020-03-01,37000,35829,1171,3.2
51097,2020-03-01,3858,3738,120,3.1
51099,2020-03-01,13830,13379,451,3.3
51101,2020-03-01,9255,8949,306,3.3
51103,2020-03-01,5564,5171,393,7.1
51105,2020-03-01,8382,7956,426,5.1
51107,2020-03-01,226550,220544,6006,2.7
51109,2020-03-01,20443,19796,647,3.2
51111,2020-03-01,5274,5091,183,3.5
51113,2020-03-01,7410,7225,185,2.5
51115,2020-03-01,4181,4036,145,3.5
51117,2020-03-01,12226,11639,587,4.8
51119,2020-03-01,5264,5090,174,3.3
51121,2020-03-01,50999,49273,1726,3.4
51125,2020-03-01,7528,7283,245,3.3
51127,2020-03-01,12618,12288,330,2.6
51131,2020-03-01,5180,4877,303,5.8
51133,2020-03-01,5646,5244,402,7.1
51135,2020-03-01,7358,7122,236,3.2
51137,2020-03-01,17559,16972,587,3.3
51139,2020-03-01,11978,11269,709,5.9
51141,2020-03-01,7118,6792,326,4.6
51143,2020-03-01,30092,28783,1309,4.3
51145,2020-03-01,14349,13914,435,3
51147,2020-03-01,10499,10011,488,4.6
51149,2020-03-01,15343,14752,591,3.9
51153,2020-03-01,250553,243069,7484,3
51155,2020-03-01,16679,15687,992,5.9
51157,2020-03-01,3679,3572,107,2.9
51159,2020-03-01,4096,3951,145,3.5
51161,2020-03-01,50091,48526,1565,3.1
51163,2020-03-01,10795,10447,348,3.2
51165,2020-03-01,41655,40471,1184,2.8
51167,2020-03-01,11417,10755,662,5.8
51169,2020-03-01,9204,8836,368,4
51171,2020-03-01,22624,21917,707,3.1
51173,2020-03-01,13821,13163,658,4.8
51175,2020-03-01,8975,8667,308,3.4
51177,2020-03-01,68243,65988,2255,3.3
51179,2020-03-01,73538,71212,2326,3.2
51181,2020-03-01,3641,3498,143,3.9
51183,2020-03-01,3745,3547,198,5.3
51185,2020-03-01,15729,14830,899,5.7
51187,2020-03-01,20740,20060,680,3.3
51191,2020-03-01,26968,25902,1066,4
51193,2020-03-01,9492,9059,433,4.6
51195,2020-03-01,13720,12888,832,6.1
51197,2020-03-01,13725,13009,716,5.2
51199,2020-03-01,33188,32166,1022,3.1
51510,2020-03-01,103295,100688,2607,2.5
51520,2020-03-01,7276,6951,325,4.5
51530,2020-03-01,3727,3618,109,2.9
51540,2020-03-01,27218,26496,722,2.7
51550,2020-03-01,124318,120172,4146,3.3
51570,2020-03-01,8945,8635,310,3.5
51580,2020-03-01,2466,2308,158,6.4
51590,2020-03-01,19303,18072,1231,6.4
51595,2020-03-01,2272,2156,116,5.1
51600,2020-03-01,13691,13350,341,2.5
51610,2020-03-01,8742,8543,199,2.3
51620,2020-03-01,3580,3431,149,4.2
51630,2020-03-01,14443,13910,533,3.7
51640,2020-03-01,3007,2809,198,6.6
51650,2020-03-01,65352,62495,2857,4.4
51660,2020-03-01,25179,24233,946,3.8
51670,2020-03-01,9885,9399,486,4.9
51678,2020-03-01,2145,2040,105,4.9
51680,2020-03-01,36901,35300,1601,4.3
51683,2020-03-01,22505,21827,678,3
51685,2020-03-01,9537,9265,272,2.9
51690,2020-03-01,5540,5255,285,5.1
51700,2020-03-01,90356,86569,3787,4.2
51710,2020-03-01,113317,108819,4498,4
51720,2020-03-01,1712,1620,92,5.4
51730,2020-03-01,13356,12462,894,6.7
51735,2020-03-01,6419,6234,185,2.9
51740,2020-03-01,44950,42947,2003,4.5
51750,2020-03-01,8861,8462,399,4.5
51760,2020-03-01,120511,115874,4637,3.8
51770,2020-03-01,49944,48095,1849,3.7
51775,2020-03-01,13202,12749,453,3.4
51790,2020-03-01,12335,11952,383,3.1
51800,2020-03-01,45235,43636,1599,3.5
51810,2020-03-01,236016,228594,7422,3.1
51820,2020-03-01,10796,10441,355,3.3
51830,2020-03-01,6807,6488,319,4.7
51840,2020-03-01,14923,14432,491,3.3
53001,2020-03-01,8464,7979,485,5.7
53003,2020-03-01,10220,9846,374,3.7
53005,2020-03-01,103923,98678,5245,5
53007,2020-03-01,42624,40402,2222,5.2
53009,2020-03-01,28217,26549,1668,5.9
53011,2020-03-01,242747,232047,10700,4.4
53013,2020-03-01,1728,1636,92,5.3
53015,2020-03-01,47986,45262,2724,5.7
53017,2020-03-01,20499,19290,1209,5.9
53019,2020-03-01,2357,2061,296,12.6
53021,2020-03-01,42158,39561,2597,6.2
53023,2020-03-01,770,725,45,5.8
53025,2020-03-01,44589,41488,3101,7
53027,2020-03-01,28568,26631,1937,6.8
53029,2020-03-01,36034,34362,1672,4.6
53031,2020-03-01,12908,12225,683,5.3
53033,2020-03-01,NA,NA,71383,5.6
53035,2020-03-01,129623,124196,5427,4.2
53037,2020-03-01,23677,22383,1294,5.5
53039,2020-03-01,9580,9051,529,5.5
53041,2020-03-01,34412,32290,2122,6.2
53043,2020-03-01,4586,4330,256,5.6
53045,2020-03-01,25326,23777,1549,6.1
53047,2020-03-01,18333,16891,1442,7.9
53049,2020-03-01,8358,7800,558,6.7
53051,2020-03-01,5016,4623,393,7.8
53053,2020-03-01,445908,423923,21985,4.9
53055,2020-03-01,8135,7789,346,4.3
53057,2020-03-01,62319,59096,3223,5.2
53059,2020-03-01,5520,5240,280,5.1
53061,2020-03-01,436723,411131,25592,5.9
53063,2020-03-01,257345,244261,13084,5.1
53065,2020-03-01,18932,17465,1467,7.7
53067,2020-03-01,145437,138675,6762,4.6
53069,2020-03-01,1325,1233,92,6.9
53071,2020-03-01,29844,28515,1329,4.5
53073,2020-03-01,115692,110210,5482,4.7
53075,2020-03-01,23788,22897,891,3.7
53077,2020-03-01,128874,120207,8667,6.7
54001,2020-03-01,7576,7004,572,7.6
54003,2020-03-01,58770,56583,2187,3.7
54005,2020-03-01,7668,7078,590,7.7
54007,2020-03-01,5497,4845,652,11.9
54009,2020-03-01,10082,9396,686,6.8
54011,2020-03-01,42334,40382,1952,4.6
54013,2020-03-01,2762,2209,553,20
54015,2020-03-01,3321,2892,429,12.9
54017,2020-03-01,4076,3847,229,5.6
54019,2020-03-01,16586,15233,1353,8.2
54021,2020-03-01,2516,2272,244,9.7
54023,2020-03-01,6056,5681,375,6.2
54025,2020-03-01,16145,15146,999,6.2
54027,2020-03-01,10993,10514,479,4.4
54029,2020-03-01,13155,12305,850,6.5
54031,2020-03-01,5913,5552,361,6.1
54033,2020-03-01,35374,33355,2019,5.7
54035,2020-03-01,13618,12710,908,6.7
54037,2020-03-01,30664,29660,1004,3.3
54039,2020-03-01,83690,79107,4583,5.5
54041,2020-03-01,6704,6128,576,8.6
54043,2020-03-01,7466,6839,627,8.4
54045,2020-03-01,11785,10752,1033,8.8
54047,2020-03-01,4721,4153,568,12
54049,2020-03-01,26374,24814,1560,5.9
54051,2020-03-01,14316,13026,1290,9
54053,2020-03-01,10510,9727,783,7.5
54055,2020-03-01,21596,20135,1461,6.8
54057,2020-03-01,12814,12012,802,6.3
54059,2020-03-01,7307,6461,846,11.6
54061,2020-03-01,56437,54219,2218,3.9
54063,2020-03-01,6171,5776,395,6.4
54065,2020-03-01,8260,7899,361,4.4
54067,2020-03-01,9895,8943,952,9.6
54069,2020-03-01,21112,19889,1223,5.8
54071,2020-03-01,3774,3609,165,4.4
54073,2020-03-01,3018,2742,276,9.1
54075,2020-03-01,4187,3918,269,6.4
54077,2020-03-01,16186,15250,936,5.8
54079,2020-03-01,27351,25956,1395,5.1
54081,2020-03-01,30732,28863,1869,6.1
54083,2020-03-01,12550,11643,907,7.2
54085,2020-03-01,4551,4177,374,8.2
54087,2020-03-01,5401,4745,656,12.1
54089,2020-03-01,4413,4086,327,7.4
54091,2020-03-01,8104,7607,497,6.1
54093,2020-03-01,3425,3186,239,7
54095,2020-03-01,3216,2889,327,10.2
54097,2020-03-01,9816,9075,741,7.5
54099,2020-03-01,16277,15174,1103,6.8
54101,2020-03-01,3493,3158,335,9.6
54103,2020-03-01,6836,6195,641,9.4
54105,2020-03-01,2406,2139,267,11.1
54107,2020-03-01,37735,35305,2430,6.4
54109,2020-03-01,6840,6227,613,9
55001,2020-03-01,8000,7495,505,6.3
55003,2020-03-01,7597,7211,386,5.1
55005,2020-03-01,23943,22828,1115,4.7
55007,2020-03-01,7322,6850,472,6.4
55009,2020-03-01,140385,136293,4092,2.9
55011,2020-03-01,6360,6020,340,5.3
55013,2020-03-01,6945,6468,477,6.9
55015,2020-03-01,27084,26377,707,2.6
55017,2020-03-01,33367,31789,1578,4.7
55019,2020-03-01,17506,16895,611,3.5
55021,2020-03-01,31654,30620,1034,3.3
55023,2020-03-01,7408,6997,411,5.5
55025,2020-03-01,321488,314587,6901,2.1
55027,2020-03-01,46946,45486,1460,3.1
55029,2020-03-01,13811,13131,680,4.9
55031,2020-03-01,22875,21690,1185,5.2
55033,2020-03-01,24521,23529,992,4
55035,2020-03-01,58685,56993,1692,2.9
55037,2020-03-01,2161,2055,106,4.9
55039,2020-03-01,56591,54900,1691,3
55041,2020-03-01,3976,3749,227,5.7
55043,2020-03-01,28129,27161,968,3.4
55045,2020-03-01,21053,20391,662,3.1
55047,2020-03-01,9002,8584,418,4.6
55049,2020-03-01,13754,13264,490,3.6
55051,2020-03-01,2500,2342,158,6.3
55053,2020-03-01,10091,9596,495,4.9
55055,2020-03-01,45650,44161,1489,3.3
55057,2020-03-01,13360,12831,529,4
55059,2020-03-01,86918,83500,3418,3.9
55061,2020-03-01,10883,10529,354,3.3
55063,2020-03-01,65856,64101,1755,2.7
55065,2020-03-01,10082,9781,301,3
55067,2020-03-01,9201,8770,431,4.7
55069,2020-03-01,15022,14369,653,4.3
55071,2020-03-01,40686,39236,1450,3.6
55073,2020-03-01,73692,71668,2024,2.7
55075,2020-03-01,19212,18240,972,5.1
55077,2020-03-01,7710,7355,355,4.6
55078,2020-03-01,1560,1467,93,6
55079,2020-03-01,462615,445666,16949,3.7
55081,2020-03-01,23176,22479,697,3
55083,2020-03-01,20494,19590,904,4.4
55085,2020-03-01,17047,16129,918,5.4
55087,2020-03-01,101547,98710,2837,2.8
55089,2020-03-01,48449,47255,1194,2.5
55091,2020-03-01,4032,3860,172,4.3
55093,2020-03-01,25073,24053,1020,4.1
55095,2020-03-01,24460,23094,1366,5.6
55097,2020-03-01,38678,37363,1315,3.4
55099,2020-03-01,6347,6054,293,4.6
55101,2020-03-01,96984,92966,4018,4.1
55103,2020-03-01,9080,8765,315,3.5
55105,2020-03-01,84583,81348,3235,3.8
55107,2020-03-01,6597,6255,342,5.2
55109,2020-03-01,49911,47907,2004,4
55111,2020-03-01,34994,33859,1135,3.2
55113,2020-03-01,7603,7169,434,5.7
55115,2020-03-01,20642,19896,746,3.6
55117,2020-03-01,60703,59011,1692,2.8
55119,2020-03-01,10881,10369,512,4.7
55121,2020-03-01,15774,15094,680,4.3
55123,2020-03-01,15128,14540,588,3.9
55125,2020-03-01,9526,9002,524,5.5
55127,2020-03-01,57080,55199,1881,3.3
55129,2020-03-01,7717,7309,408,5.3
55131,2020-03-01,76567,74452,2115,2.8
55133,2020-03-01,222810,216817,5993,2.7
55135,2020-03-01,25574,24700,874,3.4
55137,2020-03-01,11233,10714,519,4.6
55139,2020-03-01,90159,87717,2442,2.7
55141,2020-03-01,34891,33497,1394,4
56001,2020-03-01,22029,21339,690,3.1
56003,2020-03-01,5189,4903,286,5.5
56005,2020-03-01,23566,22600,966,4.1
56007,2020-03-01,7655,7328,327,4.3
56009,2020-03-01,8997,8700,297,3.3
56011,2020-03-01,3581,3449,132,3.7
56013,2020-03-01,19127,18115,1012,5.3
56015,2020-03-01,6433,6180,253,3.9
56017,2020-03-01,2227,2130,97,4.4
56019,2020-03-01,4033,3849,184,4.6
56021,2020-03-01,49303,47371,1932,3.9
56023,2020-03-01,8992,8588,404,4.5
56025,2020-03-01,39310,37489,1821,4.6
56027,2020-03-01,1183,1148,35,3
56029,2020-03-01,14646,13894,752,5.1
56031,2020-03-01,4549,4349,200,4.4
56033,2020-03-01,15795,15091,704,4.5
56035,2020-03-01,4050,3785,265,6.5
56037,2020-03-01,21297,20097,1200,5.6
56039,2020-03-01,14961,14527,434,2.9
56041,2020-03-01,9026,8589,437,4.8
56043,2020-03-01,3840,3638,202,5.3
56045,2020-03-01,3816,3691,125,3.3
72001,2020-03-01,NA,NA,NA,NA
72003,2020-03-01,NA,NA,NA,NA
72005,2020-03-01,NA,NA,NA,NA
72007,2020-03-01,NA,NA,NA,NA
72009,2020-03-01,NA,NA,NA,NA
72011,2020-03-01,NA,NA,NA,NA
72013,2020-03-01,NA,NA,NA,NA
72015,2020-03-01,NA,NA,NA,NA
72017,2020-03-01,NA,NA,NA,NA
72019,2020-03-01,NA,NA,NA,NA
72021,2020-03-01,NA,NA,NA,NA
72023,2020-03-01,NA,NA,NA,NA
72025,2020-03-01,NA,NA,NA,NA
72027,2020-03-01,NA,NA,NA,NA
72029,2020-03-01,NA,NA,NA,NA
72031,2020-03-01,NA,NA,NA,NA
72033,2020-03-01,NA,NA,NA,NA
72035,2020-03-01,NA,NA,NA,NA
72037,2020-03-01,NA,NA,NA,NA
72039,2020-03-01,NA,NA,NA,NA
72041,2020-03-01,NA,NA,NA,NA
72043,2020-03-01,NA,NA,NA,NA
72045,2020-03-01,NA,NA,NA,NA
72047,2020-03-01,NA,NA,NA,NA
72049,2020-03-01,NA,NA,NA,NA
72051,2020-03-01,NA,NA,NA,NA
72053,2020-03-01,NA,NA,NA,NA
72054,2020-03-01,NA,NA,NA,NA
72055,2020-03-01,NA,NA,NA,NA
72057,2020-03-01,NA,NA,NA,NA
72059,2020-03-01,NA,NA,NA,NA
72061,2020-03-01,NA,NA,NA,NA
72063,2020-03-01,NA,NA,NA,NA
72065,2020-03-01,NA,NA,NA,NA
72067,2020-03-01,NA,NA,NA,NA
72069,2020-03-01,NA,NA,NA,NA
72071,2020-03-01,NA,NA,NA,NA
72073,2020-03-01,NA,NA,NA,NA
72075,2020-03-01,NA,NA,NA,NA
72077,2020-03-01,NA,NA,NA,NA
72079,2020-03-01,NA,NA,NA,NA
72081,2020-03-01,NA,NA,NA,NA
72083,2020-03-01,NA,NA,NA,NA
72085,2020-03-01,NA,NA,NA,NA
72087,2020-03-01,NA,NA,NA,NA
72089,2020-03-01,NA,NA,NA,NA
72091,2020-03-01,NA,NA,NA,NA
72093,2020-03-01,NA,NA,NA,NA
72095,2020-03-01,NA,NA,NA,NA
72097,2020-03-01,NA,NA,NA,NA
72099,2020-03-01,NA,NA,NA,NA
72101,2020-03-01,NA,NA,NA,NA
72103,2020-03-01,NA,NA,NA,NA
72105,2020-03-01,NA,NA,NA,NA
72107,2020-03-01,NA,NA,NA,NA
72109,2020-03-01,NA,NA,NA,NA
72111,2020-03-01,NA,NA,NA,NA
72113,2020-03-01,NA,NA,NA,NA
72115,2020-03-01,NA,NA,NA,NA
72117,2020-03-01,NA,NA,NA,NA
72119,2020-03-01,NA,NA,NA,NA
72121,2020-03-01,NA,NA,NA,NA
72123,2020-03-01,NA,NA,NA,NA
72125,2020-03-01,NA,NA,NA,NA
72127,2020-03-01,NA,NA,NA,NA
72129,2020-03-01,NA,NA,NA,NA
72131,2020-03-01,NA,NA,NA,NA
72133,2020-03-01,NA,NA,NA,NA
72135,2020-03-01,NA,NA,NA,NA
72137,2020-03-01,NA,NA,NA,NA
72139,2020-03-01,NA,NA,NA,NA
72141,2020-03-01,NA,NA,NA,NA
72143,2020-03-01,NA,NA,NA,NA
72145,2020-03-01,NA,NA,NA,NA
72147,2020-03-01,NA,NA,NA,NA
72149,2020-03-01,NA,NA,NA,NA
72151,2020-03-01,NA,NA,NA,NA
72153,2020-03-01,NA,NA,NA,NA
01001,2020-04-01,25140,22262,2878,11.4
01003,2020-04-01,93597,79140,14457,15.4
01005,2020-04-01,8116,7310,806,9.9
01007,2020-04-01,9023,7428,1595,17.7
01009,2020-04-01,23944,21685,2259,9.4
01011,2020-04-01,4339,3947,392,9
01013,2020-04-01,9622,7728,1894,19.7
01015,2020-04-01,47895,39178,8717,18.2
01017,2020-04-01,16369,13829,2540,15.5
01019,2020-04-01,11807,10378,1429,12.1
01021,2020-04-01,19318,16973,2345,12.1
01023,2020-04-01,4306,3783,523,12.1
01025,2020-04-01,7422,6311,1111,15
01027,2020-04-01,5791,5259,532,9.2
01029,2020-04-01,5518,4821,697,12.6
01031,2020-04-01,20213,18311,1902,9.4
01033,2020-04-01,23538,19629,3909,16.6
01035,2020-04-01,4488,3827,661,14.7
01037,2020-04-01,4447,3872,575,12.9
01039,2020-04-01,14616,13066,1550,10.6
01041,2020-04-01,6450,5450,1000,15.5
01043,2020-04-01,37939,33514,4425,11.7
01045,2020-04-01,19449,17608,1841,9.5
01047,2020-04-01,15441,12232,3209,20.8
01049,2020-04-01,30221,26709,3512,11.6
01051,2020-04-01,36017,32016,4001,11.1
01053,2020-04-01,14122,12478,1644,11.6
01055,2020-04-01,43456,35210,8246,19
01057,2020-04-01,6359,5660,699,11
01059,2020-04-01,14130,12534,1596,11.3
01061,2020-04-01,10109,9289,820,8.1
01063,2020-04-01,3125,2439,686,22
01065,2020-04-01,6431,5108,1323,20.6
01067,2020-04-01,6408,5818,590,9.2
01069,2020-04-01,43989,39144,4845,11
01071,2020-04-01,22728,19721,3007,13.2
01073,2020-04-01,312995,273547,39448,12.6
01075,2020-04-01,5654,5000,654,11.6
01077,2020-04-01,41531,35460,6071,14.6
01079,2020-04-01,13548,11980,1568,11.6
01081,2020-04-01,74427,65166,9261,12.4
01083,2020-04-01,42495,37611,4884,11.5
01085,2020-04-01,3994,2956,1038,26
01087,2020-04-01,8279,6733,1546,18.7
01089,2020-04-01,177840,159193,18647,10.5
01091,2020-04-01,7345,6475,870,11.8
01093,2020-04-01,12542,11155,1387,11.1
01095,2020-04-01,42905,38210,4695,10.9
01097,2020-04-01,186958,158736,28222,15.1
01099,2020-04-01,7411,6239,1172,15.8
01101,2020-04-01,105760,89836,15924,15.1
01103,2020-04-01,55334,49192,6142,11.1
01105,2020-04-01,3533,2801,732,20.7
01107,2020-04-01,7775,6675,1100,14.1
01109,2020-04-01,14801,13464,1337,9
01111,2020-04-01,9391,8218,1173,12.5
01113,2020-04-01,22396,19997,2399,10.7
01115,2020-04-01,40058,34795,5263,13.1
01117,2020-04-01,110299,100149,10150,9.2
01119,2020-04-01,4712,4100,612,13
01121,2020-04-01,37967,30463,7504,19.8
01123,2020-04-01,19136,16025,3111,16.3
01125,2020-04-01,107364,89577,17787,16.6
01127,2020-04-01,24795,21598,3197,12.9
01129,2020-04-01,6483,5666,817,12.6
01131,2020-04-01,2894,2233,661,22.8
01133,2020-04-01,9840,8823,1017,10.3
02013,2020-04-01,2302,2078,224,9.7
02016,2020-04-01,3849,3676,173,4.5
02020,2020-04-01,143893,123898,19995,13.9
02050,2020-04-01,6695,5854,841,12.6
02060,2020-04-01,406,364,42,10.3
02068,2020-04-01,673,507,166,24.7
02070,2020-04-01,1833,1657,176,9.6
02090,2020-04-01,42677,37874,4803,11.3
02100,2020-04-01,1018,740,278,27.3
02105,2020-04-01,937,768,169,18
02110,2020-04-01,16273,14502,1771,10.9
02122,2020-04-01,24143,19989,4154,17.2
02130,2020-04-01,6217,5137,1080,17.4
02150,2020-04-01,5484,4903,581,10.6
02158,2020-04-01,2530,2015,515,20.4
02164,2020-04-01,613,526,87,14.2
02170,2020-04-01,45906,38770,7136,15.5
02180,2020-04-01,3874,3381,493,12.7
02185,2020-04-01,3242,3059,183,5.6
02188,2020-04-01,2752,2351,401,14.6
02195,2020-04-01,1288,1087,201,15.6
02198,2020-04-01,2628,2271,357,13.6
02220,2020-04-01,4055,3536,519,12.8
02230,2020-04-01,669,458,211,31.5
02240,2020-04-01,2567,2295,272,10.6
02261,2020-04-01,4340,3736,604,13.9
02275,2020-04-01,935,797,138,14.8
02282,2020-04-01,231,203,28,12.1
02290,2020-04-01,2361,2000,361,15.3
04001,2020-04-01,20086,16923,3163,15.7
04003,2020-04-01,50443,44850,5593,11.1
04005,2020-04-01,71690,59231,12459,17.4
04007,2020-04-01,21205,18722,2483,11.7
04009,2020-04-01,15390,14210,1180,7.7
04011,2020-04-01,4560,4315,245,5.4
04012,2020-04-01,9072,8288,784,8.6
04013,2020-04-01,NA,NA,288464,12.5
04015,2020-04-01,86810,70023,16787,19.3
04017,2020-04-01,40177,34421,5756,14.3
04019,2020-04-01,497905,434363,63542,12.8
04021,2020-04-01,183683,161617,22066,12
04023,2020-04-01,19320,16248,3072,15.9
04025,2020-04-01,109749,94226,15523,14.1
04027,2020-04-01,96910,73904,23006,23.7
05001,2020-04-01,8773,8313,460,5.2
05003,2020-04-01,7188,6278,910,12.7
05005,2020-04-01,15796,14108,1688,10.7
05007,2020-04-01,130437,119915,10522,8.1
05009,2020-04-01,15782,14084,1698,10.8
05011,2020-04-01,4368,3892,476,10.9
05013,2020-04-01,2297,2125,172,7.5
05015,2020-04-01,12502,11157,1345,10.8
05017,2020-04-01,3059,2628,431,14.1
05019,2020-04-01,9253,8396,857,9.3
05021,2020-04-01,5295,4830,465,8.8
05023,2020-04-01,9273,7796,1477,15.9
05025,2020-04-01,3088,2816,272,8.8
05027,2020-04-01,8929,8076,853,9.6
05029,2020-04-01,8052,7154,898,11.2
05031,2020-04-01,54877,49848,5029,9.2
05033,2020-04-01,25775,23348,2427,9.4
05035,2020-04-01,20768,17873,2895,13.9
05037,2020-04-01,7195,6436,759,10.5
05039,2020-04-01,2649,2394,255,9.6
05041,2020-04-01,5074,4588,486,9.6
05043,2020-04-01,7487,6669,818,10.9
05045,2020-04-01,59805,53364,6441,10.8
05047,2020-04-01,7156,6530,626,8.7
05049,2020-04-01,4749,4390,359,7.6
05051,2020-04-01,39997,33741,6256,15.6
05053,2020-04-01,7831,7177,654,8.4
05055,2020-04-01,19578,17507,2071,10.6
05057,2020-04-01,9346,8539,807,8.6
05059,2020-04-01,13440,12007,1433,10.7
05061,2020-04-01,5299,4866,433,8.2
05063,2020-04-01,16561,14612,1949,11.8
05065,2020-04-01,4778,4125,653,13.7
05067,2020-04-01,5362,4804,558,10.4
05069,2020-04-01,26702,23925,2777,10.4
05071,2020-04-01,9917,8799,1118,11.3
05073,2020-04-01,2354,2102,252,10.7
05075,2020-04-01,6681,6049,632,9.5
05077,2020-04-01,2627,2368,259,9.9
05079,2020-04-01,3780,3436,344,9.1
05081,2020-04-01,5283,4734,549,10.4
05083,2020-04-01,8188,7181,1007,12.3
05085,2020-04-01,32470,29413,3057,9.4
05087,2020-04-01,6894,6491,403,5.8
05089,2020-04-01,6295,5724,571,9.1
05091,2020-04-01,19605,16965,2640,13.5
05093,2020-04-01,16937,14721,2216,13.1
05095,2020-04-01,2600,2376,224,8.6
05097,2020-04-01,2761,2468,293,10.6
05099,2020-04-01,3450,3137,313,9.1
05101,2020-04-01,3210,2914,296,9.2
05103,2020-04-01,9369,8463,906,9.7
05105,2020-04-01,4006,3613,393,9.8
05107,2020-04-01,6126,5277,849,13.9
05109,2020-04-01,4055,3694,361,8.9
05111,2020-04-01,9904,9136,768,7.8
05113,2020-04-01,7751,6943,808,10.4
05115,2020-04-01,27880,25217,2663,9.6
05117,2020-04-01,3365,3113,252,7.5
05119,2020-04-01,183876,161950,21926,11.9
05121,2020-04-01,7148,6450,698,9.8
05123,2020-04-01,7898,6965,933,11.8
05125,2020-04-01,55650,50625,5025,9
05127,2020-04-01,4084,3828,256,6.3
05129,2020-04-01,2776,2472,304,11
05131,2020-04-01,55235,49185,6050,11
05133,2020-04-01,5193,4760,433,8.3
05135,2020-04-01,5579,4948,631,11.3
05137,2020-04-01,4560,4017,543,11.9
05139,2020-04-01,15107,13330,1777,11.8
05141,2020-04-01,5560,4915,645,11.6
05143,2020-04-01,119418,109397,10021,8.4
05145,2020-04-01,32405,29135,3270,10.1
05147,2020-04-01,2557,2349,208,8.1
05149,2020-04-01,7943,7367,576,7.3
06001,2020-04-01,804162,691247,112915,14
06003,2020-04-01,501,393,108,21.6
06005,2020-04-01,14521,12428,2093,14.4
06007,2020-04-01,93891,79338,14553,15.5
06009,2020-04-01,20667,17928,2739,13.3
06011,2020-04-01,10692,7808,2884,27
06013,2020-04-01,536549,458780,77769,14.5
06015,2020-04-01,9605,8332,1273,13.3
06017,2020-04-01,89864,76156,13708,15.3
06019,2020-04-01,450261,374357,75904,16.9
06021,2020-04-01,11405,9579,1826,16
06023,2020-04-01,62249,53636,8613,13.8
06025,2020-04-01,71885,51713,20172,28.1
06027,2020-04-01,8184,7056,1128,13.8
06029,2020-04-01,370837,301605,69232,18.7
06031,2020-04-01,57120,47407,9713,17
06033,2020-04-01,25957,21616,4341,16.7
06035,2020-04-01,9034,7990,1044,11.6
06037,2020-04-01,NA,NA,866928,18.2
06039,2020-04-01,62100,51730,10370,16.7
06041,2020-04-01,128079,113713,14366,11.2
06043,2020-04-01,7843,6416,1427,18.2
06045,2020-04-01,37563,32040,5523,14.7
06047,2020-04-01,115510,93893,21617,18.7
06049,2020-04-01,3071,2643,428,13.9
06051,2020-04-01,6515,4671,1844,28.3
06053,2020-04-01,201695,160322,41373,20.5
06055,2020-04-01,72320,60709,11611,16.1
06057,2020-04-01,42978,36431,6547,15.2
06059,2020-04-01,NA,NA,212626,13.8
06061,2020-04-01,179930,156462,23468,13
06063,2020-04-01,6779,5370,1409,20.8
06065,2020-04-01,NA,915734,169466,15.6
06067,2020-04-01,689861,590134,99727,14.5
06069,2020-04-01,32255,26149,6106,18.9
06071,2020-04-01,933853,806564,127289,13.6
06073,2020-04-01,NA,NA,232794,15
06075,2020-04-01,553710,483904,69806,12.6
06077,2020-04-01,325606,267666,57940,17.8
06079,2020-04-01,133405,114748,18657,14
06081,2020-04-01,431079,382084,48995,11.4
06083,2020-04-01,212287,182837,29450,13.9
06085,2020-04-01,NA,898326,119385,11.7
06087,2020-04-01,134979,112008,22971,17
06089,2020-04-01,72127,60907,11220,15.6
06091,2020-04-01,1184,1011,173,14.6
06093,2020-04-01,16529,13941,2588,15.7
06095,2020-04-01,201461,171064,30397,15.1
06097,2020-04-01,248613,212537,36076,14.5
06099,2020-04-01,233351,192522,40829,17.5
06101,2020-04-01,45124,36922,8202,18.2
06103,2020-04-01,25399,21750,3649,14.4
06105,2020-04-01,4342,3791,551,12.7
06107,2020-04-01,195697,157904,37793,19.3
06109,2020-04-01,21979,18184,3795,17.3
06111,2020-04-01,412295,354886,57409,13.9
06113,2020-04-01,101299,89524,11775,11.6
06115,2020-04-01,29686,24896,4790,16.1
08001,2020-04-01,268896,234939,33957,12.6
08003,2020-04-01,7564,6836,728,9.6
08005,2020-04-01,359691,314916,44775,12.4
08007,2020-04-01,6338,5300,1038,16.4
08009,2020-04-01,1823,1771,52,2.9
08011,2020-04-01,1646,1560,86,5.2
08013,2020-04-01,192996,174179,18817,9.7
08014,2020-04-01,39035,34714,4321,11.1
08015,2020-04-01,8768,7597,1171,13.4
08017,2020-04-01,1022,997,25,2.4
08019,2020-04-01,6219,5237,982,15.8
08021,2020-04-01,3616,3308,308,8.5
08023,2020-04-01,1619,1484,135,8.3
08025,2020-04-01,1258,1173,85,6.8
08027,2020-04-01,1777,1643,134,7.5
08029,2020-04-01,12642,11318,1324,10.5
08031,2020-04-01,415800,360065,55735,13.4
08033,2020-04-01,1047,912,135,12.9
08035,2020-04-01,187087,168270,18817,10.1
08037,2020-04-01,37139,29349,7790,21
08039,2020-04-01,14325,13236,1089,7.6
08041,2020-04-01,332426,290857,41569,12.5
08043,2020-04-01,13176,11460,1716,13
08045,2020-04-01,29489,25456,4033,13.7
08047,2020-04-01,4272,3278,994,23.3
08049,2020-04-01,9172,7388,1784,19.5
08051,2020-04-01,10567,8844,1723,16.3
08053,2020-04-01,292,265,27,9.2
08055,2020-04-01,2181,1905,276,12.7
08057,2020-04-01,874,809,65,7.4
08059,2020-04-01,329784,289971,39813,12.1
08061,2020-04-01,842,820,22,2.6
08063,2020-04-01,3666,3516,150,4.1
08065,2020-04-01,4791,3967,824,17.2
08067,2020-04-01,28608,24692,3916,13.7
08069,2020-04-01,201200,178807,22393,11.1
08071,2020-04-01,5760,5141,619,10.7
08073,2020-04-01,1960,1837,123,6.3
08075,2020-04-01,9346,8676,670,7.2
08077,2020-04-01,74253,64875,9378,12.6
08079,2020-04-01,463,412,51,11
08081,2020-04-01,6259,5586,673,10.8
08083,2020-04-01,11180,9819,1361,12.2
08085,2020-04-01,19548,17150,2398,12.3
08087,2020-04-01,14107,13127,980,6.9
08089,2020-04-01,7204,6640,564,7.8
08091,2020-04-01,2190,1774,416,19
08093,2020-04-01,10770,9684,1086,10.1
08095,2020-04-01,2241,2155,86,3.8
08097,2020-04-01,11495,8781,2714,23.6
08099,2020-04-01,5470,5191,279,5.1
08101,2020-04-01,73254,64675,8579,11.7
08103,2020-04-01,2605,2409,196,7.5
08105,2020-04-01,4848,4321,527,10.9
08107,2020-04-01,15692,12843,2849,18.2
08109,2020-04-01,3152,2926,226,7.2
08111,2020-04-01,443,379,64,14.4
08113,2020-04-01,5969,4605,1364,22.9
08115,2020-04-01,1081,1038,43,4
08117,2020-04-01,23562,18471,5091,21.6
08119,2020-04-01,12835,10901,1934,15.1
08121,2020-04-01,2440,2348,92,3.8
08123,2020-04-01,164491,148146,16345,9.9
08125,2020-04-01,5225,5053,172,3.3
09001,2020-04-01,432447,398335,34112,7.9
09003,2020-04-01,455585,419680,35905,7.9
09005,2020-04-01,96949,89741,7208,7.4
09007,2020-04-01,88083,82021,6062,6.9
09009,2020-04-01,426751,393114,33637,7.9
09011,2020-04-01,120296,105656,14640,12.2
09013,2020-04-01,81538,76242,5296,6.5
09015,2020-04-01,59568,54729,4839,8.1
10001,2020-04-01,77949,65615,12334,15.8
10003,2020-04-01,285481,245241,40240,14.1
10005,2020-04-01,99535,83649,15886,16
11001,2020-04-01,405479,362532,42947,10.6
12001,2020-04-01,124310,113349,10961,8.8
12003,2020-04-01,10207,9476,731,7.2
12005,2020-04-01,77556,67394,10162,13.1
12007,2020-04-01,9831,9046,785,8
12009,2020-04-01,267189,232927,34262,12.8
12011,2020-04-01,940796,800271,140525,14.9
12013,2020-04-01,4226,3911,315,7.5
12015,2020-04-01,67281,57397,9884,14.7
12017,2020-04-01,45445,38685,6760,14.9
12019,2020-04-01,95568,86157,9411,9.8
12021,2020-04-01,165603,143365,22238,13.4
12023,2020-04-01,26740,24255,2485,9.3
12027,2020-04-01,13670,12711,959,7
12029,2020-04-01,5213,4836,377,7.2
12031,2020-04-01,443405,392547,50858,11.5
12033,2020-04-01,134040,117143,16897,12.6
12035,2020-04-01,44104,37418,6686,15.2
12037,2020-04-01,4167,3724,443,10.6
12039,2020-04-01,16634,15370,1264,7.6
12041,2020-04-01,6231,5751,480,7.7
12043,2020-04-01,4989,4644,345,6.9
12045,2020-04-01,5013,4570,443,8.8
12047,2020-04-01,3832,3475,357,9.3
12049,2020-04-01,7924,7339,585,7.4
12051,2020-04-01,14362,12972,1390,9.7
12053,2020-04-01,66785,56874,9911,14.8
12055,2020-04-01,33826,30234,3592,10.6
12057,2020-04-01,685251,600714,84537,12.3
12059,2020-04-01,6251,5722,529,8.5
12061,2020-04-01,60549,52060,8489,14
12063,2020-04-01,15295,14117,1178,7.7
12065,2020-04-01,4924,4555,369,7.5
12067,2020-04-01,2483,2368,115,4.6
12069,2020-04-01,147195,125171,22024,15
12071,2020-04-01,321431,274440,46991,14.6
12073,2020-04-01,137108,125514,11594,8.5
12075,2020-04-01,15161,13560,1601,10.6
12077,2020-04-01,2308,2155,153,6.6
12079,2020-04-01,6637,6145,492,7.4
12081,2020-04-01,161732,139910,21822,13.5
12083,2020-04-01,129001,113464,15537,12
12085,2020-04-01,68543,60432,8111,11.8
12086,2020-04-01,NA,NA,123408,10.3
12087,2020-04-01,48467,39906,8561,17.7
12089,2020-04-01,37532,32972,4560,12.1
12091,2020-04-01,88492,76724,11768,13.3
12093,2020-04-01,15807,14616,1191,7.5
12095,2020-04-01,724131,599392,124739,17.2
12097,2020-04-01,183696,144197,39499,21.5
12099,2020-04-01,652840,560451,92389,14.2
12101,2020-04-01,220211,189715,30496,13.8
12103,2020-04-01,460435,395727,64708,14.1
12105,2020-04-01,288555,248159,40396,14
12107,2020-04-01,24005,21427,2578,10.7
12109,2020-04-01,120379,106446,13933,11.6
12111,2020-04-01,136528,117247,19281,14.1
12113,2020-04-01,74449,66664,7785,10.5
12115,2020-04-01,172051,146672,25379,14.8
12117,2020-04-01,230879,200711,30168,13.1
12119,2020-04-01,30522,26783,3739,12.3
12121,2020-04-01,16206,14875,1331,8.2
12123,2020-04-01,7485,6897,588,7.9
12125,2020-04-01,4122,3842,280,6.8
12127,2020-04-01,237627,203007,34620,14.6
12129,2020-04-01,13098,12090,1008,7.7
12131,2020-04-01,29209,24961,4248,14.5
12133,2020-04-01,8630,7784,846,9.8
13001,2020-04-01,9393,8725,668,7.1
13003,2020-04-01,4350,4020,330,7.6
13005,2020-04-01,4816,4452,364,7.6
13007,2020-04-01,1089,1001,88,8.1
13009,2020-04-01,17850,15996,1854,10.4
13011,2020-04-01,9692,8817,875,9
13013,2020-04-01,38050,33633,4417,11.6
13015,2020-04-01,48992,41919,7073,14.4
13017,2020-04-01,5307,4728,579,10.9
13019,2020-04-01,7577,6550,1027,13.6
13021,2020-04-01,64477,56725,7752,12
13023,2020-04-01,4279,3879,400,9.3
13025,2020-04-01,6106,5408,698,11.4
13027,2020-04-01,6461,5975,486,7.5
13029,2020-04-01,16729,14639,2090,12.5
13031,2020-04-01,36706,32639,4067,11.1
13033,2020-04-01,8541,7666,875,10.2
13035,2020-04-01,10047,8903,1144,11.4
13037,2020-04-01,2238,2104,134,6
13039,2020-04-01,20102,18201,1901,9.5
13043,2020-04-01,5519,5150,369,6.7
13045,2020-04-01,52340,45690,6650,12.7
13047,2020-04-01,32266,29179,3087,9.6
13049,2020-04-01,4509,4252,257,5.7
13051,2020-04-01,133316,111354,21962,16.5
13053,2020-04-01,1835,1642,193,10.5
13055,2020-04-01,10231,8546,1685,16.5
13057,2020-04-01,126937,113034,13903,11
13059,2020-04-01,56619,49728,6891,12.2
13061,2020-04-01,942,781,161,17.1
13063,2020-04-01,134689,113083,21606,16
13065,2020-04-01,2523,2346,177,7
13067,2020-04-01,398408,353043,45365,11.4
13069,2020-04-01,18924,17115,1809,9.6
13071,2020-04-01,21144,19583,1561,7.4
13073,2020-04-01,69694,63778,5916,8.5
13075,2020-04-01,7980,7359,621,7.8
13077,2020-04-01,71269,62036,9233,13
13079,2020-04-01,5213,4722,491,9.4
13081,2020-04-01,9542,8607,935,9.8
13083,2020-04-01,7658,7075,583,7.6
13085,2020-04-01,11607,10251,1356,11.7
13087,2020-04-01,11151,10360,791,7.1
13089,2020-04-01,380756,330081,50675,13.3
13091,2020-04-01,6518,5942,576,8.8
13093,2020-04-01,5244,4471,773,14.7
13095,2020-04-01,36462,31847,4615,12.7
13097,2020-04-01,69230,60452,8778,12.7
13099,2020-04-01,4233,3995,238,5.6
13101,2020-04-01,1793,1686,107,6
13103,2020-04-01,28030,24759,3271,11.7
13105,2020-04-01,7888,6903,985,12.5
13107,2020-04-01,8109,7375,734,9.1
13109,2020-04-01,4757,4383,374,7.9
13111,2020-04-01,12402,11278,1124,9.1
13113,2020-04-01,53715,48173,5542,10.3
13115,2020-04-01,44151,38302,5849,13.2
13117,2020-04-01,113375,101689,11686,10.3
13119,2020-04-01,10190,9043,1147,11.3
13121,2020-04-01,534045,460274,73771,13.8
13123,2020-04-01,11241,10039,1202,10.7
13125,2020-04-01,1194,1115,79,6.6
13127,2020-04-01,35107,28917,6190,17.6
13129,2020-04-01,29018,25451,3567,12.3
13131,2020-04-01,10175,9326,849,8.3
13133,2020-04-01,7095,6378,717,10.1
13135,2020-04-01,464061,406247,57814,12.5
13137,2020-04-01,18815,16816,1999,10.6
13139,2020-04-01,96843,86528,10315,10.7
13141,2020-04-01,2527,2230,297,11.8
13143,2020-04-01,11813,10385,1428,12.1
13145,2020-04-01,15403,13827,1576,10.2
13147,2020-04-01,11070,9967,1103,10
13149,2020-04-01,5094,4356,738,14.5
13151,2020-04-01,110213,95487,14726,13.4
13153,2020-04-01,65089,58511,6578,10.1
13155,2020-04-01,3349,3064,285,8.5
13157,2020-04-01,36555,32660,3895,10.7
13159,2020-04-01,6368,5776,592,9.3
13161,2020-04-01,5832,5341,491,8.4
13163,2020-04-01,6465,5861,604,9.3
13165,2020-04-01,3004,2747,257,8.6
13167,2020-04-01,3922,3628,294,7.5
13169,2020-04-01,12574,11553,1021,8.1
13171,2020-04-01,7559,6767,792,10.5
13173,2020-04-01,3534,3189,345,9.8
13175,2020-04-01,19177,17000,2177,11.4
13177,2020-04-01,13731,12450,1281,9.3
13179,2020-04-01,24924,22247,2677,10.7
13181,2020-04-01,3316,3022,294,8.9
13183,2020-04-01,7529,6973,556,7.4
13185,2020-04-01,48736,43727,5009,10.3
13187,2020-04-01,16159,14414,1745,10.8
13189,2020-04-01,8524,7370,1154,13.5
13191,2020-04-01,5231,4613,618,11.8
13193,2020-04-01,4494,4091,403,9
13195,2020-04-01,12540,11222,1318,10.5
13197,2020-04-01,2943,2714,229,7.8
13199,2020-04-01,8679,7308,1371,15.8
13201,2020-04-01,2648,2501,147,5.6
13205,2020-04-01,8137,7459,678,8.3
13207,2020-04-01,12061,10945,1116,9.3
13209,2020-04-01,3822,3499,323,8.5
13211,2020-04-01,8710,7706,1004,11.5
13213,2020-04-01,15611,12576,3035,19.4
13215,2020-04-01,72942,63212,9730,13.3
13217,2020-04-01,49150,43017,6133,12.5
13219,2020-04-01,18154,16570,1584,8.7
13221,2020-04-01,6546,5887,659,10.1
13223,2020-04-01,80421,71468,8953,11.1
13225,2020-04-01,11014,9812,1202,10.9
13227,2020-04-01,14163,12686,1477,10.4
13229,2020-04-01,8385,7698,687,8.2
13231,2020-04-01,8214,7398,816,9.9
13233,2020-04-01,18033,15906,2127,11.8
13235,2020-04-01,3636,3375,261,7.2
13237,2020-04-01,8037,7091,946,11.8
13239,2020-04-01,730,693,37,5.1
13241,2020-04-01,7167,6294,873,12.2
13243,2020-04-01,2470,2302,168,6.8
13245,2020-04-01,81080,71215,9865,12.2
13247,2020-04-01,42224,36860,5364,12.7
13249,2020-04-01,2156,2033,123,5.7
13251,2020-04-01,5114,4448,666,13
13253,2020-04-01,2972,2760,212,7.1
13255,2020-04-01,27020,23590,3430,12.7
13257,2020-04-01,10929,9653,1276,11.7
13259,2020-04-01,2490,2317,173,6.9
13261,2020-04-01,12841,11642,1199,9.3
13263,2020-04-01,2650,2327,323,12.2
13265,2020-04-01,567,510,57,10.1
13267,2020-04-01,9087,8516,571,6.3
13269,2020-04-01,2764,2477,287,10.4
13271,2020-04-01,3641,3201,440,12.1
13273,2020-04-01,3217,2915,302,9.4
13275,2020-04-01,16587,14873,1714,10.3
13277,2020-04-01,19954,18193,1761,8.8
13279,2020-04-01,12143,10708,1435,11.8
13281,2020-04-01,3798,3268,530,14
13283,2020-04-01,2646,2375,271,10.2
13285,2020-04-01,39923,33908,6015,15.1
13287,2020-04-01,3150,2825,325,10.3
13289,2020-04-01,2687,2377,310,11.5
13291,2020-04-01,10284,9342,942,9.2
13293,2020-04-01,11123,9777,1346,12.1
13295,2020-04-01,30305,27166,3139,10.4
13297,2020-04-01,43414,38221,5193,12
13299,2020-04-01,15325,13739,1586,10.3
13301,2020-04-01,2762,2475,287,10.4
13303,2020-04-01,6582,5982,600,9.1
13305,2020-04-01,11082,9947,1135,10.2
13307,2020-04-01,974,914,60,6.2
13309,2020-04-01,1591,1438,153,9.6
13311,2020-04-01,16714,14953,1761,10.5
13313,2020-04-01,44319,35475,8844,20
13315,2020-04-01,2611,2424,187,7.2
13317,2020-04-01,3783,3464,319,8.4
13319,2020-04-01,3833,3566,267,7
13321,2020-04-01,8252,7511,741,9
15001,2020-04-01,88821,68093,20728,23.3
15003,2020-04-01,418298,332459,85839,20.5
15007,2020-04-01,37937,25408,12529,33
15009,2020-04-01,89046,58241,30805,34.6
16001,2020-04-01,256201,224948,31253,12.2
16003,2020-04-01,1766,1387,379,21.5
16005,2020-04-01,39698,35589,4109,10.4
16007,2020-04-01,2904,2661,243,8.4
16009,2020-04-01,4263,3501,762,17.9
16011,2020-04-01,23345,21825,1520,6.5
16013,2020-04-01,13616,10573,3043,22.3
16015,2020-04-01,3662,3068,594,16.2
16017,2020-04-01,20970,17310,3660,17.5
16019,2020-04-01,57947,53110,4837,8.3
16021,2020-04-01,5404,4758,646,12
16023,2020-04-01,1400,1322,78,5.6
16025,2020-04-01,724,630,94,13
16027,2020-04-01,105183,91926,13257,12.6
16029,2020-04-01,3975,3720,255,6.4
16031,2020-04-01,11838,10971,867,7.3
16033,2020-04-01,363,343,20,5.5
16035,2020-04-01,2935,2386,549,18.7
16037,2020-04-01,1994,1792,202,10.1
16039,2020-04-01,11393,10304,1089,9.6
16041,2020-04-01,7100,6520,580,8.2
16043,2020-04-01,7595,7039,556,7.3
16045,2020-04-01,8357,7356,1001,12
16047,2020-04-01,8103,7546,557,6.9
16049,2020-04-01,6667,5798,869,13
16051,2020-04-01,14007,13110,897,6.4
16053,2020-04-01,12178,11250,928,7.6
16055,2020-04-01,80902,67166,13736,17
16057,2020-04-01,20033,18054,1979,9.9
16059,2020-04-01,3407,2994,413,12.1
16061,2020-04-01,1723,1465,258,15
16063,2020-04-01,2738,2374,364,13.3
16065,2020-04-01,20309,19330,979,4.8
16067,2020-04-01,11125,10335,790,7.1
16069,2020-04-01,19873,17500,2373,11.9
16071,2020-04-01,2327,2154,173,7.4
16073,2020-04-01,5648,5028,620,11
16075,2020-04-01,11616,10484,1132,9.7
16077,2020-04-01,3989,3741,248,6.2
16079,2020-04-01,5289,4194,1095,20.7
16081,2020-04-01,6544,5477,1067,16.3
16083,2020-04-01,41633,36898,4735,11.4
16085,2020-04-01,5873,4582,1291,22
16087,2020-04-01,4552,4116,436,9.6
17001,2020-04-01,30257,26625,3632,12
17003,2020-04-01,1811,1531,280,15.5
17005,2020-04-01,6835,5979,856,12.5
17007,2020-04-01,24993,19201,5792,23.2
17009,2020-04-01,2564,2352,212,8.3
17011,2020-04-01,16060,13870,2190,13.6
17013,2020-04-01,2133,1769,364,17.1
17015,2020-04-01,6997,5838,1159,16.6
17017,2020-04-01,5575,4995,580,10.4
17019,2020-04-01,99593,88741,10852,10.9
17021,2020-04-01,13110,11281,1829,14
17023,2020-04-01,7205,5717,1488,20.7
17025,2020-04-01,6231,4757,1474,23.7
17027,2020-04-01,18376,15880,2496,13.6
17029,2020-04-01,22445,19692,2753,12.3
17031,2020-04-01,NA,NA,459568,18.1
17033,2020-04-01,8148,6843,1305,16
17035,2020-04-01,5673,5084,589,10.4
17037,2020-04-01,48324,41080,7244,15
17039,2020-04-01,6376,5652,724,11.4
17041,2020-04-01,9416,8438,978,10.4
17043,2020-04-01,481858,411051,70807,14.7
17045,2020-04-01,8473,7139,1334,15.7
17047,2020-04-01,2692,2088,604,22.4
17049,2020-04-01,18484,15894,2590,14
17051,2020-04-01,9353,8073,1280,13.7
17053,2020-04-01,5792,5112,680,11.7
17055,2020-04-01,16704,12762,3942,23.6
17057,2020-04-01,13982,11718,2264,16.2
17059,2020-04-01,2145,1824,321,15
17061,2020-04-01,5497,4860,637,11.6
17063,2020-04-01,24284,20216,4068,16.8
17065,2020-04-01,3989,3295,694,17.4
17067,2020-04-01,7880,6708,1172,14.9
17069,2020-04-01,1245,1068,177,14.2
17071,2020-04-01,3435,2903,532,15.5
17073,2020-04-01,22400,18996,3404,15.2
17075,2020-04-01,13028,11621,1407,10.8
17077,2020-04-01,25735,22101,3634,14.1
17079,2020-04-01,4509,4037,472,10.5
17081,2020-04-01,16671,12194,4477,26.9
17083,2020-04-01,9989,8456,1533,15.3
17085,2020-04-01,9898,8148,1750,17.7
17087,2020-04-01,4151,3468,683,16.5
17089,2020-04-01,244269,203149,41120,16.8
17091,2020-04-01,51690,43590,8100,15.7
17093,2020-04-01,66082,55239,10843,16.4
17095,2020-04-01,20131,17193,2938,14.6
17097,2020-04-01,333459,284523,48936,14.7
17099,2020-04-01,51506,42071,9435,18.3
17101,2020-04-01,5710,4348,1362,23.9
17103,2020-04-01,16354,14266,2088,12.8
17105,2020-04-01,15192,13352,1840,12.1
17107,2020-04-01,11617,10271,1346,11.6
17109,2020-04-01,12434,10993,1441,11.6
17111,2020-04-01,159520,133314,26206,16.4
17113,2020-04-01,77937,67798,10139,13
17115,2020-04-01,42401,35739,6662,15.7
17117,2020-04-01,20483,17665,2818,13.8
17119,2020-04-01,122282,104257,18025,14.7
17121,2020-04-01,17348,13454,3894,22.4
17123,2020-04-01,4439,3789,650,14.6
17125,2020-04-01,5738,4971,767,13.4
17127,2020-04-01,5379,4253,1126,20.9
17129,2020-04-01,5684,4980,704,12.4
17131,2020-04-01,7239,6106,1133,15.7
17133,2020-04-01,16795,14696,2099,12.5
17135,2020-04-01,11115,9325,1790,16.1
17137,2020-04-01,15112,13436,1676,11.1
17139,2020-04-01,6810,6264,546,8
17141,2020-04-01,23040,19570,3470,15.1
17143,2020-04-01,75105,60651,14454,19.2
17145,2020-04-01,8561,6738,1823,21.3
17147,2020-04-01,7696,6940,756,9.8
17149,2020-04-01,6421,5705,716,11.2
17151,2020-04-01,1588,1359,229,14.4
17153,2020-04-01,1770,1432,338,19.1
17155,2020-04-01,2914,2433,481,16.5
17157,2020-04-01,13533,11375,2158,15.9
17159,2020-04-01,7080,5986,1094,15.5
17161,2020-04-01,66269,54530,11739,17.7
17163,2020-04-01,116380,97873,18507,15.9
17165,2020-04-01,9482,7759,1723,18.2
17167,2020-04-01,90614,77612,13002,14.3
17169,2020-04-01,3048,2702,346,11.4
17171,2020-04-01,2302,2060,242,10.5
17173,2020-04-01,9784,8670,1114,11.4
17175,2020-04-01,2057,1773,284,13.8
17177,2020-04-01,20002,17431,2571,12.9
17179,2020-04-01,55415,45793,9622,17.4
17181,2020-04-01,7013,6036,977,13.9
17183,2020-04-01,30979,25716,5263,17
17185,2020-04-01,6401,4830,1571,24.5
17187,2020-04-01,7722,6938,784,10.2
17189,2020-04-01,8417,6944,1473,17.5
17191,2020-04-01,7011,5662,1349,19.2
17193,2020-04-01,6343,5236,1107,17.5
17195,2020-04-01,26766,22516,4250,15.9
17197,2020-04-01,346466,286214,60252,17.4
17199,2020-04-01,31230,25221,6009,19.2
17201,2020-04-01,131169,102325,28844,22
17203,2020-04-01,15480,13536,1944,12.6
18001,2020-04-01,16874,13465,3409,20.2
18003,2020-04-01,184380,147853,36527,19.8
18005,2020-04-01,44242,36642,7600,17.2
18007,2020-04-01,3944,3509,435,11
18009,2020-04-01,4908,3820,1088,22.2
18011,2020-04-01,32213,29258,2955,9.2
18013,2020-04-01,7355,6169,1186,16.1
18015,2020-04-01,9354,7932,1422,15.2
18017,2020-04-01,16831,13887,2944,17.5
18019,2020-04-01,56908,46519,10389,18.3
18021,2020-04-01,10953,9410,1543,14.1
18023,2020-04-01,15761,13628,2133,13.5
18025,2020-04-01,4444,3717,727,16.4
18027,2020-04-01,14592,13373,1219,8.4
18029,2020-04-01,24242,19829,4413,18.2
18031,2020-04-01,16017,12131,3886,24.3
18033,2020-04-01,22869,17994,4875,21.3
18035,2020-04-01,52748,44174,8574,16.3
18037,2020-04-01,20556,18378,2178,10.6
18039,2020-04-01,114091,81412,32679,28.6
18041,2020-04-01,8761,6551,2210,25.2
18043,2020-04-01,37707,31459,6248,16.6
18045,2020-04-01,7630,6231,1399,18.3
18047,2020-04-01,10819,8882,1937,17.9
18049,2020-04-01,9155,7584,1571,17.2
18051,2020-04-01,19795,16068,3727,18.8
18053,2020-04-01,29806,25313,4493,15.1
18055,2020-04-01,12411,10821,1590,12.8
18057,2020-04-01,165810,148841,16969,10.2
18059,2020-04-01,37753,32432,5321,14.1
18061,2020-04-01,18394,15315,3079,16.7
18063,2020-04-01,81566,72810,8756,10.7
18065,2020-04-01,21237,17585,3652,17.2
18067,2020-04-01,40783,27131,13652,33.5
18069,2020-04-01,17941,14429,3512,19.6
18071,2020-04-01,23435,18268,5167,22
18073,2020-04-01,15359,12881,2478,16.1
18075,2020-04-01,9083,7279,1804,19.9
18077,2020-04-01,15222,11903,3319,21.8
18079,2020-04-01,14063,10875,3188,22.7
18081,2020-04-01,77511,67028,10483,13.5
18083,2020-04-01,17198,14432,2766,16.1
18085,2020-04-01,42016,34260,7756,18.5
18087,2020-04-01,21346,15270,6076,28.5
18089,2020-04-01,227905,181594,46311,20.3
18091,2020-04-01,47989,37928,10061,21
18093,2020-04-01,20401,16859,3542,17.4
18095,2020-04-01,57941,47254,10687,18.4
18097,2020-04-01,459340,394608,64732,14.1
18099,2020-04-01,22121,18040,4081,18.4
18101,2020-04-01,4691,4281,410,8.7
18103,2020-04-01,15219,11724,3495,23
18105,2020-04-01,65651,59012,6639,10.1
18107,2020-04-01,16869,14880,1989,11.8
18109,2020-04-01,33068,29176,3892,11.8
18111,2020-04-01,6470,5462,1008,15.6
18113,2020-04-01,25675,18457,7218,28.1
18115,2020-04-01,2981,2453,528,17.7
18117,2020-04-01,9165,6833,2332,25.4
18119,2020-04-01,8833,7777,1056,12
18121,2020-04-01,6163,5427,736,11.9
18123,2020-04-01,8694,7168,1526,17.6
18125,2020-04-01,5686,4836,850,14.9
18127,2020-04-01,84271,69192,15079,17.9
18129,2020-04-01,12693,11256,1437,11.3
18131,2020-04-01,5985,5037,948,15.8
18133,2020-04-01,15620,13399,2221,14.2
18135,2020-04-01,10702,8838,1864,17.4
18137,2020-04-01,13736,11266,2470,18
18139,2020-04-01,8673,7072,1601,18.5
18141,2020-04-01,129593,103114,26479,20.4
18143,2020-04-01,10450,7944,2506,24
18145,2020-04-01,23102,18629,4473,19.4
18147,2020-04-01,10150,8828,1322,13
18149,2020-04-01,9500,7653,1847,19.4
18151,2020-04-01,20527,16508,4019,19.6
18153,2020-04-01,7691,6490,1201,15.6
18155,2020-04-01,4751,3841,910,19.2
18157,2020-04-01,88927,77733,11194,12.6
18159,2020-04-01,8986,7254,1732,19.3
18161,2020-04-01,3245,2730,515,15.9
18163,2020-04-01,93185,78573,14612,15.7
18165,2020-04-01,6439,5353,1086,16.9
18167,2020-04-01,45255,37494,7761,17.1
18169,2020-04-01,14273,11911,2362,16.5
18171,2020-04-01,3733,3250,483,12.9
18173,2020-04-01,31583,27457,4126,13.1
18175,2020-04-01,12637,10253,2384,18.9
18177,2020-04-01,28758,24514,4244,14.8
18179,2020-04-01,13685,11456,2229,16.3
18181,2020-04-01,12203,10763,1440,11.8
18183,2020-04-01,17087,14150,2937,17.2
19001,2020-04-01,4123,3746,377,9.1
19003,2020-04-01,2092,1943,149,7.1
19005,2020-04-01,7319,6579,740,10.1
19007,2020-04-01,6019,5390,629,10.5
19009,2020-04-01,3031,2842,189,6.2
19011,2020-04-01,13173,11788,1385,10.5
19013,2020-04-01,70416,61885,8531,12.1
19015,2020-04-01,14563,13285,1278,8.8
19017,2020-04-01,13670,12496,1174,8.6
19019,2020-04-01,11011,10005,1006,9.1
19021,2020-04-01,11656,10943,713,6.1
19023,2020-04-01,7826,7096,730,9.3
19025,2020-04-01,4154,3832,322,7.8
19027,2020-04-01,10833,9883,950,8.8
19029,2020-04-01,6814,6314,500,7.3
19031,2020-04-01,10736,9784,952,8.9
19033,2020-04-01,24023,21251,2772,11.5
19035,2020-04-01,6160,5675,485,7.9
19037,2020-04-01,6757,5956,801,11.9
19039,2020-04-01,4851,4328,523,10.8
19041,2020-04-01,8595,7698,897,10.4
19043,2020-04-01,9835,8753,1082,11
19045,2020-04-01,23509,20484,3025,12.9
19047,2020-04-01,8099,7406,693,8.6
19049,2020-04-01,48310,44553,3757,7.8
19051,2020-04-01,4146,3841,305,7.4
19053,2020-04-01,4236,3914,322,7.6
19055,2020-04-01,10381,9486,895,8.6
19057,2020-04-01,19751,16818,2933,14.8
19059,2020-04-01,9764,8503,1261,12.9
19061,2020-04-01,53890,46946,6944,12.9
19063,2020-04-01,5282,4776,506,9.6
19065,2020-04-01,10269,9160,1109,10.8
19067,2020-04-01,8811,7698,1113,12.6
19069,2020-04-01,5558,5153,405,7.3
19071,2020-04-01,3565,3359,206,5.8
19073,2020-04-01,5483,4932,551,10
19075,2020-04-01,6408,5822,586,9.1
19077,2020-04-01,5539,4971,568,10.3
19079,2020-04-01,6774,6149,625,9.2
19081,2020-04-01,6114,5437,677,11.1
19083,2020-04-01,7912,7230,682,8.6
19085,2020-04-01,7228,6683,545,7.5
19087,2020-04-01,10007,8849,1158,11.6
19089,2020-04-01,5350,4758,592,11.1
19091,2020-04-01,5090,4624,466,9.2
19093,2020-04-01,4148,3899,249,6
19095,2020-04-01,10645,9604,1041,9.8
19097,2020-04-01,10868,9647,1221,11.2
19099,2020-04-01,19927,17831,2096,10.5
19101,2020-04-01,10316,9343,973,9.4
19103,2020-04-01,85153,76785,8368,9.8
19105,2020-04-01,10480,9310,1170,11.2
19107,2020-04-01,5281,4765,516,9.8
19109,2020-04-01,8354,7643,711,8.5
19111,2020-04-01,16731,14521,2210,13.2
19113,2020-04-01,122565,106889,15676,12.8
19115,2020-04-01,4908,4348,560,11.4
19117,2020-04-01,4622,4291,331,7.2
19119,2020-04-01,6575,6260,315,4.8
19121,2020-04-01,8622,7574,1048,12.2
19123,2020-04-01,11934,10781,1153,9.7
19125,2020-04-01,18141,16632,1509,8.3
19127,2020-04-01,17918,15905,2013,11.2
19129,2020-04-01,7300,6729,571,7.8
19131,2020-04-01,7165,6688,477,6.7
19133,2020-04-01,4316,3827,489,11.3
19135,2020-04-01,4089,3698,391,9.6
19137,2020-04-01,4976,4579,397,8
19139,2020-04-01,22891,20374,2517,11
19141,2020-04-01,8144,7596,548,6.7
19143,2020-04-01,3413,3214,199,5.8
19145,2020-04-01,6573,5924,649,9.9
19147,2020-04-01,4843,4330,513,10.6
19149,2020-04-01,14599,13514,1085,7.4
19151,2020-04-01,4469,4199,270,6
19153,2020-04-01,274935,240103,34832,12.7
19155,2020-04-01,49648,44280,5368,10.8
19157,2020-04-01,10001,9012,989,9.9
19159,2020-04-01,2370,2188,182,7.7
19161,2020-04-01,5148,4799,349,6.8
19163,2020-04-01,90540,78323,12217,13.5
19165,2020-04-01,6627,6110,517,7.8
19167,2020-04-01,20043,18903,1140,5.7
19169,2020-04-01,54990,50300,4690,8.5
19171,2020-04-01,9401,8632,769,8.2
19173,2020-04-01,3134,2937,197,6.3
19175,2020-04-01,6536,5740,796,12.2
19177,2020-04-01,3669,3304,365,9.9
19179,2020-04-01,17894,15945,1949,10.9
19181,2020-04-01,28085,25338,2747,9.8
19183,2020-04-01,11566,10621,945,8.2
19185,2020-04-01,2879,2604,275,9.6
19187,2020-04-01,19519,17580,1939,9.9
19189,2020-04-01,5618,4651,967,17.2
19191,2020-04-01,10326,9173,1153,11.2
19193,2020-04-01,56556,50811,5745,10.2
19195,2020-04-01,4330,3724,606,14
19197,2020-04-01,7051,6526,525,7.4
20001,2020-04-01,6506,5948,558,8.6
20003,2020-04-01,4093,3827,266,6.5
20005,2020-04-01,7119,6281,838,11.8
20007,2020-04-01,2189,2080,109,5
20009,2020-04-01,13690,12641,1049,7.7
20011,2020-04-01,6608,6027,581,8.8
20013,2020-04-01,5350,4891,459,8.6
20015,2020-04-01,33259,28435,4824,14.5
20017,2020-04-01,1662,1495,167,10
20019,2020-04-01,1459,1319,140,9.6
20021,2020-04-01,10215,9149,1066,10.4
20023,2020-04-01,1180,1142,38,3.2
20025,2020-04-01,963,939,24,2.5
20027,2020-04-01,3658,3371,287,7.8
20029,2020-04-01,3662,3458,204,5.6
20031,2020-04-01,3961,3628,333,8.4
20033,2020-04-01,832,796,36,4.3
20035,2020-04-01,17345,14913,2432,14
20037,2020-04-01,19131,17414,1717,9
20039,2020-04-01,1133,1075,58,5.1
20041,2020-04-01,8795,8091,704,8
20043,2020-04-01,4006,3633,373,9.3
20045,2020-04-01,65917,58350,7567,11.5
20047,2020-04-01,1222,1172,50,4.1
20049,2020-04-01,1157,1051,106,9.2
20051,2020-04-01,16903,15688,1215,7.2
20053,2020-04-01,2574,2458,116,4.5
20055,2020-04-01,20188,18988,1200,5.9
20057,2020-04-01,16414,15673,741,4.5
20059,2020-04-01,14227,12895,1332,9.4
20061,2020-04-01,11463,10219,1244,10.9
20063,2020-04-01,1403,1336,67,4.8
20065,2020-04-01,1048,993,55,5.2
20067,2020-04-01,2882,2759,123,4.3
20069,2020-04-01,2969,2890,79,2.7
20071,2020-04-01,742,727,15,2
20073,2020-04-01,3294,2994,300,9.1
20075,2020-04-01,1429,1402,27,1.9
20077,2020-04-01,2812,2643,169,6
20079,2020-04-01,16779,14902,1877,11.2
20081,2020-04-01,2048,1986,62,3
20083,2020-04-01,923,888,35,3.8
20085,2020-04-01,7247,6339,908,12.5
20087,2020-04-01,9914,8904,1010,10.2
20089,2020-04-01,1203,1154,49,4.1
20091,2020-04-01,334774,299312,35462,10.6
20093,2020-04-01,1913,1820,93,4.9
20095,2020-04-01,3286,2968,318,9.7
20097,2020-04-01,1186,1128,58,4.9
20099,2020-04-01,9826,9017,809,8.2
20101,2020-04-01,696,672,24,3.4
20103,2020-04-01,36154,31989,4165,11.5
20105,2020-04-01,1602,1544,58,3.6
20107,2020-04-01,4197,3770,427,10.2
20109,2020-04-01,1537,1467,70,4.6
20111,2020-04-01,16935,15665,1270,7.5
20113,2020-04-01,17066,16071,995,5.8
20115,2020-04-01,5847,5400,447,7.6
20117,2020-04-01,5222,4951,271,5.2
20119,2020-04-01,1951,1870,81,4.2
20121,2020-04-01,16904,15342,1562,9.2
20123,2020-04-01,3167,3058,109,3.4
20125,2020-04-01,15230,13189,2041,13.4
20127,2020-04-01,2874,2678,196,6.8
20129,2020-04-01,1024,989,35,3.4
20131,2020-04-01,4949,4686,263,5.3
20133,2020-04-01,6066,5455,611,10.1
20135,2020-04-01,1260,1192,68,5.4
20137,2020-04-01,2464,2383,81,3.3
20139,2020-04-01,7764,6988,776,10
20141,2020-04-01,1886,1801,85,4.5
20143,2020-04-01,2926,2748,178,6.1
20145,2020-04-01,2603,2472,131,5
20147,2020-04-01,2556,2387,169,6.6
20149,2020-04-01,11670,10777,893,7.7
20151,2020-04-01,4800,4531,269,5.6
20153,2020-04-01,1371,1319,52,3.8
20155,2020-04-01,30782,27649,3133,10.2
20157,2020-04-01,2109,2018,91,4.3
20159,2020-04-01,5274,4911,363,6.9
20161,2020-04-01,33405,30516,2889,8.6
20163,2020-04-01,2348,2214,134,5.7
20165,2020-04-01,1566,1435,131,8.4
20167,2020-04-01,3171,2935,236,7.4
20169,2020-04-01,30874,27918,2956,9.6
20171,2020-04-01,2594,2500,94,3.6
20173,2020-04-01,270060,219653,50407,18.7
20175,2020-04-01,9071,8527,544,6
20177,2020-04-01,90912,79856,11056,12.2
20179,2020-04-01,1292,1251,41,3.2
20181,2020-04-01,2640,2521,119,4.5
20183,2020-04-01,1836,1769,67,3.6
20185,2020-04-01,1856,1759,97,5.2
20187,2020-04-01,878,857,21,2.4
20189,2020-04-01,2534,2447,87,3.4
20191,2020-04-01,11502,9493,2009,17.5
20193,2020-04-01,4030,3858,172,4.3
20195,2020-04-01,1289,1205,84,6.5
20197,2020-04-01,3449,3186,263,7.6
20199,2020-04-01,911,891,20,2.2
20201,2020-04-01,2796,2685,111,4
20203,2020-04-01,1180,1151,29,2.5
20205,2020-04-01,4369,3551,818,18.7
20207,2020-04-01,1616,1473,143,8.8
20209,2020-04-01,78945,67158,11787,14.9
21001,2020-04-01,7394,6173,1221,16.5
21003,2020-04-01,8122,6979,1143,14.1
21005,2020-04-01,12422,10609,1813,14.6
21007,2020-04-01,3445,2938,507,14.7
21009,2020-04-01,18783,15336,3447,18.4
21011,2020-04-01,4809,3924,885,18.4
21013,2020-04-01,8732,7313,1419,16.3
21015,2020-04-01,68126,59222,8904,13.1
21017,2020-04-01,9708,8093,1615,16.6
21019,2020-04-01,18492,15082,3410,18.4
21021,2020-04-01,12811,10271,2540,19.8
21023,2020-04-01,3651,3146,505,13.8
21025,2020-04-01,3543,2903,640,18.1
21027,2020-04-01,8158,6768,1390,17
21029,2020-04-01,42410,34704,7706,18.2
21031,2020-04-01,4843,3961,882,18.2
21033,2020-04-01,5592,4776,816,14.6
21035,2020-04-01,19343,16884,2459,12.7
21037,2020-04-01,48976,42395,6581,13.4
21039,2020-04-01,2215,2022,193,8.7
21041,2020-04-01,5386,4660,726,13.5
21043,2020-04-01,10244,8202,2042,19.9
21045,2020-04-01,7141,5935,1206,16.9
21047,2020-04-01,25863,21245,4618,17.9
21049,2020-04-01,17268,14394,2874,16.6
21051,2020-04-01,5440,4472,968,17.8
21053,2020-04-01,3899,3577,322,8.3
21055,2020-04-01,3823,3372,451,11.8
21057,2020-04-01,3122,2821,301,9.6
21059,2020-04-01,46156,39288,6868,14.9
21061,2020-04-01,4664,3690,974,20.9
21063,2020-04-01,2117,1710,407,19.2
21065,2020-04-01,5504,4583,921,16.7
21067,2020-04-01,171732,147495,24237,14.1
21069,2020-04-01,6523,5337,1186,18.2
21071,2020-04-01,11291,9361,1930,17.1
21073,2020-04-01,26186,22234,3952,15.1
21075,2020-04-01,2103,1868,235,11.2
21077,2020-04-01,3979,3382,597,15
21079,2020-04-01,7657,6483,1174,15.3
21081,2020-04-01,11939,9718,2221,18.6
21083,2020-04-01,15797,13754,2043,12.9
21085,2020-04-01,11692,9537,2155,18.4
21087,2020-04-01,5165,4428,737,14.3
21089,2020-04-01,13759,11214,2545,18.5
21091,2020-04-01,3988,3296,692,17.4
21093,2020-04-01,50665,41442,9223,18.2
21095,2020-04-01,6800,5445,1355,19.9
21097,2020-04-01,9360,7697,1663,17.8
21099,2020-04-01,8119,6946,1173,14.4
21101,2020-04-01,23117,19570,3547,15.3
21103,2020-04-01,7984,6700,1284,16.1
21105,2020-04-01,1706,1527,179,10.5
21107,2020-04-01,17159,13682,3477,20.3
21109,2020-04-01,4317,3466,851,19.7
21111,2020-04-01,389413,325108,64305,16.5
21113,2020-04-01,25913,22339,3574,13.8
21115,2020-04-01,6875,5772,1103,16
21117,2020-04-01,84806,73188,11618,13.7
21119,2020-04-01,4422,3745,677,15.3
21121,2020-04-01,10465,8569,1896,18.1
21123,2020-04-01,6286,5042,1244,19.8
21125,2020-04-01,26148,21526,4622,17.7
21127,2020-04-01,5426,4560,866,16
21129,2020-04-01,2138,1850,288,13.5
21131,2020-04-01,2760,2220,540,19.6
21133,2020-04-01,6489,5323,1166,18
21135,2020-04-01,4883,3911,972,19.9
21137,2020-04-01,9593,7590,2003,20.9
21139,2020-04-01,3616,3058,558,15.4
21141,2020-04-01,12180,10316,1864,15.3
21143,2020-04-01,3034,2690,344,11.3
21145,2020-04-01,29690,24674,5016,16.9
21147,2020-04-01,4821,4058,763,15.8
21149,2020-04-01,3954,3463,491,12.4
21151,2020-04-01,46530,39525,7005,15.1
21153,2020-04-01,3678,2663,1015,27.6
21155,2020-04-01,9895,7272,2623,26.5
21157,2020-04-01,15549,13394,2155,13.9
21159,2020-04-01,2925,2385,540,18.5
21161,2020-04-01,7402,5953,1449,19.6
21163,2020-04-01,12442,10304,2138,17.2
21165,2020-04-01,2367,1967,400,16.9
21167,2020-04-01,9973,7931,2042,20.5
21169,2020-04-01,4192,3333,859,20.5
21171,2020-04-01,4766,4155,611,12.8
21173,2020-04-01,12491,10082,2409,19.3
21175,2020-04-01,4622,4048,574,12.4
21177,2020-04-01,10984,9220,1764,16.1
21179,2020-04-01,24755,19939,4816,19.5
21181,2020-04-01,3431,2825,606,17.7
21183,2020-04-01,10035,8582,1453,14.5
21185,2020-04-01,31512,27266,4246,13.5
21187,2020-04-01,5202,4387,815,15.7
21189,2020-04-01,1125,988,137,12.2
21191,2020-04-01,6606,5816,790,12
21193,2020-04-01,8444,6985,1459,17.3
21195,2020-04-01,19174,15906,3268,17
21197,2020-04-01,5115,4264,851,16.6
21199,2020-04-01,27647,22910,4737,17.1
21201,2020-04-01,804,697,107,13.3
21203,2020-04-01,6589,5526,1063,16.1
21205,2020-04-01,10939,9083,1856,17
21207,2020-04-01,6796,5408,1388,20.4
21209,2020-04-01,31436,24498,6938,22.1
21211,2020-04-01,24680,20828,3852,15.6
21213,2020-04-01,9592,7750,1842,19.2
21215,2020-04-01,10155,8338,1817,17.9
21217,2020-04-01,13094,10697,2397,18.3
21219,2020-04-01,5338,4714,624,11.7
21221,2020-04-01,6174,5121,1053,17.1
21223,2020-04-01,3892,3136,756,19.4
21225,2020-04-01,5793,4702,1091,18.8
21227,2020-04-01,61516,50240,11276,18.3
21229,2020-04-01,6876,5583,1293,18.8
21231,2020-04-01,7468,6418,1050,14.1
21233,2020-04-01,5530,4659,871,15.8
21235,2020-04-01,14138,11937,2201,15.6
21237,2020-04-01,2096,1758,338,16.1
21239,2020-04-01,14324,12454,1870,13.1
22001,2020-04-01,21405,18996,2409,11.3
22003,2020-04-01,8284,7002,1282,15.5
22005,2020-04-01,59223,51651,7572,12.8
22007,2020-04-01,8487,7130,1357,16
22009,2020-04-01,14166,12133,2033,14.4
22011,2020-04-01,13173,11781,1392,10.6
22013,2020-04-01,4786,4325,461,9.6
22015,2020-04-01,52617,46384,6233,11.8
22017,2020-04-01,95945,82327,13618,14.2
22019,2020-04-01,94688,81026,13662,14.4
22021,2020-04-01,3310,2981,329,9.9
22023,2020-04-01,3309,3016,293,8.9
22025,2020-04-01,3052,2747,305,10
22027,2020-04-01,4986,4598,388,7.8
22029,2020-04-01,6352,5626,726,11.4
22031,2020-04-01,9604,8585,1019,10.6
22033,2020-04-01,213760,185593,28167,13.2
22035,2020-04-01,1591,1404,187,11.8
22037,2020-04-01,7169,6405,764,10.7
22039,2020-04-01,10498,9300,1198,11.4
22041,2020-04-01,6527,5848,679,10.4
22043,2020-04-01,7395,6670,725,9.8
22045,2020-04-01,26006,22345,3661,14.1
22047,2020-04-01,12954,11131,1823,14.1
22049,2020-04-01,5856,5434,422,7.2
22051,2020-04-01,200217,162395,37822,18.9
22053,2020-04-01,11919,10435,1484,12.5
22055,2020-04-01,105195,91383,13812,13.1
22057,2020-04-01,38902,34557,4345,11.2
22059,2020-04-01,5958,5529,429,7.2
22061,2020-04-01,18351,16671,1680,9.2
22063,2020-04-01,63814,55510,8304,13
22065,2020-04-01,3140,2767,373,11.9
22067,2020-04-01,8828,7716,1112,12.6
22069,2020-04-01,14073,12710,1363,9.7
22071,2020-04-01,173544,134954,38590,22.2
22073,2020-04-01,64113,56420,7693,12
22075,2020-04-01,9004,7647,1357,15.1
22077,2020-04-01,8993,7868,1125,12.5
22079,2020-04-01,50337,45346,4991,9.9
22081,2020-04-01,3267,3027,240,7.3
22083,2020-04-01,7254,6476,778,10.7
22085,2020-04-01,8007,7365,642,8
22087,2020-04-01,18680,14998,3682,19.7
22089,2020-04-01,22629,19072,3557,15.7
22091,2020-04-01,4026,3380,646,16
22093,2020-04-01,8040,6877,1163,14.5
22095,2020-04-01,17995,14699,3296,18.3
22097,2020-04-01,29066,25244,3822,13.1
22099,2020-04-01,20487,17723,2764,13.5
22101,2020-04-01,18116,15513,2603,14.4
22103,2020-04-01,106886,90732,16154,15.1
22105,2020-04-01,52050,43141,8909,17.1
22107,2020-04-01,1188,1075,113,9.5
22109,2020-04-01,43934,38039,5895,13.4
22111,2020-04-01,8053,7290,763,9.5
22113,2020-04-01,21981,19222,2759,12.6
22115,2020-04-01,14085,12531,1554,11
22117,2020-04-01,15007,13233,1774,11.8
22119,2020-04-01,12988,11451,1537,11.8
22121,2020-04-01,12510,10975,1535,12.3
22123,2020-04-01,3213,2766,447,13.9
22125,2020-04-01,4775,4345,430,9
22127,2020-04-01,4197,3823,374,8.9
23001,2020-04-01,52795,47388,5407,10.2
23003,2020-04-01,27989,25304,2685,9.6
23005,2020-04-01,154098,136758,17340,11.3
23007,2020-04-01,13467,11909,1558,11.6
23009,2020-04-01,26100,23056,3044,11.7
23011,2020-04-01,59981,54015,5966,9.9
23013,2020-04-01,19182,16933,2249,11.7
23015,2020-04-01,15795,14051,1744,11
23017,2020-04-01,25043,21948,3095,12.4
23019,2020-04-01,73685,66066,7619,10.3
23021,2020-04-01,6792,6121,671,9.9
23023,2020-04-01,19098,17092,2006,10.5
23025,2020-04-01,21505,18848,2657,12.4
23027,2020-04-01,19393,17488,1905,9.8
23029,2020-04-01,12718,11314,1404,11
23031,2020-04-01,104574,93467,11107,10.6
24001,2020-04-01,30667,26617,4050,13.2
24003,2020-04-01,297816,268709,29107,9.8
24005,2020-04-01,429298,384234,45064,10.5
24009,2020-04-01,48449,44544,3905,8.1
24011,2020-04-01,16839,15366,1473,8.7
24013,2020-04-01,90237,82118,8119,9
24015,2020-04-01,49074,44369,4705,9.6
24017,2020-04-01,85183,77437,7746,9.1
24019,2020-04-01,14687,13193,1494,10.2
24021,2020-04-01,131700,119225,12475,9.5
24023,2020-04-01,15064,13190,1874,12.4
24025,2020-04-01,133295,119945,13350,10
24027,2020-04-01,174514,160345,14169,8.1
24029,2020-04-01,9670,8756,914,9.5
24031,2020-04-01,540940,495414,45526,8.4
24033,2020-04-01,499088,450872,48216,9.7
24035,2020-04-01,26696,24039,2657,10
24037,2020-04-01,54820,50979,3841,7
24039,2020-04-01,8308,7375,933,11.2
24041,2020-04-01,17866,16061,1805,10.1
24043,2020-04-01,71602,63460,8142,11.4
24045,2020-04-01,46805,40685,6120,13.1
24047,2020-04-01,25279,19809,5470,21.6
24510,2020-04-01,271941,240526,31415,11.6
25001,2020-04-01,97849,76816,21033,21.5
25003,2020-04-01,57684,48028,9656,16.7
25005,2020-04-01,283606,226043,57563,20.3
25007,2020-04-01,8515,6588,1927,22.6
25009,2020-04-01,387673,318847,68826,17.8
25011,2020-04-01,36158,31032,5126,14.2
25013,2020-04-01,203565,167145,36420,17.9
25015,2020-04-01,76570,66952,9618,12.6
25017,2020-04-01,802894,700455,102439,12.8
25019,2020-04-01,7044,5060,1984,28.2
25021,2020-04-01,351249,297196,54053,15.4
25023,2020-04-01,260006,212863,47143,18.1
25025,2020-04-01,410886,346316,64570,15.7
25027,2020-04-01,403488,340711,62777,15.6
26001,2020-04-01,3455,2605,850,24.6
26003,2020-04-01,2910,2223,687,23.6
26005,2020-04-01,57800,44746,13054,22.6
26007,2020-04-01,12687,10340,2347,18.5
26009,2020-04-01,9025,6418,2607,28.9
26011,2020-04-01,5730,3892,1838,32.1
26013,2020-04-01,3142,2273,869,27.7
26015,2020-04-01,29895,23305,6590,22
26017,2020-04-01,49024,36751,12273,25
26019,2020-04-01,8863,6530,2333,26.3
26021,2020-04-01,69228,55117,14111,20.4
26023,2020-04-01,18745,14447,4298,22.9
26025,2020-04-01,59888,45039,14849,24.8
26027,2020-04-01,25895,19386,6509,25.1
26029,2020-04-01,11618,7896,3722,32
26031,2020-04-01,9793,5776,4017,41
26033,2020-04-01,15890,12668,3222,20.3
26035,2020-04-01,10676,7177,3499,32.8
26037,2020-04-01,38999,31649,7350,18.8
26039,2020-04-01,5113,3617,1496,29.3
26041,2020-04-01,16426,12585,3841,23.4
26043,2020-04-01,12152,10147,2005,16.5
26045,2020-04-01,55742,43692,12050,21.6
26047,2020-04-01,17469,12191,5278,30.2
26049,2020-04-01,184165,128867,55298,30
26051,2020-04-01,8784,6335,2449,27.9
26053,2020-04-01,5846,4820,1026,17.6
26055,2020-04-01,48944,37172,11772,24.1
26057,2020-04-01,17236,13376,3860,22.4
26059,2020-04-01,19298,13956,5342,27.7
26061,2020-04-01,15776,13296,2480,15.7
26063,2020-04-01,14715,10636,4079,27.7
26065,2020-04-01,141123,115314,25809,18.3
26067,2020-04-01,27771,20362,7409,26.7
26069,2020-04-01,9752,7189,2563,26.3
26071,2020-04-01,4904,3983,921,18.8
26073,2020-04-01,33802,26381,7421,22
26075,2020-04-01,71979,54265,17714,24.6
26077,2020-04-01,122798,101575,21223,17.3
26079,2020-04-01,8097,5786,2311,28.5
26081,2020-04-01,336464,264763,71701,21.3
26083,2020-04-01,883,711,172,19.5
26085,2020-04-01,3357,2343,1014,30.2
26087,2020-04-01,39178,27326,11852,30.3
26089,2020-04-01,10108,7887,2221,22
26091,2020-04-01,43542,31321,12221,28.1
26093,2020-04-01,89264,69950,19314,21.6
26095,2020-04-01,2249,1802,447,19.9
26097,2020-04-01,4351,2703,1648,37.9
26099,2020-04-01,410102,299135,110967,27.1
26101,2020-04-01,9080,6217,2863,31.5
26103,2020-04-01,31370,24885,6485,20.7
26105,2020-04-01,12364,9226,3138,25.4
26107,2020-04-01,17403,12939,4464,25.7
26109,2020-04-01,10411,8896,1515,14.6
26111,2020-04-01,38000,30335,7665,20.2
26113,2020-04-01,6628,4796,1832,27.6
26115,2020-04-01,76011,56190,19821,26.1
26117,2020-04-01,28174,20684,7490,26.6
26119,2020-04-01,2748,1813,935,34
26121,2020-04-01,79299,56222,23077,29.1
26123,2020-04-01,21625,16057,5568,25.7
26125,2020-04-01,566007,455367,110640,19.5
26127,2020-04-01,11062,8096,2966,26.8
26129,2020-04-01,7543,5305,2238,29.7
26131,2020-04-01,1869,1354,515,27.6
26133,2020-04-01,10497,7580,2917,27.8
26135,2020-04-01,2786,1866,920,33
26137,2020-04-01,11145,7819,3326,29.8
26139,2020-04-01,150372,118996,31376,20.9
26141,2020-04-01,4492,3223,1269,28.3
26143,2020-04-01,7028,4631,2397,34.1
26145,2020-04-01,85274,63800,21474,25.2
26147,2020-04-01,70936,50370,20566,29
26149,2020-04-01,29086,20277,8809,30.3
26151,2020-04-01,18863,13061,5802,30.8
26153,2020-04-01,3233,2521,712,22
26155,2020-04-01,31762,22507,9255,29.1
26157,2020-04-01,22459,15283,7176,32
26159,2020-04-01,33628,26606,7022,20.9
26161,2020-04-01,186452,158866,27586,14.8
26163,2020-04-01,726341,539172,187169,25.8
26165,2020-04-01,14524,9976,4548,31.3
27001,2020-04-01,7189,6366,823,11.4
27003,2020-04-01,195729,177838,17891,9.1
27005,2020-04-01,18925,17064,1861,9.8
27007,2020-04-01,24396,22165,2231,9.1
27009,2020-04-01,22220,20105,2115,9.5
27011,2020-04-01,2389,2237,152,6.4
27013,2020-04-01,40461,37244,3217,8
27015,2020-04-01,14218,13275,943,6.6
27017,2020-04-01,17583,15703,1880,10.7
27019,2020-04-01,57160,52944,4216,7.4
27021,2020-04-01,14438,12515,1923,13.3
27023,2020-04-01,6839,6304,535,7.8
27025,2020-04-01,29571,26777,2794,9.4
27027,2020-04-01,35278,34025,1253,3.6
27029,2020-04-01,4411,3800,611,13.9
27031,2020-04-01,3145,2663,482,15.3
27033,2020-04-01,5927,5642,285,4.8
27035,2020-04-01,32472,28882,3590,11.1
27037,2020-04-01,239696,217857,21839,9.1
27039,2020-04-01,11721,10975,746,6.4
27041,2020-04-01,20868,19280,1588,7.6
27043,2020-04-01,6872,6300,572,8.3
27045,2020-04-01,11456,10732,724,6.3
27047,2020-04-01,16146,14915,1231,7.6
27049,2020-04-01,26873,24554,2319,8.6
27051,2020-04-01,3281,3060,221,6.7
27053,2020-04-01,699395,636621,62774,9
27055,2020-04-01,9786,9291,495,5.1
27057,2020-04-01,9776,8751,1025,10.5
27059,2020-04-01,21049,18998,2051,9.7
27061,2020-04-01,21258,18794,2464,11.6
27063,2020-04-01,5562,5300,262,4.7
27065,2020-04-01,9024,8038,986,10.9
27067,2020-04-01,23771,22309,1462,6.2
27069,2020-04-01,2282,2179,103,4.5
27071,2020-04-01,5714,5101,613,10.7
27073,2020-04-01,3515,3308,207,5.9
27075,2020-04-01,5312,4785,527,9.9
27077,2020-04-01,2427,2162,265,10.9
27079,2020-04-01,15952,14386,1566,9.8
27081,2020-04-01,3141,2996,145,4.6
27083,2020-04-01,14184,13391,793,5.6
27085,2020-04-01,18812,17412,1400,7.4
27087,2020-04-01,2524,2088,436,17.3
27089,2020-04-01,5300,4866,434,8.2
27091,2020-04-01,9788,9148,640,6.5
27093,2020-04-01,13057,12187,870,6.7
27095,2020-04-01,12839,11375,1464,11.4
27097,2020-04-01,17517,15931,1586,9.1
27099,2020-04-01,20307,19077,1230,6.1
27101,2020-04-01,4604,4317,287,6.2
27103,2020-04-01,20703,19266,1437,6.9
27105,2020-04-01,11045,10576,469,4.2
27107,2020-04-01,3232,2989,243,7.5
27109,2020-04-01,88086,82003,6083,6.9
27111,2020-04-01,30657,28260,2397,7.8
27113,2020-04-01,8622,7754,868,10.1
27115,2020-04-01,15089,13263,1826,12.1
27117,2020-04-01,4625,4420,205,4.4
27119,2020-04-01,16313,15305,1008,6.2
27121,2020-04-01,6407,6020,387,6
27123,2020-04-01,287111,260567,26544,9.2
27125,2020-04-01,2197,1992,205,9.3
27127,2020-04-01,7739,7054,685,8.9
27129,2020-04-01,8398,7792,606,7.2
27131,2020-04-01,36771,34201,2570,7
27133,2020-04-01,5518,5332,186,3.4
27135,2020-04-01,7850,7186,664,8.5
27137,2020-04-01,100599,90103,10496,10.4
27139,2020-04-01,83010,75410,7600,9.2
27141,2020-04-01,51692,47021,4671,9
27143,2020-04-01,8407,7792,615,7.3
27145,2020-04-01,90726,83513,7213,8
27147,2020-04-01,21100,19626,1474,7
27149,2020-04-01,5196,4998,198,3.8
27151,2020-04-01,4824,4428,396,8.2
27153,2020-04-01,13386,12535,851,6.4
27155,2020-04-01,1750,1667,83,4.7
27157,2020-04-01,12342,11414,928,7.5
27159,2020-04-01,6098,5417,681,11.2
27161,2020-04-01,8929,8203,726,8.1
27163,2020-04-01,141074,129390,11684,8.3
27165,2020-04-01,6394,6040,354,5.5
27167,2020-04-01,3427,3310,117,3.4
27169,2020-04-01,28438,26395,2043,7.2
27171,2020-04-01,74191,68006,6185,8.3
27173,2020-04-01,5320,4920,400,7.5
28001,2020-04-01,10364,8601,1763,17
28003,2020-04-01,14715,12857,1858,12.6
28005,2020-04-01,4060,3589,471,11.6
28007,2020-04-01,6476,5615,861,13.3
28009,2020-04-01,2773,2361,412,14.9
28011,2020-04-01,11185,9965,1220,10.9
28013,2020-04-01,5959,4748,1211,20.3
28015,2020-04-01,3204,2777,427,13.3
28017,2020-04-01,7824,5501,2323,29.7
28019,2020-04-01,3364,3032,332,9.9
28021,2020-04-01,2868,2267,601,21
28023,2020-04-01,5390,4664,726,13.5
28025,2020-04-01,8097,6190,1907,23.6
28027,2020-04-01,8407,6652,1755,20.9
28029,2020-04-01,10136,8902,1234,12.2
28031,2020-04-01,7169,6447,722,10.1
28033,2020-04-01,80876,71633,9243,11.4
28035,2020-04-01,30764,26488,4276,13.9
28037,2020-04-01,2569,2262,307,12
28039,2020-04-01,8275,7026,1249,15.1
28041,2020-04-01,4070,3494,576,14.2
28043,2020-04-01,8637,7523,1114,12.9
28045,2020-04-01,17491,14308,3183,18.2
28047,2020-04-01,85795,66205,19590,22.8
28049,2020-04-01,102086,84665,17421,17.1
28051,2020-04-01,6044,4384,1660,27.5
28053,2020-04-01,2264,1862,402,17.8
28055,2020-04-01,344,308,36,10.5
28057,2020-04-01,10408,8340,2068,19.9
28059,2020-04-01,56265,44428,11837,21
28061,2020-04-01,5559,4924,635,11.4
28063,2020-04-01,1872,1473,399,21.3
28065,2020-04-01,3765,3266,499,13.3
28067,2020-04-01,23387,20981,2406,10.3
28069,2020-04-01,3290,2824,466,14.2
28071,2020-04-01,25468,22514,2954,11.6
28073,2020-04-01,27758,24615,3143,11.3
28075,2020-04-01,27376,23949,3427,12.5
28077,2020-04-01,4242,3655,587,13.8
28079,2020-04-01,7583,6520,1063,14
28081,2020-04-01,41141,32314,8827,21.5
28083,2020-04-01,9463,7841,1622,17.1
28085,2020-04-01,13353,11586,1767,13.2
28087,2020-04-01,23746,20009,3737,15.7
28089,2020-04-01,49522,42535,6987,14.1
28091,2020-04-01,8864,7851,1013,11.4
28093,2020-04-01,12653,11258,1395,11
28095,2020-04-01,15491,12037,3454,22.3
28097,2020-04-01,3686,3181,505,13.7
28099,2020-04-01,9953,8174,1779,17.9
28101,2020-04-01,8099,7014,1085,13.4
28103,2020-04-01,3716,3085,631,17
28105,2020-04-01,20693,17827,2866,13.9
28107,2020-04-01,11720,9803,1917,16.4
28109,2020-04-01,21061,18410,2651,12.6
28111,2020-04-01,3913,3393,520,13.3
28113,2020-04-01,13333,11552,1781,13.4
28115,2020-04-01,15369,11654,3715,24.2
28117,2020-04-01,10907,9048,1859,17
28119,2020-04-01,2350,1969,381,16.2
28121,2020-04-01,68894,61096,7798,11.3
28123,2020-04-01,11537,10392,1145,9.9
28125,2020-04-01,1505,1311,194,12.9
28127,2020-04-01,9586,8637,949,9.9
28129,2020-04-01,6063,5590,473,7.8
28131,2020-04-01,6381,5431,950,14.9
28133,2020-04-01,7324,6293,1031,14.1
28135,2020-04-01,4831,4361,470,9.7
28137,2020-04-01,11118,9744,1374,12.4
28139,2020-04-01,9177,7499,1678,18.3
28141,2020-04-01,8143,6993,1150,14.1
28143,2020-04-01,5070,3557,1513,29.8
28145,2020-04-01,14150,11231,2919,20.6
28147,2020-04-01,4442,3877,565,12.7
28149,2020-04-01,19080,15857,3223,16.9
28151,2020-04-01,15779,13301,2478,15.7
28153,2020-04-01,6847,6065,782,11.4
28155,2020-04-01,3693,3209,484,13.1
28157,2020-04-01,2473,2098,375,15.2
28159,2020-04-01,6853,5853,1000,14.6
28161,2020-04-01,4609,3874,735,15.9
28163,2020-04-01,9246,7608,1638,17.7
29001,2020-04-01,10047,9338,709,7.1
29003,2020-04-01,9482,8907,575,6.1
29005,2020-04-01,2850,2683,167,5.9
29007,2020-04-01,10904,9782,1122,10.3
29009,2020-04-01,15966,14547,1419,8.9
29011,2020-04-01,5327,4875,452,8.5
29013,2020-04-01,7573,7061,512,6.8
29015,2020-04-01,7184,6486,698,9.7
29017,2020-04-01,5393,4876,517,9.6
29019,2020-04-01,96279,90019,6260,6.5
29021,2020-04-01,43384,40220,3164,7.3
29023,2020-04-01,18110,16149,1961,10.8
29025,2020-04-01,4374,3963,411,9.4
29027,2020-04-01,20669,19244,1425,6.9
29029,2020-04-01,18844,16329,2515,13.3
29031,2020-04-01,39440,35694,3746,9.5
29033,2020-04-01,4768,4425,343,7.2
29035,2020-04-01,2509,2299,210,8.4
29037,2020-04-01,52490,47895,4595,8.8
29039,2020-04-01,5702,5417,285,5
29041,2020-04-01,3763,3567,196,5.2
29043,2020-04-01,44133,40182,3951,9
29045,2020-04-01,3350,3008,342,10.2
29047,2020-04-01,135933,118820,17113,12.6
29049,2020-04-01,10798,9530,1268,11.7
29051,2020-04-01,37523,34970,2553,6.8
29053,2020-04-01,7429,6755,674,9.1
29055,2020-04-01,10875,9838,1037,9.5
29057,2020-04-01,3618,3423,195,5.4
29059,2020-04-01,7030,6399,631,9
29061,2020-04-01,4296,4053,243,5.7
29063,2020-04-01,4808,4513,295,6.1
29065,2020-04-01,6159,5781,378,6.1
29067,2020-04-01,5360,4614,746,13.9
29069,2020-04-01,11707,10669,1038,8.9
29071,2020-04-01,52314,46725,5589,10.7
29073,2020-04-01,7817,7070,747,9.6
29075,2020-04-01,3585,3424,161,4.5
29077,2020-04-01,149940,135666,14274,9.5
29079,2020-04-01,4479,4169,310,6.9
29081,2020-04-01,3920,3709,211,5.4
29083,2020-04-01,9552,8805,747,7.8
29085,2020-04-01,3844,3579,265,6.9
29087,2020-04-01,2638,2511,127,4.8
29089,2020-04-01,4722,4462,260,5.5
29091,2020-04-01,16347,14783,1564,9.6
29093,2020-04-01,3469,3175,294,8.5
29095,2020-04-01,352702,312421,40281,11.4
29097,2020-04-01,56789,51114,5675,10
29099,2020-04-01,114902,103023,11879,10.3
29101,2020-04-01,23231,21279,1952,8.4
29103,2020-04-01,1780,1708,72,4
29105,2020-04-01,17908,15242,2666,14.9
29107,2020-04-01,16424,15010,1414,8.6
29109,2020-04-01,18085,16559,1526,8.4
29111,2020-04-01,5138,4766,372,7.2
29113,2020-04-01,28607,25069,3538,12.4
29115,2020-04-01,5094,4670,424,8.3
29117,2020-04-01,7460,7016,444,6
29119,2020-04-01,10487,9779,708,6.8
29121,2020-04-01,7388,6932,456,6.2
29123,2020-04-01,5611,5041,570,10.2
29125,2020-04-01,3808,3594,214,5.6
29127,2020-04-01,14280,13292,988,6.9
29129,2020-04-01,2042,1968,74,3.6
29131,2020-04-01,12537,11063,1474,11.8
29133,2020-04-01,5718,5408,310,5.4
29135,2020-04-01,7215,6809,406,5.6
29137,2020-04-01,3812,3487,325,8.5
29139,2020-04-01,5844,5375,469,8
29141,2020-04-01,8172,7351,821,10
29143,2020-04-01,8582,7943,639,7.4
29145,2020-04-01,27470,24629,2841,10.3
29147,2020-04-01,11623,10554,1069,9.2
29149,2020-04-01,4079,3732,347,8.5
29151,2020-04-01,6903,6554,349,5.1
29153,2020-04-01,3568,3197,371,10.4
29155,2020-04-01,6449,5871,578,9
29157,2020-04-01,10675,9096,1579,14.8
29159,2020-04-01,21327,19170,2157,10.1
29161,2020-04-01,19102,17826,1276,6.7
29163,2020-04-01,7457,6848,609,8.2
29165,2020-04-01,57026,51326,5700,10
29167,2020-04-01,14019,13157,862,6.1
29169,2020-04-01,14324,13213,1111,7.8
29171,2020-04-01,2343,2223,120,5.1
29173,2020-04-01,5606,5232,374,6.7
29175,2020-04-01,10245,9345,900,8.8
29177,2020-04-01,11334,9608,1726,15.2
29179,2020-04-01,2956,2742,214,7.2
29181,2020-04-01,5138,4502,636,12.4
29183,2020-04-01,221541,200359,21182,9.6
29185,2020-04-01,3790,3497,293,7.7
29186,2020-04-01,9151,8369,782,8.5
29187,2020-04-01,26347,23703,2644,10
29189,2020-04-01,512721,465883,46838,9.1
29195,2020-04-01,10703,10195,508,4.7
29197,2020-04-01,1967,1840,127,6.5
29199,2020-04-01,2432,2324,108,4.4
29201,2020-04-01,19655,18146,1509,7.7
29203,2020-04-01,3397,3015,382,11.2
29205,2020-04-01,3127,2994,133,4.3
29207,2020-04-01,13601,12233,1368,10.1
29209,2020-04-01,14405,12037,2368,16.4
29211,2020-04-01,2764,2601,163,5.9
29213,2020-04-01,31170,23517,7653,24.6
29215,2020-04-01,8886,8235,651,7.3
29217,2020-04-01,9399,8947,452,4.8
29219,2020-04-01,17770,15883,1887,10.6
29221,2020-04-01,10174,9112,1062,10.4
29223,2020-04-01,4941,4517,424,8.6
29225,2020-04-01,17212,15663,1549,9
29227,2020-04-01,1257,1170,87,6.9
29229,2020-04-01,7883,6981,902,11.4
29510,2020-04-01,150250,132658,17592,11.7
30001,2020-04-01,4744,4400,344,7.3
30003,2020-04-01,4362,3900,462,10.6
30005,2020-04-01,2354,2227,127,5.4
30007,2020-04-01,2460,2184,276,11.2
30009,2020-04-01,5499,4821,678,12.3
30011,2020-04-01,628,607,21,3.3
30013,2020-04-01,36848,32347,4501,12.2
30015,2020-04-01,2356,2215,141,6
30017,2020-04-01,5599,5132,467,8.3
30019,2020-04-01,835,799,36,4.3
30021,2020-04-01,4230,3923,307,7.3
30023,2020-04-01,4772,4270,502,10.5
30025,2020-04-01,1578,1485,93,5.9
30027,2020-04-01,5554,5093,461,8.3
30029,2020-04-01,47788,39852,7936,16.6
30031,2020-04-01,67109,58831,8278,12.3
30033,2020-04-01,722,690,32,4.4
30035,2020-04-01,5186,4512,674,13
30037,2020-04-01,352,329,23,6.5
30039,2020-04-01,1713,1433,280,16.3
30041,2020-04-01,7052,6438,614,8.7
30043,2020-04-01,5363,4847,516,9.6
30045,2020-04-01,1028,952,76,7.4
30047,2020-04-01,12435,11232,1203,9.7
30049,2020-04-01,33958,30341,3617,10.7
30051,2020-04-01,945,919,26,2.8
30053,2020-04-01,7931,6465,1466,18.5
30055,2020-04-01,900,872,28,3.1
30057,2020-04-01,4909,4502,407,8.3
30059,2020-04-01,903,833,70,7.8
30061,2020-04-01,1760,1439,321,18.2
30063,2020-04-01,64082,55553,8529,13.3
30065,2020-04-01,2145,1936,209,9.7
30067,2020-04-01,9034,7501,1533,17
30069,2020-04-01,263,255,8,3
30071,2020-04-01,1807,1667,140,7.7
30073,2020-04-01,2517,2333,184,7.3
30075,2020-04-01,929,880,49,5.3
30077,2020-04-01,2737,2457,280,10.2
30079,2020-04-01,439,412,27,6.2
30081,2020-04-01,19388,17296,2092,10.8
30083,2020-04-01,5475,4862,613,11.2
30085,2020-04-01,4060,3734,326,8
30087,2020-04-01,3513,3242,271,7.7
30089,2020-04-01,4727,4066,661,14
30091,2020-04-01,1689,1548,141,8.3
30093,2020-04-01,16567,14269,2298,13.9
30095,2020-04-01,5180,4690,490,9.5
30097,2020-04-01,1707,1590,117,6.9
30099,2020-04-01,2616,2432,184,7
30101,2020-04-01,1983,1823,160,8.1
30103,2020-04-01,326,311,15,4.6
30105,2020-04-01,3814,3528,286,7.5
30107,2020-04-01,815,717,98,12
30109,2020-04-01,441,395,46,10.4
30111,2020-04-01,79904,71061,8843,11.1
31001,2020-04-01,17588,16127,1461,8.3
31003,2020-04-01,3769,3641,128,3.4
31005,2020-04-01,244,227,17,7
31007,2020-04-01,402,382,20,5
31009,2020-04-01,273,265,8,2.9
31011,2020-04-01,3075,2961,114,3.7
31013,2020-04-01,5606,5175,431,7.7
31015,2020-04-01,1143,1092,51,4.5
31017,2020-04-01,1443,1395,48,3.3
31019,2020-04-01,29859,26911,2948,9.9
31021,2020-04-01,3609,3387,222,6.2
31023,2020-04-01,4826,4504,322,6.7
31025,2020-04-01,13535,12391,1144,8.5
31027,2020-04-01,4658,4410,248,5.3
31029,2020-04-01,2347,2292,55,2.3
31031,2020-04-01,3475,3331,144,4.1
31033,2020-04-01,4498,4131,367,8.2
31035,2020-04-01,3444,3234,210,6.1
31037,2020-04-01,5687,5429,258,4.5
31039,2020-04-01,4952,4737,215,4.3
31041,2020-04-01,6580,6301,279,4.2
31043,2020-04-01,10657,9832,825,7.7
31045,2020-04-01,5021,4797,224,4.5
31047,2020-04-01,13508,12764,744,5.5
31049,2020-04-01,994,941,53,5.3
31051,2020-04-01,3056,2870,186,6.1
31053,2020-04-01,20480,19091,1389,6.8
31055,2020-04-01,304076,272165,31911,10.5
31057,2020-04-01,1222,1189,33,2.7
31059,2020-04-01,3280,3122,158,4.8
31061,2020-04-01,1551,1469,82,5.3
31063,2020-04-01,1613,1553,60,3.7
31065,2020-04-01,2687,2549,138,5.1
31067,2020-04-01,11554,10476,1078,9.3
31069,2020-04-01,1105,1043,62,5.6
31071,2020-04-01,1131,1097,34,3
31073,2020-04-01,1103,1054,49,4.4
31075,2020-04-01,435,425,10,2.3
31077,2020-04-01,1280,1217,63,4.9
31079,2020-04-01,33108,29157,3951,11.9
31081,2020-04-01,4816,4461,355,7.4
31083,2020-04-01,1832,1753,79,4.3
31085,2020-04-01,651,634,17,2.6
31087,2020-04-01,1286,1223,63,4.9
31089,2020-04-01,5942,5704,238,4
31091,2020-04-01,388,368,20,5.2
31093,2020-04-01,3484,3130,354,10.2
31095,2020-04-01,4277,4073,204,4.8
31097,2020-04-01,2132,1990,142,6.7
31099,2020-04-01,4028,3751,277,6.9
31101,2020-04-01,4677,4376,301,6.4
31103,2020-04-01,630,612,18,2.9
31105,2020-04-01,2026,1933,93,4.6
31107,2020-04-01,4787,4563,224,4.7
31109,2020-04-01,180731,163826,16905,9.4
31111,2020-04-01,19034,17598,1436,7.5
31113,2020-04-01,502,473,29,5.8
31115,2020-04-01,419,407,12,2.9
31117,2020-04-01,456,439,17,3.7
31119,2020-04-01,20495,19195,1300,6.3
31121,2020-04-01,4113,3751,362,8.8
31123,2020-04-01,2718,2570,148,5.4
31125,2020-04-01,2066,1955,111,5.4
31127,2020-04-01,3704,3481,223,6
31129,2020-04-01,2457,2357,100,4.1
31131,2020-04-01,8604,8007,597,6.9
31133,2020-04-01,1530,1459,71,4.6
31135,2020-04-01,1876,1832,44,2.3
31137,2020-04-01,5148,4863,285,5.5
31139,2020-04-01,4217,4013,204,4.8
31141,2020-04-01,18565,17021,1544,8.3
31143,2020-04-01,3099,2918,181,5.8
31145,2020-04-01,5966,5669,297,5
31147,2020-04-01,4355,4122,233,5.4
31149,2020-04-01,914,877,37,4
31151,2020-04-01,7604,7140,464,6.1
31153,2020-04-01,96954,88105,8849,9.1
31155,2020-04-01,11148,10290,858,7.7
31157,2020-04-01,18618,17233,1385,7.4
31159,2020-04-01,9111,8364,747,8.2
31161,2020-04-01,2700,2612,88,3.3
31163,2020-04-01,1724,1624,100,5.8
31165,2020-04-01,780,747,33,4.2
31167,2020-04-01,3618,3423,195,5.4
31169,2020-04-01,2888,2738,150,5.2
31171,2020-04-01,429,417,12,2.8
31173,2020-04-01,3289,2968,321,9.8
31175,2020-04-01,2238,2117,121,5.4
31177,2020-04-01,11160,10372,788,7.1
31179,2020-04-01,5875,5604,271,4.6
31181,2020-04-01,1759,1650,109,6.2
31183,2020-04-01,616,597,19,3.1
31185,2020-04-01,7591,7123,468,6.2
32001,2020-04-01,10621,9421,1200,11.3
32003,2020-04-01,NA,696527,359352,34
32005,2020-04-01,22772,18494,4278,18.8
32007,2020-04-01,26944,23171,3773,14
32009,2020-04-01,397,370,27,6.8
32011,2020-04-01,1004,941,63,6.3
32013,2020-04-01,7711,7067,644,8.4
32015,2020-04-01,2954,2721,233,7.9
32017,2020-04-01,1899,1729,170,9
32019,2020-04-01,22136,17959,4177,18.9
32021,2020-04-01,1969,1755,214,10.9
32023,2020-04-01,17238,13870,3368,19.5
32027,2020-04-01,2402,2183,219,9.1
32029,2020-04-01,1803,1393,410,22.7
32031,2020-04-01,221873,176614,45259,20.4
32033,2020-04-01,4359,4025,334,7.7
32510,2020-04-01,23589,18607,4982,21.1
33001,2020-04-01,29271,23229,6042,20.6
33003,2020-04-01,21685,16417,5268,24.3
33005,2020-04-01,37122,31639,5483,14.8
33007,2020-04-01,13707,10665,3042,22.2
33009,2020-04-01,45262,37975,7287,16.1
33011,2020-04-01,228030,188742,39288,17.2
33013,2020-04-01,77363,65232,12131,15.7
33015,2020-04-01,172611,142230,30381,17.6
33017,2020-04-01,68123,56983,11140,16.4
33019,2020-04-01,20579,17775,2804,13.6
34001,2020-04-01,122476,81068,41408,33.8
34003,2020-04-01,477518,403413,74105,15.5
34005,2020-04-01,230986,200040,30946,13.4
34007,2020-04-01,259701,217661,42040,16.2
34009,2020-04-01,42045,30715,11330,26.9
34011,2020-04-01,67714,56567,11147,16.5
34013,2020-04-01,366044,304445,61599,16.8
34015,2020-04-01,153658,129341,24317,15.8
34017,2020-04-01,358627,301197,57430,16
34019,2020-04-01,61918,54326,7592,12.3
34021,2020-04-01,202050,180059,21991,10.9
34023,2020-04-01,423155,363053,60102,14.2
34025,2020-04-01,321846,271602,50244,15.6
34027,2020-04-01,247877,215594,32283,13
34029,2020-04-01,273188,225983,47205,17.3
34031,2020-04-01,249112,199887,49225,19.8
34033,2020-04-01,29409,25170,4239,14.4
34035,2020-04-01,164019,143699,20320,12.4
34037,2020-04-01,74516,61790,12726,17.1
34039,2020-04-01,271937,230044,41893,15.4
34041,2020-04-01,56731,48557,8174,14.4
35001,2020-04-01,316164,277094,39070,12.4
35003,2020-04-01,1022,948,74,7.2
35005,2020-04-01,27030,24393,2637,9.8
35006,2020-04-01,8609,7825,784,9.1
35007,2020-04-01,5181,4715,466,9
35009,2020-04-01,20911,19574,1337,6.4
35011,2020-04-01,669,639,30,4.5
35013,2020-04-01,91298,80668,10630,11.6
35015,2020-04-01,35374,33161,2213,6.3
35017,2020-04-01,11686,10879,807,6.9
35019,2020-04-01,1435,1340,95,6.6
35021,2020-04-01,258,250,8,3.1
35023,2020-04-01,1966,1874,92,4.7
35025,2020-04-01,32120,29225,2895,9
35027,2020-04-01,8938,7739,1199,13.4
35028,2020-04-01,9071,8616,455,5
35029,2020-04-01,9948,8226,1722,17.3
35031,2020-04-01,23717,21259,2458,10.4
35033,2020-04-01,1987,1814,173,8.7
35035,2020-04-01,25178,22191,2987,11.9
35037,2020-04-01,3012,2806,206,6.8
35039,2020-04-01,16032,14320,1712,10.7
35041,2020-04-01,7760,7271,489,6.3
35043,2020-04-01,62934,54705,8229,13.1
35045,2020-04-01,48362,41959,6403,13.2
35047,2020-04-01,10588,9507,1081,10.2
35049,2020-04-01,69089,60422,8667,12.5
35051,2020-04-01,3660,3227,433,11.8
35053,2020-04-01,6034,5535,499,8.3
35055,2020-04-01,16316,13717,2599,15.9
35057,2020-04-01,5008,4434,574,11.5
35059,2020-04-01,1634,1542,92,5.6
35061,2020-04-01,28159,25184,2975,10.6
36001,2020-04-01,154095,135738,18357,11.9
36003,2020-04-01,19358,16805,2553,13.2
36005,2020-04-01,553448,460440,93008,16.8
36007,2020-04-01,84985,72103,12882,15.2
36009,2020-04-01,35380,29158,6222,17.6
36011,2020-04-01,35833,30368,5465,15.3
36013,2020-04-01,55480,46761,8719,15.7
36015,2020-04-01,36692,30823,5869,16
36017,2020-04-01,21730,19171,2559,11.8
36019,2020-04-01,37476,31796,5680,15.2
36021,2020-04-01,30441,27134,3307,10.9
36023,2020-04-01,22596,19400,3196,14.1
36025,2020-04-01,18585,16258,2327,12.5
36027,2020-04-01,140037,120114,19923,14.2
36029,2020-04-01,438057,356220,81837,18.7
36031,2020-04-01,16503,13688,2815,17.1
36033,2020-04-01,20001,17138,2863,14.3
36035,2020-04-01,22616,19150,3466,15.3
36037,2020-04-01,29392,25159,4233,14.4
36039,2020-04-01,20577,17529,3048,14.8
36041,2020-04-01,2159,1853,306,14.2
36043,2020-04-01,27440,23350,4090,14.9
36045,2020-04-01,42604,35289,7315,17.2
36047,2020-04-01,NA,936738,161246,14.7
36049,2020-04-01,11158,9558,1600,14.3
36051,2020-04-01,29368,25262,4106,14
36053,2020-04-01,32032,26833,5199,16.2
36055,2020-04-01,352339,299253,53086,15.1
36057,2020-04-01,21734,18510,3224,14.8
36059,2020-04-01,677995,572044,105951,15.6
36061,2020-04-01,805923,717059,88864,11
36063,2020-04-01,101299,79070,22229,21.9
36065,2020-04-01,100489,85339,15150,15.1
36067,2020-04-01,217600,182640,34960,16.1
36069,2020-04-01,53650,45871,7779,14.5
36071,2020-04-01,176824,149068,27756,15.7
36073,2020-04-01,17008,14306,2702,15.9
36075,2020-04-01,51975,43122,8853,17
36077,2020-04-01,26719,23496,3223,12.1
36079,2020-04-01,49910,42746,7164,14.4
36081,2020-04-01,NA,896079,175491,16.4
36083,2020-04-01,79572,69789,9783,12.3
36085,2020-04-01,202193,173878,28315,14
36087,2020-04-01,145992,125900,20092,13.8
36089,2020-04-01,44571,38339,6232,14
36091,2020-04-01,118384,102739,15645,13.2
36093,2020-04-01,75541,65413,10128,13.4
36095,2020-04-01,14038,12382,1656,11.8
36097,2020-04-01,8311,6922,1389,16.7
36099,2020-04-01,15942,13520,2422,15.2
36101,2020-04-01,42992,36407,6585,15.3
36103,2020-04-01,749536,626210,123326,16.5
36105,2020-04-01,37052,32160,4892,13.2
36107,2020-04-01,23147,19679,3468,15
36109,2020-04-01,48430,43482,4948,10.2
36111,2020-04-01,87774,74666,13108,14.9
36113,2020-04-01,30657,25344,5313,17.3
36115,2020-04-01,26204,22508,3696,14.1
36117,2020-04-01,42100,36085,6015,14.3
36119,2020-04-01,457070,392478,64592,14.1
36121,2020-04-01,17933,15182,2751,15.3
36123,2020-04-01,11185,9705,1480,13.2
37001,2020-04-01,73034,63710,9324,12.8
37003,2020-04-01,17278,13804,3474,20.1
37005,2020-04-01,4348,3897,451,10.4
37007,2020-04-01,10067,9238,829,8.2
37009,2020-04-01,12785,11437,1348,10.5
37011,2020-04-01,7378,6621,757,10.3
37013,2020-04-01,18450,16937,1513,8.2
37015,2020-04-01,7454,6981,473,6.3
37017,2020-04-01,14616,13318,1298,8.9
37019,2020-04-01,46268,38253,8015,17.3
37021,2020-04-01,130172,107158,23014,17.7
37023,2020-04-01,36923,31226,5697,15.4
37025,2020-04-01,100865,88588,12277,12.2
37027,2020-04-01,33041,27746,5295,16
37029,2020-04-01,4484,4096,388,8.7
37031,2020-04-01,31003,27515,3488,11.3
37033,2020-04-01,9459,8125,1334,14.1
37035,2020-04-01,73926,60107,13819,18.7
37037,2020-04-01,32299,29554,2745,8.5
37039,2020-04-01,11340,10016,1324,11.7
37041,2020-04-01,5430,5006,424,7.8
37043,2020-04-01,4201,3747,454,10.8
37045,2020-04-01,49117,42925,6192,12.6
37047,2020-04-01,22332,19887,2445,10.9
37049,2020-04-01,38752,34617,4135,10.7
37051,2020-04-01,119269,101606,17663,14.8
37053,2020-04-01,13381,11608,1773,13.3
37055,2020-04-01,20078,15246,4832,24.1
37057,2020-04-01,74611,64606,10005,13.4
37059,2020-04-01,19061,16558,2503,13.1
37061,2020-04-01,24718,22947,1771,7.2
37063,2020-04-01,158079,142219,15860,10
37065,2020-04-01,19633,17014,2619,13.3
37067,2020-04-01,170784,149876,20908,12.2
37069,2020-04-01,28359,25214,3145,11.1
37071,2020-04-01,104221,89919,14302,13.7
37073,2020-04-01,4743,4399,344,7.3
37075,2020-04-01,3396,2925,471,13.9
37077,2020-04-01,28792,26164,2628,9.1
37079,2020-04-01,9125,8419,706,7.7
37081,2020-04-01,239018,203978,35040,14.7
37083,2020-04-01,19729,17547,2182,11.1
37085,2020-04-01,51148,44991,6157,12
37087,2020-04-01,26703,22769,3934,14.7
37089,2020-04-01,48674,41975,6699,13.8
37091,2020-04-01,8906,8291,615,6.9
37093,2020-04-01,18452,16043,2409,13.1
37095,2020-04-01,1794,1535,259,14.4
37097,2020-04-01,84598,72664,11934,14.1
37099,2020-04-01,21194,18745,2449,11.6
37101,2020-04-01,89891,80195,9696,10.8
37103,2020-04-01,4009,3664,345,8.6
37105,2020-04-01,25823,22238,3585,13.9
37107,2020-04-01,27359,25476,1883,6.9
37109,2020-04-01,40460,35305,5155,12.7
37111,2020-04-01,20922,18482,2440,11.7
37113,2020-04-01,15337,13609,1728,11.3
37115,2020-04-01,8839,7719,1120,12.7
37117,2020-04-01,8563,7835,728,8.5
37119,2020-04-01,578434,504359,74075,12.8
37121,2020-04-01,6102,5341,761,12.5
37123,2020-04-01,10877,9753,1124,10.3
37125,2020-04-01,40881,35661,5220,12.8
37127,2020-04-01,39944,34962,4982,12.5
37129,2020-04-01,112423,95473,16950,15.1
37131,2020-04-01,7237,6696,541,7.5
37133,2020-04-01,61529,54138,7391,12
37135,2020-04-01,71342,65491,5851,8.2
37137,2020-04-01,4857,4449,408,8.4
37139,2020-04-01,16515,14654,1861,11.3
37141,2020-04-01,25413,22228,3185,12.5
37143,2020-04-01,4790,4309,481,10
37145,2020-04-01,17443,15213,2230,12.8
37147,2020-04-01,79995,72217,7778,9.7
37149,2020-04-01,8574,7677,897,10.5
37151,2020-04-01,60709,51734,8975,14.8
37153,2020-04-01,16673,14730,1943,11.7
37155,2020-04-01,48593,43617,4976,10.2
37157,2020-04-01,36816,31123,5693,15.5
37159,2020-04-01,62400,53523,8877,14.2
37161,2020-04-01,25573,21994,3579,14
37163,2020-04-01,28476,26428,2048,7.2
37165,2020-04-01,11892,10201,1691,14.2
37167,2020-04-01,29180,26304,2876,9.9
37169,2020-04-01,19455,17347,2108,10.8
37171,2020-04-01,33618,29349,4269,12.7
37173,2020-04-01,7342,6273,1069,14.6
37175,2020-04-01,14047,12570,1477,10.5
37177,2020-04-01,1322,1132,190,14.4
37179,2020-04-01,112143,100676,11467,10.2
37181,2020-04-01,17706,15531,2175,12.3
37183,2020-04-01,542408,482857,59551,11
37185,2020-04-01,6606,5803,803,12.2
37187,2020-04-01,4119,3712,407,9.9
37189,2020-04-01,29264,25984,3280,11.2
37191,2020-04-01,45917,41507,4410,9.6
37193,2020-04-01,28297,25053,3244,11.5
37195,2020-04-01,34969,30448,4521,12.9
37197,2020-04-01,16796,14233,2563,15.3
37199,2020-04-01,7937,7094,843,10.6
38001,2020-04-01,1029,977,52,5.1
38003,2020-04-01,5125,4756,369,7.2
38005,2020-04-01,2409,2124,285,11.8
38007,2020-04-01,363,341,22,6.1
38009,2020-04-01,2871,2610,261,9.1
38011,2020-04-01,1606,1497,109,6.8
38013,2020-04-01,1050,960,90,8.6
38015,2020-04-01,48795,44249,4546,9.3
38017,2020-04-01,103756,94254,9502,9.2
38019,2020-04-01,1870,1762,108,5.8
38021,2020-04-01,2362,2131,231,9.8
38023,2020-04-01,1377,1303,74,5.4
38025,2020-04-01,3285,3129,156,4.7
38027,2020-04-01,1210,1119,91,7.5
38029,2020-04-01,1422,1309,113,7.9
38031,2020-04-01,1464,1370,94,6.4
38033,2020-04-01,823,785,38,4.6
38035,2020-04-01,37084,33667,3417,9.2
38037,2020-04-01,1192,1143,49,4.1
38039,2020-04-01,1003,964,39,3.9
38041,2020-04-01,1363,1295,68,5
38043,2020-04-01,1278,1174,104,8.1
38045,2020-04-01,2043,1932,111,5.4
38047,2020-04-01,872,826,46,5.3
38049,2020-04-01,3078,2825,253,8.2
38051,2020-04-01,1065,1028,37,3.5
38053,2020-04-01,9946,9034,912,9.2
38055,2020-04-01,4574,4265,309,6.8
38057,2020-04-01,3416,3126,290,8.5
38059,2020-04-01,16231,14541,1690,10.4
38061,2020-04-01,7238,6802,436,6
38063,2020-04-01,1358,1258,100,7.4
38065,2020-04-01,850,782,68,8
38067,2020-04-01,3453,3006,447,12.9
38069,2020-04-01,1677,1531,146,8.7
38071,2020-04-01,5520,5036,484,8.8
38073,2020-04-01,3086,2606,480,15.6
38075,2020-04-01,1210,1118,92,7.6
38077,2020-04-01,8801,7913,888,10.1
38079,2020-04-01,4665,3932,733,15.7
38081,2020-04-01,3082,2523,559,18.1
38083,2020-04-01,671,615,56,8.3
38085,2020-04-01,1148,1108,40,3.5
38087,2020-04-01,389,376,13,3.3
38089,2020-04-01,18705,16846,1859,9.9
38091,2020-04-01,972,929,43,4.4
38093,2020-04-01,10115,9514,601,5.9
38095,2020-04-01,1079,1039,40,3.7
38097,2020-04-01,4290,4017,273,6.4
38099,2020-04-01,5038,4679,359,7.1
38101,2020-04-01,31866,28562,3304,10.4
38103,2020-04-01,1887,1758,129,6.8
38105,2020-04-01,23972,21278,2694,11.2
39001,2020-04-01,10421,8609,1812,17.4
39003,2020-04-01,48866,38833,10033,20.5
39005,2020-04-01,26118,22846,3272,12.5
39007,2020-04-01,42685,35936,6749,15.8
39009,2020-04-01,26514,23522,2992,11.3
39011,2020-04-01,25471,20532,4939,19.4
39013,2020-04-01,28636,23439,5197,18.1
39015,2020-04-01,18888,15924,2964,15.7
39017,2020-04-01,186305,159906,26399,14.2
39019,2020-04-01,12711,10574,2137,16.8
39021,2020-04-01,19524,15602,3922,20.1
39023,2020-04-01,64955,53667,11288,17.4
39025,2020-04-01,101667,87553,14114,13.9
39027,2020-04-01,17902,14832,3070,17.1
39029,2020-04-01,46929,37288,9641,20.5
39031,2020-04-01,13818,11550,2268,16.4
39033,2020-04-01,18240,13867,4373,24
39035,2020-04-01,593098,457459,135639,22.9
39037,2020-04-01,25609,21096,4513,17.6
39039,2020-04-01,18338,14191,4147,22.6
39041,2020-04-01,103663,92245,11418,11
39043,2020-04-01,37826,28212,9614,25.4
39045,2020-04-01,75686,65110,10576,14
39047,2020-04-01,13960,11711,2249,16.1
39049,2020-04-01,674112,580504,93608,13.9
39051,2020-04-01,22607,17896,4711,20.8
39053,2020-04-01,12511,10838,1673,13.4
39055,2020-04-01,44475,37139,7336,16.5
39057,2020-04-01,80621,70318,10303,12.8
39059,2020-04-01,18289,15568,2721,14.9
39061,2020-04-01,396489,340371,56118,14.2
39063,2020-04-01,42882,35513,7369,17.2
39065,2020-04-01,13504,10478,3026,22.4
39067,2020-04-01,6468,5495,973,15
39069,2020-04-01,12912,10204,2708,21
39071,2020-04-01,16662,13311,3351,20.1
39073,2020-04-01,12793,10758,2035,15.9
39075,2020-04-01,20765,19432,1333,6.4
39077,2020-04-01,27967,21983,5984,21.4
39079,2020-04-01,12695,10796,1899,15
39081,2020-04-01,26971,22048,4923,18.3
39083,2020-04-01,30470,26693,3777,12.4
39085,2020-04-01,120486,95013,25473,21.1
39087,2020-04-01,23806,19945,3861,16.2
39089,2020-04-01,86987,75455,11532,13.3
39091,2020-04-01,23837,16669,7168,30.1
39093,2020-04-01,153014,115115,37899,24.8
39095,2020-04-01,214217,163891,50326,23.5
39097,2020-04-01,20235,17610,2625,13
39099,2020-04-01,100598,80261,20337,20.2
39101,2020-04-01,28260,23302,4958,17.5
39103,2020-04-01,92599,73734,18865,20.4
39105,2020-04-01,8609,7251,1358,15.8
39107,2020-04-01,23551,20226,3325,14.1
39109,2020-04-01,54488,45821,8667,15.9
39111,2020-04-01,5170,4326,844,16.3
39113,2020-04-01,254723,211630,43093,16.9
39115,2020-04-01,6317,5208,1109,17.6
39117,2020-04-01,16661,13971,2690,16.1
39119,2020-04-01,39441,33205,6236,15.8
39121,2020-04-01,4574,3812,762,16.7
39123,2020-04-01,19856,16010,3846,19.4
39125,2020-04-01,8593,6860,1733,20.2
39127,2020-04-01,15763,13108,2655,16.8
39129,2020-04-01,25628,22098,3530,13.8
39131,2020-04-01,10783,8859,1924,17.8
39133,2020-04-01,81949,70020,11929,14.6
39135,2020-04-01,20124,17191,2933,14.6
39137,2020-04-01,18483,15745,2738,14.8
39139,2020-04-01,53442,42612,10830,20.3
39141,2020-04-01,35509,28985,6524,18.4
39143,2020-04-01,30264,24266,5998,19.8
39145,2020-04-01,28602,24340,4262,14.9
39147,2020-04-01,27305,21513,5792,21.2
39149,2020-04-01,25198,19763,5435,21.6
39151,2020-04-01,180267,151103,29164,16.2
39153,2020-04-01,260229,218010,42219,16.2
39155,2020-04-01,85143,67201,17942,21.1
39157,2020-04-01,44486,37739,6747,15.2
39159,2020-04-01,29360,24468,4892,16.7
39161,2020-04-01,15234,12727,2507,16.5
39163,2020-04-01,5371,4481,890,16.6
39165,2020-04-01,112846,97929,14917,13.2
39167,2020-04-01,27908,23763,4145,14.9
39169,2020-04-01,61450,54251,7199,11.7
39171,2020-04-01,19333,15230,4103,21.2
39173,2020-04-01,67705,56240,11465,16.9
39175,2020-04-01,13221,10526,2695,20.4
40001,2020-04-01,7571,6761,810,10.7
40003,2020-04-01,2559,2390,169,6.6
40005,2020-04-01,4737,4092,645,13.6
40007,2020-04-01,2529,2431,98,3.9
40009,2020-04-01,9276,7888,1388,15
40011,2020-04-01,4366,3888,478,10.9
40013,2020-04-01,20572,18088,2484,12.1
40015,2020-04-01,11340,9919,1421,12.5
40017,2020-04-01,72309,61037,11272,15.6
40019,2020-04-01,21519,17513,4006,18.6
40021,2020-04-01,17683,15752,1931,10.9
40023,2020-04-01,5211,4453,758,14.5
40025,2020-04-01,1263,1230,33,2.6
40027,2020-04-01,135890,116900,18990,14
40029,2020-04-01,2246,1999,247,11
40031,2020-04-01,47329,38301,9028,19.1
40033,2020-04-01,2768,2235,533,19.3
40035,2020-04-01,5528,4876,652,11.8
40037,2020-04-01,30067,25781,4286,14.3
40039,2020-04-01,14591,13110,1481,10.2
40041,2020-04-01,17459,15222,2237,12.8
40043,2020-04-01,2714,2517,197,7.3
40045,2020-04-01,1920,1788,132,6.9
40047,2020-04-01,25575,22649,2926,11.4
40049,2020-04-01,11993,10336,1657,13.8
40051,2020-04-01,25345,21854,3491,13.8
40053,2020-04-01,2468,2312,156,6.3
40055,2020-04-01,1844,1576,268,14.5
40057,2020-04-01,1116,1051,65,5.8
40059,2020-04-01,1629,1549,80,4.9
40061,2020-04-01,4065,3463,602,14.8
40063,2020-04-01,5208,4476,732,14.1
40065,2020-04-01,9976,9113,863,8.7
40067,2020-04-01,2486,2112,374,15
40069,2020-04-01,3342,2680,662,19.8
40071,2020-04-01,17561,14859,2702,15.4
40073,2020-04-01,8223,7569,654,8
40075,2020-04-01,3223,2864,359,11.1
40077,2020-04-01,3032,2494,538,17.7
40079,2020-04-01,18071,15580,2491,13.8
40081,2020-04-01,14769,12946,1823,12.3
40083,2020-04-01,20673,18208,2465,11.9
40085,2020-04-01,5944,5178,766,12.9
40087,2020-04-01,18788,16307,2481,13.2
40089,2020-04-01,14103,12399,1704,12.1
40091,2020-04-01,7075,5919,1156,16.3
40093,2020-04-01,3558,3264,294,8.3
40095,2020-04-01,7007,5786,1221,17.4
40097,2020-04-01,18062,16204,1858,10.3
40099,2020-04-01,6044,5296,748,12.4
40101,2020-04-01,28331,24629,3702,13.1
40103,2020-04-01,5200,4704,496,9.5
40105,2020-04-01,4282,3856,426,9.9
40107,2020-04-01,4285,3740,545,12.7
40109,2020-04-01,371093,314071,57022,15.4
40111,2020-04-01,14999,12715,2284,15.2
40113,2020-04-01,19722,16940,2782,14.1
40115,2020-04-01,14498,12077,2421,16.7
40117,2020-04-01,7019,6032,987,14.1
40119,2020-04-01,36527,31941,4586,12.6
40121,2020-04-01,16724,13942,2782,16.6
40123,2020-04-01,18350,16019,2331,12.7
40125,2020-04-01,30954,26730,4224,13.6
40127,2020-04-01,4133,3590,543,13.1
40129,2020-04-01,1735,1566,169,9.7
40131,2020-04-01,42804,37005,5799,13.5
40133,2020-04-01,9117,7789,1328,14.6
40135,2020-04-01,15916,13302,2614,16.4
40137,2020-04-01,17958,15233,2725,15.2
40139,2020-04-01,10648,10336,312,2.9
40141,2020-04-01,3240,2557,683,21.1
40143,2020-04-01,313277,264582,48695,15.5
40145,2020-04-01,36157,31123,5034,13.9
40147,2020-04-01,20986,18229,2757,13.1
40149,2020-04-01,4864,4258,606,12.5
40151,2020-04-01,4260,3980,280,6.6
40153,2020-04-01,8350,7301,1049,12.6
41001,2020-04-01,7129,6191,938,13.2
41003,2020-04-01,47671,42747,4924,10.3
41005,2020-04-01,218466,188315,30151,13.8
41007,2020-04-01,19063,14437,4626,24.3
41009,2020-04-01,24434,20768,3666,15
41011,2020-04-01,26811,21810,5001,18.7
41013,2020-04-01,9710,7912,1798,18.5
41015,2020-04-01,8684,7114,1570,18.1
41017,2020-04-01,96249,78664,17585,18.3
41019,2020-04-01,47102,39342,7760,16.5
41021,2020-04-01,896,795,101,11.3
41023,2020-04-01,3200,2726,474,14.8
41025,2020-04-01,3501,3166,335,9.6
41027,2020-04-01,13571,11641,1930,14.2
41029,2020-04-01,102887,86475,16412,16
41031,2020-04-01,9843,8441,1402,14.2
41033,2020-04-01,35928,30441,5487,15.3
41035,2020-04-01,29071,24517,4554,15.7
41037,2020-04-01,3505,3165,340,9.7
41039,2020-04-01,180016,151235,28781,16
41041,2020-04-01,20944,15469,5475,26.1
41043,2020-04-01,60724,51431,9293,15.3
41045,2020-04-01,12453,11448,1005,8.1
41047,2020-04-01,159713,138484,21229,13.3
41049,2020-04-01,5613,5187,426,7.6
41051,2020-04-01,463445,389777,73668,15.9
41053,2020-04-01,38971,34009,4962,12.7
41055,2020-04-01,959,843,116,12.1
41057,2020-04-01,11843,9716,2127,18
41059,2020-04-01,37583,32384,5199,13.8
41061,2020-04-01,12194,9921,2273,18.6
41063,2020-04-01,3376,2895,481,14.2
41065,2020-04-01,12429,10604,1825,14.7
41067,2020-04-01,318046,279522,38524,12.1
41069,2020-04-01,684,644,40,5.8
41071,2020-04-01,54527,47352,7175,13.2
42001,2020-04-01,54638,46796,7842,14.4
42003,2020-04-01,627393,528764,98629,15.7
42005,2020-04-01,31460,26039,5421,17.2
42007,2020-04-01,83374,68208,15166,18.2
42009,2020-04-01,23428,19311,4117,17.6
42011,2020-04-01,223420,185996,37424,16.8
42013,2020-04-01,61364,50961,10403,17
42015,2020-04-01,27720,24280,3440,12.4
42017,2020-04-01,335675,285186,50489,15
42019,2020-04-01,96397,81565,14832,15.4
42021,2020-04-01,57618,47651,9967,17.3
42023,2020-04-01,2226,1689,537,24.1
42025,2020-04-01,32568,26521,6047,18.6
42027,2020-04-01,79742,71986,7756,9.7
42029,2020-04-01,269402,238228,31174,11.6
42031,2020-04-01,17077,14269,2808,16.4
42033,2020-04-01,36668,30567,6101,16.6
42035,2020-04-01,17662,14965,2697,15.3
42037,2020-04-01,34894,29731,5163,14.8
42039,2020-04-01,37759,31665,6094,16.1
42041,2020-04-01,130840,115178,15662,12
42043,2020-04-01,146261,124988,21273,14.5
42045,2020-04-01,296432,252907,43525,14.7
42047,2020-04-01,16802,12686,4116,24.5
42049,2020-04-01,126086,104851,21235,16.8
42051,2020-04-01,57130,45726,11404,20
42053,2020-04-01,1859,1532,327,17.6
42055,2020-04-01,76584,66700,9884,12.9
42057,2020-04-01,8086,6708,1378,17
42059,2020-04-01,15601,13366,2235,14.3
42061,2020-04-01,19801,16464,3337,16.9
42063,2020-04-01,37833,32132,5701,15.1
42065,2020-04-01,20315,17046,3269,16.1
42067,2020-04-01,12794,10573,2221,17.4
42069,2020-04-01,102777,85105,17672,17.2
42071,2020-04-01,277205,236422,40783,14.7
42073,2020-04-01,40440,33096,7344,18.2
42075,2020-04-01,73845,63736,10109,13.7
42077,2020-04-01,192225,160494,31731,16.5
42079,2020-04-01,155205,126502,28703,18.5
42081,2020-04-01,52782,43859,8923,16.9
42083,2020-04-01,17287,14131,3156,18.3
42085,2020-04-01,48178,39858,8320,17.3
42087,2020-04-01,21088,17717,3371,16
42089,2020-04-01,83058,66232,16826,20.3
42091,2020-04-01,437696,378200,59496,13.6
42093,2020-04-01,9193,8186,1007,11
42095,2020-04-01,159784,134401,25383,15.9
42097,2020-04-01,42955,35755,7200,16.8
42099,2020-04-01,24403,21247,3156,12.9
42101,2020-04-01,739062,613684,125378,17
42103,2020-04-01,24882,20122,4760,19.1
42105,2020-04-01,6976,5928,1048,15
42107,2020-04-01,66873,56053,10820,16.2
42109,2020-04-01,20469,17012,3457,16.9
42111,2020-04-01,32533,26791,5742,17.6
42113,2020-04-01,2487,2116,371,14.9
42115,2020-04-01,19213,16742,2471,12.9
42117,2020-04-01,18412,15723,2689,14.6
42119,2020-04-01,19245,16666,2579,13.4
42121,2020-04-01,21772,18514,3258,15
42123,2020-04-01,18275,15917,2358,12.9
42125,2020-04-01,104663,86981,17682,16.9
42127,2020-04-01,21644,17700,3944,18.2
42129,2020-04-01,177683,147125,30558,17.2
42131,2020-04-01,13039,11020,2019,15.5
42133,2020-04-01,240179,204548,35631,14.8
44001,2020-04-01,23759,20307,3452,14.5
44003,2020-04-01,86280,70691,15589,18.1
44005,2020-04-01,41172,34538,6634,16.1
44007,2020-04-01,309856,251905,57951,18.7
44009,2020-04-01,62294,52409,9885,15.9
45001,2020-04-01,10097,8703,1394,13.8
45003,2020-04-01,75678,68149,7529,9.9
45005,2020-04-01,2577,2245,332,12.9
45007,2020-04-01,92951,81268,11683,12.6
45009,2020-04-01,4804,4247,557,11.6
45011,2020-04-01,7814,7010,804,10.3
45013,2020-04-01,75837,66770,9067,12
45015,2020-04-01,101035,90144,10891,10.8
45017,2020-04-01,6454,5903,551,8.5
45019,2020-04-01,211096,183515,27581,13.1
45021,2020-04-01,26741,22334,4407,16.5
45023,2020-04-01,13484,11531,1953,14.5
45025,2020-04-01,21754,19379,2375,10.9
45027,2020-04-01,12671,11235,1436,11.3
45029,2020-04-01,16181,14717,1464,9
45031,2020-04-01,30403,27329,3074,10.1
45033,2020-04-01,12789,11630,1159,9.1
45035,2020-04-01,76292,67737,8555,11.2
45037,2020-04-01,10892,9754,1138,10.4
45039,2020-04-01,9640,8530,1110,11.5
45041,2020-04-01,65889,60272,5617,8.5
45043,2020-04-01,26097,22157,3940,15.1
45045,2020-04-01,259495,227709,31786,12.2
45047,2020-04-01,30720,27289,3431,11.2
45049,2020-04-01,7942,7368,574,7.2
45051,2020-04-01,146260,113297,32963,22.5
45053,2020-04-01,12008,10862,1146,9.5
45055,2020-04-01,29055,26376,2679,9.2
45057,2020-04-01,40953,35708,5245,12.8
45059,2020-04-01,31214,26813,4401,14.1
45061,2020-04-01,6657,5856,801,12
45063,2020-04-01,147193,136019,11174,7.6
45065,2020-04-01,3314,2929,385,11.6
45067,2020-04-01,12522,11035,1487,11.9
45069,2020-04-01,9553,7885,1668,17.5
45071,2020-04-01,18542,16908,1634,8.8
45073,2020-04-01,35317,31079,4238,12
45075,2020-04-01,35128,30461,4667,13.3
45077,2020-04-01,57407,51094,6313,11
45079,2020-04-01,197151,179502,17649,9
45081,2020-04-01,8687,8073,614,7.1
45083,2020-04-01,161761,137456,24305,15
45085,2020-04-01,45137,40167,4970,11
45087,2020-04-01,12675,10355,2320,18.3
45089,2020-04-01,11908,10467,1441,12.1
45091,2020-04-01,138502,121985,16517,11.9
46003,2020-04-01,1478,1394,84,5.7
46005,2020-04-01,9436,8729,707,7.5
46007,2020-04-01,1033,965,68,6.6
46009,2020-04-01,2823,2578,245,8.7
46011,2020-04-01,19124,17461,1663,8.7
46013,2020-04-01,21143,18971,2172,10.3
46015,2020-04-01,2513,2228,285,11.3
46017,2020-04-01,693,592,101,14.6
46019,2020-04-01,5215,4556,659,12.6
46021,2020-04-01,745,696,49,6.6
46023,2020-04-01,3798,3359,439,11.6
46025,2020-04-01,1860,1687,173,9.3
46027,2020-04-01,7748,7085,663,8.6
46029,2020-04-01,16172,14051,2121,13.1
46031,2020-04-01,1283,1203,80,6.2
46033,2020-04-01,4042,3502,540,13.4
46035,2020-04-01,10993,10045,948,8.6
46037,2020-04-01,2776,2405,371,13.4
46039,2020-04-01,2193,1929,264,12
46041,2020-04-01,2121,1929,192,9.1
46043,2020-04-01,1492,1429,63,4.2
46045,2020-04-01,1959,1868,91,4.6
46047,2020-04-01,2982,2670,312,10.5
46049,2020-04-01,1004,949,55,5.5
46051,2020-04-01,4407,4016,391,8.9
46053,2020-04-01,1990,1847,143,7.2
46055,2020-04-01,1000,956,44,4.4
46057,2020-04-01,3176,2937,239,7.5
46059,2020-04-01,1688,1606,82,4.9
46061,2020-04-01,1704,1548,156,9.2
46063,2020-04-01,704,655,49,7
46065,2020-04-01,9768,9012,756,7.7
46067,2020-04-01,3509,3264,245,7
46069,2020-04-01,644,617,27,4.2
46071,2020-04-01,1172,1107,65,5.5
46073,2020-04-01,1058,1010,48,4.5
46075,2020-04-01,508,478,30,5.9
46077,2020-04-01,2625,2446,179,6.8
46079,2020-04-01,6624,6151,473,7.1
46081,2020-04-01,15217,11884,3333,21.9
46083,2020-04-01,34415,31299,3116,9.1
46085,2020-04-01,1633,1468,165,10.1
46087,2020-04-01,3030,2792,238,7.9
46089,2020-04-01,988,895,93,9.4
46091,2020-04-01,2353,2076,277,11.8
46093,2020-04-01,14189,12329,1860,13.1
46095,2020-04-01,720,659,61,8.5
46097,2020-04-01,1141,1054,87,7.6
46099,2020-04-01,114719,101951,12768,11.1
46101,2020-04-01,4076,3591,485,11.9
46102,2020-04-01,3375,3020,355,10.5
46103,2020-04-01,57388,49339,8049,14
46105,2020-04-01,1366,1299,67,4.9
46107,2020-04-01,985,932,53,5.4
46109,2020-04-01,5159,4258,901,17.5
46111,2020-04-01,1129,1042,87,7.7
46115,2020-04-01,3113,2868,245,7.9
46117,2020-04-01,1825,1660,165,9
46119,2020-04-01,766,722,44,5.7
46121,2020-04-01,3090,2816,274,8.9
46123,2020-04-01,2920,2762,158,5.4
46125,2020-04-01,4657,4283,374,8
46127,2020-04-01,8763,7689,1074,12.3
46129,2020-04-01,2077,1843,234,11.3
46135,2020-04-01,12408,10939,1469,11.8
46137,2020-04-01,872,826,46,5.3
47001,2020-04-01,33630,28627,5003,14.9
47003,2020-04-01,21770,17722,4048,18.6
47005,2020-04-01,6841,5847,994,14.5
47007,2020-04-01,4418,3690,728,16.5
47009,2020-04-01,61609,52761,8848,14.4
47011,2020-04-01,49564,42816,6748,13.6
47013,2020-04-01,14568,12150,2418,16.6
47015,2020-04-01,6422,5401,1021,15.9
47017,2020-04-01,11573,9976,1597,13.8
47019,2020-04-01,23075,20214,2861,12.4
47021,2020-04-01,20390,18014,2376,11.7
47023,2020-04-01,7575,6738,837,11
47025,2020-04-01,12880,10963,1917,14.9
47027,2020-04-01,2659,2295,364,13.7
47029,2020-04-01,16101,12063,4038,25.1
47031,2020-04-01,26654,21371,5283,19.8
47033,2020-04-01,6218,5558,660,10.6
47035,2020-04-01,22726,19843,2883,12.7
47037,2020-04-01,395756,332178,63578,16.1
47039,2020-04-01,4484,3821,663,14.8
47041,2020-04-01,7785,6068,1717,22.1
47043,2020-04-01,25676,22127,3549,13.8
47045,2020-04-01,16146,13845,2301,14.3
47047,2020-04-01,17501,15847,1654,9.5
47049,2020-04-01,7287,6569,718,9.9
47051,2020-04-01,21704,17138,4566,21
47053,2020-04-01,21169,18623,2546,12
47055,2020-04-01,15336,12338,2998,19.5
47057,2020-04-01,9181,7858,1323,14.4
47059,2020-04-01,30050,25017,5033,16.7
47061,2020-04-01,5714,4301,1413,24.7
47063,2020-04-01,27862,23689,4173,15
47065,2020-04-01,185870,159179,26691,14.4
47067,2020-04-01,2075,1813,262,12.6
47069,2020-04-01,8987,8097,890,9.9
47071,2020-04-01,10289,9143,1146,11.1
47073,2020-04-01,23149,19599,3550,15.3
47075,2020-04-01,7400,6471,929,12.6
47077,2020-04-01,12145,10207,1938,16
47079,2020-04-01,14014,11969,2045,14.6
47081,2020-04-01,10715,9380,1335,12.5
47083,2020-04-01,3180,2753,427,13.4
47085,2020-04-01,8660,7632,1028,11.9
47087,2020-04-01,4725,3928,797,16.9
47089,2020-04-01,25027,20729,4298,17.2
47091,2020-04-01,7514,6645,869,11.6
47093,2020-04-01,233205,203055,30150,12.9
47095,2020-04-01,1719,1489,230,13.4
47097,2020-04-01,9487,8174,1313,13.8
47099,2020-04-01,19844,16198,3646,18.4
47101,2020-04-01,5363,4300,1063,19.8
47103,2020-04-01,15945,13367,2578,16.2
47105,2020-04-01,22998,19500,3498,15.2
47107,2020-04-01,24582,20363,4219,17.2
47109,2020-04-01,8328,7262,1066,12.8
47111,2020-04-01,10775,9292,1483,13.8
47113,2020-04-01,44901,38427,6474,14.4
47115,2020-04-01,12500,10698,1802,14.4
47117,2020-04-01,16513,12533,3980,24.1
47119,2020-04-01,51717,40421,11296,21.8
47121,2020-04-01,5370,4382,988,18.4
47123,2020-04-01,21282,16633,4649,21.8
47125,2020-04-01,83019,70200,12819,15.4
47127,2020-04-01,3614,3172,442,12.2
47129,2020-04-01,7262,6491,771,10.6
47131,2020-04-01,12227,10970,1257,10.3
47133,2020-04-01,9837,8505,1332,13.5
47135,2020-04-01,2961,2275,686,23.2
47137,2020-04-01,2237,2001,236,10.5
47139,2020-04-01,7120,6155,965,13.6
47141,2020-04-01,34962,29907,5055,14.5
47143,2020-04-01,14036,10693,3343,23.8
47145,2020-04-01,21849,19257,2592,11.9
47147,2020-04-01,35831,31215,4616,12.9
47149,2020-04-01,181474,151187,30287,16.7
47151,2020-04-01,8491,7028,1463,17.2
47153,2020-04-01,6352,5311,1041,16.4
47155,2020-04-01,57128,40493,16635,29.1
47157,2020-04-01,420365,365058,55307,13.2
47159,2020-04-01,9045,7759,1286,14.2
47161,2020-04-01,5149,4556,593,11.5
47163,2020-04-01,68044,58237,9807,14.4
47165,2020-04-01,98617,84069,14548,14.8
47167,2020-04-01,25936,23157,2779,10.7
47169,2020-04-01,5059,4445,614,12.1
47171,2020-04-01,6828,5943,885,13
47173,2020-04-01,7217,6286,931,12.9
47175,2020-04-01,2080,1664,416,20
47177,2020-04-01,16749,12550,4199,25.1
47179,2020-04-01,58920,51147,7773,13.2
47181,2020-04-01,6127,5350,777,12.7
47183,2020-04-01,14697,13300,1397,9.5
47185,2020-04-01,12131,10104,2027,16.7
47187,2020-04-01,118157,105804,12353,10.5
47189,2020-04-01,73122,62941,10181,13.9
48001,2020-04-01,20955,19334,1621,7.7
48003,2020-04-01,8958,7971,987,11
48005,2020-04-01,32414,28588,3826,11.8
48007,2020-04-01,8446,7212,1234,14.6
48009,2020-04-01,3585,3275,310,8.6
48011,2020-04-01,818,764,54,6.6
48013,2020-04-01,19963,17340,2623,13.1
48015,2020-04-01,12503,11290,1213,9.7
48017,2020-04-01,2100,1965,135,6.4
48019,2020-04-01,8888,8048,840,9.5
48021,2020-04-01,38610,34486,4124,10.7
48023,2020-04-01,1522,1462,60,3.9
48025,2020-04-01,8952,7797,1155,12.9
48027,2020-04-01,133620,118291,15329,11.5
48029,2020-04-01,885070,761808,123262,13.9
48031,2020-04-01,5661,5279,382,6.7
48033,2020-04-01,358,345,13,3.6
48035,2020-04-01,7292,6664,628,8.6
48037,2020-04-01,37203,32144,5059,13.6
48039,2020-04-01,164993,142698,22295,13.5
48041,2020-04-01,110838,101159,9679,8.7
48043,2020-04-01,3897,3406,491,12.6
48045,2020-04-01,494,464,30,6.1
48047,2020-04-01,2399,2081,318,13.3
48049,2020-04-01,13544,12190,1354,10
48051,2020-04-01,7731,7054,677,8.8
48053,2020-04-01,20654,18829,1825,8.8
48055,2020-04-01,17613,15757,1856,10.5
48057,2020-04-01,10923,9949,974,8.9
48059,2020-04-01,5383,4965,418,7.8
48061,2020-04-01,156495,130037,26458,16.9
48063,2020-04-01,4432,3983,449,10.1
48065,2020-04-01,2655,2483,172,6.5
48067,2020-04-01,11276,9941,1335,11.8
48069,2020-04-01,2922,2804,118,4
48071,2020-04-01,18145,15422,2723,15
48073,2020-04-01,19138,16716,2422,12.7
48075,2020-04-01,2485,2350,135,5.4
48077,2020-04-01,4274,3901,373,8.7
48079,2020-04-01,1005,906,99,9.9
48081,2020-04-01,1248,1155,93,7.5
48083,2020-04-01,2538,2244,294,11.6
48085,2020-04-01,525007,461401,63606,12.1
48087,2020-04-01,945,897,48,5.1
48089,2020-04-01,8491,7869,622,7.3
48091,2020-04-01,66712,58752,7960,11.9
48093,2020-04-01,4848,4509,339,7
48095,2020-04-01,1176,1104,72,6.1
48097,2020-04-01,18746,16142,2604,13.9
48099,2020-04-01,22124,19805,2319,10.5
48101,2020-04-01,451,421,30,6.7
48103,2020-04-01,1473,1193,280,19
48105,2020-04-01,1479,1305,174,11.8
48107,2020-04-01,2163,2009,154,7.1
48109,2020-04-01,891,801,90,10.1
48111,2020-04-01,3227,3122,105,3.3
48113,2020-04-01,NA,NA,165785,13
48115,2020-04-01,4186,3735,451,10.8
48117,2020-04-01,7292,6953,339,4.6
48119,2020-04-01,2149,1959,190,8.8
48121,2020-04-01,465348,405745,59603,12.8
48123,2020-04-01,8658,7987,671,7.8
48125,2020-04-01,590,539,51,8.6
48127,2020-04-01,6340,5867,473,7.5
48129,2020-04-01,1152,1089,63,5.5
48131,2020-04-01,4551,3844,707,15.5
48133,2020-04-01,6779,6160,619,9.1
48135,2020-04-01,79892,68955,10937,13.7
48137,2020-04-01,952,918,34,3.6
48139,2020-04-01,84995,75803,9192,10.8
48141,2020-04-01,334025,284081,49944,15
48143,2020-04-01,18405,16814,1591,8.6
48145,2020-04-01,5894,5371,523,8.9
48147,2020-04-01,15606,14451,1155,7.4
48149,2020-04-01,10318,9606,712,6.9
48151,2020-04-01,1359,1292,67,4.9
48153,2020-04-01,2235,2055,180,8.1
48155,2020-04-01,517,478,39,7.5
48157,2020-04-01,360575,313642,46933,13
48159,2020-04-01,4090,3733,357,8.7
48161,2020-04-01,5584,4974,610,10.9
48163,2020-04-01,9041,8449,592,6.5
48165,2020-04-01,8551,7946,605,7.1
48167,2020-04-01,156162,131592,24570,15.7
48169,2020-04-01,1876,1720,156,8.3
48171,2020-04-01,12012,10778,1234,10.3
48173,2020-04-01,687,653,34,4.9
48175,2020-04-01,2843,2540,303,10.7
48177,2020-04-01,8357,7746,611,7.3
48179,2020-04-01,7170,6428,742,10.3
48181,2020-04-01,59788,53643,6145,10.3
48183,2020-04-01,53391,46389,7002,13.1
48185,2020-04-01,10134,9027,1107,10.9
48187,2020-04-01,73648,65604,8044,10.9
48189,2020-04-01,10512,9522,990,9.4
48191,2020-04-01,907,837,70,7.7
48193,2020-04-01,3136,2925,211,6.7
48195,2020-04-01,2251,2178,73,3.2
48197,2020-04-01,1480,1401,79,5.3
48199,2020-04-01,23164,19537,3627,15.7
48201,2020-04-01,NA,NA,315353,14.6
48203,2020-04-01,26142,23121,3021,11.6
48205,2020-04-01,2319,2259,60,2.6
48207,2020-04-01,1946,1817,129,6.6
48209,2020-04-01,110748,96589,14159,12.8
48211,2020-04-01,1554,1463,91,5.9
48213,2020-04-01,32868,29575,3293,10
48215,2020-04-01,337518,276347,61171,18.1
48217,2020-04-01,14638,13165,1473,10.1
48219,2020-04-01,10082,8927,1155,11.5
48221,2020-04-01,24720,22000,2720,11
48223,2020-04-01,15439,14139,1300,8.4
48225,2020-04-01,8768,8187,581,6.6
48227,2020-04-01,12620,11308,1312,10.4
48229,2020-04-01,1644,1448,196,11.9
48231,2020-04-01,39699,35325,4374,11
48233,2020-04-01,7602,6790,812,10.7
48235,2020-04-01,648,600,48,7.4
48237,2020-04-01,2950,2643,307,10.4
48239,2020-04-01,6641,6109,532,8
48241,2020-04-01,11907,9852,2055,17.3
48243,2020-04-01,880,801,79,9
48245,2020-04-01,100516,81442,19074,19
48247,2020-04-01,1594,1398,196,12.3
48249,2020-04-01,15784,13131,2653,16.8
48251,2020-04-01,74619,65913,8706,11.7
48253,2020-04-01,5142,4654,488,9.5
48255,2020-04-01,6408,5935,473,7.4
48257,2020-04-01,59677,52839,6838,11.5
48259,2020-04-01,19626,17791,1835,9.3
48261,2020-04-01,171,161,10,5.8
48263,2020-04-01,410,389,21,5.1
48265,2020-04-01,20053,17784,2269,11.3
48267,2020-04-01,1549,1464,85,5.5
48269,2020-04-01,202,198,4,2
48271,2020-04-01,1199,1109,90,7.5
48273,2020-04-01,12237,10721,1516,12.4
48275,2020-04-01,1248,1155,93,7.5
48277,2020-04-01,21950,19654,2296,10.5
48279,2020-04-01,4621,4300,321,6.9
48281,2020-04-01,8273,7596,677,8.2
48283,2020-04-01,3753,3453,300,8
48285,2020-04-01,7173,6656,517,7.2
48287,2020-04-01,8676,8047,629,7.2
48289,2020-04-01,5537,4969,568,10.3
48291,2020-04-01,30787,26053,4734,15.4
48293,2020-04-01,7548,6859,689,9.1
48295,2020-04-01,1360,1284,76,5.6
48297,2020-04-01,4945,4496,449,9.1
48299,2020-04-01,7614,6895,719,9.4
48301,2020-04-01,602,595,7,1.2
48303,2020-04-01,140381,126171,14210,10.1
48305,2020-04-01,2409,2246,163,6.8
48307,2020-04-01,2860,2572,288,10.1
48309,2020-04-01,108584,97067,11517,10.6
48311,2020-04-01,744,726,18,2.4
48313,2020-04-01,3947,3592,355,9
48315,2020-04-01,3781,3303,478,12.6
48317,2020-04-01,2484,2315,169,6.8
48319,2020-04-01,1507,1395,112,7.4
48321,2020-04-01,15501,13252,2249,14.5
48323,2020-04-01,22590,18130,4460,19.7
48325,2020-04-01,19548,17547,2001,10.2
48327,2020-04-01,737,683,54,7.3
48329,2020-04-01,95590,85853,9737,10.2
48331,2020-04-01,8566,7621,945,11
48333,2020-04-01,1598,1522,76,4.8
48335,2020-04-01,2037,1845,192,9.4
48337,2020-04-01,8415,7464,951,11.3
48339,2020-04-01,261391,226976,34415,13.2
48341,2020-04-01,9202,8757,445,4.8
48343,2020-04-01,4373,3774,599,13.7
48345,2020-04-01,404,382,22,5.4
48347,2020-04-01,24753,22170,2583,10.4
48349,2020-04-01,21347,19245,2102,9.8
48351,2020-04-01,4712,3939,773,16.4
48353,2020-04-01,6190,5793,397,6.4
48355,2020-04-01,152199,128424,23775,15.6
48357,2020-04-01,3644,3355,289,7.9
48359,2020-04-01,804,758,46,5.7
48361,2020-04-01,33777,27881,5896,17.5
48363,2020-04-01,12086,10805,1281,10.6
48365,2020-04-01,8905,7961,944,10.6
48367,2020-04-01,60446,54135,6311,10.4
48369,2020-04-01,4060,3952,108,2.7
48371,2020-04-01,5561,5002,559,10.1
48373,2020-04-01,16238,14268,1970,12.1
48375,2020-04-01,49733,45088,4645,9.3
48377,2020-04-01,3049,2403,646,21.2
48379,2020-04-01,5376,4979,397,7.4
48381,2020-04-01,64932,59331,5601,8.6
48383,2020-04-01,1747,1543,204,11.7
48385,2020-04-01,864,786,78,9
48387,2020-04-01,4425,4034,391,8.8
48389,2020-04-01,10745,10147,598,5.6
48391,2020-04-01,2792,2482,310,11.1
48393,2020-04-01,356,334,22,6.2
48395,2020-04-01,7036,6444,592,8.4
48397,2020-04-01,48240,42581,5659,11.7
48399,2020-04-01,4000,3691,309,7.7
48401,2020-04-01,20451,18370,2081,10.2
48403,2020-04-01,3405,2831,574,16.9
48405,2020-04-01,3122,2783,339,10.9
48407,2020-04-01,10419,9263,1156,11.1
48409,2020-04-01,27135,22693,4442,16.4
48411,2020-04-01,2160,2021,139,6.4
48413,2020-04-01,1080,995,85,7.9
48415,2020-04-01,5838,5221,617,10.6
48417,2020-04-01,1609,1503,106,6.6
48419,2020-04-01,9731,8871,860,8.8
48421,2020-04-01,1174,1141,33,2.8
48423,2020-04-01,99841,87819,12022,12
48425,2020-04-01,3882,3481,401,10.3
48427,2020-04-01,24359,18545,5814,23.9
48429,2020-04-01,3445,3219,226,6.6
48431,2020-04-01,509,470,39,7.7
48433,2020-04-01,480,452,28,5.8
48435,2020-04-01,1173,1029,144,12.3
48437,2020-04-01,2238,2079,159,7.1
48439,2020-04-01,NA,867153,134643,13.4
48441,2020-04-01,60256,54800,5456,9.1
48443,2020-04-01,313,295,18,5.8
48445,2020-04-01,4324,3912,412,9.5
48447,2020-04-01,528,506,22,4.2
48449,2020-04-01,11647,10416,1231,10.6
48451,2020-04-01,47640,42566,5074,10.7
48453,2020-04-01,682299,597462,84837,12.4
48455,2020-04-01,4717,4205,512,10.9
48457,2020-04-01,6534,5572,962,14.7
48459,2020-04-01,16104,14243,1861,11.6
48461,2020-04-01,1458,1349,109,7.5
48463,2020-04-01,10081,9049,1032,10.2
48465,2020-04-01,20646,17879,2767,13.4
48467,2020-04-01,23470,21067,2403,10.2
48469,2020-04-01,38811,33204,5607,14.4
48471,2020-04-01,21718,19275,2443,11.2
48473,2020-04-01,21312,18758,2554,12
48475,2020-04-01,7024,6374,650,9.3
48477,2020-04-01,13283,12246,1037,7.8
48479,2020-04-01,108142,93701,14441,13.4
48481,2020-04-01,19345,17471,1874,9.7
48483,2020-04-01,1950,1814,136,7
48485,2020-04-01,49989,44121,5868,11.7
48487,2020-04-01,4284,3966,318,7.4
48489,2020-04-01,6265,5189,1076,17.2
48491,2020-04-01,286928,253119,33809,11.8
48493,2020-04-01,21948,20025,1923,8.8
48495,2020-04-01,3499,3089,410,11.7
48497,2020-04-01,28895,25574,3321,11.5
48499,2020-04-01,15865,14214,1651,10.4
48501,2020-04-01,3611,3018,593,16.4
48503,2020-04-01,6969,6391,578,8.3
48505,2020-04-01,4255,3671,584,13.7
48507,2020-04-01,2944,2427,517,17.6
49001,2020-04-01,2811,2627,184,6.5
49003,2020-04-01,26428,23669,2759,10.4
49005,2020-04-01,62058,58272,3786,6.1
49007,2020-04-01,8363,7553,810,9.7
49009,2020-04-01,368,335,33,9
49011,2020-04-01,173873,158303,15570,9
49013,2020-04-01,7898,6897,1001,12.7
49015,2020-04-01,4228,3868,360,8.5
49017,2020-04-01,2869,2177,692,24.1
49019,2020-04-01,6796,4959,1837,27
49021,2020-04-01,23346,21166,2180,9.3
49023,2020-04-01,5442,5131,311,5.7
49025,2020-04-01,3568,3022,546,15.3
49027,2020-04-01,5806,5473,333,5.7
49029,2020-04-01,5502,5072,430,7.8
49031,2020-04-01,483,431,52,10.8
49033,2020-04-01,992,918,74,7.5
49035,2020-04-01,631486,560482,71004,11.2
49037,2020-04-01,5873,4899,974,16.6
49039,2020-04-01,12208,11478,730,6
49041,2020-04-01,9506,8727,779,8.2
49043,2020-04-01,24160,19237,4923,20.4
49045,2020-04-01,33477,29949,3528,10.5
49047,2020-04-01,14082,11838,2244,15.9
49049,2020-04-01,299698,275992,23706,7.9
49051,2020-04-01,16109,13283,2826,17.5
49053,2020-04-01,75371,65989,9382,12.4
49055,2020-04-01,1420,1191,229,16.1
49057,2020-04-01,129680,115749,13931,10.7
50001,2020-04-01,21030,17921,3109,14.8
50003,2020-04-01,18488,15035,3453,18.7
50005,2020-04-01,14971,12372,2599,17.4
50007,2020-04-01,94950,81456,13494,14.2
50009,2020-04-01,2878,2307,571,19.8
50011,2020-04-01,27434,23098,4336,15.8
50013,2020-04-01,4094,3376,718,17.5
50015,2020-04-01,15159,11273,3886,25.6
50017,2020-04-01,16182,13882,2300,14.2
50019,2020-04-01,14036,10738,3298,23.5
50021,2020-04-01,31879,25045,6834,21.4
50023,2020-04-01,34417,29119,5298,15.4
50025,2020-04-01,23064,19016,4048,17.6
50027,2020-04-01,29221,24755,4466,15.3
51001,2020-04-01,16007,14401,1606,10
51003,2020-04-01,56643,51552,5091,9
51005,2020-04-01,6800,5967,833,12.3
51007,2020-04-01,6068,5474,594,9.8
51009,2020-04-01,14451,13123,1328,9.2
51011,2020-04-01,6854,6236,618,9
51013,2020-04-01,148308,137956,10352,7
51015,2020-04-01,37962,34809,3153,8.3
51017,2020-04-01,2785,2205,580,20.8
51019,2020-04-01,37155,33636,3519,9.5
51021,2020-04-01,2808,2483,325,11.6
51023,2020-04-01,16763,15350,1413,8.4
51025,2020-04-01,5704,5107,597,10.5
51027,2020-04-01,6488,5554,934,14.4
51029,2020-04-01,6322,5687,635,10
51031,2020-04-01,25159,22693,2466,9.8
51033,2020-04-01,14922,13301,1621,10.9
51035,2020-04-01,13856,11584,2272,16.4
51036,2020-04-01,3544,3194,350,9.9
51037,2020-04-01,5005,4582,423,8.5
51041,2020-04-01,183671,164314,19357,10.5
51043,2020-04-01,7338,6744,594,8.1
51045,2020-04-01,2230,2012,218,9.8
51047,2020-04-01,23916,21771,2145,9
51049,2020-04-01,4477,4064,413,9.2
51051,2020-04-01,4679,4103,576,12.3
51053,2020-04-01,13130,11890,1240,9.4
51057,2020-04-01,5344,4739,605,11.3
51059,2020-04-01,629279,565010,64269,10.2
51061,2020-04-01,36248,33083,3165,8.7
51063,2020-04-01,7881,7010,871,11.1
51065,2020-04-01,13797,12554,1243,9
51067,2020-04-01,25521,23150,2371,9.3
51069,2020-04-01,46720,42262,4458,9.5
51071,2020-04-01,7677,6695,982,12.8
51073,2020-04-01,18929,17001,1928,10.2
51075,2020-04-01,10747,9803,944,8.8
51077,2020-04-01,8064,7168,896,11.1
51079,2020-04-01,10446,9459,987,9.4
51081,2020-04-01,4055,3709,346,8.5
51083,2020-04-01,15022,13382,1640,10.9
51085,2020-04-01,57183,52091,5092,8.9
51087,2020-04-01,179056,159477,19579,10.9
51089,2020-04-01,23847,20734,3113,13.1
51091,2020-04-01,1119,1048,71,6.3
51093,2020-04-01,18392,16837,1555,8.5
51095,2020-04-01,36754,31731,5023,13.7
51097,2020-04-01,3693,3408,285,7.7
51099,2020-04-01,12810,11809,1001,7.8
51101,2020-04-01,8853,8007,846,9.6
51103,2020-04-01,5317,4703,614,11.5
51105,2020-04-01,8094,7185,909,11.2
51107,2020-04-01,219877,198184,21693,9.9
51109,2020-04-01,19454,17701,1753,9
51111,2020-04-01,4993,4610,383,7.7
51113,2020-04-01,7099,6597,502,7.1
51115,2020-04-01,3928,3582,346,8.8
51117,2020-04-01,11925,10602,1323,11.1
51119,2020-04-01,5080,4617,463,9.1
51121,2020-04-01,47043,42726,4317,9.2
51125,2020-04-01,7375,6653,722,9.8
51127,2020-04-01,12028,10969,1059,8.8
51131,2020-04-01,5170,4559,611,11.8
51133,2020-04-01,5371,4843,528,9.8
51135,2020-04-01,6915,6390,525,7.6
51137,2020-04-01,17098,15410,1688,9.9
51139,2020-04-01,12149,10434,1715,14.1
51141,2020-04-01,7222,6206,1016,14.1
51143,2020-04-01,29710,25884,3826,12.9
51145,2020-04-01,13699,12401,1298,9.5
51147,2020-04-01,10074,9098,976,9.7
51149,2020-04-01,14584,13144,1440,9.9
51153,2020-04-01,245818,218156,27662,11.3
51155,2020-04-01,16351,13605,2746,16.8
51157,2020-04-01,3558,3259,299,8.4
51159,2020-04-01,3873,3584,289,7.5
51161,2020-04-01,48141,43505,4636,9.6
51163,2020-04-01,10510,9505,1005,9.6
51165,2020-04-01,41022,37097,3925,9.6
51167,2020-04-01,10959,9760,1199,10.9
51169,2020-04-01,8740,7890,850,9.7
51171,2020-04-01,21949,19821,2128,9.7
51173,2020-04-01,13228,11782,1446,10.9
51175,2020-04-01,8480,7886,594,7
51177,2020-04-01,66636,59318,7318,11
51179,2020-04-01,70908,63917,6991,9.9
51181,2020-04-01,3498,3168,330,9.4
51183,2020-04-01,3657,3287,370,10.1
51185,2020-04-01,15338,13394,1944,12.7
51187,2020-04-01,20283,18059,2224,11
51191,2020-04-01,25831,23073,2758,10.7
51193,2020-04-01,9092,8275,817,9
51195,2020-04-01,13177,11562,1615,12.3
51197,2020-04-01,14220,11734,2486,17.5
51199,2020-04-01,31743,28438,3305,10.4
51510,2020-04-01,100306,90356,9950,9.9
51520,2020-04-01,7281,6166,1115,15.3
51530,2020-04-01,3498,3186,312,8.9
51540,2020-04-01,26735,23884,2851,10.7
51550,2020-04-01,118358,106284,12074,10.2
51570,2020-04-01,8665,7680,985,11.4
51580,2020-04-01,2494,2063,431,17.3
51590,2020-04-01,19259,16106,3153,16.4
51595,2020-04-01,2249,1952,297,13.2
51600,2020-04-01,13316,11977,1339,10.1
51610,2020-04-01,8137,7664,473,5.8
51620,2020-04-01,3393,3062,331,9.8
51630,2020-04-01,14179,12472,1707,12
51640,2020-04-01,3068,2523,545,17.8
51650,2020-04-01,63778,55243,8535,13.4
51660,2020-04-01,24703,21953,2750,11.1
51670,2020-04-01,9787,8360,1427,14.6
51678,2020-04-01,2034,1817,217,10.7
51680,2020-04-01,35739,31571,4168,11.7
51683,2020-04-01,21964,19579,2385,10.9
51685,2020-04-01,9414,8318,1096,11.6
51690,2020-04-01,5695,4724,971,17.1
51700,2020-04-01,88873,76475,12398,14
51710,2020-04-01,110858,96122,14736,13.3
51720,2020-04-01,1668,1456,212,12.7
51730,2020-04-01,13280,11085,2195,16.5
51735,2020-04-01,6036,5557,479,7.9
51740,2020-04-01,43513,37939,5574,12.8
51750,2020-04-01,8251,7318,933,11.3
51760,2020-04-01,119974,103085,16889,14.1
51770,2020-04-01,49285,43098,6187,12.6
51775,2020-04-01,12765,11417,1348,10.6
51790,2020-04-01,12777,11354,1423,11.1
51800,2020-04-01,42753,38612,4141,9.7
51810,2020-04-01,230313,202103,28210,12.2
51820,2020-04-01,11144,9908,1236,11.1
51830,2020-04-01,6742,5731,1011,15
51840,2020-04-01,14582,12944,1638,11.2
53001,2020-04-01,9438,8581,857,9.1
53003,2020-04-01,9667,8808,859,8.9
53005,2020-04-01,105445,90994,14451,13.7
53007,2020-04-01,44043,36912,7131,16.2
53009,2020-04-01,31914,25920,5994,18.8
53011,2020-04-01,244704,209486,35218,14.4
53013,2020-04-01,1727,1528,199,11.5
53015,2020-04-01,48630,40664,7966,16.4
53017,2020-04-01,21109,17920,3189,15.1
53019,2020-04-01,2434,2065,369,15.2
53021,2020-04-01,43714,38008,5706,13.1
53023,2020-04-01,817,701,116,14.2
53025,2020-04-01,48429,42304,6125,12.6
53027,2020-04-01,32277,26055,6222,19.3
53029,2020-04-01,37574,31651,5923,15.8
53031,2020-04-01,14043,11596,2447,17.4
53033,2020-04-01,NA,NA,188230,14.9
53035,2020-04-01,132712,113416,19296,14.5
53037,2020-04-01,24736,20812,3924,15.9
53039,2020-04-01,10152,8939,1213,11.9
53041,2020-04-01,37671,31434,6237,16.6
53043,2020-04-01,4648,4113,535,11.5
53045,2020-04-01,27604,23093,4511,16.3
53047,2020-04-01,19283,16432,2851,14.8
53049,2020-04-01,9412,7812,1600,17
53051,2020-04-01,4824,4063,761,15.8
53053,2020-04-01,457362,371915,85447,18.7
53055,2020-04-01,8251,6786,1465,17.8
53057,2020-04-01,65334,52850,12484,19.1
53059,2020-04-01,5553,4737,816,14.7
53061,2020-04-01,450382,363997,86385,19.2
53063,2020-04-01,257277,214347,42930,16.7
53065,2020-04-01,18436,15404,3032,16.4
53067,2020-04-01,150044,126145,23899,15.9
53069,2020-04-01,1389,1197,192,13.8
53071,2020-04-01,30496,26767,3729,12.2
53073,2020-04-01,119667,98460,21207,17.7
53075,2020-04-01,23593,21640,1953,8.3
53077,2020-04-01,133602,114525,19077,14.3
54001,2020-04-01,6785,5854,931,13.7
54003,2020-04-01,55240,48530,6710,12.1
54005,2020-04-01,7432,6016,1416,19.1
54007,2020-04-01,4879,4066,813,16.7
54009,2020-04-01,9538,7981,1557,16.3
54011,2020-04-01,41849,35046,6803,16.3
54013,2020-04-01,2259,1741,518,22.9
54015,2020-04-01,3044,2462,582,19.1
54017,2020-04-01,3739,3368,371,9.9
54019,2020-04-01,16403,13343,3060,18.7
54021,2020-04-01,2354,2017,337,14.3
54023,2020-04-01,5634,5040,594,10.5
54025,2020-04-01,15375,12511,2864,18.6
54027,2020-04-01,10271,9286,985,9.6
54029,2020-04-01,13093,10442,2651,20.2
54031,2020-04-01,5726,5040,686,12
54033,2020-04-01,34159,29052,5107,15
54035,2020-04-01,12421,10538,1883,15.2
54037,2020-04-01,29210,25881,3329,11.4
54039,2020-04-01,81666,67223,14443,17.7
54041,2020-04-01,6297,5161,1136,18
54043,2020-04-01,7199,5931,1268,17.6
54045,2020-04-01,11132,8632,2500,22.5
54047,2020-04-01,4310,3699,611,14.2
54049,2020-04-01,24933,20667,4266,17.1
54051,2020-04-01,13155,10904,2251,17.1
54053,2020-04-01,9911,8239,1672,16.9
54055,2020-04-01,20884,17422,3462,16.6
54057,2020-04-01,11792,10201,1591,13.5
54059,2020-04-01,6764,5100,1664,24.6
54061,2020-04-01,53441,46969,6472,12.1
54063,2020-04-01,5764,4938,826,14.3
54065,2020-04-01,7755,6700,1055,13.6
54067,2020-04-01,9222,7400,1822,19.8
54069,2020-04-01,19965,16647,3318,16.6
54071,2020-04-01,3515,3222,293,8.3
54073,2020-04-01,2862,2417,445,15.5
54075,2020-04-01,3876,3188,688,17.8
54077,2020-04-01,15406,13240,2166,14.1
54079,2020-04-01,26978,22541,4437,16.4
54081,2020-04-01,30864,25286,5578,18.1
54083,2020-04-01,12025,9863,2162,18
54085,2020-04-01,4179,3621,558,13.4
54087,2020-04-01,4855,3923,932,19.2
54089,2020-04-01,4029,3439,590,14.6
54091,2020-04-01,7327,6280,1047,14.3
54093,2020-04-01,3241,2685,556,17.2
54095,2020-04-01,2912,2487,425,14.6
54097,2020-04-01,9142,7656,1486,16.3
54099,2020-04-01,15553,13171,2382,15.3
54101,2020-04-01,3070,2625,445,14.5
54103,2020-04-01,6189,5259,930,15
54105,2020-04-01,2247,1891,356,15.8
54107,2020-04-01,37350,31122,6228,16.7
54109,2020-04-01,6240,5133,1107,17.7
55001,2020-04-01,8261,6578,1683,20.4
55003,2020-04-01,7824,6346,1478,18.9
55005,2020-04-01,23613,20165,3448,14.6
55007,2020-04-01,7783,6053,1730,22.2
55009,2020-04-01,138248,120300,17948,13
55011,2020-04-01,6680,5490,1190,17.8
55013,2020-04-01,7289,5718,1571,21.6
55015,2020-04-01,26362,23446,2916,11.1
55017,2020-04-01,32028,27916,4112,12.8
55019,2020-04-01,16843,15265,1578,9.4
55021,2020-04-01,30569,26307,4262,13.9
55023,2020-04-01,7610,6247,1363,17.9
55025,2020-04-01,299526,267983,31543,10.5
55027,2020-04-01,45279,40241,5038,11.1
55029,2020-04-01,14161,11530,2631,18.6
55031,2020-04-01,24414,19288,5126,21
55033,2020-04-01,22168,19704,2464,11.1
55035,2020-04-01,56385,49650,6735,11.9
55037,2020-04-01,2248,1862,386,17.2
55039,2020-04-01,57329,48716,8613,15
55041,2020-04-01,3929,3325,604,15.4
55043,2020-04-01,25899,23024,2875,11.1
55045,2020-04-01,19867,17692,2175,10.9
55047,2020-04-01,9425,7652,1773,18.8
55049,2020-04-01,13884,11616,2268,16.3
55051,2020-04-01,2737,2069,668,24.4
55053,2020-04-01,10451,8537,1914,18.3
55055,2020-04-01,44054,38783,5271,12
55057,2020-04-01,13333,11279,2054,15.4
55059,2020-04-01,89137,75897,13240,14.9
55061,2020-04-01,10477,9504,973,9.3
55063,2020-04-01,63860,56032,7828,12.3
55065,2020-04-01,9588,8724,864,9
55067,2020-04-01,8952,7785,1167,13
55069,2020-04-01,14482,12585,1897,13.1
55071,2020-04-01,40462,34416,6046,14.9
55073,2020-04-01,70998,62867,8131,11.5
55075,2020-04-01,19436,15963,3473,17.9
55077,2020-04-01,7568,6436,1132,15
55078,2020-04-01,1738,1313,425,24.5
55079,2020-04-01,464262,395528,68734,14.8
55081,2020-04-01,22580,19844,2736,12.1
55083,2020-04-01,20397,17467,2930,14.4
55085,2020-04-01,17302,14093,3209,18.5
55087,2020-04-01,100381,87023,13358,13.3
55089,2020-04-01,47674,42073,5601,11.7
55091,2020-04-01,4034,3477,557,13.8
55093,2020-04-01,25684,21669,4015,15.6
55095,2020-04-01,24392,20451,3941,16.2
55097,2020-04-01,35604,31699,3905,11
55099,2020-04-01,6379,5371,1008,15.8
55101,2020-04-01,99971,85699,14272,14.3
55103,2020-04-01,8851,7793,1058,12
55105,2020-04-01,85026,71565,13461,15.8
55107,2020-04-01,6488,5568,920,14.2
55109,2020-04-01,51173,42945,8228,16.1
55111,2020-04-01,36622,29603,7019,19.2
55113,2020-04-01,7842,6320,1522,19.4
55115,2020-04-01,20629,17773,2856,13.8
55117,2020-04-01,61425,52880,8545,13.9
55119,2020-04-01,10309,9282,1027,10
55121,2020-04-01,16283,13425,2858,17.6
55123,2020-04-01,14628,13028,1600,10.9
55125,2020-04-01,9857,7892,1965,19.9
55127,2020-04-01,54739,47066,7673,14
55129,2020-04-01,7828,6461,1367,17.5
55131,2020-04-01,75793,66275,9518,12.6
55133,2020-04-01,218068,192449,25619,11.7
55135,2020-04-01,24931,21824,3107,12.5
55137,2020-04-01,11165,9563,1602,14.3
55139,2020-04-01,89910,78010,11900,13.2
55141,2020-04-01,34450,29466,4984,14.5
56001,2020-04-01,21182,20029,1153,5.4
56003,2020-04-01,5104,4758,346,6.8
56005,2020-04-01,23527,21129,2398,10.2
56007,2020-04-01,7520,7011,509,6.8
56009,2020-04-01,8766,8209,557,6.4
56011,2020-04-01,3553,3350,203,5.7
56013,2020-04-01,18885,17129,1756,9.3
56015,2020-04-01,6300,5911,389,6.2
56017,2020-04-01,2161,2003,158,7.3
56019,2020-04-01,4095,3698,397,9.7
56021,2020-04-01,50162,45626,4536,9
56023,2020-04-01,8827,8040,787,8.9
56025,2020-04-01,40233,35152,5081,12.6
56027,2020-04-01,1170,1116,54,4.6
56029,2020-04-01,14827,13425,1402,9.5
56031,2020-04-01,4608,4285,323,7
56033,2020-04-01,15752,14396,1356,8.6
56035,2020-04-01,4008,3552,456,11.4
56037,2020-04-01,21150,18921,2229,10.5
56039,2020-04-01,15485,12665,2820,18.2
56041,2020-04-01,8918,8081,837,9.4
56043,2020-04-01,3765,3487,278,7.4
56045,2020-04-01,3715,3503,212,5.7
72001,2020-04-01,NA,NA,NA,NA
72003,2020-04-01,NA,NA,NA,NA
72005,2020-04-01,NA,NA,NA,NA
72007,2020-04-01,NA,NA,NA,NA
72009,2020-04-01,NA,NA,NA,NA
72011,2020-04-01,NA,NA,NA,NA
72013,2020-04-01,NA,NA,NA,NA
72015,2020-04-01,NA,NA,NA,NA
72017,2020-04-01,NA,NA,NA,NA
72019,2020-04-01,NA,NA,NA,NA
72021,2020-04-01,NA,NA,NA,NA
72023,2020-04-01,NA,NA,NA,NA
72025,2020-04-01,NA,NA,NA,NA
72027,2020-04-01,NA,NA,NA,NA
72029,2020-04-01,NA,NA,NA,NA
72031,2020-04-01,NA,NA,NA,NA
72033,2020-04-01,NA,NA,NA,NA
72035,2020-04-01,NA,NA,NA,NA
72037,2020-04-01,NA,NA,NA,NA
72039,2020-04-01,NA,NA,NA,NA
72041,2020-04-01,NA,NA,NA,NA
72043,2020-04-01,NA,NA,NA,NA
72045,2020-04-01,NA,NA,NA,NA
72047,2020-04-01,NA,NA,NA,NA
72049,2020-04-01,NA,NA,NA,NA
72051,2020-04-01,NA,NA,NA,NA
72053,2020-04-01,NA,NA,NA,NA
72054,2020-04-01,NA,NA,NA,NA
72055,2020-04-01,NA,NA,NA,NA
72057,2020-04-01,NA,NA,NA,NA
72059,2020-04-01,NA,NA,NA,NA
72061,2020-04-01,NA,NA,NA,NA
72063,2020-04-01,NA,NA,NA,NA
72065,2020-04-01,NA,NA,NA,NA
72067,2020-04-01,NA,NA,NA,NA
72069,2020-04-01,NA,NA,NA,NA
72071,2020-04-01,NA,NA,NA,NA
72073,2020-04-01,NA,NA,NA,NA
72075,2020-04-01,NA,NA,NA,NA
72077,2020-04-01,NA,NA,NA,NA
72079,2020-04-01,NA,NA,NA,NA
72081,2020-04-01,NA,NA,NA,NA
72083,2020-04-01,NA,NA,NA,NA
72085,2020-04-01,NA,NA,NA,NA
72087,2020-04-01,NA,NA,NA,NA
72089,2020-04-01,NA,NA,NA,NA
72091,2020-04-01,NA,NA,NA,NA
72093,2020-04-01,NA,NA,NA,NA
72095,2020-04-01,NA,NA,NA,NA
72097,2020-04-01,NA,NA,NA,NA
72099,2020-04-01,NA,NA,NA,NA
72101,2020-04-01,NA,NA,NA,NA
72103,2020-04-01,NA,NA,NA,NA
72105,2020-04-01,NA,NA,NA,NA
72107,2020-04-01,NA,NA,NA,NA
72109,2020-04-01,NA,NA,NA,NA
72111,2020-04-01,NA,NA,NA,NA
72113,2020-04-01,NA,NA,NA,NA
72115,2020-04-01,NA,NA,NA,NA
72117,2020-04-01,NA,NA,NA,NA
72119,2020-04-01,NA,NA,NA,NA
72121,2020-04-01,NA,NA,NA,NA
72123,2020-04-01,NA,NA,NA,NA
72125,2020-04-01,NA,NA,NA,NA
72127,2020-04-01,NA,NA,NA,NA
72129,2020-04-01,NA,NA,NA,NA
72131,2020-04-01,NA,NA,NA,NA
72133,2020-04-01,NA,NA,NA,NA
72135,2020-04-01,NA,NA,NA,NA
72137,2020-04-01,NA,NA,NA,NA
72139,2020-04-01,NA,NA,NA,NA
72141,2020-04-01,NA,NA,NA,NA
72143,2020-04-01,NA,NA,NA,NA
72145,2020-04-01,NA,NA,NA,NA
72147,2020-04-01,NA,NA,NA,NA
72149,2020-04-01,NA,NA,NA,NA
72151,2020-04-01,NA,NA,NA,NA
72153,2020-04-01,NA,NA,NA,NA
01001,2020-05-01,25586,23593,1993,7.8
01003,2020-05-01,96285,87248,9037,9.4
01005,2020-05-01,8700,7947,753,8.7
01007,2020-05-01,8814,7872,942,10.7
01009,2020-05-01,24584,23016,1568,6.4
01011,2020-05-01,4551,4238,313,6.9
01013,2020-05-01,9564,8398,1166,12.2
01015,2020-05-01,45149,39929,5220,11.6
01017,2020-05-01,16749,14799,1950,11.6
01019,2020-05-01,11892,10990,902,7.6
01021,2020-05-01,19696,17968,1728,8.8
01023,2020-05-01,4518,4091,427,9.5
01025,2020-05-01,7790,6872,918,11.8
01027,2020-05-01,6028,5698,330,5.5
01029,2020-05-01,5537,5125,412,7.4
01031,2020-05-01,21371,19944,1427,6.7
01033,2020-05-01,23384,20804,2580,11
01035,2020-05-01,4614,4170,444,9.6
01037,2020-05-01,4611,4222,389,8.4
01039,2020-05-01,15360,14250,1110,7.2
01041,2020-05-01,6422,5888,534,8.3
01043,2020-05-01,39295,36392,2903,7.4
01045,2020-05-01,20506,19035,1471,7.2
01047,2020-05-01,15543,13267,2276,14.6
01049,2020-05-01,31383,29148,2235,7.1
01051,2020-05-01,36699,33947,2752,7.5
01053,2020-05-01,14830,13610,1220,8.2
01055,2020-05-01,41743,36690,5053,12.1
01057,2020-05-01,6713,6145,568,8.5
01059,2020-05-01,14516,13569,947,6.5
01061,2020-05-01,10473,9828,645,6.2
01063,2020-05-01,3162,2654,508,16.1
01065,2020-05-01,6272,5388,884,14.1
01067,2020-05-01,6670,6176,494,7.4
01069,2020-05-01,45181,41475,3706,8.2
01071,2020-05-01,23267,21311,1956,8.4
01073,2020-05-01,320223,290151,30072,9.4
01075,2020-05-01,5858,5437,421,7.2
01077,2020-05-01,41627,37662,3965,9.5
01079,2020-05-01,13694,12582,1112,8.1
01081,2020-05-01,76186,69633,6553,8.6
01083,2020-05-01,42925,39861,3064,7.1
01085,2020-05-01,3796,3119,677,17.8
01087,2020-05-01,8422,7219,1203,14.3
01089,2020-05-01,182319,168816,13503,7.4
01091,2020-05-01,7687,7038,649,8.4
01093,2020-05-01,13092,12141,951,7.3
01095,2020-05-01,44493,41601,2892,6.5
01097,2020-05-01,190718,167578,23140,12.1
01099,2020-05-01,7627,6811,816,10.7
01101,2020-05-01,107480,95087,12393,11.5
01103,2020-05-01,55806,51636,4170,7.5
01105,2020-05-01,3508,2983,525,15
01107,2020-05-01,7860,7071,789,10
01109,2020-05-01,15582,14541,1041,6.7
01111,2020-05-01,9691,8906,785,8.1
01113,2020-05-01,22989,21079,1910,8.3
01115,2020-05-01,40153,36930,3223,8
01117,2020-05-01,113395,106267,7128,6.3
01119,2020-05-01,4890,4389,501,10.2
01121,2020-05-01,36842,32686,4156,11.3
01123,2020-05-01,19488,17597,1891,9.7
01125,2020-05-01,106470,95105,11365,10.7
01127,2020-05-01,25182,22958,2224,8.8
01129,2020-05-01,6937,6113,824,11.9
01131,2020-05-01,2980,2418,562,18.9
01133,2020-05-01,10232,9563,669,6.5
02013,2020-05-01,1540,1298,242,15.7
02016,2020-05-01,3094,2501,593,19.2
02020,2020-05-01,142856,125242,17614,12.3
02050,2020-05-01,6799,5843,956,14.1
02060,2020-05-01,447,401,46,10.3
02068,2020-05-01,1101,937,164,14.9
02070,2020-05-01,1872,1677,195,10.4
02090,2020-05-01,43026,38611,4415,10.3
02100,2020-05-01,1150,890,260,22.6
02105,2020-05-01,1178,980,198,16.8
02110,2020-05-01,16146,14393,1753,10.9
02122,2020-05-01,25378,21807,3571,14.1
02130,2020-05-01,6509,5506,1003,15.4
02150,2020-05-01,5253,4716,537,10.2
02158,2020-05-01,2718,2167,551,20.3
02164,2020-05-01,720,629,91,12.6
02170,2020-05-01,45046,39191,5855,13
02180,2020-05-01,3836,3267,569,14.8
02185,2020-05-01,2970,2729,241,8.1
02188,2020-05-01,2710,2268,442,16.3
02195,2020-05-01,1245,1053,192,15.4
02198,2020-05-01,2666,2304,362,13.6
02220,2020-05-01,4105,3598,507,12.4
02230,2020-05-01,906,723,183,20.2
02240,2020-05-01,2707,2423,284,10.5
02261,2020-05-01,4470,3908,562,12.6
02275,2020-05-01,971,843,128,13.2
02282,2020-05-01,231,201,30,13
02290,2020-05-01,2455,2045,410,16.7
04001,2020-05-01,19607,17415,2192,11.2
04003,2020-05-01,51250,47570,3680,7.2
04005,2020-05-01,70186,61948,8238,11.7
04007,2020-05-01,20990,19408,1582,7.5
04009,2020-05-01,15510,14580,930,6
04011,2020-05-01,4578,4386,192,4.2
04012,2020-05-01,8799,8269,530,6
04013,2020-05-01,NA,NA,192137,8.3
04015,2020-05-01,88464,76387,12077,13.7
04017,2020-05-01,39771,35931,3840,9.7
04019,2020-05-01,502124,460027,42097,8.4
04021,2020-05-01,183657,168733,14924,8.1
04023,2020-05-01,18821,16788,2033,10.8
04025,2020-05-01,109444,100165,9279,8.5
04027,2020-05-01,92032,75299,16733,18.2
05001,2020-05-01,9042,8572,470,5.2
05003,2020-05-01,7407,6493,914,12.3
05005,2020-05-01,16266,14678,1588,9.8
05007,2020-05-01,135561,126034,9527,7
05009,2020-05-01,15999,14651,1348,8.4
05011,2020-05-01,4355,3996,359,8.2
05013,2020-05-01,2341,2188,153,6.5
05015,2020-05-01,12755,11564,1191,9.3
05017,2020-05-01,3101,2688,413,13.3
05019,2020-05-01,9565,8718,847,8.9
05021,2020-05-01,5426,4949,477,8.8
05023,2020-05-01,9195,8098,1097,11.9
05025,2020-05-01,3158,2890,268,8.5
05027,2020-05-01,9210,8381,829,9
05029,2020-05-01,8187,7428,759,9.3
05031,2020-05-01,56130,51315,4815,8.6
05033,2020-05-01,26688,24293,2395,9
05035,2020-05-01,21308,18623,2685,12.6
05037,2020-05-01,7262,6636,626,8.6
05039,2020-05-01,2690,2479,211,7.8
05041,2020-05-01,5203,4705,498,9.6
05043,2020-05-01,7614,6875,739,9.7
05045,2020-05-01,61155,55445,5710,9.3
05047,2020-05-01,7560,6760,800,10.6
05049,2020-05-01,4911,4563,348,7.1
05051,2020-05-01,42090,36387,5703,13.5
05053,2020-05-01,8046,7429,617,7.7
05055,2020-05-01,20031,18098,1933,9.7
05057,2020-05-01,9525,8836,689,7.2
05059,2020-05-01,13814,12567,1247,9
05061,2020-05-01,5372,5010,362,6.7
05063,2020-05-01,16622,15171,1451,8.7
05065,2020-05-01,4860,4280,580,11.9
05067,2020-05-01,5442,4926,516,9.5
05069,2020-05-01,27660,24748,2912,10.5
05071,2020-05-01,10190,9116,1074,10.5
05073,2020-05-01,2410,2164,246,10.2
05075,2020-05-01,6828,6221,607,8.9
05077,2020-05-01,2700,2410,290,10.7
05079,2020-05-01,3819,3523,296,7.8
05081,2020-05-01,5419,4951,468,8.6
05083,2020-05-01,8453,7432,1021,12.1
05085,2020-05-01,33265,30460,2805,8.4
05087,2020-05-01,7150,6739,411,5.7
05089,2020-05-01,6585,5963,622,9.4
05091,2020-05-01,19730,17752,1978,10
05093,2020-05-01,17841,15200,2641,14.8
05095,2020-05-01,2655,2429,226,8.5
05097,2020-05-01,2806,2523,283,10.1
05099,2020-05-01,3554,3261,293,8.2
05101,2020-05-01,3276,3015,261,8
05103,2020-05-01,9583,8792,791,8.3
05105,2020-05-01,4091,3742,349,8.5
05107,2020-05-01,6283,5426,857,13.6
05109,2020-05-01,4171,3800,371,8.9
05111,2020-05-01,10132,9339,793,7.8
05113,2020-05-01,7900,7164,736,9.3
05115,2020-05-01,28635,26189,2446,8.5
05117,2020-05-01,3439,3191,248,7.2
05119,2020-05-01,190432,168408,22024,11.6
05121,2020-05-01,7306,6681,625,8.6
05123,2020-05-01,8194,7212,982,12
05125,2020-05-01,57374,52644,4730,8.2
05127,2020-05-01,4195,3934,261,6.2
05129,2020-05-01,2846,2574,272,9.6
05131,2020-05-01,57280,51272,6008,10.5
05133,2020-05-01,5289,4911,378,7.1
05135,2020-05-01,5730,5150,580,10.1
05137,2020-05-01,4583,4132,451,9.8
05139,2020-05-01,15717,13845,1872,11.9
05141,2020-05-01,5720,5108,612,10.7
05143,2020-05-01,124285,114997,9288,7.5
05145,2020-05-01,33343,30293,3050,9.1
05147,2020-05-01,2601,2394,207,8
05149,2020-05-01,8139,7585,554,6.8
06001,2020-05-01,803440,693368,110072,13.7
06003,2020-05-01,481,375,106,22
06005,2020-05-01,14067,11911,2156,15.3
06007,2020-05-01,91796,79579,12217,13.3
06009,2020-05-01,20020,17606,2414,12.1
06011,2020-05-01,10164,8069,2095,20.6
06013,2020-05-01,534027,460157,73870,13.8
06015,2020-05-01,9199,7986,1213,13.2
06017,2020-05-01,90579,76892,13687,15.1
06019,2020-05-01,446406,377189,69217,15.5
06021,2020-05-01,11098,9582,1516,13.7
06023,2020-05-01,60892,53582,7310,12
06025,2020-05-01,71751,51887,19864,27.7
06027,2020-05-01,7946,6952,994,12.5
06029,2020-05-01,368270,301716,66554,18.1
06031,2020-05-01,56984,48072,8912,15.6
06033,2020-05-01,25479,21534,3945,15.5
06035,2020-05-01,8880,7992,888,10
06037,2020-05-01,NA,NA,878281,18.8
06039,2020-05-01,62377,52965,9412,15.1
06041,2020-05-01,127663,114239,13424,10.5
06043,2020-05-01,7749,6389,1360,17.6
06045,2020-05-01,36409,31559,4850,13.3
06047,2020-05-01,113414,94844,18570,16.4
06049,2020-05-01,3016,2686,330,10.9
06051,2020-05-01,6348,4485,1863,29.3
06053,2020-05-01,200202,167033,33169,16.6
06055,2020-05-01,72137,61676,10461,14.5
06057,2020-05-01,39690,33955,5735,14.4
06059,2020-05-01,NA,NA,227097,14.7
06061,2020-05-01,180623,157991,22632,12.5
06063,2020-05-01,6387,5323,1064,16.7
06065,2020-05-01,NA,913024,172827,15.9
06067,2020-05-01,695484,596140,99344,14.3
06069,2020-05-01,30941,26139,4802,15.5
06071,2020-05-01,934777,803330,131447,14.1
06073,2020-05-01,NA,NA,235733,15.2
06075,2020-05-01,553517,483093,70424,12.7
06077,2020-05-01,321545,268039,53506,16.6
06079,2020-05-01,130428,113639,16789,12.9
06081,2020-05-01,429431,381414,48017,11.2
06083,2020-05-01,209637,182551,27086,12.9
06085,2020-05-01,NA,898288,113417,11.2
06087,2020-05-01,130694,111661,19033,14.6
06089,2020-05-01,71000,61789,9211,13
06091,2020-05-01,1138,996,142,12.5
06093,2020-05-01,15826,13694,2132,13.5
06095,2020-05-01,199928,171172,28756,14.4
06097,2020-05-01,246920,214860,32060,13
06099,2020-05-01,232106,194490,37616,16.2
06101,2020-05-01,43034,36099,6935,16.1
06103,2020-05-01,24434,21340,3094,12.7
06105,2020-05-01,4274,3815,459,10.7
06107,2020-05-01,192967,157940,35027,18.2
06109,2020-05-01,20830,17377,3453,16.6
06111,2020-05-01,405527,350099,55428,13.7
06113,2020-05-01,101640,90879,10761,10.6
06115,2020-05-01,28553,24162,4391,15.4
08001,2020-05-01,269592,240389,29203,10.8
08003,2020-05-01,7656,7072,584,7.6
08005,2020-05-01,361568,322505,39063,10.8
08007,2020-05-01,6664,5912,752,11.3
08009,2020-05-01,1807,1765,42,2.3
08011,2020-05-01,1614,1543,71,4.4
08013,2020-05-01,195128,179003,16125,8.3
08014,2020-05-01,39335,35557,3778,9.6
08015,2020-05-01,9428,8475,953,10.1
08017,2020-05-01,1000,979,21,2.1
08019,2020-05-01,6201,5358,843,13.6
08021,2020-05-01,3611,3380,231,6.4
08023,2020-05-01,1650,1511,139,8.4
08025,2020-05-01,1253,1194,59,4.7
08027,2020-05-01,1903,1777,126,6.6
08029,2020-05-01,13305,12240,1065,8
08031,2020-05-01,416540,368731,47809,11.5
08033,2020-05-01,1084,972,112,10.3
08035,2020-05-01,187788,172313,15475,8.2
08037,2020-05-01,36620,30137,6483,17.7
08039,2020-05-01,14307,13445,862,6
08041,2020-05-01,335703,303547,32156,9.6
08043,2020-05-01,14311,12959,1352,9.4
08045,2020-05-01,29702,26715,2987,10.1
08047,2020-05-01,4263,3355,908,21.3
08049,2020-05-01,9031,7575,1456,16.1
08051,2020-05-01,10938,9529,1409,12.9
08053,2020-05-01,345,326,19,5.5
08055,2020-05-01,2236,1993,243,10.9
08057,2020-05-01,884,836,48,5.4
08059,2020-05-01,329917,296866,33051,10
08061,2020-05-01,826,808,18,2.2
08063,2020-05-01,3740,3624,116,3.1
08065,2020-05-01,4867,4130,737,15.1
08067,2020-05-01,29149,26192,2957,10.1
08069,2020-05-01,202109,184784,17325,8.6
08071,2020-05-01,5763,5230,533,9.2
08073,2020-05-01,1941,1843,98,5
08075,2020-05-01,9363,8791,572,6.1
08077,2020-05-01,75629,68739,6890,9.1
08079,2020-05-01,437,394,43,9.8
08081,2020-05-01,6233,5734,499,8
08083,2020-05-01,11028,10006,1022,9.3
08085,2020-05-01,19230,17434,1796,9.3
08087,2020-05-01,14175,13216,959,6.8
08089,2020-05-01,7173,6698,475,6.6
08091,2020-05-01,2362,2042,320,13.5
08093,2020-05-01,10780,9884,896,8.3
08095,2020-05-01,2247,2176,71,3.2
08097,2020-05-01,11544,9224,2320,20.1
08099,2020-05-01,5575,5298,277,5
08101,2020-05-01,74046,67299,6747,9.1
08103,2020-05-01,2638,2479,159,6
08105,2020-05-01,4866,4459,407,8.4
08107,2020-05-01,15572,13323,2249,14.4
08109,2020-05-01,3227,3024,203,6.3
08111,2020-05-01,548,484,64,11.7
08113,2020-05-01,5539,4310,1229,22.2
08115,2020-05-01,1090,1052,38,3.5
08117,2020-05-01,23582,19009,4573,19.4
08119,2020-05-01,12919,11371,1548,12
08121,2020-05-01,2393,2309,84,3.5
08123,2020-05-01,164569,150378,14191,8.6
08125,2020-05-01,5178,5038,140,2.7
09001,2020-05-01,439087,397359,41728,9.5
09003,2020-05-01,458932,415829,43103,9.4
09005,2020-05-01,97141,89355,7786,8
09007,2020-05-01,88256,81336,6920,7.8
09009,2020-05-01,428875,389374,39501,9.2
09011,2020-05-01,124135,106927,17208,13.9
09013,2020-05-01,81471,75544,5927,7.3
09015,2020-05-01,59837,54272,5565,9.3
10001,2020-05-01,79530,66148,13382,16.8
10003,2020-05-01,289260,245981,43279,15
10005,2020-05-01,102606,86181,16425,16
11001,2020-05-01,396512,360847,35665,9
12001,2020-05-01,125991,115876,10115,8
12003,2020-05-01,10669,9915,754,7.1
12005,2020-05-01,78536,70379,8157,10.4
12007,2020-05-01,10021,9269,752,7.5
12009,2020-05-01,270705,239436,31269,11.6
12011,2020-05-01,979822,831114,148708,15.2
12013,2020-05-01,4307,3993,314,7.3
12015,2020-05-01,67918,59443,8475,12.5
12017,2020-05-01,45788,39706,6082,13.3
12019,2020-05-01,99032,90227,8805,8.9
12021,2020-05-01,165796,145329,20467,12.3
12023,2020-05-01,27110,24808,2302,8.5
12027,2020-05-01,13807,12886,921,6.7
12029,2020-05-01,5346,4930,416,7.8
12031,2020-05-01,461194,410677,50517,11
12033,2020-05-01,135227,120506,14721,10.9
12035,2020-05-01,44491,38389,6102,13.7
12037,2020-05-01,4204,3804,400,9.5
12039,2020-05-01,17120,15708,1412,8.2
12041,2020-05-01,6326,5912,414,6.5
12043,2020-05-01,5129,4751,378,7.4
12045,2020-05-01,5211,4770,441,8.5
12047,2020-05-01,3940,3535,405,10.3
12049,2020-05-01,7997,7343,654,8.2
12051,2020-05-01,14600,13038,1562,10.7
12053,2020-05-01,68108,58887,9221,13.5
12055,2020-05-01,34651,31067,3584,10.3
12057,2020-05-01,705063,622081,82982,11.8
12059,2020-05-01,6408,5878,530,8.3
12061,2020-05-01,61054,53415,7639,12.5
12063,2020-05-01,15668,14429,1239,7.9
12065,2020-05-01,5009,4655,354,7.1
12067,2020-05-01,2543,2407,136,5.3
12069,2020-05-01,148317,120387,27930,18.8
12071,2020-05-01,327399,284812,42587,13
12073,2020-05-01,139673,128270,11403,8.2
12075,2020-05-01,15285,13888,1397,9.1
12077,2020-05-01,2344,2204,140,6
12079,2020-05-01,6798,6288,510,7.5
12081,2020-05-01,165671,146042,19629,11.8
12083,2020-05-01,132803,118618,14185,10.7
12085,2020-05-01,69955,62659,7296,10.4
12086,2020-05-01,NA,NA,122125,10.3
12087,2020-05-01,48916,40866,8050,16.5
12089,2020-05-01,38382,34482,3900,10.2
12091,2020-05-01,89355,80808,8547,9.6
12093,2020-05-01,16124,14894,1230,7.6
12095,2020-05-01,736927,577053,159874,21.7
12097,2020-05-01,195685,138872,56813,29
12099,2020-05-01,675742,585813,89929,13.3
12101,2020-05-01,224764,196551,28213,12.6
12103,2020-05-01,467996,410020,57976,12.4
12105,2020-05-01,308461,254055,54406,17.6
12107,2020-05-01,24534,21869,2665,10.9
12109,2020-05-01,123180,111333,11847,9.6
12111,2020-05-01,139648,121701,17947,12.9
12113,2020-05-01,75183,68679,6504,8.7
12115,2020-05-01,174734,152914,21820,12.5
12117,2020-05-01,223471,193365,30106,13.5
12119,2020-05-01,30844,27174,3670,11.9
12121,2020-05-01,16501,15186,1315,8
12123,2020-05-01,7670,7016,654,8.5
12125,2020-05-01,4150,3885,265,6.4
12127,2020-05-01,240021,208020,32001,13.3
12129,2020-05-01,13296,12351,945,7.1
12131,2020-05-01,29519,26291,3228,10.9
12133,2020-05-01,8774,7984,790,9
13001,2020-05-01,9491,8992,499,5.3
13003,2020-05-01,4323,4135,188,4.3
13005,2020-05-01,4803,4564,239,5
13007,2020-05-01,1114,1043,71,6.4
13009,2020-05-01,17712,16253,1459,8.2
13011,2020-05-01,9725,9102,623,6.4
13013,2020-05-01,37898,34871,3027,8
13015,2020-05-01,47962,43468,4494,9.4
13017,2020-05-01,5212,4858,354,6.8
13019,2020-05-01,7293,6826,467,6.4
13021,2020-05-01,64395,58232,6163,9.6
13023,2020-05-01,4293,3989,304,7.1
13025,2020-05-01,6215,5748,467,7.5
13027,2020-05-01,6554,6189,365,5.6
13029,2020-05-01,17026,15608,1418,8.3
13031,2020-05-01,36739,33557,3182,8.7
13033,2020-05-01,8685,7931,754,8.7
13035,2020-05-01,10049,9233,816,8.1
13037,2020-05-01,2284,2167,117,5.1
13039,2020-05-01,20064,18737,1327,6.6
13043,2020-05-01,5604,5313,291,5.2
13045,2020-05-01,52292,47368,4924,9.4
13047,2020-05-01,32130,30202,1928,6
13049,2020-05-01,4594,4401,193,4.2
13051,2020-05-01,134467,118754,15713,11.7
13053,2020-05-01,1841,1695,146,7.9
13055,2020-05-01,10076,8849,1227,12.2
13057,2020-05-01,126581,117150,9431,7.5
13059,2020-05-01,57288,52105,5183,9
13061,2020-05-01,939,810,129,13.7
13063,2020-05-01,135940,117243,18697,13.8
13065,2020-05-01,2568,2432,136,5.3
13067,2020-05-01,400306,365913,34393,8.6
13069,2020-05-01,18714,17565,1149,6.1
13071,2020-05-01,21364,20310,1054,4.9
13073,2020-05-01,70006,65862,4144,5.9
13075,2020-05-01,7918,7526,392,5
13077,2020-05-01,71095,64315,6780,9.5
13079,2020-05-01,5197,4855,342,6.6
13081,2020-05-01,9461,8808,653,6.9
13083,2020-05-01,7729,7317,412,5.3
13085,2020-05-01,11484,10625,859,7.5
13087,2020-05-01,11215,10655,560,5
13089,2020-05-01,385140,342134,43006,11.2
13091,2020-05-01,6569,6124,445,6.8
13093,2020-05-01,5050,4605,445,8.8
13095,2020-05-01,36489,32900,3589,9.8
13097,2020-05-01,70159,62658,7501,10.7
13099,2020-05-01,4336,4119,217,5
13101,2020-05-01,1839,1751,88,4.8
13103,2020-05-01,28677,26415,2262,7.9
13105,2020-05-01,7806,7180,626,8
13107,2020-05-01,8148,7568,580,7.1
13109,2020-05-01,4824,4529,295,6.1
13111,2020-05-01,12229,11515,714,5.8
13113,2020-05-01,54531,49940,4591,8.4
13115,2020-05-01,44138,40212,3926,8.9
13117,2020-05-01,113986,105415,8571,7.5
13119,2020-05-01,10017,9202,815,8.1
13121,2020-05-01,537738,477117,60621,11.3
13123,2020-05-01,11098,10311,787,7.1
13125,2020-05-01,1209,1150,59,4.9
13127,2020-05-01,34863,30836,4027,11.6
13129,2020-05-01,28248,26215,2033,7.2
13131,2020-05-01,10109,9612,497,4.9
13133,2020-05-01,7027,6517,510,7.3
13135,2020-05-01,465018,421028,43990,9.5
13137,2020-05-01,18769,17380,1389,7.4
13139,2020-05-01,96713,89333,7380,7.6
13141,2020-05-01,2524,2279,245,9.7
13143,2020-05-01,11816,10765,1051,8.9
13145,2020-05-01,15383,14254,1129,7.3
13147,2020-05-01,10946,10190,756,6.9
13149,2020-05-01,4985,4517,468,9.4
13151,2020-05-01,111387,99011,12376,11.1
13153,2020-05-01,65772,61217,4555,6.9
13155,2020-05-01,3388,3190,198,5.8
13157,2020-05-01,36288,33659,2629,7.2
13159,2020-05-01,6416,5991,425,6.6
13161,2020-05-01,5800,5462,338,5.8
13163,2020-05-01,6462,6003,459,7.1
13165,2020-05-01,3072,2825,247,8
13167,2020-05-01,3922,3715,207,5.3
13169,2020-05-01,12657,11869,788,6.2
13171,2020-05-01,7629,7011,618,8.1
13173,2020-05-01,3494,3291,203,5.8
13175,2020-05-01,18970,17386,1584,8.4
13177,2020-05-01,13744,12863,881,6.4
13179,2020-05-01,25441,23444,1997,7.8
13181,2020-05-01,3355,3127,228,6.8
13183,2020-05-01,7754,7348,406,5.2
13185,2020-05-01,49072,45107,3965,8.1
13187,2020-05-01,15856,14687,1169,7.4
13189,2020-05-01,8437,7615,822,9.7
13191,2020-05-01,5332,4918,414,7.8
13193,2020-05-01,4513,4219,294,6.5
13195,2020-05-01,12668,11752,916,7.2
13197,2020-05-01,2999,2799,200,6.7
13199,2020-05-01,8607,7578,1029,12
13201,2020-05-01,2675,2575,100,3.7
13205,2020-05-01,8167,7637,530,6.5
13207,2020-05-01,12055,11244,811,6.7
13209,2020-05-01,3834,3588,246,6.4
13211,2020-05-01,8702,7995,707,8.1
13213,2020-05-01,15032,13389,1643,10.9
13215,2020-05-01,73003,65118,7885,10.8
13217,2020-05-01,49542,44601,4941,10
13219,2020-05-01,18429,17353,1076,5.8
13221,2020-05-01,6605,6171,434,6.6
13223,2020-05-01,80488,74098,6390,7.9
13225,2020-05-01,11050,10269,781,7.1
13227,2020-05-01,14118,13150,968,6.9
13229,2020-05-01,8384,7937,447,5.3
13231,2020-05-01,8242,7670,572,6.9
13233,2020-05-01,17976,16359,1617,9
13235,2020-05-01,3716,3531,185,5
13237,2020-05-01,7937,7247,690,8.7
13239,2020-05-01,764,723,41,5.4
13241,2020-05-01,7080,6529,551,7.8
13243,2020-05-01,2499,2361,138,5.5
13245,2020-05-01,81477,73555,7922,9.7
13247,2020-05-01,42671,38208,4463,10.5
13249,2020-05-01,2221,2089,132,5.9
13251,2020-05-01,5161,4578,583,11.3
13253,2020-05-01,2985,2823,162,5.4
13255,2020-05-01,27093,24459,2634,9.7
13257,2020-05-01,10753,9818,935,8.7
13259,2020-05-01,2544,2378,166,6.5
13261,2020-05-01,12907,11981,926,7.2
13263,2020-05-01,2664,2414,250,9.4
13265,2020-05-01,566,521,45,8
13267,2020-05-01,9216,8796,420,4.6
13269,2020-05-01,2794,2613,181,6.5
13271,2020-05-01,3608,3252,356,9.9
13273,2020-05-01,3265,3013,252,7.7
13275,2020-05-01,16522,15323,1199,7.3
13277,2020-05-01,19849,18664,1185,6
13279,2020-05-01,11970,10979,991,8.3
13281,2020-05-01,3629,3282,347,9.6
13283,2020-05-01,2619,2444,175,6.7
13285,2020-05-01,38658,34699,3959,10.2
13287,2020-05-01,3113,2892,221,7.1
13289,2020-05-01,2695,2443,252,9.4
13291,2020-05-01,10164,9542,622,6.1
13293,2020-05-01,11089,10125,964,8.7
13295,2020-05-01,30202,28127,2075,6.9
13297,2020-05-01,42993,39627,3366,7.8
13299,2020-05-01,15147,14163,984,6.5
13301,2020-05-01,2776,2540,236,8.5
13303,2020-05-01,6571,6098,473,7.2
13305,2020-05-01,10951,10188,763,7
13307,2020-05-01,993,936,57,5.7
13309,2020-05-01,1592,1478,114,7.2
13311,2020-05-01,16451,15362,1089,6.6
13313,2020-05-01,42413,37773,4640,10.9
13315,2020-05-01,2605,2456,149,5.7
13317,2020-05-01,3818,3548,270,7.1
13319,2020-05-01,3916,3674,242,6.2
13321,2020-05-01,8287,7772,515,6.2
15001,2020-05-01,86557,67227,19330,22.3
15003,2020-05-01,417414,330736,86678,20.8
15007,2020-05-01,35883,24596,11287,31.5
15009,2020-05-01,84771,55936,28835,34
16001,2020-05-01,257793,233928,23865,9.3
16003,2020-05-01,1743,1501,242,13.9
16005,2020-05-01,40211,37110,3101,7.7
16007,2020-05-01,2979,2805,174,5.8
16009,2020-05-01,4124,3679,445,10.8
16011,2020-05-01,23758,22420,1338,5.6
16013,2020-05-01,12848,10923,1925,15
16015,2020-05-01,3608,3186,422,11.7
16017,2020-05-01,20805,18199,2606,12.5
16019,2020-05-01,59338,55898,3440,5.8
16021,2020-05-01,5499,4999,500,9.1
16023,2020-05-01,1458,1387,71,4.9
16025,2020-05-01,697,643,54,7.7
16027,2020-05-01,105032,95373,9659,9.2
16029,2020-05-01,4073,3889,184,4.5
16031,2020-05-01,12025,11338,687,5.7
16033,2020-05-01,383,367,16,4.2
16035,2020-05-01,2887,2519,368,12.7
16037,2020-05-01,2147,1998,149,6.9
16039,2020-05-01,11606,10791,815,7
16041,2020-05-01,6877,6556,321,4.7
16043,2020-05-01,7747,7328,419,5.4
16045,2020-05-01,8341,7623,718,8.6
16047,2020-05-01,8144,7712,432,5.3
16049,2020-05-01,6777,6116,661,9.8
16051,2020-05-01,14467,13823,644,4.5
16053,2020-05-01,11989,11341,648,5.4
16055,2020-05-01,79535,70616,8919,11.2
16057,2020-05-01,19813,18326,1487,7.5
16059,2020-05-01,3574,3232,342,9.6
16061,2020-05-01,1730,1548,182,10.5
16063,2020-05-01,2643,2432,211,8
16065,2020-05-01,21029,20174,855,4.1
16067,2020-05-01,11276,10643,633,5.6
16069,2020-05-01,19467,17834,1633,8.4
16071,2020-05-01,2375,2220,155,6.5
16073,2020-05-01,5731,5236,495,8.6
16075,2020-05-01,11630,10703,927,8
16077,2020-05-01,3998,3785,213,5.3
16079,2020-05-01,5102,4307,795,15.6
16081,2020-05-01,6641,5896,745,11.2
16083,2020-05-01,40928,37450,3478,8.5
16085,2020-05-01,5753,4976,777,13.5
16087,2020-05-01,4587,4223,364,7.9
17001,2020-05-01,31442,28149,3293,10.5
17003,2020-05-01,1860,1596,264,14.2
17005,2020-05-01,7361,6460,901,12.2
17007,2020-05-01,25660,20491,5169,20.1
17009,2020-05-01,2673,2491,182,6.8
17011,2020-05-01,16973,14991,1982,11.7
17013,2020-05-01,2213,1908,305,13.8
17015,2020-05-01,7390,6421,969,13.1
17017,2020-05-01,5916,5318,598,10.1
17019,2020-05-01,101569,91222,10347,10.2
17021,2020-05-01,13680,12067,1613,11.8
17023,2020-05-01,7499,6552,947,12.6
17025,2020-05-01,6467,5156,1311,20.3
17027,2020-05-01,19178,17045,2133,11.1
17029,2020-05-01,22265,19786,2479,11.1
17031,2020-05-01,NA,NA,427640,16.4
17033,2020-05-01,8157,7312,845,10.4
17035,2020-05-01,5881,5365,516,8.8
17037,2020-05-01,50506,43715,6791,13.4
17039,2020-05-01,6726,6073,653,9.7
17041,2020-05-01,9817,8939,878,8.9
17043,2020-05-01,494407,431647,62760,12.7
17045,2020-05-01,8707,7581,1126,12.9
17047,2020-05-01,2623,2283,340,13
17049,2020-05-01,19222,16831,2391,12.4
17051,2020-05-01,9859,8700,1159,11.8
17053,2020-05-01,6107,5434,673,11
17055,2020-05-01,16646,13435,3211,19.3
17057,2020-05-01,14486,12618,1868,12.9
17059,2020-05-01,2215,1936,279,12.6
17061,2020-05-01,5829,5280,549,9.4
17063,2020-05-01,24728,21307,3421,13.8
17065,2020-05-01,4144,3609,535,12.9
17067,2020-05-01,8235,7299,936,11.4
17069,2020-05-01,1281,1132,149,11.6
17071,2020-05-01,3646,3209,437,12
17073,2020-05-01,23553,20421,3132,13.3
17075,2020-05-01,13781,12612,1169,8.5
17077,2020-05-01,26510,23006,3504,13.2
17079,2020-05-01,4856,4414,442,9.1
17081,2020-05-01,17278,13906,3372,19.5
17083,2020-05-01,10375,9028,1347,13
17085,2020-05-01,10731,9094,1637,15.3
17087,2020-05-01,4223,3600,623,14.8
17089,2020-05-01,253866,215337,38529,15.2
17091,2020-05-01,53484,46246,7238,13.5
17093,2020-05-01,67418,58060,9358,13.9
17095,2020-05-01,21083,18332,2751,13
17097,2020-05-01,348456,303001,45455,13
17099,2020-05-01,53303,44918,8385,15.7
17101,2020-05-01,5679,4919,760,13.4
17103,2020-05-01,16899,14954,1945,11.5
17105,2020-05-01,15864,14312,1552,9.8
17107,2020-05-01,12048,10839,1209,10
17109,2020-05-01,12936,11638,1298,10
17111,2020-05-01,161889,140276,21613,13.4
17113,2020-05-01,80794,71772,9022,11.2
17115,2020-05-01,44732,38030,6702,15
17117,2020-05-01,21404,18956,2448,11.4
17119,2020-05-01,127667,110726,16941,13.3
17121,2020-05-01,17523,14371,3152,18
17123,2020-05-01,4682,4138,544,11.6
17125,2020-05-01,6108,5412,696,11.4
17127,2020-05-01,5417,4506,911,16.8
17129,2020-05-01,5952,5336,616,10.3
17131,2020-05-01,7654,6616,1038,13.6
17133,2020-05-01,17386,15641,1745,10
17135,2020-05-01,11505,9915,1590,13.8
17137,2020-05-01,15806,14258,1548,9.8
17139,2020-05-01,7203,6680,523,7.3
17141,2020-05-01,23929,20786,3143,13.1
17143,2020-05-01,78452,64850,13602,17.3
17145,2020-05-01,8719,7099,1620,18.6
17147,2020-05-01,7922,7252,670,8.5
17149,2020-05-01,6812,6225,587,8.6
17151,2020-05-01,1676,1470,206,12.3
17153,2020-05-01,1875,1582,293,15.6
17155,2020-05-01,3062,2683,379,12.4
17157,2020-05-01,13921,12033,1888,13.6
17159,2020-05-01,7224,6380,844,11.7
17161,2020-05-01,69582,57941,11641,16.7
17163,2020-05-01,122028,103863,18165,14.9
17165,2020-05-01,9750,8196,1554,15.9
17167,2020-05-01,95048,82443,12605,13.3
17169,2020-05-01,3187,2887,300,9.4
17171,2020-05-01,2462,2240,222,9
17173,2020-05-01,10433,9312,1121,10.7
17175,2020-05-01,2211,1960,251,11.4
17177,2020-05-01,20911,18725,2186,10.5
17179,2020-05-01,57551,49148,8403,14.6
17181,2020-05-01,7275,6387,888,12.2
17183,2020-05-01,31983,27487,4496,14.1
17185,2020-05-01,6026,5207,819,13.6
17187,2020-05-01,8160,7416,744,9.1
17189,2020-05-01,8848,7711,1137,12.9
17191,2020-05-01,7300,6152,1148,15.7
17193,2020-05-01,6368,5608,760,11.9
17195,2020-05-01,27731,23679,4052,14.6
17197,2020-05-01,353308,300615,52693,14.9
17199,2020-05-01,31516,26181,5335,16.9
17201,2020-05-01,134828,108753,26075,19.3
17203,2020-05-01,16280,14591,1689,10.4
18001,2020-05-01,16835,15197,1638,9.7
18003,2020-05-01,190202,163635,26567,14
18005,2020-05-01,45662,39880,5782,12.7
18007,2020-05-01,4243,3860,383,9
18009,2020-05-01,5027,4211,816,16.2
18011,2020-05-01,34492,32166,2326,6.7
18013,2020-05-01,7756,6784,972,12.5
18015,2020-05-01,9890,8627,1263,12.8
18017,2020-05-01,18000,15707,2293,12.7
18019,2020-05-01,58517,50952,7565,12.9
18021,2020-05-01,11701,10475,1226,10.5
18023,2020-05-01,17143,15191,1952,11.4
18025,2020-05-01,4665,4163,502,10.8
18027,2020-05-01,16069,15161,908,5.7
18029,2020-05-01,24999,22134,2865,11.5
18031,2020-05-01,16277,13607,2670,16.4
18033,2020-05-01,23434,20117,3317,14.2
18035,2020-05-01,52374,46095,6279,12
18037,2020-05-01,22049,20799,1250,5.7
18039,2020-05-01,108353,95554,12799,11.8
18041,2020-05-01,8967,7304,1663,18.5
18043,2020-05-01,38972,34479,4493,11.5
18045,2020-05-01,8120,7006,1114,13.7
18047,2020-05-01,11248,10149,1099,9.8
18049,2020-05-01,9713,8680,1033,10.6
18051,2020-05-01,20557,17870,2687,13.1
18053,2020-05-01,31474,28161,3313,10.5
18055,2020-05-01,13328,12136,1192,8.9
18057,2020-05-01,176109,162882,13227,7.5
18059,2020-05-01,39513,35583,3930,9.9
18061,2020-05-01,19029,16812,2217,11.7
18063,2020-05-01,86633,79622,7011,8.1
18065,2020-05-01,22354,19557,2797,12.5
18067,2020-05-01,41547,32225,9322,22.4
18069,2020-05-01,18629,16111,2518,13.5
18071,2020-05-01,24445,20409,4036,16.5
18073,2020-05-01,16179,14278,1901,11.7
18075,2020-05-01,9591,8224,1367,14.3
18077,2020-05-01,15639,13363,2276,14.6
18079,2020-05-01,14310,12087,2223,15.5
18081,2020-05-01,81468,73444,8024,9.8
18083,2020-05-01,18177,16122,2055,11.3
18085,2020-05-01,41486,37811,3675,8.9
18087,2020-05-01,19663,17664,1999,10.2
18089,2020-05-01,236937,198764,38173,16.1
18091,2020-05-01,49631,42183,7448,15
18093,2020-05-01,21190,18777,2413,11.4
18095,2020-05-01,60051,51836,8215,13.7
18097,2020-05-01,486707,431380,55327,11.4
18099,2020-05-01,22650,20387,2263,10
18101,2020-05-01,5167,4863,304,5.9
18103,2020-05-01,15720,13420,2300,14.6
18105,2020-05-01,70513,64996,5517,7.8
18107,2020-05-01,18347,16648,1699,9.3
18109,2020-05-01,34998,32020,2978,8.5
18111,2020-05-01,6856,6079,777,11.3
18113,2020-05-01,24759,20764,3995,16.1
18115,2020-05-01,3189,2732,457,14.3
18117,2020-05-01,9438,7697,1741,18.4
18119,2020-05-01,9460,8625,835,8.8
18121,2020-05-01,6823,6223,600,8.8
18123,2020-05-01,9118,8049,1069,11.7
18125,2020-05-01,6041,5453,588,9.7
18127,2020-05-01,87695,75783,11912,13.6
18129,2020-05-01,13414,12415,999,7.4
18131,2020-05-01,6359,5763,596,9.4
18133,2020-05-01,16626,14744,1882,11.3
18135,2020-05-01,11193,9949,1244,11.1
18137,2020-05-01,14292,12645,1647,11.5
18139,2020-05-01,9176,7992,1184,12.9
18141,2020-05-01,130872,113711,17161,13.1
18143,2020-05-01,10624,8710,1914,18
18145,2020-05-01,23914,20457,3457,14.5
18147,2020-05-01,11115,10217,898,8.1
18149,2020-05-01,9865,8643,1222,12.4
18151,2020-05-01,20784,18355,2429,11.7
18153,2020-05-01,8138,7260,878,10.8
18155,2020-05-01,5088,4311,777,15.3
18157,2020-05-01,93634,82691,10943,11.7
18159,2020-05-01,9435,8291,1144,12.1
18161,2020-05-01,3380,3067,313,9.3
18163,2020-05-01,97362,85915,11447,11.8
18165,2020-05-01,6810,5986,824,12.1
18167,2020-05-01,47205,41531,5674,12
18169,2020-05-01,14910,13401,1509,10.1
18171,2020-05-01,4047,3644,403,10
18173,2020-05-01,33092,30060,3032,9.2
18175,2020-05-01,13172,11418,1754,13.3
18177,2020-05-01,30577,27450,3127,10.2
18179,2020-05-01,14262,12797,1465,10.3
18181,2020-05-01,13464,12222,1242,9.2
18183,2020-05-01,17668,15716,1952,11
19001,2020-05-01,4140,3807,333,8
19003,2020-05-01,2109,1954,155,7.3
19005,2020-05-01,7149,6562,587,8.2
19007,2020-05-01,5984,5413,571,9.5
19009,2020-05-01,3019,2854,165,5.5
19011,2020-05-01,13101,11897,1204,9.2
19013,2020-05-01,70036,61722,8314,11.9
19015,2020-05-01,14451,13342,1109,7.7
19017,2020-05-01,13592,12473,1119,8.2
19019,2020-05-01,10928,10016,912,8.3
19021,2020-05-01,11527,10869,658,5.7
19023,2020-05-01,7683,7057,626,8.1
19025,2020-05-01,4148,3834,314,7.6
19027,2020-05-01,10787,9926,861,8
19029,2020-05-01,6735,6306,429,6.4
19031,2020-05-01,10588,9782,806,7.6
19033,2020-05-01,23581,21383,2198,9.3
19035,2020-05-01,6028,5637,391,6.5
19037,2020-05-01,6410,5964,446,7
19039,2020-05-01,4829,4330,499,10.3
19041,2020-05-01,8425,7719,706,8.4
19043,2020-05-01,9822,8918,904,9.2
19045,2020-05-01,23192,20376,2816,12.1
19047,2020-05-01,8018,7383,635,7.9
19049,2020-05-01,46998,43616,3382,7.2
19051,2020-05-01,4143,3865,278,6.7
19053,2020-05-01,4240,3907,333,7.9
19055,2020-05-01,10237,9506,731,7.1
19057,2020-05-01,19630,16935,2695,13.7
19059,2020-05-01,9695,8746,949,9.8
19061,2020-05-01,54847,47913,6934,12.6
19063,2020-05-01,5250,4802,448,8.5
19065,2020-05-01,10089,9152,937,9.3
19067,2020-05-01,8495,7697,798,9.4
19069,2020-05-01,5463,5140,323,5.9
19071,2020-05-01,3532,3327,205,5.8
19073,2020-05-01,5497,5019,478,8.7
19075,2020-05-01,6345,5817,528,8.3
19077,2020-05-01,5356,4887,469,8.8
19079,2020-05-01,6656,6142,514,7.7
19081,2020-05-01,5997,5438,559,9.3
19083,2020-05-01,7834,7207,627,8
19085,2020-05-01,7149,6651,498,7
19087,2020-05-01,9871,8840,1031,10.4
19089,2020-05-01,5058,4732,326,6.4
19091,2020-05-01,4983,4617,366,7.3
19093,2020-05-01,4039,3828,211,5.2
19095,2020-05-01,10477,9554,923,8.8
19097,2020-05-01,10943,9721,1222,11.2
19099,2020-05-01,19868,17891,1977,10
19101,2020-05-01,10406,9347,1059,10.2
19103,2020-05-01,84536,76746,7790,9.2
19105,2020-05-01,10453,9393,1060,10.1
19107,2020-05-01,5199,4731,468,9
19109,2020-05-01,8234,7653,581,7.1
19111,2020-05-01,16479,14476,2003,12.2
19113,2020-05-01,121707,107835,13872,11.4
19115,2020-05-01,6202,5617,585,9.4
19117,2020-05-01,4555,4260,295,6.5
19119,2020-05-01,6577,6307,270,4.1
19121,2020-05-01,8301,7423,878,10.6
19123,2020-05-01,11998,10840,1158,9.7
19125,2020-05-01,18145,16613,1532,8.4
19127,2020-05-01,18157,16124,2033,11.2
19129,2020-05-01,7208,6692,516,7.2
19131,2020-05-01,7022,6655,367,5.2
19133,2020-05-01,4203,3831,372,8.9
19135,2020-05-01,4067,3698,369,9.1
19137,2020-05-01,4947,4541,406,8.2
19139,2020-05-01,23276,20186,3090,13.3
19141,2020-05-01,7972,7527,445,5.6
19143,2020-05-01,3376,3196,180,5.3
19145,2020-05-01,6497,5866,631,9.7
19147,2020-05-01,4754,4333,421,8.9
19149,2020-05-01,14294,13419,875,6.1
19151,2020-05-01,4407,4159,248,5.6
19153,2020-05-01,266351,234908,31443,11.8
19155,2020-05-01,48926,44003,4923,10.1
19157,2020-05-01,9864,8809,1055,10.7
19159,2020-05-01,2390,2213,177,7.4
19161,2020-05-01,5118,4820,298,5.8
19163,2020-05-01,88985,77385,11600,13
19165,2020-05-01,6522,6112,410,6.3
19167,2020-05-01,19767,18912,855,4.3
19169,2020-05-01,54696,50817,3879,7.1
19171,2020-05-01,9306,8560,746,8
19173,2020-05-01,3142,2944,198,6.3
19175,2020-05-01,6362,5700,662,10.4
19177,2020-05-01,3644,3340,304,8.3
19179,2020-05-01,17922,16080,1842,10.3
19181,2020-05-01,27113,24797,2316,8.5
19183,2020-05-01,11494,10624,870,7.6
19185,2020-05-01,2812,2569,243,8.6
19187,2020-05-01,19349,17658,1691,8.7
19189,2020-05-01,5405,4683,722,13.4
19191,2020-05-01,10078,9211,867,8.6
19193,2020-05-01,55905,50380,5525,9.9
19195,2020-05-01,4176,3719,457,10.9
19197,2020-05-01,6939,6462,477,6.9
20001,2020-05-01,6572,6081,491,7.5
20003,2020-05-01,4157,3922,235,5.7
20005,2020-05-01,7047,6347,700,9.9
20007,2020-05-01,2273,2168,105,4.6
20009,2020-05-01,13742,12833,909,6.6
20011,2020-05-01,6604,6090,514,7.8
20013,2020-05-01,5431,5031,400,7.4
20015,2020-05-01,32900,29232,3668,11.1
20017,2020-05-01,1678,1556,122,7.3
20019,2020-05-01,1482,1352,130,8.8
20021,2020-05-01,10211,9317,894,8.8
20023,2020-05-01,1251,1214,37,3
20025,2020-05-01,1018,992,26,2.6
20027,2020-05-01,3761,3509,252,6.7
20029,2020-05-01,3746,3541,205,5.5
20031,2020-05-01,3850,3581,269,7
20033,2020-05-01,891,847,44,4.9
20035,2020-05-01,16927,15119,1808,10.7
20037,2020-05-01,19072,17487,1585,8.3
20039,2020-05-01,1200,1138,62,5.2
20041,2020-05-01,8964,8326,638,7.1
20043,2020-05-01,4038,3732,306,7.6
20045,2020-05-01,66431,59546,6885,10.4
20047,2020-05-01,1289,1235,54,4.2
20049,2020-05-01,1158,1076,82,7.1
20051,2020-05-01,16917,15945,972,5.7
20053,2020-05-01,2659,2555,104,3.9
20055,2020-05-01,20389,19351,1038,5.1
20057,2020-05-01,16785,16013,772,4.6
20059,2020-05-01,14236,13058,1178,8.3
20061,2020-05-01,11550,10308,1242,10.8
20063,2020-05-01,1459,1406,53,3.6
20065,2020-05-01,1116,1041,75,6.7
20067,2020-05-01,3059,2904,155,5.1
20069,2020-05-01,3191,3112,79,2.5
20071,2020-05-01,789,774,15,1.9
20073,2020-05-01,3263,3011,252,7.7
20075,2020-05-01,1555,1529,26,1.7
20077,2020-05-01,2858,2685,173,6.1
20079,2020-05-01,16772,15346,1426,8.5
20081,2020-05-01,2166,2095,71,3.3
20083,2020-05-01,985,953,32,3.2
20085,2020-05-01,7303,6478,825,11.3
20087,2020-05-01,9907,9122,785,7.9
20089,2020-05-01,1266,1211,55,4.3
20091,2020-05-01,335505,304195,31310,9.3
20093,2020-05-01,2000,1920,80,4
20095,2020-05-01,3362,3111,251,7.5
20097,2020-05-01,1251,1189,62,5
20099,2020-05-01,9955,9156,799,8
20101,2020-05-01,752,724,28,3.7
20103,2020-05-01,36315,32513,3802,10.5
20105,2020-05-01,1657,1599,58,3.5
20107,2020-05-01,4298,3872,426,9.9
20109,2020-05-01,1586,1532,54,3.4
20111,2020-05-01,16976,15761,1215,7.2
20113,2020-05-01,17166,16265,901,5.2
20115,2020-05-01,6017,5664,353,5.9
20117,2020-05-01,5333,5091,242,4.5
20119,2020-05-01,2071,1989,82,4
20121,2020-05-01,16964,15605,1359,8
20123,2020-05-01,3275,3157,118,3.6
20125,2020-05-01,14998,13356,1642,10.9
20127,2020-05-01,2960,2799,161,5.4
20129,2020-05-01,1063,1027,36,3.4
20131,2020-05-01,5101,4868,233,4.6
20133,2020-05-01,6140,5585,555,9
20135,2020-05-01,1319,1255,64,4.9
20137,2020-05-01,2572,2488,84,3.3
20139,2020-05-01,7779,7174,605,7.8
20141,2020-05-01,1968,1890,78,4
20143,2020-05-01,3045,2840,205,6.7
20145,2020-05-01,2745,2607,138,5
20147,2020-05-01,2620,2490,130,5
20149,2020-05-01,11856,11109,747,6.3
20151,2020-05-01,4900,4645,255,5.2
20153,2020-05-01,1442,1392,50,3.5
20155,2020-05-01,30459,27977,2482,8.1
20157,2020-05-01,2214,2113,101,4.6
20159,2020-05-01,5289,5000,289,5.5
20161,2020-05-01,33955,31290,2665,7.8
20163,2020-05-01,2471,2337,134,5.4
20165,2020-05-01,1582,1486,96,6.1
20167,2020-05-01,3250,3029,221,6.8
20169,2020-05-01,30996,28282,2714,8.8
20171,2020-05-01,2756,2655,101,3.7
20173,2020-05-01,264806,225277,39529,14.9
20175,2020-05-01,9363,8741,622,6.6
20177,2020-05-01,90199,81251,8948,9.9
20179,2020-05-01,1376,1336,40,2.9
20181,2020-05-01,2751,2629,122,4.4
20183,2020-05-01,1954,1889,65,3.3
20185,2020-05-01,1968,1874,94,4.8
20187,2020-05-01,942,916,26,2.8
20189,2020-05-01,2700,2610,90,3.3
20191,2020-05-01,11305,9809,1496,13.2
20193,2020-05-01,4132,3978,154,3.7
20195,2020-05-01,1324,1252,72,5.4
20197,2020-05-01,3519,3295,224,6.4
20199,2020-05-01,976,958,18,1.8
20201,2020-05-01,2928,2831,97,3.3
20203,2020-05-01,1300,1274,26,2
20205,2020-05-01,4064,3665,399,9.8
20207,2020-05-01,1668,1528,140,8.4
20209,2020-05-01,79388,68202,11186,14.1
21001,2020-05-01,7280,6517,763,10.5
21003,2020-05-01,8509,7760,749,8.8
21005,2020-05-01,12096,10966,1130,9.3
21007,2020-05-01,3394,3083,311,9.2
21009,2020-05-01,18490,16316,2174,11.8
21011,2020-05-01,4800,4236,564,11.8
21013,2020-05-01,8325,7500,825,9.9
21015,2020-05-01,69229,63144,6085,8.8
21017,2020-05-01,10139,9218,921,9.1
21019,2020-05-01,18327,15996,2331,12.7
21021,2020-05-01,12226,10766,1460,11.9
21023,2020-05-01,3726,3407,319,8.6
21025,2020-05-01,3407,2987,420,12.3
21027,2020-05-01,8229,7290,939,11.4
21029,2020-05-01,41605,36447,5158,12.4
21031,2020-05-01,4882,4272,610,12.5
21033,2020-05-01,5590,5110,480,8.6
21035,2020-05-01,18925,17446,1479,7.8
21037,2020-05-01,49391,45125,4266,8.6
21039,2020-05-01,2277,2152,125,5.5
21041,2020-05-01,5460,4915,545,10
21043,2020-05-01,9898,8598,1300,13.1
21045,2020-05-01,6858,6265,593,8.6
21047,2020-05-01,26622,23416,3206,12
21049,2020-05-01,16912,15305,1607,9.5
21051,2020-05-01,5297,4641,656,12.4
21053,2020-05-01,4064,3812,252,6.2
21055,2020-05-01,3834,3554,280,7.3
21057,2020-05-01,3296,3050,246,7.5
21059,2020-05-01,46134,41422,4712,10.2
21061,2020-05-01,4617,3976,641,13.9
21063,2020-05-01,2101,1826,275,13.1
21065,2020-05-01,5381,4763,618,11.5
21067,2020-05-01,172003,156482,15521,9
21069,2020-05-01,6454,5714,740,11.5
21071,2020-05-01,10995,9685,1310,11.9
21073,2020-05-01,25533,22976,2557,10
21075,2020-05-01,2175,2002,173,8
21077,2020-05-01,4083,3675,408,10
21079,2020-05-01,7531,6820,711,9.4
21081,2020-05-01,11783,10425,1358,11.5
21083,2020-05-01,15791,14529,1262,8
21085,2020-05-01,11302,10011,1291,11.4
21087,2020-05-01,5197,4747,450,8.7
21089,2020-05-01,13685,11947,1738,12.7
21091,2020-05-01,4031,3481,550,13.6
21093,2020-05-01,49329,43242,6087,12.3
21095,2020-05-01,6546,5561,985,15
21097,2020-05-01,9021,8158,863,9.6
21099,2020-05-01,8165,7440,725,8.9
21101,2020-05-01,23109,20703,2406,10.4
21103,2020-05-01,8060,7226,834,10.3
21105,2020-05-01,1853,1734,119,6.4
21107,2020-05-01,16853,14614,2239,13.3
21109,2020-05-01,4113,3537,576,14
21111,2020-05-01,386186,340828,45358,11.7
21113,2020-05-01,25860,23644,2216,8.6
21115,2020-05-01,6721,5963,758,11.3
21117,2020-05-01,85688,77954,7734,9
21119,2020-05-01,4312,3870,442,10.3
21121,2020-05-01,10189,8875,1314,12.9
21123,2020-05-01,6081,5337,744,12.2
21125,2020-05-01,25184,22273,2911,11.6
21127,2020-05-01,5365,4771,594,11.1
21129,2020-05-01,2107,1888,219,10.4
21131,2020-05-01,2656,2295,361,13.6
21133,2020-05-01,6251,5444,807,12.9
21135,2020-05-01,4788,4118,670,14
21137,2020-05-01,9095,7987,1108,12.2
21139,2020-05-01,3565,3173,392,11
21141,2020-05-01,12664,11595,1069,8.4
21143,2020-05-01,3003,2802,201,6.7
21145,2020-05-01,28524,25420,3104,10.9
21147,2020-05-01,4847,4343,504,10.4
21149,2020-05-01,4086,3755,331,8.1
21151,2020-05-01,44955,40422,4533,10.1
21153,2020-05-01,3440,2755,685,19.9
21155,2020-05-01,10409,8796,1613,15.5
21157,2020-05-01,15154,13854,1300,8.6
21159,2020-05-01,2915,2508,407,14
21161,2020-05-01,7321,6380,941,12.9
21163,2020-05-01,12302,10827,1475,12
21165,2020-05-01,2317,2063,254,11
21167,2020-05-01,9789,8678,1111,11.3
21169,2020-05-01,4172,3642,530,12.7
21171,2020-05-01,4717,4403,314,6.7
21173,2020-05-01,12043,10568,1475,12.2
21175,2020-05-01,4637,4257,380,8.2
21177,2020-05-01,10723,9483,1240,11.6
21179,2020-05-01,23968,20948,3020,12.6
21181,2020-05-01,3440,3071,369,10.7
21183,2020-05-01,10175,9151,1024,10.1
21185,2020-05-01,31564,28761,2803,8.9
21187,2020-05-01,5226,4689,537,10.3
21189,2020-05-01,1147,1050,97,8.5
21191,2020-05-01,6731,6248,483,7.2
21193,2020-05-01,8133,7155,978,12
21195,2020-05-01,18872,16616,2256,12
21197,2020-05-01,4991,4478,513,10.3
21199,2020-05-01,27368,24229,3139,11.5
21201,2020-05-01,835,773,62,7.4
21203,2020-05-01,6481,5664,817,12.6
21205,2020-05-01,10510,9343,1167,11.1
21207,2020-05-01,6576,5693,883,13.4
21209,2020-05-01,29006,26046,2960,10.2
21211,2020-05-01,24713,22266,2447,9.9
21213,2020-05-01,9337,8204,1133,12.1
21215,2020-05-01,9977,8782,1195,12
21217,2020-05-01,12566,11153,1413,11.2
21219,2020-05-01,5552,5159,393,7.1
21221,2020-05-01,6381,5745,636,10
21223,2020-05-01,3894,3358,536,13.8
21225,2020-05-01,6207,5504,703,11.3
21227,2020-05-01,61212,53735,7477,12.2
21229,2020-05-01,6748,6019,729,10.8
21231,2020-05-01,7560,6925,635,8.4
21233,2020-05-01,5803,5243,560,9.7
21235,2020-05-01,13869,12330,1539,11.1
21237,2020-05-01,2060,1846,214,10.4
21239,2020-05-01,15161,14026,1135,7.5
22001,2020-05-01,22885,20259,2626,11.5
22003,2020-05-01,8796,7434,1362,15.5
22005,2020-05-01,61773,54419,7354,11.9
22007,2020-05-01,8836,7510,1326,15
22009,2020-05-01,14839,12836,2003,13.5
22011,2020-05-01,13919,12518,1401,10.1
22013,2020-05-01,5139,4568,571,11.1
22015,2020-05-01,55058,48879,6179,11.2
22017,2020-05-01,101918,86757,15161,14.9
22019,2020-05-01,101953,87446,14507,14.2
22021,2020-05-01,3522,3171,351,10
22023,2020-05-01,3556,3254,302,8.5
22025,2020-05-01,3222,2909,313,9.7
22027,2020-05-01,5288,4856,432,8.2
22029,2020-05-01,6793,6008,785,11.6
22031,2020-05-01,10109,9047,1062,10.5
22033,2020-05-01,224898,195539,29359,13.1
22035,2020-05-01,1728,1484,244,14.1
22037,2020-05-01,7532,6751,781,10.4
22039,2020-05-01,11233,9844,1389,12.4
22041,2020-05-01,6972,6187,785,11.3
22043,2020-05-01,7823,7069,754,9.6
22045,2020-05-01,27795,23837,3958,14.2
22047,2020-05-01,13752,11727,2025,14.7
22049,2020-05-01,6271,5761,510,8.1
22051,2020-05-01,206517,170974,35543,17.2
22053,2020-05-01,12706,11107,1599,12.6
22055,2020-05-01,111164,97484,13680,12.3
22057,2020-05-01,40157,35938,4219,10.5
22059,2020-05-01,6287,5844,443,7
22061,2020-05-01,19575,17612,1963,10
22063,2020-05-01,66290,58497,7793,11.8
22065,2020-05-01,3362,2931,431,12.8
22067,2020-05-01,9521,8210,1311,13.8
22069,2020-05-01,14910,13433,1477,9.9
22071,2020-05-01,179291,142111,37180,20.7
22073,2020-05-01,68939,60895,8044,11.7
22075,2020-05-01,9278,8051,1227,13.2
22077,2020-05-01,9461,8294,1167,12.3
22079,2020-05-01,53318,48048,5270,9.9
22081,2020-05-01,3480,3197,283,8.1
22083,2020-05-01,7721,6886,835,10.8
22085,2020-05-01,8455,7786,669,7.9
22087,2020-05-01,19265,15799,3466,18
22089,2020-05-01,23487,20078,3409,14.5
22091,2020-05-01,4324,3562,762,17.6
22093,2020-05-01,8541,7238,1303,15.3
22095,2020-05-01,19058,15470,3588,18.8
22097,2020-05-01,30987,26758,4229,13.6
22099,2020-05-01,21735,18900,2835,13
22101,2020-05-01,19240,16392,2848,14.8
22103,2020-05-01,110052,95558,14494,13.2
22105,2020-05-01,54341,45053,9288,17.1
22107,2020-05-01,1280,1139,141,11
22109,2020-05-01,45244,39547,5697,12.6
22111,2020-05-01,8727,7865,862,9.9
22113,2020-05-01,23139,20508,2631,11.4
22115,2020-05-01,14886,13241,1645,11.1
22117,2020-05-01,16100,13975,2125,13.2
22119,2020-05-01,13698,12066,1632,11.9
22121,2020-05-01,13101,11562,1539,11.7
22123,2020-05-01,3369,2926,443,13.1
22125,2020-05-01,5012,4579,433,8.6
22127,2020-05-01,4450,4041,409,9.2
23001,2020-05-01,53698,48693,5005,9.3
23003,2020-05-01,28828,26503,2325,8.1
23005,2020-05-01,156076,139839,16237,10.4
23007,2020-05-01,13712,12213,1499,10.9
23009,2020-05-01,27009,24556,2453,9.1
23011,2020-05-01,61126,56025,5101,8.3
23013,2020-05-01,19616,17884,1732,8.8
23015,2020-05-01,16347,14988,1359,8.3
23017,2020-05-01,25595,22781,2814,11
23019,2020-05-01,73265,66324,6941,9.5
23021,2020-05-01,6966,6406,560,8
23023,2020-05-01,19371,17772,1599,8.3
23025,2020-05-01,22091,19809,2282,10.3
23027,2020-05-01,19737,18225,1512,7.7
23029,2020-05-01,13131,12106,1025,7.8
23031,2020-05-01,105995,95924,10071,9.5
24001,2020-05-01,30323,26833,3490,11.5
24003,2020-05-01,301036,273512,27524,9.1
24005,2020-05-01,435066,391058,44008,10.1
24009,2020-05-01,47617,43949,3668,7.7
24011,2020-05-01,16942,15599,1343,7.9
24013,2020-05-01,91007,83626,7381,8.1
24015,2020-05-01,49177,45008,4169,8.5
24017,2020-05-01,84301,76232,8069,9.6
24019,2020-05-01,14764,13355,1409,9.5
24021,2020-05-01,130398,118426,11972,9.2
24023,2020-05-01,14909,13363,1546,10.4
24025,2020-05-01,134209,121935,12274,9.1
24027,2020-05-01,177323,163248,14075,7.9
24029,2020-05-01,9699,8877,822,8.5
24031,2020-05-01,542859,494050,48809,9
24033,2020-05-01,498709,444474,54235,10.9
24035,2020-05-01,26912,24519,2393,8.9
24037,2020-05-01,53988,50338,3650,6.8
24039,2020-05-01,8548,7652,896,10.5
24041,2020-05-01,17902,16327,1575,8.8
24043,2020-05-01,71005,63687,7318,10.3
24045,2020-05-01,47899,42366,5533,11.6
24047,2020-05-01,25182,20659,4523,18
24510,2020-05-01,276230,244541,31689,11.5
25001,2020-05-01,103782,83218,20564,19.8
25003,2020-05-01,59762,50301,9461,15.8
25005,2020-05-01,291760,234445,57315,19.6
25007,2020-05-01,9231,7716,1515,16.4
25009,2020-05-01,403302,329253,74049,18.4
25011,2020-05-01,37568,32532,5036,13.4
25013,2020-05-01,212128,173170,38958,18.4
25015,2020-05-01,79519,69379,10140,12.8
25017,2020-05-01,835505,722188,113317,13.6
25019,2020-05-01,7532,6216,1316,17.5
25021,2020-05-01,364729,305831,58898,16.1
25023,2020-05-01,269531,219608,49923,18.5
25025,2020-05-01,432245,356122,76123,17.6
25027,2020-05-01,418908,352737,66171,15.8
26001,2020-05-01,3871,3138,733,18.9
26003,2020-05-01,3063,2398,665,21.7
26005,2020-05-01,62252,51659,10593,17
26007,2020-05-01,13488,11388,2100,15.6
26009,2020-05-01,10060,7900,2160,21.5
26011,2020-05-01,6286,4838,1448,23
26013,2020-05-01,3242,2467,775,23.9
26015,2020-05-01,31591,26412,5179,16.4
26017,2020-05-01,50609,40517,10092,19.9
26019,2020-05-01,9280,7526,1754,18.9
26021,2020-05-01,75747,61720,14027,18.5
26023,2020-05-01,19834,16025,3809,19.2
26025,2020-05-01,64919,50419,14500,22.3
26027,2020-05-01,25330,21029,4301,17
26029,2020-05-01,13107,10085,3022,23.1
26031,2020-05-01,10654,7479,3175,29.8
26033,2020-05-01,16751,14018,2733,16.3
26035,2020-05-01,11734,8908,2826,24.1
26037,2020-05-01,40641,34246,6395,15.7
26039,2020-05-01,5552,4243,1309,23.6
26041,2020-05-01,17890,14843,3047,17
26043,2020-05-01,13440,11785,1655,12.3
26045,2020-05-01,57829,47165,10664,18.4
26047,2020-05-01,19339,15088,4251,22
26049,2020-05-01,193348,145605,47743,24.7
26051,2020-05-01,9624,7649,1975,20.5
26053,2020-05-01,6293,5428,865,13.7
26055,2020-05-01,52453,42836,9617,18.3
26057,2020-05-01,18546,15359,3187,17.2
26059,2020-05-01,20773,16051,4722,22.7
26061,2020-05-01,16468,14187,2281,13.9
26063,2020-05-01,16444,13432,3012,18.3
26065,2020-05-01,148528,124453,24075,16.2
26067,2020-05-01,29953,23792,6161,20.6
26069,2020-05-01,10616,8403,2213,20.8
26071,2020-05-01,5582,4845,737,13.2
26073,2020-05-01,36339,30018,6321,17.4
26075,2020-05-01,76762,61229,15533,20.2
26077,2020-05-01,133873,113541,20332,15.2
26079,2020-05-01,8597,6670,1927,22.4
26081,2020-05-01,362634,299853,62781,17.3
26083,2020-05-01,920,762,158,17.2
26085,2020-05-01,3863,3021,842,21.8
26087,2020-05-01,38615,28288,10327,26.7
26089,2020-05-01,10965,9090,1875,17.1
26091,2020-05-01,46918,36357,10561,22.5
26093,2020-05-01,90190,72379,17811,19.7
26095,2020-05-01,2460,2094,366,14.9
26097,2020-05-01,4638,3231,1407,30.3
26099,2020-05-01,415176,309371,105805,25.5
26101,2020-05-01,10333,7878,2455,23.8
26103,2020-05-01,33422,27457,5965,17.8
26105,2020-05-01,13677,11089,2588,18.9
26107,2020-05-01,19284,15680,3604,18.7
26109,2020-05-01,11134,9724,1410,12.7
26111,2020-05-01,40430,34023,6407,15.8
26113,2020-05-01,7351,5940,1411,19.2
26115,2020-05-01,77904,61231,16673,21.4
26117,2020-05-01,29333,23443,5890,20.1
26119,2020-05-01,3004,2246,758,25.2
26121,2020-05-01,83386,62745,20641,24.8
26123,2020-05-01,23803,19250,4553,19.1
26125,2020-05-01,584007,471034,112973,19.3
26127,2020-05-01,11920,9433,2487,20.9
26129,2020-05-01,8401,6653,1748,20.8
26131,2020-05-01,2065,1623,442,21.4
26133,2020-05-01,12016,9806,2210,18.4
26135,2020-05-01,3079,2308,771,25
26137,2020-05-01,12077,9329,2748,22.8
26139,2020-05-01,160845,134828,26017,16.2
26141,2020-05-01,4845,3779,1066,22
26143,2020-05-01,7825,5829,1996,25.5
26145,2020-05-01,89049,70517,18532,20.8
26147,2020-05-01,70070,52120,17950,25.6
26149,2020-05-01,30132,24260,5872,19.5
26151,2020-05-01,20391,15735,4656,22.8
26153,2020-05-01,3599,3040,559,15.5
26155,2020-05-01,33791,26381,7410,21.9
26157,2020-05-01,24204,18570,5634,23.3
26159,2020-05-01,35819,29821,5998,16.7
26161,2020-05-01,197655,170264,27391,13.9
26163,2020-05-01,737185,541570,195615,26.5
26165,2020-05-01,15993,12460,3533,22.1
27001,2020-05-01,7117,6338,779,10.9
27003,2020-05-01,195974,176786,19188,9.8
27005,2020-05-01,18575,16966,1609,8.7
27007,2020-05-01,24131,21954,2177,9
27009,2020-05-01,22201,20128,2073,9.3
27011,2020-05-01,2357,2236,121,5.1
27013,2020-05-01,40162,36710,3452,8.6
27015,2020-05-01,14155,13173,982,6.9
27017,2020-05-01,17543,15637,1906,10.9
27019,2020-05-01,57328,52683,4645,8.1
27021,2020-05-01,14218,12457,1761,12.4
27023,2020-05-01,6705,6264,441,6.6
27025,2020-05-01,29385,26663,2722,9.3
27027,2020-05-01,36158,34199,1959,5.4
27029,2020-05-01,4245,3780,465,11
27031,2020-05-01,3086,2664,422,13.7
27033,2020-05-01,5924,5601,323,5.5
27035,2020-05-01,32004,28654,3350,10.5
27037,2020-05-01,240727,216535,24192,10
27039,2020-05-01,11948,10967,981,8.2
27041,2020-05-01,20571,19151,1420,6.9
27043,2020-05-01,6870,6276,594,8.6
27045,2020-05-01,11579,10749,830,7.2
27047,2020-05-01,16131,14795,1336,8.3
27049,2020-05-01,27033,24411,2622,9.7
27051,2020-05-01,3236,3053,183,5.7
27053,2020-05-01,705938,633344,72594,10.3
27055,2020-05-01,9892,9313,579,5.9
27057,2020-05-01,9571,8712,859,9
27059,2020-05-01,20865,18896,1969,9.4
27061,2020-05-01,21206,18623,2583,12.2
27063,2020-05-01,5610,5292,318,5.7
27065,2020-05-01,8814,7987,827,9.4
27067,2020-05-01,23560,22125,1435,6.1
27069,2020-05-01,2336,2172,164,7
27071,2020-05-01,5637,5070,567,10.1
27073,2020-05-01,3470,3302,168,4.8
27075,2020-05-01,5423,4750,673,12.4
27077,2020-05-01,2339,2147,192,8.2
27079,2020-05-01,15703,14339,1364,8.7
27081,2020-05-01,3127,2997,130,4.2
27083,2020-05-01,14047,13290,757,5.4
27085,2020-05-01,18674,17282,1392,7.5
27087,2020-05-01,2528,2072,456,18
27089,2020-05-01,5225,4836,389,7.4
27091,2020-05-01,9794,9121,673,6.9
27093,2020-05-01,12898,12109,789,6.1
27095,2020-05-01,12709,11326,1383,10.9
27097,2020-05-01,17284,15867,1417,8.2
27099,2020-05-01,20351,18913,1438,7.1
27101,2020-05-01,4533,4301,232,5.1
27103,2020-05-01,20529,19025,1504,7.3
27105,2020-05-01,11146,10513,633,5.7
27107,2020-05-01,3251,2995,256,7.9
27109,2020-05-01,90720,81789,8931,9.8
27111,2020-05-01,30053,28085,1968,6.5
27113,2020-05-01,8466,7681,785,9.3
27115,2020-05-01,14954,13170,1784,11.9
27117,2020-05-01,4619,4404,215,4.7
27119,2020-05-01,16393,15152,1241,7.6
27121,2020-05-01,6327,5977,350,5.5
27123,2020-05-01,289863,259152,30711,10.6
27125,2020-05-01,2171,1980,191,8.8
27127,2020-05-01,7690,7020,670,8.7
27129,2020-05-01,8359,7751,608,7.3
27131,2020-05-01,36637,33900,2737,7.5
27133,2020-05-01,5564,5328,236,4.2
27135,2020-05-01,7772,7121,651,8.4
27137,2020-05-01,101091,89632,11459,11.3
27139,2020-05-01,83249,74973,8276,9.9
27141,2020-05-01,51386,46745,4641,9
27143,2020-05-01,8359,7785,574,6.9
27145,2020-05-01,91462,83578,7884,8.6
27147,2020-05-01,21056,19418,1638,7.8
27149,2020-05-01,5144,4970,174,3.4
27151,2020-05-01,4691,4425,266,5.7
27153,2020-05-01,13390,12497,893,6.7
27155,2020-05-01,1745,1667,78,4.5
27157,2020-05-01,12496,11430,1066,8.5
27159,2020-05-01,5928,5396,532,9
27161,2020-05-01,8907,8148,759,8.5
27163,2020-05-01,141320,128599,12721,9
27165,2020-05-01,6378,6001,377,5.9
27167,2020-05-01,3480,3302,178,5.1
27169,2020-05-01,28238,26163,2075,7.3
27171,2020-05-01,73697,67689,6008,8.2
27173,2020-05-01,5208,4904,304,5.8
28001,2020-05-01,10776,9480,1296,12
28003,2020-05-01,14887,13840,1047,7
28005,2020-05-01,4249,3900,349,8.2
28007,2020-05-01,6712,6092,620,9.2
28009,2020-05-01,2796,2535,261,9.3
28011,2020-05-01,11664,10763,901,7.7
28013,2020-05-01,5659,5182,477,8.4
28015,2020-05-01,3275,2998,277,8.5
28017,2020-05-01,6883,5948,935,13.6
28019,2020-05-01,3508,3284,224,6.4
28021,2020-05-01,2943,2445,498,16.9
28023,2020-05-01,5587,5037,550,9.8
28025,2020-05-01,7773,6653,1120,14.4
28027,2020-05-01,8515,7256,1259,14.8
28029,2020-05-01,10495,9554,941,9
28031,2020-05-01,7560,6983,577,7.6
28033,2020-05-01,83350,76910,6440,7.7
28035,2020-05-01,31633,28522,3111,9.8
28037,2020-05-01,2710,2472,238,8.8
28039,2020-05-01,8555,7623,932,10.9
28041,2020-05-01,4228,3792,436,10.3
28043,2020-05-01,8979,8253,726,8.1
28045,2020-05-01,17706,15560,2146,12.1
28047,2020-05-01,85107,71968,13139,15.4
28049,2020-05-01,103362,90717,12645,12.2
28051,2020-05-01,5886,4666,1220,20.7
28053,2020-05-01,2322,2010,312,13.4
28055,2020-05-01,358,334,24,6.7
28057,2020-05-01,9885,9039,846,8.6
28059,2020-05-01,56524,48288,8236,14.6
28061,2020-05-01,5820,5290,530,9.1
28063,2020-05-01,1965,1606,359,18.3
28065,2020-05-01,3912,3510,402,10.3
28067,2020-05-01,24340,22523,1817,7.5
28069,2020-05-01,3427,3056,371,10.8
28071,2020-05-01,25885,23899,1986,7.7
28073,2020-05-01,28712,26495,2217,7.7
28075,2020-05-01,28319,25831,2488,8.8
28077,2020-05-01,4426,3983,443,10
28079,2020-05-01,7959,7127,832,10.5
28081,2020-05-01,39540,34991,4549,11.5
28083,2020-05-01,9485,8454,1031,10.9
28085,2020-05-01,13898,12624,1274,9.2
28087,2020-05-01,24033,21536,2497,10.4
28089,2020-05-01,50623,45586,5037,10
28091,2020-05-01,9298,8549,749,8.1
28093,2020-05-01,13202,12098,1104,8.4
28095,2020-05-01,14803,13100,1703,11.5
28097,2020-05-01,3815,3466,349,9.1
28099,2020-05-01,10497,9056,1441,13.7
28101,2020-05-01,8389,7578,811,9.7
28103,2020-05-01,3839,3355,484,12.6
28105,2020-05-01,21254,19293,1961,9.2
28107,2020-05-01,12020,10626,1394,11.6
28109,2020-05-01,21674,19759,1915,8.8
28111,2020-05-01,4041,3657,384,9.5
28113,2020-05-01,13927,12531,1396,10
28115,2020-05-01,14056,12631,1425,10.1
28117,2020-05-01,10743,9846,897,8.3
28119,2020-05-01,2421,2138,283,11.7
28121,2020-05-01,70445,65463,4982,7.1
28123,2020-05-01,12182,11285,897,7.4
28125,2020-05-01,1573,1411,162,10.3
28127,2020-05-01,9993,9269,724,7.2
28129,2020-05-01,6405,6043,362,5.7
28131,2020-05-01,6526,5866,660,10.1
28133,2020-05-01,7570,6856,714,9.4
28135,2020-05-01,5133,4781,352,6.9
28137,2020-05-01,11508,10477,1031,9
28139,2020-05-01,8754,8041,713,8.1
28141,2020-05-01,8084,7466,618,7.6
28143,2020-05-01,4952,3831,1121,22.6
28145,2020-05-01,13500,12196,1304,9.7
28147,2020-05-01,4642,4217,425,9.2
28149,2020-05-01,19459,17094,2365,12.2
28151,2020-05-01,16334,14496,1838,11.3
28153,2020-05-01,7226,6577,649,9
28155,2020-05-01,3738,3439,299,8
28157,2020-05-01,2599,2274,325,12.5
28159,2020-05-01,7132,6364,768,10.8
28161,2020-05-01,4633,4145,488,10.5
28163,2020-05-01,9417,8183,1234,13.1
29001,2020-05-01,9887,9272,615,6.2
29003,2020-05-01,9333,8834,499,5.3
29005,2020-05-01,2757,2607,150,5.4
29007,2020-05-01,10764,9652,1112,10.3
29009,2020-05-01,15951,14354,1597,10
29011,2020-05-01,5176,4817,359,6.9
29013,2020-05-01,7490,6994,496,6.6
29015,2020-05-01,7184,6453,731,10.2
29017,2020-05-01,5151,4720,431,8.4
29019,2020-05-01,94580,88397,6183,6.5
29021,2020-05-01,42950,39977,2973,6.9
29023,2020-05-01,17896,16111,1785,10
29025,2020-05-01,4311,3919,392,9.1
29027,2020-05-01,20961,19687,1274,6.1
29029,2020-05-01,18242,16362,1880,10.3
29031,2020-05-01,38020,34666,3354,8.8
29033,2020-05-01,4637,4341,296,6.4
29035,2020-05-01,2507,2292,215,8.6
29037,2020-05-01,52094,47834,4260,8.2
29039,2020-05-01,5646,5356,290,5.1
29041,2020-05-01,3666,3503,163,4.4
29043,2020-05-01,43616,40176,3440,7.9
29045,2020-05-01,3272,2963,309,9.4
29047,2020-05-01,135686,118784,16902,12.5
29049,2020-05-01,10675,9474,1201,11.3
29051,2020-05-01,38257,35879,2378,6.2
29053,2020-05-01,7327,6678,649,8.9
29055,2020-05-01,10787,9782,1005,9.3
29057,2020-05-01,3549,3362,187,5.3
29059,2020-05-01,6876,6345,531,7.7
29061,2020-05-01,4190,3960,230,5.5
29063,2020-05-01,4709,4444,265,5.6
29065,2020-05-01,6117,5754,363,5.9
29067,2020-05-01,5265,4577,688,13.1
29069,2020-05-01,11531,10464,1067,9.3
29071,2020-05-01,52055,46374,5681,10.9
29073,2020-05-01,7758,7003,755,9.7
29075,2020-05-01,3459,3342,117,3.4
29077,2020-05-01,148121,135522,12599,8.5
29079,2020-05-01,4360,4099,261,6
29081,2020-05-01,3831,3633,198,5.2
29083,2020-05-01,9576,8752,824,8.6
29085,2020-05-01,3780,3557,223,5.9
29087,2020-05-01,2545,2454,91,3.6
29089,2020-05-01,4689,4411,278,5.9
29091,2020-05-01,16151,14743,1408,8.7
29093,2020-05-01,3502,3159,343,9.8
29095,2020-05-01,353789,312644,41145,11.6
29097,2020-05-01,56408,51365,5043,8.9
29099,2020-05-01,114130,102481,11649,10.2
29101,2020-05-01,23072,21196,1876,8.1
29103,2020-05-01,1742,1673,69,4
29105,2020-05-01,17239,15154,2085,12.1
29107,2020-05-01,16220,14902,1318,8.1
29109,2020-05-01,17923,16426,1497,8.4
29111,2020-05-01,5062,4680,382,7.5
29113,2020-05-01,28039,24847,3192,11.4
29115,2020-05-01,4959,4626,333,6.7
29117,2020-05-01,7228,6918,310,4.3
29119,2020-05-01,10489,9830,659,6.3
29121,2020-05-01,7283,6877,406,5.6
29123,2020-05-01,5523,5012,511,9.3
29125,2020-05-01,3821,3585,236,6.2
29127,2020-05-01,14082,13207,875,6.2
29129,2020-05-01,1971,1895,76,3.9
29131,2020-05-01,12270,11077,1193,9.7
29133,2020-05-01,5650,5323,327,5.8
29135,2020-05-01,7301,6882,419,5.7
29137,2020-05-01,3731,3446,285,7.6
29139,2020-05-01,5747,5297,450,7.8
29141,2020-05-01,8026,7309,717,8.9
29143,2020-05-01,8455,7790,665,7.9
29145,2020-05-01,27094,24671,2423,8.9
29147,2020-05-01,10989,10432,557,5.1
29149,2020-05-01,4010,3686,324,8.1
29151,2020-05-01,6968,6658,310,4.4
29153,2020-05-01,3500,3149,351,10
29155,2020-05-01,6471,5797,674,10.4
29157,2020-05-01,10272,8998,1274,12.4
29159,2020-05-01,21330,19034,2296,10.8
29161,2020-05-01,18922,17773,1149,6.1
29163,2020-05-01,7481,6797,684,9.1
29165,2020-05-01,57119,51288,5831,10.2
29167,2020-05-01,14005,13098,907,6.5
29169,2020-05-01,14241,13156,1085,7.6
29171,2020-05-01,2295,2156,139,6.1
29173,2020-05-01,5510,5181,329,6
29175,2020-05-01,10176,9283,893,8.8
29177,2020-05-01,11253,9583,1670,14.8
29179,2020-05-01,2938,2718,220,7.5
29181,2020-05-01,5092,4468,624,12.3
29183,2020-05-01,219539,198872,20667,9.4
29185,2020-05-01,3754,3444,310,8.3
29186,2020-05-01,9017,8296,721,8
29187,2020-05-01,26459,23630,2829,10.7
29189,2020-05-01,516372,463097,53275,10.3
29195,2020-05-01,10571,10070,501,4.7
29197,2020-05-01,1902,1804,98,5.2
29199,2020-05-01,2352,2272,80,3.4
29201,2020-05-01,19257,17853,1404,7.3
29203,2020-05-01,3286,2969,317,9.6
29205,2020-05-01,3072,2938,134,4.4
29207,2020-05-01,13116,12073,1043,8
29209,2020-05-01,14251,12040,2211,15.5
29211,2020-05-01,2656,2551,105,4
29213,2020-05-01,30156,23501,6655,22.1
29215,2020-05-01,8715,8127,588,6.7
29217,2020-05-01,9287,8811,476,5.1
29219,2020-05-01,17493,15749,1744,10
29221,2020-05-01,10136,9073,1063,10.5
29223,2020-05-01,4950,4510,440,8.9
29225,2020-05-01,16884,15567,1317,7.8
29227,2020-05-01,1190,1135,55,4.6
29229,2020-05-01,7531,6851,680,9
29510,2020-05-01,152443,131839,20604,13.5
30001,2020-05-01,4831,4581,250,5.2
30003,2020-05-01,4520,4099,421,9.3
30005,2020-05-01,2405,2290,115,4.8
30007,2020-05-01,2482,2293,189,7.6
30009,2020-05-01,5399,4925,474,8.8
30011,2020-05-01,603,586,17,2.8
30013,2020-05-01,37557,34510,3047,8.1
30015,2020-05-01,2362,2252,110,4.7
30017,2020-05-01,5854,5473,381,6.5
30019,2020-05-01,846,816,30,3.5
30021,2020-05-01,4437,4074,363,8.2
30023,2020-05-01,4848,4524,324,6.7
30025,2020-05-01,1617,1535,82,5.1
30027,2020-05-01,5635,5315,320,5.7
30029,2020-05-01,48287,42531,5756,11.9
30031,2020-05-01,68160,62076,6084,8.9
30033,2020-05-01,691,669,22,3.2
30035,2020-05-01,5381,4857,524,9.7
30037,2020-05-01,352,328,24,6.8
30039,2020-05-01,1625,1444,181,11.1
30041,2020-05-01,7177,6745,432,6
30043,2020-05-01,5482,5090,392,7.2
30045,2020-05-01,1007,952,55,5.5
30047,2020-05-01,13000,11950,1050,8.1
30049,2020-05-01,34501,32107,2394,6.9
30051,2020-05-01,908,886,22,2.4
30053,2020-05-01,7945,6938,1007,12.7
30055,2020-05-01,892,860,32,3.6
30057,2020-05-01,4345,4019,326,7.5
30059,2020-05-01,872,815,57,6.5
30061,2020-05-01,1789,1561,228,12.7
30063,2020-05-01,64615,58607,6008,9.3
30065,2020-05-01,2162,1996,166,7.7
30067,2020-05-01,9291,8106,1185,12.8
30069,2020-05-01,258,248,10,3.9
30071,2020-05-01,1797,1690,107,6
30073,2020-05-01,2554,2390,164,6.4
30075,2020-05-01,914,879,35,3.8
30077,2020-05-01,2775,2591,184,6.6
30079,2020-05-01,458,424,34,7.4
30081,2020-05-01,19680,18225,1455,7.4
30083,2020-05-01,5601,5070,531,9.5
30085,2020-05-01,4260,3929,331,7.8
30087,2020-05-01,3779,3481,298,7.9
30089,2020-05-01,4791,4309,482,10.1
30091,2020-05-01,1687,1581,106,6.3
30093,2020-05-01,16549,15050,1499,9.1
30095,2020-05-01,5247,4893,354,6.7
30097,2020-05-01,1721,1640,81,4.7
30099,2020-05-01,2630,2495,135,5.1
30101,2020-05-01,2035,1889,146,7.2
30103,2020-05-01,325,310,15,4.6
30105,2020-05-01,3920,3714,206,5.3
30107,2020-05-01,789,711,78,9.9
30109,2020-05-01,436,409,27,6.2
30111,2020-05-01,79830,73587,6243,7.8
31001,2020-05-01,17210,16315,895,5.2
31003,2020-05-01,3618,3545,73,2
31005,2020-05-01,222,214,8,3.6
31007,2020-05-01,377,367,10,2.7
31009,2020-05-01,250,246,4,1.6
31011,2020-05-01,2961,2891,70,2.4
31013,2020-05-01,5521,5229,292,5.3
31015,2020-05-01,1083,1053,30,2.8
31017,2020-05-01,1406,1372,34,2.4
31019,2020-05-01,28731,26996,1735,6
31021,2020-05-01,3511,3378,133,3.8
31023,2020-05-01,4663,4464,199,4.3
31025,2020-05-01,13242,12574,668,5
31027,2020-05-01,4529,4406,123,2.7
31029,2020-05-01,2283,2246,37,1.6
31031,2020-05-01,3356,3275,81,2.4
31033,2020-05-01,4338,4133,205,4.7
31035,2020-05-01,3321,3203,118,3.6
31037,2020-05-01,5667,5458,209,3.7
31039,2020-05-01,4837,4707,130,2.7
31041,2020-05-01,6435,6271,164,2.5
31043,2020-05-01,10560,9963,597,5.7
31045,2020-05-01,4947,4805,142,2.9
31047,2020-05-01,13290,12751,539,4.1
31049,2020-05-01,965,937,28,2.9
31051,2020-05-01,2940,2830,110,3.7
31053,2020-05-01,20111,19347,764,3.8
31055,2020-05-01,296674,277765,18909,6.4
31057,2020-05-01,1158,1137,21,1.8
31059,2020-05-01,3191,3084,107,3.4
31061,2020-05-01,1491,1439,52,3.5
31063,2020-05-01,1541,1500,41,2.7
31065,2020-05-01,2574,2501,73,2.8
31067,2020-05-01,11038,10570,468,4.2
31069,2020-05-01,1067,1028,39,3.7
31071,2020-05-01,1121,1099,22,2
31073,2020-05-01,1113,1076,37,3.3
31075,2020-05-01,408,402,6,1.5
31077,2020-05-01,1238,1201,37,3
31079,2020-05-01,32166,29490,2676,8.3
31081,2020-05-01,4644,4433,211,4.5
31083,2020-05-01,1844,1779,65,3.5
31085,2020-05-01,619,609,10,1.6
31087,2020-05-01,1265,1224,41,3.2
31089,2020-05-01,5771,5629,142,2.5
31091,2020-05-01,450,439,11,2.4
31093,2020-05-01,3306,3113,193,5.8
31095,2020-05-01,4216,4085,131,3.1
31097,2020-05-01,2068,1986,82,4
31099,2020-05-01,3893,3736,157,4
31101,2020-05-01,4611,4451,160,3.5
31103,2020-05-01,586,578,8,1.4
31105,2020-05-01,2008,1936,72,3.6
31107,2020-05-01,4661,4531,130,2.8
31109,2020-05-01,177742,168557,9185,5.2
31111,2020-05-01,18818,17900,918,4.9
31113,2020-05-01,467,453,14,3
31115,2020-05-01,398,391,7,1.8
31117,2020-05-01,446,436,10,2.2
31119,2020-05-01,20107,19357,750,3.7
31121,2020-05-01,3934,3726,208,5.3
31123,2020-05-01,2658,2555,103,3.9
31125,2020-05-01,2018,1943,75,3.7
31127,2020-05-01,3599,3455,144,4
31129,2020-05-01,2368,2315,53,2.2
31131,2020-05-01,8418,8086,332,3.9
31133,2020-05-01,1480,1440,40,2.7
31135,2020-05-01,1814,1784,30,1.7
31137,2020-05-01,5025,4844,181,3.6
31139,2020-05-01,4130,4018,112,2.7
31141,2020-05-01,18061,17099,962,5.3
31143,2020-05-01,2973,2861,112,3.8
31145,2020-05-01,5911,5702,209,3.5
31147,2020-05-01,4262,4140,122,2.9
31149,2020-05-01,875,856,19,2.2
31151,2020-05-01,7462,7161,301,4
31153,2020-05-01,94874,89910,4964,5.2
31155,2020-05-01,10843,10405,438,4
31157,2020-05-01,18263,17447,816,4.5
31159,2020-05-01,8940,8469,471,5.3
31161,2020-05-01,2612,2556,56,2.1
31163,2020-05-01,1650,1594,56,3.4
31165,2020-05-01,726,714,12,1.7
31167,2020-05-01,3539,3425,114,3.2
31169,2020-05-01,2754,2684,70,2.5
31171,2020-05-01,421,408,13,3.1
31173,2020-05-01,3184,2970,214,6.7
31175,2020-05-01,2173,2110,63,2.9
31177,2020-05-01,10958,10502,456,4.2
31179,2020-05-01,5674,5507,167,2.9
31181,2020-05-01,1687,1617,70,4.1
31183,2020-05-01,553,542,11,2
31185,2020-05-01,7436,7109,327,4.4
32001,2020-05-01,10232,9357,875,8.6
32003,2020-05-01,NA,725343,293895,28.8
32005,2020-05-01,22116,18827,3289,14.9
32007,2020-05-01,26581,23436,3145,11.8
32009,2020-05-01,371,351,20,5.4
32011,2020-05-01,910,873,37,4.1
32013,2020-05-01,7560,6974,586,7.8
32015,2020-05-01,2890,2713,177,6.1
32017,2020-05-01,1821,1706,115,6.3
32019,2020-05-01,21213,18281,2932,13.8
32021,2020-05-01,1950,1788,162,8.3
32023,2020-05-01,16666,14112,2554,15.3
32027,2020-05-01,2260,2118,142,6.3
32029,2020-05-01,1733,1458,275,15.9
32031,2020-05-01,219674,184468,35206,16
32033,2020-05-01,4299,4066,233,5.4
32510,2020-05-01,22729,19267,3462,15.2
33001,2020-05-01,29700,24444,5256,17.7
33003,2020-05-01,22365,17739,4626,20.7
33005,2020-05-01,38033,33117,4916,12.9
33007,2020-05-01,14071,11437,2634,18.7
33009,2020-05-01,47078,40497,6581,14
33011,2020-05-01,233163,196518,36645,15.7
33013,2020-05-01,79142,68146,10996,13.9
33015,2020-05-01,175860,148429,27431,15.6
33017,2020-05-01,70095,59609,10486,15
33019,2020-05-01,21025,18647,2378,11.3
34001,2020-05-01,123110,83049,40061,32.5
34003,2020-05-01,485218,412954,72264,14.9
34005,2020-05-01,233012,203531,29481,12.7
34007,2020-05-01,260938,221249,39689,15.2
34009,2020-05-01,43185,33438,9747,22.6
34011,2020-05-01,67865,57612,10253,15.1
34013,2020-05-01,373779,311862,61917,16.6
34015,2020-05-01,153752,131509,22243,14.5
34017,2020-05-01,366145,308162,57983,15.8
34019,2020-05-01,62914,55820,7094,11.3
34021,2020-05-01,203684,182163,21521,10.6
34023,2020-05-01,431564,373444,58120,13.5
34025,2020-05-01,326077,279749,46328,14.2
34027,2020-05-01,251580,220910,30670,12.2
34029,2020-05-01,275790,232692,43098,15.6
34031,2020-05-01,251967,204562,47405,18.8
34033,2020-05-01,29772,25811,3961,13.3
34035,2020-05-01,166895,147232,19663,11.8
34037,2020-05-01,74645,63421,11224,15
34039,2020-05-01,276606,235570,41036,14.8
34041,2020-05-01,57348,50091,7257,12.7
35001,2020-05-01,312487,284028,28459,9.1
35003,2020-05-01,1029,968,61,5.9
35005,2020-05-01,26370,24289,2081,7.9
35006,2020-05-01,8540,7820,720,8.4
35007,2020-05-01,5049,4703,346,6.9
35009,2020-05-01,20492,19450,1042,5.1
35011,2020-05-01,658,634,24,3.6
35013,2020-05-01,90239,82555,7684,8.5
35015,2020-05-01,34845,32885,1960,5.6
35017,2020-05-01,11821,10795,1026,8.7
35019,2020-05-01,1413,1335,78,5.5
35021,2020-05-01,266,258,8,3
35023,2020-05-01,2010,1923,87,4.3
35025,2020-05-01,31830,29070,2760,8.7
35027,2020-05-01,8570,7736,834,9.7
35028,2020-05-01,8876,8560,316,3.6
35029,2020-05-01,10189,8819,1370,13.4
35031,2020-05-01,23123,21151,1972,8.5
35033,2020-05-01,1997,1853,144,7.2
35035,2020-05-01,24227,22070,2157,8.9
35037,2020-05-01,2950,2780,170,5.8
35039,2020-05-01,15626,14384,1242,7.9
35041,2020-05-01,7640,7243,397,5.2
35043,2020-05-01,62108,56103,6005,9.7
35045,2020-05-01,47206,42348,4858,10.3
35047,2020-05-01,10302,9514,788,7.6
35049,2020-05-01,68971,62501,6470,9.4
35051,2020-05-01,3584,3250,334,9.3
35053,2020-05-01,5927,5551,376,6.3
35055,2020-05-01,15610,13734,1876,12
35057,2020-05-01,4991,4556,435,8.7
35059,2020-05-01,1610,1538,72,4.5
35061,2020-05-01,28141,25856,2285,8.1
36001,2020-05-01,158449,143680,14769,9.3
36003,2020-05-01,19223,17299,1924,10
36005,2020-05-01,551649,432595,119054,21.6
36007,2020-05-01,86585,77356,9229,10.7
36009,2020-05-01,34895,30333,4562,13.1
36011,2020-05-01,35694,31919,3775,10.6
36013,2020-05-01,55294,49260,6034,10.9
36015,2020-05-01,37574,33039,4535,12.1
36017,2020-05-01,21906,20118,1788,8.2
36019,2020-05-01,37925,33789,4136,10.9
36021,2020-05-01,30777,28304,2473,8
36023,2020-05-01,22515,20192,2323,10.3
36025,2020-05-01,18866,17171,1695,9
36027,2020-05-01,142374,127330,15044,10.6
36029,2020-05-01,443627,382581,61046,13.8
36031,2020-05-01,16534,14608,1926,11.6
36033,2020-05-01,20047,17829,2218,11.1
36035,2020-05-01,22715,20183,2532,11.1
36037,2020-05-01,29498,26528,2970,10.1
36039,2020-05-01,20772,18504,2268,10.9
36041,2020-05-01,2332,2120,212,9.1
36043,2020-05-01,27523,24707,2816,10.2
36045,2020-05-01,42520,37493,5027,11.8
36047,2020-05-01,NA,881135,195687,18.2
36049,2020-05-01,11013,9967,1046,9.5
36051,2020-05-01,29465,26653,2812,9.5
36053,2020-05-01,32010,28432,3578,11.2
36055,2020-05-01,358146,317324,40822,11.4
36057,2020-05-01,21891,19468,2423,11.1
36059,2020-05-01,696392,612377,84015,12.1
36061,2020-05-01,781659,674688,106971,13.7
36063,2020-05-01,100755,84829,15926,15.8
36065,2020-05-01,101964,90421,11543,11.3
36067,2020-05-01,220407,194340,26067,11.8
36069,2020-05-01,53975,48549,5426,10.1
36071,2020-05-01,180632,159225,21407,11.9
36073,2020-05-01,16977,15031,1946,11.5
36075,2020-05-01,52206,45845,6361,12.2
36077,2020-05-01,26939,24650,2289,8.5
36079,2020-05-01,50699,45368,5331,10.5
36081,2020-05-01,NA,842550,208050,19.8
36083,2020-05-01,81367,73877,7490,9.2
36085,2020-05-01,195494,163226,32268,16.5
36087,2020-05-01,151758,134906,16852,11.1
36089,2020-05-01,44697,40110,4587,10.3
36091,2020-05-01,120423,108782,11641,9.7
36093,2020-05-01,77528,69250,8278,10.7
36095,2020-05-01,14279,13052,1227,8.6
36097,2020-05-01,8375,7378,997,11.9
36099,2020-05-01,16072,14285,1787,11.1
36101,2020-05-01,42877,38052,4825,11.3
36103,2020-05-01,764755,669738,95017,12.4
36105,2020-05-01,38275,34140,4135,10.8
36107,2020-05-01,23467,21070,2397,10.2
36109,2020-05-01,49538,45655,3883,7.8
36111,2020-05-01,90153,80408,9745,10.8
36113,2020-05-01,31529,27701,3828,12.1
36115,2020-05-01,27100,24438,2662,9.8
36117,2020-05-01,42257,38029,4228,10
36119,2020-05-01,473594,420879,52715,11.1
36121,2020-05-01,17697,15920,1777,10
36123,2020-05-01,11149,10170,979,8.8
37001,2020-05-01,77929,68065,9864,12.7
37003,2020-05-01,16825,14504,2321,13.8
37005,2020-05-01,4498,4007,491,10.9
37007,2020-05-01,10382,9312,1070,10.3
37009,2020-05-01,13082,11749,1333,10.2
37011,2020-05-01,7818,7079,739,9.5
37013,2020-05-01,18825,17112,1713,9.1
37015,2020-05-01,7694,7073,621,8.1
37017,2020-05-01,15384,13872,1512,9.8
37019,2020-05-01,50494,42855,7639,15.1
37021,2020-05-01,137387,114089,23298,17
37023,2020-05-01,37990,32831,5159,13.6
37025,2020-05-01,104652,91663,12989,12.4
37027,2020-05-01,34077,29183,4894,14.4
37029,2020-05-01,4532,4158,374,8.3
37031,2020-05-01,31743,28521,3222,10.2
37033,2020-05-01,9645,8384,1261,13.1
37035,2020-05-01,75114,63285,11829,15.7
37037,2020-05-01,32630,29645,2985,9.1
37039,2020-05-01,11929,10249,1680,14.1
37041,2020-05-01,5530,5080,450,8.1
37043,2020-05-01,4298,3808,490,11.4
37045,2020-05-01,49749,43521,6228,12.5
37047,2020-05-01,23159,20524,2635,11.4
37049,2020-05-01,39254,34974,4280,10.9
37051,2020-05-01,123431,104103,19328,15.7
37053,2020-05-01,13650,12042,1608,11.8
37055,2020-05-01,20563,16597,3966,19.3
37057,2020-05-01,75827,66690,9137,12
37059,2020-05-01,19652,17084,2568,13.1
37061,2020-05-01,25021,22993,2028,8.1
37063,2020-05-01,160745,142700,18045,11.2
37065,2020-05-01,20772,17565,3207,15.4
37067,2020-05-01,178031,154786,23245,13.1
37069,2020-05-01,28988,25667,3321,11.5
37071,2020-05-01,108354,93067,15287,14.1
37073,2020-05-01,4971,4557,414,8.3
37075,2020-05-01,3566,2998,568,15.9
37077,2020-05-01,29302,26483,2819,9.6
37079,2020-05-01,9366,8572,794,8.5
37081,2020-05-01,249235,212135,37100,14.9
37083,2020-05-01,20463,17874,2589,12.7
37085,2020-05-01,51851,45515,6336,12.2
37087,2020-05-01,28457,24245,4212,14.8
37089,2020-05-01,51294,44648,6646,13
37091,2020-05-01,9285,8459,826,8.9
37093,2020-05-01,19117,16424,2693,14.1
37095,2020-05-01,1858,1595,263,14.2
37097,2020-05-01,86948,75171,11777,13.5
37099,2020-05-01,22341,19069,3272,14.6
37101,2020-05-01,91708,81596,10112,11
37103,2020-05-01,4046,3688,358,8.8
37105,2020-05-01,26276,22866,3410,13
37107,2020-05-01,28086,25636,2450,8.7
37109,2020-05-01,41663,36507,5156,12.4
37111,2020-05-01,21559,19002,2557,11.9
37113,2020-05-01,15734,14021,1713,10.9
37115,2020-05-01,9417,8214,1203,12.8
37117,2020-05-01,8802,7942,860,9.8
37119,2020-05-01,604065,522012,82053,13.6
37121,2020-05-01,6109,5368,741,12.1
37123,2020-05-01,11105,9982,1123,10.1
37125,2020-05-01,41685,36477,5208,12.5
37127,2020-05-01,41600,36111,5489,13.2
37129,2020-05-01,116465,100433,16032,13.8
37131,2020-05-01,7500,6813,687,9.2
37133,2020-05-01,63114,55734,7380,11.7
37135,2020-05-01,72236,65720,6516,9
37137,2020-05-01,4926,4489,437,8.9
37139,2020-05-01,16788,14894,1894,11.3
37141,2020-05-01,26363,23330,3033,11.5
37143,2020-05-01,4837,4367,470,9.7
37145,2020-05-01,17604,15255,2349,13.3
37147,2020-05-01,84899,76050,8849,10.4
37149,2020-05-01,8810,7886,924,10.5
37151,2020-05-01,61827,53747,8080,13.1
37153,2020-05-01,17188,14953,2235,13
37155,2020-05-01,49972,44070,5902,11.8
37157,2020-05-01,37763,32337,5426,14.4
37159,2020-05-01,64863,55352,9511,14.7
37161,2020-05-01,26043,22200,3843,14.8
37163,2020-05-01,28953,26579,2374,8.2
37165,2020-05-01,12235,10245,1990,16.3
37167,2020-05-01,30202,27111,3091,10.2
37169,2020-05-01,20171,17899,2272,11.3
37171,2020-05-01,33623,29861,3762,11.2
37173,2020-05-01,7507,6057,1450,19.3
37175,2020-05-01,14531,13066,1465,10.1
37177,2020-05-01,1414,1216,198,14
37179,2020-05-01,115948,104096,11852,10.2
37181,2020-05-01,18410,15761,2649,14.4
37183,2020-05-01,555808,491713,64095,11.5
37185,2020-05-01,6880,5915,965,14
37187,2020-05-01,4266,3809,457,10.7
37189,2020-05-01,30180,26830,3350,11.1
37191,2020-05-01,46871,42100,4771,10.2
37193,2020-05-01,29786,26497,3289,11
37195,2020-05-01,35388,30826,4562,12.9
37197,2020-05-01,17036,14671,2365,13.9
37199,2020-05-01,8220,7291,929,11.3
38001,2020-05-01,1008,960,48,4.8
38003,2020-05-01,4980,4668,312,6.3
38005,2020-05-01,2377,2093,284,11.9
38007,2020-05-01,357,334,23,6.4
38009,2020-05-01,2816,2590,226,8
38011,2020-05-01,1578,1488,90,5.7
38013,2020-05-01,1040,950,90,8.7
38015,2020-05-01,48852,45100,3752,7.7
38017,2020-05-01,103845,95695,8150,7.8
38019,2020-05-01,1827,1723,104,5.7
38021,2020-05-01,2221,2106,115,5.2
38023,2020-05-01,1340,1277,63,4.7
38025,2020-05-01,3313,3095,218,6.6
38027,2020-05-01,1178,1097,81,6.9
38029,2020-05-01,1376,1279,97,7
38031,2020-05-01,1431,1353,78,5.5
38033,2020-05-01,805,767,38,4.7
38035,2020-05-01,36635,33457,3178,8.7
38037,2020-05-01,1159,1113,46,4
38039,2020-05-01,985,944,41,4.2
38041,2020-05-01,1342,1268,74,5.5
38043,2020-05-01,1217,1135,82,6.7
38045,2020-05-01,1952,1881,71,3.6
38047,2020-05-01,848,809,39,4.6
38049,2020-05-01,3012,2779,233,7.7
38051,2020-05-01,1047,1007,40,3.8
38053,2020-05-01,10171,9011,1160,11.4
38055,2020-05-01,4532,4220,312,6.9
38057,2020-05-01,3416,3131,285,8.3
38059,2020-05-01,16065,14750,1315,8.2
38061,2020-05-01,7362,6785,577,7.8
38063,2020-05-01,1334,1230,104,7.8
38065,2020-05-01,836,781,55,6.6
38067,2020-05-01,3434,2964,470,13.7
38069,2020-05-01,1620,1507,113,7
38071,2020-05-01,5473,5011,462,8.4
38073,2020-05-01,2751,2587,164,6
38075,2020-05-01,1199,1102,97,8.1
38077,2020-05-01,8399,7852,547,6.5
38079,2020-05-01,4732,3926,806,17
38081,2020-05-01,2673,2505,168,6.3
38083,2020-05-01,643,596,47,7.3
38085,2020-05-01,1183,1116,67,5.7
38087,2020-05-01,376,360,16,4.3
38089,2020-05-01,19014,16858,2156,11.3
38091,2020-05-01,958,909,49,5.1
38093,2020-05-01,10046,9466,580,5.8
38095,2020-05-01,1046,1004,42,4
38097,2020-05-01,4258,3988,270,6.3
38099,2020-05-01,4955,4602,353,7.1
38101,2020-05-01,31868,28586,3282,10.3
38103,2020-05-01,1833,1725,108,5.9
38105,2020-05-01,25141,21323,3818,15.2
39001,2020-05-01,10602,9266,1336,12.6
39003,2020-05-01,48695,41284,7411,15.2
39005,2020-05-01,26253,23714,2539,9.7
39007,2020-05-01,43207,37849,5358,12.4
39009,2020-05-01,26868,24410,2458,9.1
39011,2020-05-01,25176,22204,2972,11.8
39013,2020-05-01,29356,24855,4501,15.3
39015,2020-05-01,19224,16868,2356,12.3
39017,2020-05-01,192485,169562,22923,11.9
39019,2020-05-01,12824,11126,1698,13.2
39021,2020-05-01,19579,17408,2171,11.1
39023,2020-05-01,63862,55877,7985,12.5
39025,2020-05-01,104641,92906,11735,11.2
39027,2020-05-01,17851,15528,2323,13
39029,2020-05-01,47272,39884,7388,15.6
39031,2020-05-01,13962,12140,1822,13
39033,2020-05-01,18321,14915,3406,18.6
39035,2020-05-01,620495,508052,112443,18.1
39037,2020-05-01,25594,22564,3030,11.8
39039,2020-05-01,18262,15325,2937,16.1
39041,2020-05-01,105986,97058,8928,8.4
39043,2020-05-01,37622,30024,7598,20.2
39045,2020-05-01,76181,68331,7850,10.3
39047,2020-05-01,13904,12242,1662,12
39049,2020-05-01,691127,610795,80332,11.6
39051,2020-05-01,22326,19141,3185,14.3
39053,2020-05-01,12515,11218,1297,10.4
39055,2020-05-01,46708,41265,5443,11.7
39057,2020-05-01,81483,73437,8046,9.9
39059,2020-05-01,18491,16211,2280,12.3
39061,2020-05-01,411563,361396,50167,12.2
39063,2020-05-01,42657,37088,5569,13.1
39065,2020-05-01,13849,11829,2020,14.6
39067,2020-05-01,6639,5749,890,13.4
39069,2020-05-01,12855,10991,1864,14.5
39071,2020-05-01,16786,14409,2377,14.2
39073,2020-05-01,12737,11331,1406,11
39075,2020-05-01,20788,19709,1079,5.2
39077,2020-05-01,27776,23551,4225,15.2
39079,2020-05-01,12816,11234,1582,12.3
39081,2020-05-01,27563,23414,4149,15.1
39083,2020-05-01,30881,27971,2910,9.4
39085,2020-05-01,124296,105399,18897,15.2
39087,2020-05-01,24277,21077,3200,13.2
39089,2020-05-01,88417,79268,9149,10.3
39091,2020-05-01,22723,19622,3101,13.6
39093,2020-05-01,157258,127566,29692,18.9
39095,2020-05-01,218751,176811,41940,19.2
39097,2020-05-01,20308,18371,1937,9.5
39099,2020-05-01,99977,84444,15533,15.5
39101,2020-05-01,28242,24642,3600,12.7
39103,2020-05-01,95781,81738,14043,14.7
39105,2020-05-01,8789,7716,1073,12.2
39107,2020-05-01,23478,21326,2152,9.2
39109,2020-05-01,53991,47796,6195,11.5
39111,2020-05-01,5277,4487,790,15
39113,2020-05-01,257031,221384,35647,13.9
39115,2020-05-01,6469,5663,806,12.5
39117,2020-05-01,16606,14673,1933,11.6
39119,2020-05-01,39597,35148,4449,11.2
39121,2020-05-01,4625,4065,560,12.1
39123,2020-05-01,20156,17308,2848,14.1
39125,2020-05-01,8642,7370,1272,14.7
39127,2020-05-01,15589,13737,1852,11.9
39129,2020-05-01,25917,23150,2767,10.7
39131,2020-05-01,10821,9313,1508,13.9
39133,2020-05-01,82851,73646,9205,11.1
39135,2020-05-01,20532,18144,2388,11.6
39137,2020-05-01,18572,16587,1985,10.7
39139,2020-05-01,53459,45054,8405,15.7
39141,2020-05-01,35520,30753,4767,13.4
39143,2020-05-01,30387,25678,4709,15.5
39145,2020-05-01,28953,25527,3426,11.8
39147,2020-05-01,27361,23235,4126,15.1
39149,2020-05-01,24520,21287,3233,13.2
39151,2020-05-01,182776,159548,23228,12.7
39153,2020-05-01,263353,229369,33984,12.9
39155,2020-05-01,84698,70762,13936,16.5
39157,2020-05-01,44894,39650,5244,11.7
39159,2020-05-01,28081,25604,2477,8.8
39161,2020-05-01,15136,13427,1709,11.3
39163,2020-05-01,5489,4789,700,12.8
39165,2020-05-01,116183,103883,12300,10.6
39167,2020-05-01,28070,24668,3402,12.1
39169,2020-05-01,61685,55921,5764,9.3
39171,2020-05-01,19269,16344,2925,15.2
39173,2020-05-01,69570,60566,9004,12.9
39175,2020-05-01,13153,11144,2009,15.3
40001,2020-05-01,8411,7028,1383,16.4
40003,2020-05-01,2639,2442,197,7.5
40005,2020-05-01,4904,4277,627,12.8
40007,2020-05-01,2648,2496,152,5.7
40009,2020-05-01,9627,8266,1361,14.1
40011,2020-05-01,4564,4041,523,11.5
40013,2020-05-01,21252,18910,2342,11
40015,2020-05-01,11617,10271,1346,11.6
40017,2020-05-01,73971,64186,9785,13.2
40019,2020-05-01,21751,18309,3442,15.8
40021,2020-05-01,18588,16452,2136,11.5
40023,2020-05-01,5389,4653,736,13.7
40025,2020-05-01,1260,1222,38,3
40027,2020-05-01,140821,123298,17523,12.4
40029,2020-05-01,2336,2092,244,10.4
40031,2020-05-01,48250,40711,7539,15.6
40033,2020-05-01,2843,2349,494,17.4
40035,2020-05-01,5654,5075,579,10.2
40037,2020-05-01,30930,27154,3776,12.2
40039,2020-05-01,15335,13726,1609,10.5
40041,2020-05-01,18140,16016,2124,11.7
40043,2020-05-01,2809,2596,213,7.6
40045,2020-05-01,2000,1836,164,8.2
40047,2020-05-01,26089,23326,2763,10.6
40049,2020-05-01,12268,10782,1486,12.1
40051,2020-05-01,26042,22950,3092,11.9
40053,2020-05-01,2491,2339,152,6.1
40055,2020-05-01,1857,1610,247,13.3
40057,2020-05-01,1134,1073,61,5.4
40059,2020-05-01,1662,1566,96,5.8
40061,2020-05-01,4184,3624,560,13.4
40063,2020-05-01,5281,4626,655,12.4
40065,2020-05-01,10292,9491,801,7.8
40067,2020-05-01,2550,2184,366,14.4
40069,2020-05-01,3382,2795,587,17.4
40071,2020-05-01,17865,15525,2340,13.1
40073,2020-05-01,8622,7841,781,9.1
40075,2020-05-01,3329,2982,347,10.4
40077,2020-05-01,3119,2609,510,16.4
40079,2020-05-01,19003,16389,2614,13.8
40081,2020-05-01,15290,13632,1658,10.8
40083,2020-05-01,21345,19139,2206,10.3
40085,2020-05-01,6034,5386,648,10.7
40087,2020-05-01,19360,17121,2239,11.6
40089,2020-05-01,14403,12887,1516,10.5
40091,2020-05-01,7132,6197,935,13.1
40093,2020-05-01,3703,3364,339,9.2
40095,2020-05-01,7031,6045,986,14
40097,2020-05-01,18837,16996,1841,9.8
40099,2020-05-01,6293,5544,749,11.9
40101,2020-05-01,29044,25876,3168,10.9
40103,2020-05-01,5348,4903,445,8.3
40105,2020-05-01,4492,4021,471,10.5
40107,2020-05-01,4359,3894,465,10.7
40109,2020-05-01,382809,331380,51429,13.4
40111,2020-05-01,15238,13341,1897,12.4
40113,2020-05-01,20323,17761,2562,12.6
40115,2020-05-01,14433,12596,1837,12.7
40117,2020-05-01,7214,6338,876,12.1
40119,2020-05-01,37699,33409,4290,11.4
40121,2020-05-01,16919,14596,2323,13.7
40123,2020-05-01,18725,16791,1934,10.3
40125,2020-05-01,31874,28089,3785,11.9
40127,2020-05-01,4208,3714,494,11.7
40129,2020-05-01,1760,1607,153,8.7
40131,2020-05-01,44104,38873,5231,11.9
40133,2020-05-01,9311,8159,1152,12.4
40135,2020-05-01,16717,14021,2696,16.1
40137,2020-05-01,18803,16032,2771,14.7
40139,2020-05-01,10994,10598,396,3.6
40141,2020-05-01,3234,2636,598,18.5
40143,2020-05-01,321896,278902,42994,13.4
40145,2020-05-01,37079,32755,4324,11.7
40147,2020-05-01,21689,19145,2544,11.7
40149,2020-05-01,5007,4404,603,12
40151,2020-05-01,4432,4125,307,6.9
40153,2020-05-01,8703,7621,1082,12.4
41001,2020-05-01,6970,6103,867,12.4
41003,2020-05-01,47269,42668,4601,9.7
41005,2020-05-01,219248,190353,28895,13.2
41007,2020-05-01,18829,14529,4300,22.8
41009,2020-05-01,24234,20930,3304,13.6
41011,2020-05-01,26763,22190,4573,17.1
41013,2020-05-01,9775,8144,1631,16.7
41015,2020-05-01,8773,7299,1474,16.8
41017,2020-05-01,97322,81882,15440,15.9
41019,2020-05-01,47231,40331,6900,14.6
41021,2020-05-01,892,796,96,10.8
41023,2020-05-01,3158,2748,410,13
41025,2020-05-01,3475,3161,314,9
41027,2020-05-01,13303,11556,1747,13.1
41029,2020-05-01,104319,89349,14970,14.4
41031,2020-05-01,10015,8434,1581,15.8
41033,2020-05-01,35997,31160,4837,13.4
41035,2020-05-01,28988,24928,4060,14
41037,2020-05-01,3568,3276,292,8.2
41039,2020-05-01,184312,158037,26275,14.3
41041,2020-05-01,21290,16327,4963,23.3
41043,2020-05-01,59586,51652,7934,13.3
41045,2020-05-01,12412,11385,1027,8.3
41047,2020-05-01,161353,141141,20212,12.5
41049,2020-05-01,5625,5217,408,7.3
41051,2020-05-01,467136,394133,73003,15.6
41053,2020-05-01,39089,34588,4501,11.5
41055,2020-05-01,945,845,100,10.6
41057,2020-05-01,11616,9707,1909,16.4
41059,2020-05-01,37577,33092,4485,11.9
41061,2020-05-01,11343,9518,1825,16.1
41063,2020-05-01,3310,2894,416,12.6
41065,2020-05-01,12566,10759,1807,14.4
41067,2020-05-01,320494,282341,38153,11.9
41069,2020-05-01,677,638,39,5.8
41071,2020-05-01,55037,47915,7122,12.9
42001,2020-05-01,57611,51063,6548,11.4
42003,2020-05-01,640526,554620,85906,13.4
42005,2020-05-01,31584,27459,4125,13.1
42007,2020-05-01,84294,71623,12671,15
42009,2020-05-01,23757,20689,3068,12.9
42011,2020-05-01,228621,197423,31198,13.6
42013,2020-05-01,60832,52822,8010,13.2
42015,2020-05-01,28727,25785,2942,10.2
42017,2020-05-01,339962,296419,43543,12.8
42019,2020-05-01,97343,85803,11540,11.9
42021,2020-05-01,56913,49302,7611,13.4
42023,2020-05-01,2210,1775,435,19.7
42025,2020-05-01,32157,27513,4644,14.4
42027,2020-05-01,80592,74048,6544,8.1
42029,2020-05-01,277903,250382,27521,9.9
42031,2020-05-01,17005,15093,1912,11.2
42033,2020-05-01,36349,31819,4530,12.5
42035,2020-05-01,17956,15899,2057,11.5
42037,2020-05-01,34447,30421,4026,11.7
42039,2020-05-01,38341,33364,4977,13
42041,2020-05-01,133327,119830,13497,10.1
42043,2020-05-01,149225,129659,19566,13.1
42045,2020-05-01,300492,260616,39876,13.3
42047,2020-05-01,16437,13265,3172,19.3
42049,2020-05-01,127309,109562,17747,13.9
42051,2020-05-01,57437,48103,9334,16.3
42053,2020-05-01,1828,1587,241,13.2
42055,2020-05-01,78606,69712,8894,11.3
42057,2020-05-01,8405,7122,1283,15.3
42059,2020-05-01,16630,14488,2142,12.9
42061,2020-05-01,19908,17289,2619,13.2
42063,2020-05-01,38972,34078,4894,12.6
42065,2020-05-01,20363,17927,2436,12
42067,2020-05-01,12288,11194,1094,8.9
42069,2020-05-01,102683,87619,15064,14.7
42071,2020-05-01,292827,259302,33525,11.4
42073,2020-05-01,40655,35008,5647,13.9
42075,2020-05-01,75104,66461,8643,11.5
42077,2020-05-01,193711,166230,27481,14.2
42079,2020-05-01,155531,130269,25262,16.2
42081,2020-05-01,52741,45967,6774,12.8
42083,2020-05-01,17544,14941,2603,14.8
42085,2020-05-01,48041,41357,6684,13.9
42087,2020-05-01,21091,18780,2311,11
42089,2020-05-01,83000,67844,15156,18.3
42091,2020-05-01,444855,392698,52157,11.7
42093,2020-05-01,9200,8376,824,9
42095,2020-05-01,160979,139210,21769,13.5
42097,2020-05-01,42829,37308,5521,12.9
42099,2020-05-01,24752,22314,2438,9.8
42101,2020-05-01,745386,622963,122423,16.4
42103,2020-05-01,24937,20940,3997,16
42105,2020-05-01,7162,6336,826,11.5
42107,2020-05-01,67226,58494,8732,13
42109,2020-05-01,20169,18106,2063,10.2
42111,2020-05-01,32693,28478,4215,12.9
42113,2020-05-01,2513,2244,269,10.7
42115,2020-05-01,19800,17843,1957,9.9
42117,2020-05-01,18986,16778,2208,11.6
42119,2020-05-01,19448,17507,1941,10
42121,2020-05-01,21947,19331,2616,11.9
42123,2020-05-01,18625,16638,1987,10.7
42125,2020-05-01,106081,91413,14668,13.8
42127,2020-05-01,21614,18744,2870,13.3
42129,2020-05-01,179240,154606,24634,13.7
42131,2020-05-01,13014,11460,1554,11.9
42133,2020-05-01,241666,211586,30080,12.4
44001,2020-05-01,23467,20537,2930,12.5
44003,2020-05-01,84922,71493,13429,15.8
44005,2020-05-01,40666,34929,5737,14.1
44007,2020-05-01,308056,254763,53293,17.3
44009,2020-05-01,61758,53336,8422,13.6
45001,2020-05-01,10345,8911,1434,13.9
45003,2020-05-01,76489,68826,7663,10
45005,2020-05-01,2700,2355,345,12.8
45007,2020-05-01,93939,82416,11523,12.3
45009,2020-05-01,5087,4418,669,13.2
45011,2020-05-01,8080,7198,882,10.9
45013,2020-05-01,78794,69950,8844,11.2
45015,2020-05-01,102870,91578,11292,11
45017,2020-05-01,6756,6067,689,10.2
45019,2020-05-01,214688,186788,27900,13
45021,2020-05-01,26810,22729,4081,15.2
45023,2020-05-01,13889,11672,2217,16
45025,2020-05-01,22280,19989,2291,10.3
45027,2020-05-01,13082,11610,1472,11.3
45029,2020-05-01,16751,15143,1608,9.6
45031,2020-05-01,31763,28410,3353,10.6
45033,2020-05-01,13341,12095,1246,9.3
45035,2020-05-01,77815,68861,8954,11.5
45037,2020-05-01,11064,9936,1128,10.2
45039,2020-05-01,10069,8738,1331,13.2
45041,2020-05-01,68652,62422,6230,9.1
45043,2020-05-01,26825,23221,3604,13.4
45045,2020-05-01,262634,230762,31872,12.1
45047,2020-05-01,31542,27992,3550,11.3
45049,2020-05-01,8360,7726,634,7.6
45051,2020-05-01,152161,124524,27637,18.2
45053,2020-05-01,12640,11422,1218,9.6
45055,2020-05-01,29878,27006,2872,9.6
45057,2020-05-01,41686,36124,5562,13.3
45059,2020-05-01,31781,27258,4523,14.2
45061,2020-05-01,6902,6046,856,12.4
45063,2020-05-01,151165,138974,12191,8.1
45065,2020-05-01,3389,2999,390,11.5
45067,2020-05-01,13096,11541,1555,11.9
45069,2020-05-01,9803,8119,1684,17.2
45071,2020-05-01,19185,17551,1634,8.5
45073,2020-05-01,35918,31927,3991,11.1
45075,2020-05-01,36659,31414,5245,14.3
45077,2020-05-01,58140,51798,6342,10.9
45079,2020-05-01,203326,182769,20557,10.1
45081,2020-05-01,9105,8449,656,7.2
45083,2020-05-01,160435,137404,23031,14.4
45085,2020-05-01,45545,40519,5026,11
45087,2020-05-01,12387,10358,2029,16.4
45089,2020-05-01,12406,10828,1578,12.7
45091,2020-05-01,140737,123159,17578,12.5
46003,2020-05-01,1494,1403,91,6.1
46005,2020-05-01,9465,8894,571,6
46007,2020-05-01,1034,958,76,7.4
46009,2020-05-01,2787,2588,199,7.1
46011,2020-05-01,18794,17263,1531,8.1
46013,2020-05-01,21014,19127,1887,9
46015,2020-05-01,2483,2244,239,9.6
46017,2020-05-01,720,604,116,16.1
46019,2020-05-01,5083,4572,511,10.1
46021,2020-05-01,734,693,41,5.6
46023,2020-05-01,3906,3445,461,11.8
46025,2020-05-01,1881,1727,154,8.2
46027,2020-05-01,7143,6422,721,10.1
46029,2020-05-01,15548,14127,1421,9.1
46031,2020-05-01,1282,1191,91,7.1
46033,2020-05-01,3965,3526,439,11.1
46035,2020-05-01,11023,10176,847,7.7
46037,2020-05-01,2765,2521,244,8.8
46039,2020-05-01,2147,1971,176,8.2
46041,2020-05-01,2073,1899,174,8.4
46043,2020-05-01,1511,1448,63,4.2
46045,2020-05-01,1951,1863,88,4.5
46047,2020-05-01,3101,2764,337,10.9
46049,2020-05-01,997,944,53,5.3
46051,2020-05-01,4338,4064,274,6.3
46053,2020-05-01,2013,1875,138,6.9
46055,2020-05-01,991,951,40,4
46057,2020-05-01,3199,3000,199,6.2
46059,2020-05-01,1716,1641,75,4.4
46061,2020-05-01,1701,1558,143,8.4
46063,2020-05-01,689,649,40,5.8
46065,2020-05-01,9981,9311,670,6.7
46067,2020-05-01,3486,3259,227,6.5
46069,2020-05-01,633,603,30,4.7
46071,2020-05-01,1250,1189,61,4.9
46073,2020-05-01,1055,1010,45,4.3
46075,2020-05-01,539,501,38,7.1
46077,2020-05-01,2618,2457,161,6.1
46079,2020-05-01,6545,6152,393,6
46081,2020-05-01,14046,12076,1970,14
46083,2020-05-01,34709,31900,2809,8.1
46085,2020-05-01,1677,1511,166,9.9
46087,2020-05-01,3051,2814,237,7.8
46089,2020-05-01,971,885,86,8.9
46091,2020-05-01,2367,2191,176,7.4
46093,2020-05-01,13991,12561,1430,10.2
46095,2020-05-01,726,655,71,9.8
46097,2020-05-01,1134,1066,68,6
46099,2020-05-01,115499,103993,11506,10
46101,2020-05-01,4127,3678,449,10.9
46102,2020-05-01,3382,3024,358,10.6
46103,2020-05-01,56710,50464,6246,11
46105,2020-05-01,1383,1307,76,5.5
46107,2020-05-01,1001,950,51,5.1
46109,2020-05-01,4789,4316,473,9.9
46111,2020-05-01,1114,1033,81,7.3
46115,2020-05-01,3103,2909,194,6.3
46117,2020-05-01,1849,1698,151,8.2
46119,2020-05-01,763,725,38,5
46121,2020-05-01,3079,2807,272,8.8
46123,2020-05-01,2925,2754,171,5.8
46125,2020-05-01,4672,4301,371,7.9
46127,2020-05-01,8636,7727,909,10.5
46129,2020-05-01,2072,1885,187,9
46135,2020-05-01,12071,11071,1000,8.3
46137,2020-05-01,866,811,55,6.4
47001,2020-05-01,34546,31109,3437,9.9
47003,2020-05-01,22173,19185,2988,13.5
47005,2020-05-01,7071,6362,709,10
47007,2020-05-01,4395,3944,451,10.3
47009,2020-05-01,63168,57299,5869,9.3
47011,2020-05-01,51202,46449,4753,9.3
47013,2020-05-01,14802,13197,1605,10.8
47015,2020-05-01,6558,5778,780,11.9
47017,2020-05-01,11822,10705,1117,9.4
47019,2020-05-01,23304,21272,2032,8.7
47021,2020-05-01,20990,19314,1676,8
47023,2020-05-01,8040,7382,658,8.2
47025,2020-05-01,13069,11832,1237,9.5
47027,2020-05-01,2765,2499,266,9.6
47029,2020-05-01,15697,13241,2456,15.6
47031,2020-05-01,26976,23258,3718,13.8
47033,2020-05-01,6528,6062,466,7.1
47035,2020-05-01,23493,21463,2030,8.6
47037,2020-05-01,405883,355954,49929,12.3
47039,2020-05-01,4682,4148,534,11.4
47041,2020-05-01,8009,6750,1259,15.7
47043,2020-05-01,25891,23694,2197,8.5
47045,2020-05-01,16519,14695,1824,11
47047,2020-05-01,18415,16933,1482,8
47049,2020-05-01,7534,7011,523,6.9
47051,2020-05-01,21487,18497,2990,13.9
47053,2020-05-01,21927,20001,1926,8.8
47055,2020-05-01,15426,13353,2073,13.4
47057,2020-05-01,9461,8523,938,9.9
47059,2020-05-01,30035,26706,3329,11.1
47061,2020-05-01,5491,4562,929,16.9
47063,2020-05-01,28156,25177,2979,10.6
47065,2020-05-01,188078,169235,18843,10
47067,2020-05-01,2167,1926,241,11.1
47069,2020-05-01,9358,8571,787,8.4
47071,2020-05-01,10542,9735,807,7.7
47073,2020-05-01,23347,20685,2662,11.4
47075,2020-05-01,7723,6900,823,10.7
47077,2020-05-01,12454,10980,1474,11.8
47079,2020-05-01,14151,12818,1333,9.4
47081,2020-05-01,10973,10048,925,8.4
47083,2020-05-01,3262,2956,306,9.4
47085,2020-05-01,8807,8135,672,7.6
47087,2020-05-01,4753,4234,519,10.9
47089,2020-05-01,25046,22034,3012,12
47091,2020-05-01,7786,7063,723,9.3
47093,2020-05-01,240620,220612,20008,8.3
47095,2020-05-01,1736,1587,149,8.6
47097,2020-05-01,9728,8570,1158,11.9
47099,2020-05-01,19659,17200,2459,12.5
47101,2020-05-01,5281,4609,672,12.7
47103,2020-05-01,16178,14330,1848,11.4
47105,2020-05-01,23147,21133,2014,8.7
47107,2020-05-01,24626,21812,2814,11.4
47109,2020-05-01,8495,7721,774,9.1
47111,2020-05-01,10979,9906,1073,9.8
47113,2020-05-01,47205,42207,4998,10.6
47115,2020-05-01,12592,11378,1214,9.6
47117,2020-05-01,16827,13983,2844,16.9
47119,2020-05-01,51131,43284,7847,15.3
47121,2020-05-01,5348,4733,615,11.5
47123,2020-05-01,20995,18400,2595,12.4
47125,2020-05-01,86014,77342,8672,10.1
47127,2020-05-01,3747,3409,338,9
47129,2020-05-01,7598,7038,560,7.4
47131,2020-05-01,12512,11571,941,7.5
47133,2020-05-01,9958,9094,864,8.7
47135,2020-05-01,2930,2449,481,16.4
47137,2020-05-01,2326,2148,178,7.7
47139,2020-05-01,7378,6674,704,9.5
47141,2020-05-01,35294,32117,3177,9
47143,2020-05-01,13936,12143,1793,12.9
47145,2020-05-01,22651,20906,1745,7.7
47147,2020-05-01,36578,33373,3205,8.8
47149,2020-05-01,184550,161906,22644,12.3
47151,2020-05-01,8437,7522,915,10.8
47153,2020-05-01,6379,5653,726,11.4
47155,2020-05-01,56513,46506,10007,17.7
47157,2020-05-01,441190,391083,50107,11.4
47159,2020-05-01,9224,8302,922,10
47161,2020-05-01,5440,5043,397,7.3
47163,2020-05-01,68204,61503,6701,9.8
47165,2020-05-01,100330,90088,10242,10.2
47167,2020-05-01,27040,24778,2262,8.4
47169,2020-05-01,5206,4758,448,8.6
47171,2020-05-01,6899,6230,669,9.7
47173,2020-05-01,7493,6830,663,8.8
47175,2020-05-01,2081,1828,253,12.2
47177,2020-05-01,16768,13922,2846,17
47179,2020-05-01,58938,53744,5194,8.8
47181,2020-05-01,6147,5565,582,9.5
47183,2020-05-01,15123,14080,1043,6.9
47185,2020-05-01,12385,11104,1281,10.3
47187,2020-05-01,122125,113394,8731,7.1
47189,2020-05-01,74672,67384,7288,9.8
48001,2020-05-01,21900,20091,1809,8.3
48003,2020-05-01,9564,8323,1241,13
48005,2020-05-01,33684,29726,3958,11.8
48007,2020-05-01,8705,7565,1140,13.1
48009,2020-05-01,3709,3416,293,7.9
48011,2020-05-01,837,783,54,6.5
48013,2020-05-01,21139,18239,2900,13.7
48015,2020-05-01,13078,11811,1267,9.7
48017,2020-05-01,2168,2019,149,6.9
48019,2020-05-01,9353,8479,874,9.3
48021,2020-05-01,39995,35899,4096,10.2
48023,2020-05-01,1605,1526,79,4.9
48025,2020-05-01,9495,8134,1361,14.3
48027,2020-05-01,136478,121369,15109,11.1
48029,2020-05-01,923755,802003,121752,13.2
48031,2020-05-01,5887,5524,363,6.2
48033,2020-05-01,372,355,17,4.6
48035,2020-05-01,7607,6974,633,8.3
48037,2020-05-01,38007,33709,4298,11.3
48039,2020-05-01,172305,149329,22976,13.3
48041,2020-05-01,113916,104056,9860,8.7
48043,2020-05-01,4015,3542,473,11.8
48045,2020-05-01,512,480,32,6.3
48047,2020-05-01,2573,2160,413,16.1
48049,2020-05-01,14146,12718,1428,10.1
48051,2020-05-01,8006,7262,744,9.3
48053,2020-05-01,21316,19676,1640,7.7
48055,2020-05-01,18294,16403,1891,10.3
48057,2020-05-01,11287,10321,966,8.6
48059,2020-05-01,5666,5194,472,8.3
48061,2020-05-01,159995,134414,25581,16
48063,2020-05-01,4604,4140,464,10.1
48065,2020-05-01,2705,2539,166,6.1
48067,2020-05-01,11587,10355,1232,10.6
48069,2020-05-01,3041,2891,150,4.9
48071,2020-05-01,18913,16146,2767,14.6
48073,2020-05-01,19854,17381,2473,12.5
48075,2020-05-01,2605,2453,152,5.8
48077,2020-05-01,4445,4065,380,8.5
48079,2020-05-01,1044,927,117,11.2
48081,2020-05-01,1309,1203,106,8.1
48083,2020-05-01,2630,2343,287,10.9
48085,2020-05-01,540673,479639,61034,11.3
48087,2020-05-01,981,929,52,5.3
48089,2020-05-01,8943,8206,737,8.2
48091,2020-05-01,69752,61943,7809,11.2
48093,2020-05-01,5108,4682,426,8.3
48095,2020-05-01,1203,1128,75,6.2
48097,2020-05-01,18986,16800,2186,11.5
48099,2020-05-01,22579,20322,2257,10
48101,2020-05-01,467,435,32,6.9
48103,2020-05-01,1595,1243,352,22.1
48105,2020-05-01,1579,1355,224,14.2
48107,2020-05-01,2271,2097,174,7.7
48109,2020-05-01,954,834,120,12.6
48111,2020-05-01,3366,3234,132,3.9
48113,2020-05-01,NA,NA,170095,12.8
48115,2020-05-01,4459,3879,580,13
48117,2020-05-01,7539,7188,351,4.7
48119,2020-05-01,2218,2033,185,8.3
48121,2020-05-01,478182,421591,56591,11.8
48123,2020-05-01,9101,8328,773,8.5
48125,2020-05-01,608,554,54,8.9
48127,2020-05-01,6710,6118,592,8.8
48129,2020-05-01,1195,1129,66,5.5
48131,2020-05-01,4875,4003,872,17.9
48133,2020-05-01,7133,6428,705,9.9
48135,2020-05-01,84968,70951,14017,16.5
48137,2020-05-01,996,949,47,4.7
48139,2020-05-01,87685,78824,8861,10.1
48141,2020-05-01,347966,297233,50733,14.6
48143,2020-05-01,19042,17375,1667,8.8
48145,2020-05-01,6220,5678,542,8.7
48147,2020-05-01,16133,14968,1165,7.2
48149,2020-05-01,10762,10007,755,7
48151,2020-05-01,1432,1337,95,6.6
48153,2020-05-01,2318,2119,199,8.6
48155,2020-05-01,529,493,36,6.8
48157,2020-05-01,376606,328511,48095,12.8
48159,2020-05-01,4236,3885,351,8.3
48161,2020-05-01,5895,5179,716,12.1
48163,2020-05-01,9519,8765,754,7.9
48165,2020-05-01,9040,8255,785,8.7
48167,2020-05-01,161097,137793,23304,14.5
48169,2020-05-01,2009,1802,207,10.3
48171,2020-05-01,12341,11263,1078,8.7
48173,2020-05-01,704,663,41,5.8
48175,2020-05-01,2980,2652,328,11
48177,2020-05-01,8790,8018,772,8.8
48179,2020-05-01,7528,6716,812,10.8
48181,2020-05-01,61027,55153,5874,9.6
48183,2020-05-01,54613,47585,7028,12.9
48185,2020-05-01,10618,9358,1260,11.9
48187,2020-05-01,78166,69006,9160,11.7
48189,2020-05-01,11007,9897,1110,10.1
48191,2020-05-01,946,867,79,8.4
48193,2020-05-01,3264,3039,225,6.9
48195,2020-05-01,2337,2250,87,3.7
48197,2020-05-01,1551,1453,98,6.3
48199,2020-05-01,23751,20266,3485,14.7
48201,2020-05-01,NA,NA,323817,14.4
48203,2020-05-01,27263,23934,3329,12.2
48205,2020-05-01,2406,2340,66,2.7
48207,2020-05-01,2019,1875,144,7.1
48209,2020-05-01,113973,100572,13401,11.8
48211,2020-05-01,1620,1522,98,6
48213,2020-05-01,34291,30854,3437,10
48215,2020-05-01,350895,289308,61587,17.6
48217,2020-05-01,15348,13777,1571,10.2
48219,2020-05-01,10666,9315,1351,12.7
48221,2020-05-01,25829,23081,2748,10.6
48223,2020-05-01,15936,14692,1244,7.8
48225,2020-05-01,9191,8515,676,7.4
48227,2020-05-01,13403,11784,1619,12.1
48229,2020-05-01,1722,1500,222,12.9
48231,2020-05-01,41070,36735,4335,10.6
48233,2020-05-01,7964,7083,881,11.1
48235,2020-05-01,685,623,62,9.1
48237,2020-05-01,3112,2768,344,11.1
48239,2020-05-01,6912,6350,562,8.1
48241,2020-05-01,12295,10230,2065,16.8
48243,2020-05-01,903,828,75,8.3
48245,2020-05-01,104168,84513,19655,18.9
48247,2020-05-01,1692,1462,230,13.6
48249,2020-05-01,16795,13697,3098,18.4
48251,2020-05-01,77608,69050,8558,11
48253,2020-05-01,5375,4835,540,10
48255,2020-05-01,6817,6184,633,9.3
48257,2020-05-01,61708,54889,6819,11.1
48259,2020-05-01,20533,18737,1796,8.7
48261,2020-05-01,173,162,11,6.4
48263,2020-05-01,424,402,22,5.2
48265,2020-05-01,20638,18569,2069,10
48267,2020-05-01,1624,1515,109,6.7
48269,2020-05-01,209,203,6,2.9
48271,2020-05-01,1246,1147,99,7.9
48273,2020-05-01,12820,11143,1677,13.1
48275,2020-05-01,1298,1186,112,8.6
48277,2020-05-01,22584,20439,2145,9.5
48279,2020-05-01,4817,4446,371,7.7
48281,2020-05-01,8463,7803,660,7.8
48283,2020-05-01,3961,3584,377,9.5
48285,2020-05-01,7567,6958,609,8
48287,2020-05-01,9017,8381,636,7.1
48289,2020-05-01,5806,5175,631,10.9
48291,2020-05-01,32261,27273,4988,15.5
48293,2020-05-01,7939,7155,784,9.9
48295,2020-05-01,1423,1335,88,6.2
48297,2020-05-01,5205,4685,520,10
48299,2020-05-01,7916,7226,690,8.7
48301,2020-05-01,627,619,8,1.3
48303,2020-05-01,147482,133549,13933,9.4
48305,2020-05-01,2563,2349,214,8.3
48307,2020-05-01,3000,2681,319,10.6
48309,2020-05-01,114400,103186,11214,9.8
48311,2020-05-01,781,755,26,3.3
48313,2020-05-01,4167,3723,444,10.7
48315,2020-05-01,3935,3434,501,12.7
48317,2020-05-01,2543,2325,218,8.6
48319,2020-05-01,1580,1454,126,8
48321,2020-05-01,16278,13790,2488,15.3
48323,2020-05-01,23996,18856,5140,21.4
48325,2020-05-01,20634,18440,2194,10.6
48327,2020-05-01,779,711,68,8.7
48329,2020-05-01,98927,86350,12577,12.7
48331,2020-05-01,8916,7924,992,11.1
48333,2020-05-01,1663,1575,88,5.3
48335,2020-05-01,2178,1923,255,11.7
48337,2020-05-01,8730,7801,929,10.6
48339,2020-05-01,271817,237919,33898,12.5
48341,2020-05-01,9657,9123,534,5.5
48343,2020-05-01,4527,3922,605,13.4
48345,2020-05-01,414,392,22,5.3
48347,2020-05-01,25610,23058,2552,10
48349,2020-05-01,22218,20040,2178,9.8
48351,2020-05-01,4878,4080,798,16.4
48353,2020-05-01,6525,6045,480,7.4
48355,2020-05-01,157490,134543,22947,14.6
48357,2020-05-01,3795,3482,313,8.2
48359,2020-05-01,813,772,41,5
48361,2020-05-01,34910,28950,5960,17.1
48363,2020-05-01,12659,11282,1377,10.9
48365,2020-05-01,9371,8271,1100,11.7
48367,2020-05-01,62917,56731,6186,9.8
48369,2020-05-01,4217,4085,132,3.1
48371,2020-05-01,5972,5200,772,12.9
48373,2020-05-01,17089,14889,2200,12.9
48375,2020-05-01,51135,46329,4806,9.4
48377,2020-05-01,3224,2487,737,22.9
48379,2020-05-01,5580,5184,396,7.1
48381,2020-05-01,66096,60795,5301,8
48383,2020-05-01,1872,1604,268,14.3
48385,2020-05-01,909,815,94,10.3
48387,2020-05-01,4622,4197,425,9.2
48389,2020-05-01,11450,10552,898,7.8
48391,2020-05-01,2947,2587,360,12.2
48393,2020-05-01,373,348,25,6.7
48395,2020-05-01,7244,6623,621,8.6
48397,2020-05-01,49607,44293,5314,10.7
48399,2020-05-01,4164,3823,341,8.2
48401,2020-05-01,21059,18855,2204,10.5
48403,2020-05-01,3536,2936,600,17
48405,2020-05-01,3280,2888,392,12
48407,2020-05-01,10936,9687,1249,11.4
48409,2020-05-01,28103,23724,4379,15.6
48411,2020-05-01,2247,2103,144,6.4
48413,2020-05-01,1151,1032,119,10.3
48415,2020-05-01,6224,5451,773,12.4
48417,2020-05-01,1701,1564,137,8.1
48419,2020-05-01,10242,9210,1032,10.1
48421,2020-05-01,1212,1172,40,3.3
48423,2020-05-01,103773,92029,11744,11.3
48425,2020-05-01,4068,3651,417,10.3
48427,2020-05-01,25413,19324,6089,24
48429,2020-05-01,3678,3351,327,8.9
48431,2020-05-01,523,479,44,8.4
48433,2020-05-01,511,471,40,7.8
48435,2020-05-01,1247,1072,175,14
48437,2020-05-01,2335,2162,173,7.4
48439,2020-05-01,NA,908801,135300,13
48441,2020-05-01,62705,57162,5543,8.8
48443,2020-05-01,330,305,25,7.6
48445,2020-05-01,4584,4061,523,11.4
48447,2020-05-01,562,522,40,7.1
48449,2020-05-01,12006,10843,1163,9.7
48451,2020-05-01,49367,44063,5304,10.7
48453,2020-05-01,704399,622616,81783,11.6
48455,2020-05-01,4961,4365,596,12
48457,2020-05-01,6799,5774,1025,15.1
48459,2020-05-01,16612,14619,1993,12
48461,2020-05-01,1552,1406,146,9.4
48463,2020-05-01,10422,9395,1027,9.9
48465,2020-05-01,21710,18572,3138,14.5
48467,2020-05-01,24348,21942,2406,9.9
48469,2020-05-01,39806,34659,5147,12.9
48471,2020-05-01,22565,20108,2457,10.9
48473,2020-05-01,22268,19617,2651,11.9
48475,2020-05-01,7500,6643,857,11.4
48477,2020-05-01,13897,12756,1141,8.2
48479,2020-05-01,113431,97440,15991,14.1
48481,2020-05-01,20167,18173,1994,9.9
48483,2020-05-01,2041,1882,159,7.8
48485,2020-05-01,51520,46195,5325,10.3
48487,2020-05-01,4470,4122,348,7.8
48489,2020-05-01,6491,5368,1123,17.3
48491,2020-05-01,295352,263368,31984,10.8
48493,2020-05-01,23313,21072,2241,9.6
48495,2020-05-01,3797,3231,566,14.9
48497,2020-05-01,30107,26788,3319,11
48499,2020-05-01,16498,14822,1676,10.2
48501,2020-05-01,3877,3133,744,19.2
48503,2020-05-01,7228,6659,569,7.9
48505,2020-05-01,4631,3859,772,16.7
48507,2020-05-01,3171,2513,658,20.8
49001,2020-05-01,2818,2655,163,5.8
49003,2020-05-01,27050,24248,2802,10.4
49005,2020-05-01,61511,58531,2980,4.8
49007,2020-05-01,8499,7888,611,7.2
49009,2020-05-01,377,358,19,5
49011,2020-05-01,175950,163353,12597,7.2
49013,2020-05-01,7957,7009,948,11.9
49015,2020-05-01,4439,4172,267,6
49017,2020-05-01,3020,2572,448,14.8
49019,2020-05-01,6718,5604,1114,16.6
49021,2020-05-01,23498,21668,1830,7.8
49023,2020-05-01,5504,5283,221,4
49025,2020-05-01,3756,3357,399,10.6
49027,2020-05-01,5799,5535,264,4.6
49029,2020-05-01,5534,5225,309,5.6
49031,2020-05-01,489,443,46,9.4
49033,2020-05-01,1115,1065,50,4.5
49035,2020-05-01,634780,574711,60069,9.5
49037,2020-05-01,6268,5409,859,13.7
49039,2020-05-01,12112,11477,635,5.2
49041,2020-05-01,9540,8954,586,6.1
49043,2020-05-01,24382,20236,4146,17
49045,2020-05-01,33684,30657,3027,9
49047,2020-05-01,14133,12240,1893,13.4
49049,2020-05-01,303555,284634,18921,6.2
49051,2020-05-01,16527,14186,2341,14.2
49053,2020-05-01,76889,69619,7270,9.5
49055,2020-05-01,1458,1287,171,11.7
49057,2020-05-01,130546,119216,11330,8.7
50001,2020-05-01,20871,18899,1972,9.4
50003,2020-05-01,18409,15709,2700,14.7
50005,2020-05-01,15087,13272,1815,12
50007,2020-05-01,94258,83257,11001,11.7
50009,2020-05-01,2836,2440,396,14
50011,2020-05-01,27039,23881,3158,11.7
50013,2020-05-01,3953,3451,502,12.7
50015,2020-05-01,14407,11684,2723,18.9
50017,2020-05-01,15990,14432,1558,9.7
50019,2020-05-01,13605,11370,2235,16.4
50021,2020-05-01,30954,26198,4756,15.4
50023,2020-05-01,32975,29259,3716,11.3
50025,2020-05-01,22915,19668,3247,14.2
50027,2020-05-01,28949,25267,3682,12.7
51001,2020-05-01,16487,15017,1470,8.9
51003,2020-05-01,56914,52557,4357,7.7
51005,2020-05-01,6778,6174,604,8.9
51007,2020-05-01,6055,5596,459,7.6
51009,2020-05-01,14303,13259,1044,7.3
51011,2020-05-01,6796,6293,503,7.4
51013,2020-05-01,149048,140267,8781,5.9
51015,2020-05-01,37882,35441,2441,6.4
51017,2020-05-01,2734,2315,419,15.3
51019,2020-05-01,36800,34117,2683,7.3
51021,2020-05-01,2760,2540,220,8
51023,2020-05-01,16669,15478,1191,7.1
51025,2020-05-01,5809,5243,566,9.7
51027,2020-05-01,6440,5772,668,10.4
51029,2020-05-01,6368,5791,577,9.1
51031,2020-05-01,24969,22961,2008,8
51033,2020-05-01,14956,13598,1358,9.1
51035,2020-05-01,13585,12122,1463,10.8
51036,2020-05-01,3568,3247,321,9
51037,2020-05-01,5058,4721,337,6.7
51041,2020-05-01,183715,167989,15726,8.6
51043,2020-05-01,7366,6864,502,6.8
51045,2020-05-01,2220,2038,182,8.2
51047,2020-05-01,24040,22261,1779,7.4
51049,2020-05-01,4511,4160,351,7.8
51051,2020-05-01,4656,4234,422,9.1
51053,2020-05-01,13294,12201,1093,8.2
51057,2020-05-01,5409,4915,494,9.1
51059,2020-05-01,629244,575787,53457,8.5
51061,2020-05-01,36127,33631,2496,6.9
51063,2020-05-01,7551,6949,602,8
51065,2020-05-01,13864,12807,1057,7.6
51067,2020-05-01,25390,23411,1979,7.8
51069,2020-05-01,46511,43073,3438,7.4
51071,2020-05-01,7364,6617,747,10.1
51073,2020-05-01,19147,17662,1485,7.8
51075,2020-05-01,10820,10081,739,6.8
51077,2020-05-01,8048,7468,580,7.2
51079,2020-05-01,10450,9662,788,7.5
51081,2020-05-01,4178,3827,351,8.4
51083,2020-05-01,15255,13986,1269,8.3
51085,2020-05-01,57253,53231,4022,7
51087,2020-05-01,179513,162950,16563,9.2
51089,2020-05-01,24064,21612,2452,10.2
51091,2020-05-01,1155,1092,63,5.5
51093,2020-05-01,18784,17504,1280,6.8
51095,2020-05-01,36979,33026,3953,10.7
51097,2020-05-01,3755,3509,246,6.6
51099,2020-05-01,12812,12022,790,6.2
51101,2020-05-01,8909,8232,677,7.6
51103,2020-05-01,5505,5028,477,8.7
51105,2020-05-01,8098,7412,686,8.5
51107,2020-05-01,218974,201257,17717,8.1
51109,2020-05-01,19825,18362,1463,7.4
51111,2020-05-01,5048,4725,323,6.4
51113,2020-05-01,7251,6851,400,5.5
51115,2020-05-01,3984,3728,256,6.4
51117,2020-05-01,12150,11068,1082,8.9
51119,2020-05-01,5183,4820,363,7
51121,2020-05-01,45438,42048,3390,7.5
51125,2020-05-01,7448,6845,603,8.1
51127,2020-05-01,12038,11229,809,6.7
51131,2020-05-01,5313,4755,558,10.5
51133,2020-05-01,5605,5197,408,7.3
51135,2020-05-01,6926,6493,433,6.3
51137,2020-05-01,17297,15906,1391,8
51139,2020-05-01,12177,10808,1369,11.2
51141,2020-05-01,7156,6535,621,8.7
51143,2020-05-01,29355,26788,2567,8.7
51145,2020-05-01,13726,12724,1002,7.3
51147,2020-05-01,10106,9308,798,7.9
51149,2020-05-01,14673,13414,1259,8.6
51153,2020-05-01,245602,221635,23967,9.8
51155,2020-05-01,15316,13433,1883,12.3
51157,2020-05-01,3591,3362,229,6.4
51159,2020-05-01,3969,3733,236,5.9
51161,2020-05-01,47709,43936,3773,7.9
51163,2020-05-01,10763,9944,819,7.6
51165,2020-05-01,39891,36796,3095,7.8
51167,2020-05-01,10885,9986,899,8.3
51169,2020-05-01,8707,8086,621,7.1
51171,2020-05-01,22132,20398,1734,7.8
51173,2020-05-01,13341,12173,1168,8.8
51175,2020-05-01,8662,8118,544,6.3
51177,2020-05-01,66175,60294,5881,8.9
51179,2020-05-01,70530,64793,5737,8.1
51181,2020-05-01,3606,3338,268,7.4
51183,2020-05-01,3702,3320,382,10.3
51185,2020-05-01,15227,13770,1457,9.6
51187,2020-05-01,20176,18425,1751,8.7
51191,2020-05-01,25695,23648,2047,8
51193,2020-05-01,9335,8650,685,7.3
51195,2020-05-01,12900,11773,1127,8.7
51197,2020-05-01,13601,12001,1600,11.8
51199,2020-05-01,32184,29521,2663,8.3
51510,2020-05-01,100323,91900,8423,8.4
51520,2020-05-01,7129,6367,762,10.7
51530,2020-05-01,3501,3260,241,6.9
51540,2020-05-01,26716,24272,2444,9.1
51550,2020-05-01,120521,110209,10312,8.6
51570,2020-05-01,8668,7855,813,9.4
51580,2020-05-01,2489,2138,351,14.1
51590,2020-05-01,19117,16769,2348,12.3
51595,2020-05-01,2343,2013,330,14.1
51600,2020-05-01,13341,12216,1125,8.4
51610,2020-05-01,8207,7817,390,4.8
51620,2020-05-01,3518,3194,324,9.2
51630,2020-05-01,14098,12658,1440,10.2
51640,2020-05-01,2964,2664,300,10.1
51650,2020-05-01,64801,57289,7512,11.6
51660,2020-05-01,24314,21752,2562,10.5
51670,2020-05-01,9842,8520,1322,13.4
51678,2020-05-01,2044,1867,177,8.7
51680,2020-05-01,35346,31867,3479,9.8
51683,2020-05-01,22019,19929,2090,9.5
51685,2020-05-01,9449,8492,957,10.1
51690,2020-05-01,5754,4940,814,14.1
51700,2020-05-01,90287,79284,11003,12.2
51710,2020-05-01,112614,99661,12953,11.5
51720,2020-05-01,1661,1503,158,9.5
51730,2020-05-01,13575,11321,2254,16.6
51735,2020-05-01,6127,5765,362,5.9
51740,2020-05-01,44624,39366,5258,11.8
51750,2020-05-01,7933,7173,760,9.6
51760,2020-05-01,119975,105483,14492,12.1
51770,2020-05-01,49037,43532,5505,11.2
51775,2020-05-01,12615,11503,1112,8.8
51790,2020-05-01,12727,11571,1156,9.1
51800,2020-05-01,43824,39998,3826,8.7
51810,2020-05-01,231762,209980,21782,9.4
51820,2020-05-01,11122,10091,1031,9.3
51830,2020-05-01,6784,5959,825,12.2
51840,2020-05-01,14503,13182,1321,9.1
53001,2020-05-01,9861,8668,1193,12.1
53003,2020-05-01,9624,8829,795,8.3
53005,2020-05-01,105777,92831,12946,12.2
53007,2020-05-01,44084,37683,6401,14.5
53009,2020-05-01,30805,25710,5095,16.5
53011,2020-05-01,244163,208602,35561,14.6
53013,2020-05-01,1719,1538,181,10.5
53015,2020-05-01,49775,42087,7688,15.4
53017,2020-05-01,21154,18320,2834,13.4
53019,2020-05-01,2398,2019,379,15.8
53021,2020-05-01,44811,39305,5506,12.3
53023,2020-05-01,796,696,100,12.6
53025,2020-05-01,47208,41208,6000,12.7
53027,2020-05-01,31758,25685,6073,19.1
53029,2020-05-01,36442,31454,4988,13.7
53031,2020-05-01,13651,11480,2171,15.9
53033,2020-05-01,NA,NA,181693,14.4
53035,2020-05-01,133933,116266,17667,13.2
53037,2020-05-01,23419,20091,3328,14.2
53039,2020-05-01,10047,8861,1186,11.8
53041,2020-05-01,36440,30734,5706,15.7
53043,2020-05-01,4464,4022,442,9.9
53045,2020-05-01,26894,22932,3962,14.7
53047,2020-05-01,18702,16143,2559,13.7
53049,2020-05-01,9139,7575,1564,17.1
53051,2020-05-01,4855,4131,724,14.9
53053,2020-05-01,460479,382880,77599,16.9
53055,2020-05-01,8003,6711,1292,16.1
53057,2020-05-01,64393,53747,10646,16.5
53059,2020-05-01,5544,4714,830,15
53061,2020-05-01,438703,367767,70936,16.2
53063,2020-05-01,256138,217564,38574,15.1
53065,2020-05-01,18104,15657,2447,13.5
53067,2020-05-01,148781,127594,21187,14.2
53069,2020-05-01,1407,1214,193,13.7
53071,2020-05-01,30433,27179,3254,10.7
53073,2020-05-01,119856,101198,18658,15.6
53075,2020-05-01,23091,21398,1693,7.3
53077,2020-05-01,135473,116628,18845,13.9
54001,2020-05-01,6881,6088,793,11.5
54003,2020-05-01,56392,50390,6002,10.6
54005,2020-05-01,7341,6274,1067,14.5
54007,2020-05-01,4814,4197,617,12.8
54009,2020-05-01,9777,8487,1290,13.2
54011,2020-05-01,42686,37108,5578,13.1
54013,2020-05-01,2230,1810,420,18.8
54015,2020-05-01,3058,2572,486,15.9
54017,2020-05-01,3824,3501,323,8.4
54019,2020-05-01,16492,14207,2285,13.9
54021,2020-05-01,2461,2160,301,12.2
54023,2020-05-01,5723,5198,525,9.2
54025,2020-05-01,15772,13681,2091,13.3
54027,2020-05-01,10487,9611,876,8.4
54029,2020-05-01,13343,11096,2247,16.8
54031,2020-05-01,5816,5170,646,11.1
54033,2020-05-01,34582,30571,4011,11.6
54035,2020-05-01,12532,11069,1463,11.7
54037,2020-05-01,29476,26523,2953,10
54039,2020-05-01,81567,70110,11457,14
54041,2020-05-01,6271,5343,928,14.8
54043,2020-05-01,7226,6279,947,13.1
54045,2020-05-01,10768,8948,1820,16.9
54047,2020-05-01,4366,3786,580,13.3
54049,2020-05-01,24973,21584,3389,13.6
54051,2020-05-01,13672,11598,2074,15.2
54053,2020-05-01,9801,8588,1213,12.4
54055,2020-05-01,20581,17844,2737,13.3
54057,2020-05-01,11914,10638,1276,10.7
54059,2020-05-01,6553,5286,1267,19.3
54061,2020-05-01,53913,48661,5252,9.7
54063,2020-05-01,5782,5151,631,10.9
54065,2020-05-01,7783,7006,777,10
54067,2020-05-01,8977,7733,1244,13.9
54069,2020-05-01,20508,17707,2801,13.7
54071,2020-05-01,3550,3299,251,7.1
54073,2020-05-01,2933,2511,422,14.4
54075,2020-05-01,3968,3401,567,14.3
54077,2020-05-01,15405,13759,1646,10.7
54079,2020-05-01,27051,23875,3176,11.7
54081,2020-05-01,30943,26923,4020,13
54083,2020-05-01,11900,10281,1619,13.6
54085,2020-05-01,4232,3769,463,10.9
54087,2020-05-01,4894,4106,788,16.1
54089,2020-05-01,4070,3621,449,11
54091,2020-05-01,7468,6661,807,10.8
54093,2020-05-01,3197,2772,425,13.3
54095,2020-05-01,2955,2569,386,13.1
54097,2020-05-01,8978,7747,1231,13.7
54099,2020-05-01,15858,13947,1911,12.1
54101,2020-05-01,3145,2765,380,12.1
54103,2020-05-01,6299,5436,863,13.7
54105,2020-05-01,2278,1995,283,12.4
54107,2020-05-01,37723,32756,4967,13.2
54109,2020-05-01,6205,5374,831,13.4
55001,2020-05-01,8350,6931,1419,17
55003,2020-05-01,7977,6705,1272,15.9
55005,2020-05-01,23803,21154,2649,11.1
55007,2020-05-01,7663,6379,1284,16.8
55009,2020-05-01,142576,124859,17717,12.4
55011,2020-05-01,6488,5647,841,13
55013,2020-05-01,7154,6051,1103,15.4
55015,2020-05-01,26659,24194,2465,9.2
55017,2020-05-01,31879,28529,3350,10.5
55019,2020-05-01,17081,15858,1223,7.2
55021,2020-05-01,30673,27093,3580,11.7
55023,2020-05-01,7589,6592,997,13.1
55025,2020-05-01,306192,277303,28889,9.4
55027,2020-05-01,46519,42000,4519,9.7
55029,2020-05-01,14179,12226,1953,13.8
55031,2020-05-01,24149,19848,4301,17.8
55033,2020-05-01,23511,21154,2357,10
55035,2020-05-01,57262,50949,6313,11
55037,2020-05-01,2342,2006,336,14.3
55039,2020-05-01,58505,51898,6607,11.3
55041,2020-05-01,4478,3505,973,21.7
55043,2020-05-01,27954,24898,3056,10.9
55045,2020-05-01,19828,18135,1693,8.5
55047,2020-05-01,9487,8266,1221,12.9
55049,2020-05-01,13591,11853,1738,12.8
55051,2020-05-01,2703,2188,515,19.1
55053,2020-05-01,10521,8903,1618,15.4
55055,2020-05-01,45795,41308,4487,9.8
55057,2020-05-01,13862,11948,1914,13.8
55059,2020-05-01,90059,78029,12030,13.4
55061,2020-05-01,10710,9728,982,9.2
55063,2020-05-01,65059,57860,7199,11.1
55065,2020-05-01,9849,9028,821,8.3
55067,2020-05-01,9189,8246,943,10.3
55069,2020-05-01,14798,13337,1461,9.9
55071,2020-05-01,41487,36655,4832,11.6
55073,2020-05-01,72918,66177,6741,9.2
55075,2020-05-01,19862,16900,2962,14.9
55077,2020-05-01,7706,6755,951,12.3
55078,2020-05-01,1995,1373,622,31.2
55079,2020-05-01,476959,407954,69005,14.5
55081,2020-05-01,23069,20846,2223,9.6
55083,2020-05-01,20253,18023,2230,11
55085,2020-05-01,17277,14961,2316,13.4
55087,2020-05-01,101498,90252,11246,11.1
55089,2020-05-01,48384,43339,5045,10.4
55091,2020-05-01,4055,3607,448,11
55093,2020-05-01,25692,22161,3531,13.7
55095,2020-05-01,24402,21386,3016,12.4
55097,2020-05-01,38509,34762,3747,9.7
55099,2020-05-01,6406,5649,757,11.8
55101,2020-05-01,101807,89160,12647,12.4
55103,2020-05-01,9071,8236,835,9.2
55105,2020-05-01,84030,72397,11633,13.8
55107,2020-05-01,6543,5862,681,10.4
55109,2020-05-01,51155,44058,7097,13.9
55111,2020-05-01,36797,31050,5747,15.6
55113,2020-05-01,7591,6653,938,12.4
55115,2020-05-01,21570,18624,2946,13.7
55117,2020-05-01,62640,54707,7933,12.7
55119,2020-05-01,10461,9736,725,6.9
55121,2020-05-01,15952,14040,1912,12
55123,2020-05-01,14935,13631,1304,8.7
55125,2020-05-01,9612,8369,1243,12.9
55127,2020-05-01,57283,50726,6557,11.4
55129,2020-05-01,7824,6925,899,11.5
55131,2020-05-01,76659,68232,8427,11
55133,2020-05-01,222369,198518,23851,10.7
55135,2020-05-01,25580,22916,2664,10.4
55137,2020-05-01,11461,10234,1227,10.7
55139,2020-05-01,90840,80959,9881,10.9
55141,2020-05-01,35557,31296,4261,12
56001,2020-05-01,21256,20214,1042,4.9
56003,2020-05-01,5118,4820,298,5.8
56005,2020-05-01,23642,21334,2308,9.8
56007,2020-05-01,7634,7100,534,7
56009,2020-05-01,8944,8287,657,7.3
56011,2020-05-01,3595,3410,185,5.1
56013,2020-05-01,18899,17295,1604,8.5
56015,2020-05-01,6340,6006,334,5.3
56017,2020-05-01,2172,2023,149,6.9
56019,2020-05-01,4077,3746,331,8.1
56021,2020-05-01,49664,45730,3934,7.9
56023,2020-05-01,8798,8115,683,7.8
56025,2020-05-01,39607,35022,4585,11.6
56027,2020-05-01,1188,1133,55,4.6
56029,2020-05-01,14825,13584,1241,8.4
56031,2020-05-01,4649,4347,302,6.5
56033,2020-05-01,15770,14561,1209,7.7
56035,2020-05-01,4002,3609,393,9.8
56037,2020-05-01,21155,19097,2058,9.7
56039,2020-05-01,15049,12786,2263,15
56041,2020-05-01,8959,8159,800,8.9
56043,2020-05-01,3796,3526,270,7.1
56045,2020-05-01,3730,3542,188,5
72001,2020-05-01,3716,3281,435,11.7
72003,2020-05-01,11019,9799,1220,11.1
72005,2020-05-01,13327,11930,1397,10.5
72007,2020-05-01,6076,5403,673,11.1
72009,2020-05-01,5775,5230,545,9.4
72011,2020-05-01,8124,7383,741,9.1
72013,2020-05-01,22638,20286,2352,10.4
72015,2020-05-01,4194,3796,398,9.5
72017,2020-05-01,5436,4759,677,12.5
72019,2020-05-01,6784,6009,775,11.4
72021,2020-05-01,62150,55921,6229,10
72023,2020-05-01,12708,11369,1339,10.5
72025,2020-05-01,44533,40593,3940,8.8
72027,2020-05-01,9019,8137,882,9.8
72029,2020-05-01,15078,13646,1432,9.5
72031,2020-05-01,58341,52727,5614,9.6
72033,2020-05-01,7431,6664,767,10.3
72035,2020-05-01,14872,13712,1160,7.8
72037,2020-05-01,3417,3066,351,10.3
72039,2020-05-01,3486,3017,469,13.5
72041,2020-05-01,14149,13167,982,6.9
72043,2020-05-01,9040,8123,917,10.1
72045,2020-05-01,4547,4048,499,11
72047,2020-05-01,8429,7312,1117,13.3
72049,2020-05-01,879,816,63,7.2
72051,2020-05-01,12330,11354,976,7.9
72053,2020-05-01,10128,8976,1152,11.4
72054,2020-05-01,3046,2674,372,12.2
72055,2020-05-01,3617,3169,448,12.4
72057,2020-05-01,10014,9130,884,8.8
72059,2020-05-01,4753,4284,469,9.9
72061,2020-05-01,35371,33184,2187,6.2
72063,2020-05-01,16546,15482,1064,6.4
72065,2020-05-01,12278,11162,1116,9.1
72067,2020-05-01,5015,4492,523,10.4
72069,2020-05-01,15619,14221,1398,9
72071,2020-05-01,10745,9695,1050,9.8
72073,2020-05-01,3631,3364,267,7.4
72075,2020-05-01,14080,12906,1174,8.3
72077,2020-05-01,11250,10173,1077,9.6
72079,2020-05-01,4780,4151,629,13.2
72081,2020-05-01,6230,5394,836,13.4
72083,2020-05-01,2450,2138,312,12.7
72085,2020-05-01,10296,9357,939,9.1
72087,2020-05-01,7798,7057,741,9.5
72089,2020-05-01,5763,5127,636,11
72091,2020-05-01,10588,9573,1015,9.6
72093,2020-05-01,1623,1493,130,8
72095,2020-05-01,2549,2278,271,10.6
72097,2020-05-01,19966,17879,2087,10.5
72099,2020-05-01,9628,8534,1094,11.4
72101,2020-05-01,7442,6548,894,12
72103,2020-05-01,7432,6789,643,8.7
72105,2020-05-01,6840,5823,1017,14.9
72107,2020-05-01,4636,3992,644,13.9
72109,2020-05-01,3802,3407,395,10.4
72111,2020-05-01,5280,4670,610,11.6
72113,2020-05-01,42267,38137,4130,9.8
72115,2020-05-01,5788,5060,728,12.6
72117,2020-05-01,4318,3753,565,13.1
72119,2020-05-01,15916,14236,1680,10.6
72121,2020-05-01,5402,4818,584,10.8
72123,2020-05-01,6375,5681,694,10.9
72125,2020-05-01,8828,7925,903,10.2
72127,2020-05-01,127659,116897,10762,8.4
72129,2020-05-01,10629,9666,963,9.1
72131,2020-05-01,9270,8083,1187,12.8
72133,2020-05-01,7686,7156,530,6.9
72135,2020-05-01,25377,23234,2143,8.4
72137,2020-05-01,27355,24996,2359,8.6
72139,2020-05-01,25216,23492,1724,6.8
72141,2020-05-01,5905,5335,570,9.7
72143,2020-05-01,9126,8080,1046,11.5
72145,2020-05-01,12449,10812,1637,13.1
72147,2020-05-01,2517,2291,226,9
72149,2020-05-01,6484,5833,651,10
72151,2020-05-01,7847,6992,855,10.9
72153,2020-05-01,8813,7732,1081,12.3
01001,2020-06-01,25060,23412,1648,6.6
01003,2020-06-01,97972,90847,7125,7.3
01005,2020-06-01,8949,8166,783,8.7
01007,2020-06-01,8550,7824,726,8.5
01009,2020-06-01,24380,23010,1370,5.6
01011,2020-06-01,4810,4498,312,6.5
01013,2020-06-01,9481,8469,1012,10.7
01015,2020-06-01,44000,39888,4112,9.3
01017,2020-06-01,16168,14638,1530,9.5
01019,2020-06-01,11619,10937,682,5.9
01021,2020-06-01,19285,17994,1291,6.7
01023,2020-06-01,4537,4104,433,9.5
01025,2020-06-01,7899,7029,870,11
01027,2020-06-01,6159,5880,279,4.5
01029,2020-06-01,5636,5298,338,6
01031,2020-06-01,21606,20328,1278,5.9
01033,2020-06-01,22870,20863,2007,8.8
01035,2020-06-01,4691,4269,422,9
01037,2020-06-01,4556,4250,306,6.7
01039,2020-06-01,15563,14577,986,6.3
01041,2020-06-01,6522,6079,443,6.8
01043,2020-06-01,38756,36678,2078,5.4
01045,2020-06-01,20603,19280,1323,6.4
01047,2020-06-01,15126,13141,1985,13.1
01049,2020-06-01,31374,29629,1745,5.6
01051,2020-06-01,35946,33590,2356,6.6
01053,2020-06-01,14955,13766,1189,8
01055,2020-06-01,40566,36642,3924,9.7
01057,2020-06-01,6591,6137,454,6.9
01059,2020-06-01,14584,13761,823,5.6
01061,2020-06-01,10708,10108,600,5.6
01063,2020-06-01,3096,2673,423,13.7
01065,2020-06-01,6167,5439,728,11.8
01067,2020-06-01,6689,6264,425,6.4
01069,2020-06-01,44981,41631,3350,7.4
01071,2020-06-01,23419,21822,1597,6.8
01073,2020-06-01,313654,287043,26611,8.5
01075,2020-06-01,5808,5446,362,6.2
01077,2020-06-01,40791,37776,3015,7.4
01079,2020-06-01,13654,12725,929,6.8
01081,2020-06-01,72148,66840,5308,7.4
01083,2020-06-01,42228,39828,2400,5.7
01085,2020-06-01,3755,3124,631,16.8
01087,2020-06-01,8115,7074,1041,12.8
01089,2020-06-01,179671,167971,11700,6.5
01091,2020-06-01,7867,7238,629,8
01093,2020-06-01,13318,12476,842,6.3
01095,2020-06-01,44659,42286,2373,5.3
01097,2020-06-01,187486,166060,21426,11.4
01099,2020-06-01,7781,6973,808,10.4
01101,2020-06-01,105411,93966,11445,10.9
01103,2020-06-01,55286,51847,3439,6.2
01105,2020-06-01,3613,3115,498,13.8
01107,2020-06-01,7633,6992,641,8.4
01109,2020-06-01,15660,14613,1047,6.7
01111,2020-06-01,9672,9049,623,6.4
01113,2020-06-01,22844,21161,1683,7.4
01115,2020-06-01,39171,36627,2544,6.5
01117,2020-06-01,111112,105169,5943,5.3
01119,2020-06-01,4883,4419,464,9.5
01121,2020-06-01,35974,32986,2988,8.3
01123,2020-06-01,19111,17527,1584,8.3
01125,2020-06-01,101335,92356,8979,8.9
01127,2020-06-01,24752,22801,1951,7.9
01129,2020-06-01,7017,6240,777,11.1
01131,2020-06-01,3061,2500,561,18.3
01133,2020-06-01,10105,9486,619,6.1
02013,2020-06-01,2495,2355,140,5.6
02016,2020-06-01,3206,2900,306,9.5
02020,2020-06-01,148733,130926,17807,12
02050,2020-06-01,7478,6298,1180,15.8
02060,2020-06-01,682,635,47,6.9
02068,2020-06-01,1363,1197,166,12.2
02070,2020-06-01,2317,2084,233,10.1
02090,2020-06-01,43811,39226,4585,10.5
02100,2020-06-01,1270,1015,255,20.1
02105,2020-06-01,1274,1061,213,16.7
02110,2020-06-01,16481,14551,1930,11.7
02122,2020-06-01,26860,23251,3609,13.4
02130,2020-06-01,6942,5937,1005,14.5
02150,2020-06-01,5686,5100,586,10.3
02158,2020-06-01,2598,1955,643,24.7
02164,2020-06-01,859,753,106,12.3
02170,2020-06-01,47200,41015,6185,13.1
02180,2020-06-01,4045,3393,652,16.1
02185,2020-06-01,3092,2786,306,9.9
02188,2020-06-01,2858,2320,538,18.8
02195,2020-06-01,1342,1159,183,13.6
02198,2020-06-01,2950,2533,417,14.1
02220,2020-06-01,4446,3921,525,11.8
02230,2020-06-01,961,781,180,18.7
02240,2020-06-01,2815,2511,304,10.8
02261,2020-06-01,5168,4635,533,10.3
02275,2020-06-01,1026,894,132,12.9
02282,2020-06-01,233,203,30,12.9
02290,2020-06-01,2609,2185,424,16.3
04001,2020-06-01,19679,16476,3203,16.3
04003,2020-06-01,50825,46355,4470,8.8
04005,2020-06-01,70331,60945,9386,13.3
04007,2020-06-01,20675,18765,1910,9.2
04009,2020-06-01,14916,13591,1325,8.9
04011,2020-06-01,4625,4296,329,7.1
04012,2020-06-01,8750,8051,699,8
04013,2020-06-01,NA,NA,223946,9.8
04015,2020-06-01,86439,75455,10984,12.7
04017,2020-06-01,39757,34625,5132,12.9
04019,2020-06-01,496222,447038,49184,9.9
04021,2020-06-01,182956,164821,18135,9.9
04023,2020-06-01,18760,16215,2545,13.6
04025,2020-06-01,108470,98460,10010,9.2
04027,2020-06-01,92547,72198,20349,22
05001,2020-06-01,9098,8581,517,5.7
05003,2020-06-01,7336,6496,840,11.5
05005,2020-06-01,16133,14665,1468,9.1
05007,2020-06-01,134076,125540,8536,6.4
05009,2020-06-01,15734,14639,1095,7
05011,2020-06-01,4333,4004,329,7.6
05013,2020-06-01,2350,2191,159,6.8
05015,2020-06-01,12497,11563,934,7.5
05017,2020-06-01,3129,2696,433,13.8
05019,2020-06-01,9508,8714,794,8.4
05021,2020-06-01,5413,4960,453,8.4
05023,2020-06-01,8958,8093,865,9.7
05025,2020-06-01,3121,2880,241,7.7
05027,2020-06-01,9156,8378,778,8.5
05029,2020-06-01,8087,7426,661,8.2
05031,2020-06-01,55214,50863,4351,7.9
05033,2020-06-01,26095,24181,1914,7.3
05035,2020-06-01,21093,18592,2501,11.9
05037,2020-06-01,7176,6644,532,7.4
05039,2020-06-01,2684,2479,205,7.6
05041,2020-06-01,5196,4716,480,9.2
05043,2020-06-01,7547,6883,664,8.8
05045,2020-06-01,60070,55428,4642,7.7
05047,2020-06-01,7312,6755,557,7.6
05049,2020-06-01,4916,4560,356,7.2
05051,2020-06-01,41219,36724,4495,10.9
05053,2020-06-01,8023,7434,589,7.3
05055,2020-06-01,19775,18077,1698,8.6
05057,2020-06-01,9494,8839,655,6.9
05059,2020-06-01,13680,12588,1092,8
05061,2020-06-01,5366,5017,349,6.5
05063,2020-06-01,16428,15165,1263,7.7
05065,2020-06-01,4815,4278,537,11.2
05067,2020-06-01,5464,4938,526,9.6
05069,2020-06-01,27370,24604,2766,10.1
05071,2020-06-01,9928,9116,812,8.2
05073,2020-06-01,2407,2168,239,9.9
05075,2020-06-01,6788,6213,575,8.5
05077,2020-06-01,2677,2419,258,9.6
05079,2020-06-01,3802,3512,290,7.6
05081,2020-06-01,5393,4952,441,8.2
05083,2020-06-01,8210,7428,782,9.5
05085,2020-06-01,33023,30473,2550,7.7
05087,2020-06-01,7108,6730,378,5.3
05089,2020-06-01,6519,5955,564,8.7
05091,2020-06-01,19490,17754,1736,8.9
05093,2020-06-01,17428,15212,2216,12.7
05095,2020-06-01,2691,2436,255,9.5
05097,2020-06-01,2795,2537,258,9.2
05099,2020-06-01,3561,3258,303,8.5
05101,2020-06-01,3233,3016,217,6.7
05103,2020-06-01,9546,8787,759,8
05105,2020-06-01,4038,3743,295,7.3
05107,2020-06-01,6184,5435,749,12.1
05109,2020-06-01,4133,3806,327,7.9
05111,2020-06-01,10013,9276,737,7.4
05113,2020-06-01,7824,7169,655,8.4
05115,2020-06-01,28369,26176,2193,7.7
05117,2020-06-01,3483,3199,284,8.2
05119,2020-06-01,187577,168335,19242,10.3
05121,2020-06-01,7253,6681,572,7.9
05123,2020-06-01,8000,7214,786,9.8
05125,2020-06-01,56765,52619,4146,7.3
05127,2020-06-01,4198,3939,259,6.2
05129,2020-06-01,2810,2570,240,8.5
05131,2020-06-01,55450,51013,4437,8
05133,2020-06-01,5310,4917,393,7.4
05135,2020-06-01,5693,5145,548,9.6
05137,2020-06-01,4571,4139,432,9.5
05139,2020-06-01,15578,13837,1741,11.2
05141,2020-06-01,5623,5107,516,9.2
05143,2020-06-01,122647,114541,8106,6.6
05145,2020-06-01,33083,30269,2814,8.5
05147,2020-06-01,2607,2403,204,7.8
05149,2020-06-01,8121,7595,526,6.5
06001,2020-06-01,824065,712987,111078,13.5
06003,2020-06-01,480,387,93,19.4
06005,2020-06-01,14457,12615,1842,12.7
06007,2020-06-01,93734,82294,11440,12.2
06009,2020-06-01,20660,18392,2268,11
06011,2020-06-01,9945,8118,1827,18.4
06013,2020-06-01,546913,473489,73424,13.4
06015,2020-06-01,9322,8156,1166,12.5
06017,2020-06-01,90884,79212,11672,12.8
06019,2020-06-01,450021,384869,65152,14.5
06021,2020-06-01,11088,9668,1420,12.8
06023,2020-06-01,59888,52908,6980,11.7
06025,2020-06-01,73161,53082,20079,27.4
06027,2020-06-01,8320,7405,915,11
06029,2020-06-01,375049,309572,65477,17.5
06031,2020-06-01,57031,48836,8195,14.4
06033,2020-06-01,25853,22179,3674,14.2
06035,2020-06-01,8861,8027,834,9.4
06037,2020-06-01,NA,NA,865005,17.9
06039,2020-06-01,62205,53564,8641,13.9
06041,2020-06-01,132971,119545,13426,10.1
06043,2020-06-01,7872,6760,1112,14.1
06045,2020-06-01,37719,33057,4662,12.4
06047,2020-06-01,114591,96703,17888,15.6
06049,2020-06-01,3068,2767,301,9.8
06051,2020-06-01,6774,5104,1670,24.7
06053,2020-06-01,203516,174210,29306,14.4
06055,2020-06-01,73298,64044,9254,12.6
06057,2020-06-01,41196,35809,5387,13.1
06059,2020-06-01,NA,NA,217619,13.6
06061,2020-06-01,183001,162626,20375,11.1
06063,2020-06-01,6776,5850,926,13.7
06065,2020-06-01,NA,939253,161873,14.7
06067,2020-06-01,709583,613336,96247,13.6
06069,2020-06-01,31248,26961,4287,13.7
06071,2020-06-01,958185,826031,132154,13.8
06073,2020-06-01,NA,NA,219345,13.8
06075,2020-06-01,569986,498786,71200,12.5
06077,2020-06-01,327409,275626,51783,15.8
06079,2020-06-01,132859,117629,15230,11.5
06081,2020-06-01,441686,393929,47757,10.8
06083,2020-06-01,213557,188894,24663,11.5
06085,2020-06-01,NA,926706,110653,10.7
06087,2020-06-01,132288,114932,17356,13.1
06089,2020-06-01,72702,64354,8348,11.5
06091,2020-06-01,1187,1053,134,11.3
06093,2020-06-01,16249,14228,2021,12.4
06095,2020-06-01,203712,176066,27646,13.6
06097,2020-06-01,252242,222886,29356,11.6
06099,2020-06-01,236496,201109,35387,15
06101,2020-06-01,43232,36750,6482,15
06103,2020-06-01,24754,21836,2918,11.8
06105,2020-06-01,4550,4114,436,9.6
06107,2020-06-01,195252,161873,33379,17.1
06109,2020-06-01,20568,17620,2948,14.3
06111,2020-06-01,412869,360985,51884,12.6
06113,2020-06-01,104298,93378,10920,10.5
06115,2020-06-01,28714,24618,4096,14.3
08001,2020-06-01,282953,249876,33077,11.7
08003,2020-06-01,8002,7269,733,9.2
08005,2020-06-01,379772,335780,43992,11.6
08007,2020-06-01,7269,6443,826,11.4
08009,2020-06-01,1861,1784,77,4.1
08011,2020-06-01,1660,1551,109,6.6
08013,2020-06-01,198765,179764,19001,9.6
08014,2020-06-01,41156,36969,4187,10.2
08015,2020-06-01,10573,9599,974,9.2
08017,2020-06-01,1021,982,39,3.8
08019,2020-06-01,6413,5581,832,13
08021,2020-06-01,3740,3447,293,7.8
08023,2020-06-01,1732,1554,178,10.3
08025,2020-06-01,1329,1227,102,7.7
08027,2020-06-01,2021,1856,165,8.2
08029,2020-06-01,13953,12600,1353,9.7
08031,2020-06-01,436243,383849,52394,12
08033,2020-06-01,1110,997,113,10.2
08035,2020-06-01,196587,179311,17276,8.8
08037,2020-06-01,38073,32046,6027,15.8
08039,2020-06-01,15004,13937,1067,7.1
08041,2020-06-01,352626,315687,36939,10.5
08043,2020-06-01,15113,13459,1654,10.9
08045,2020-06-01,33113,29887,3226,9.7
08047,2020-06-01,4359,3497,862,19.8
08049,2020-06-01,9898,8584,1314,13.3
08051,2020-06-01,11693,10422,1271,10.9
08053,2020-06-01,441,416,25,5.7
08055,2020-06-01,2390,2054,336,14.1
08057,2020-06-01,932,882,50,5.4
08059,2020-06-01,345481,309160,36321,10.5
08061,2020-06-01,844,810,34,4
08063,2020-06-01,3838,3660,178,4.6
08065,2020-06-01,5061,4358,703,13.9
08067,2020-06-01,31395,28136,3259,10.4
08069,2020-06-01,209794,190396,19398,9.2
08071,2020-06-01,6097,5407,690,11.3
08073,2020-06-01,2015,1873,142,7
08075,2020-06-01,9764,9017,747,7.7
08077,2020-06-01,79237,71203,8034,10.1
08079,2020-06-01,534,489,45,8.4
08081,2020-06-01,6588,5996,592,9
08083,2020-06-01,11552,10362,1190,10.3
08085,2020-06-01,20083,17996,2087,10.4
08087,2020-06-01,14767,13489,1278,8.7
08089,2020-06-01,7530,6866,664,8.8
08091,2020-06-01,2754,2413,341,12.4
08093,2020-06-01,11296,10324,972,8.6
08095,2020-06-01,2366,2253,113,4.8
08097,2020-06-01,12334,10351,1983,16.1
08099,2020-06-01,5781,5395,386,6.7
08101,2020-06-01,77445,68993,8452,10.9
08103,2020-06-01,2771,2552,219,7.9
08105,2020-06-01,5013,4521,492,9.8
08107,2020-06-01,16378,14224,2154,13.2
08109,2020-06-01,3405,3070,335,9.8
08111,2020-06-01,691,634,57,8.2
08113,2020-06-01,6302,5219,1083,17.2
08115,2020-06-01,1127,1064,63,5.6
08117,2020-06-01,23740,19774,3966,16.7
08119,2020-06-01,13419,11874,1545,11.5
08121,2020-06-01,2450,2323,127,5.2
08123,2020-06-01,170164,152935,17229,10.1
08125,2020-06-01,5287,5030,257,4.9
09001,2020-06-01,471357,422345,49012,10.4
09003,2020-06-01,483530,433058,50472,10.4
09005,2020-06-01,103482,94682,8800,8.5
09007,2020-06-01,93233,85421,7812,8.4
09009,2020-06-01,459710,413296,46414,10.1
09011,2020-06-01,136450,118964,17486,12.8
09013,2020-06-01,85478,78683,6795,7.9
09015,2020-06-01,63201,57054,6147,9.7
10001,2020-06-01,83141,71507,11634,14
10003,2020-06-01,297828,259016,38812,13
10005,2020-06-01,109483,96746,12737,11.6
11001,2020-06-01,400830,364052,36778,9.2
12001,2020-06-01,126728,118486,8242,6.5
12003,2020-06-01,11044,10392,652,5.9
12005,2020-06-01,79907,74431,5476,6.9
12007,2020-06-01,10276,9554,722,7
12009,2020-06-01,275374,252731,22643,8.2
12011,2020-06-01,994236,877175,117061,11.8
12013,2020-06-01,4439,4163,276,6.2
12015,2020-06-01,68811,62573,6238,9.1
12017,2020-06-01,45532,41048,4484,9.8
12019,2020-06-01,101202,94495,6707,6.6
12021,2020-06-01,167548,151743,15805,9.4
12023,2020-06-01,27820,25938,1882,6.8
12027,2020-06-01,13881,13066,815,5.9
12029,2020-06-01,5276,4916,360,6.8
12031,2020-06-01,469978,430717,39261,8.4
12033,2020-06-01,136917,126151,10766,7.9
12035,2020-06-01,44732,40505,4227,9.4
12037,2020-06-01,4243,3978,265,6.2
12039,2020-06-01,17866,16547,1319,7.4
12041,2020-06-01,6424,6064,360,5.6
12043,2020-06-01,4771,4430,341,7.1
12045,2020-06-01,5417,5046,371,6.8
12047,2020-06-01,4205,3850,355,8.4
12049,2020-06-01,7745,7105,640,8.3
12051,2020-06-01,13787,12328,1459,10.6
12053,2020-06-01,68749,61900,6849,10
12055,2020-06-01,34748,31652,3096,8.9
12057,2020-06-01,716859,652027,64832,9
12059,2020-06-01,6503,6082,421,6.5
12061,2020-06-01,61612,55922,5690,9.2
12063,2020-06-01,15580,14503,1077,6.9
12065,2020-06-01,5099,4762,337,6.6
12067,2020-06-01,2547,2426,121,4.8
12069,2020-06-01,146356,126154,20202,13.8
12071,2020-06-01,329431,297787,31644,9.6
12073,2020-06-01,141763,131771,9992,7
12075,2020-06-01,15446,14326,1120,7.3
12077,2020-06-01,2404,2263,141,5.9
12079,2020-06-01,6961,6474,487,7
12081,2020-06-01,168961,154775,14186,8.4
12083,2020-06-01,133762,122711,11051,8.3
12085,2020-06-01,70722,65209,5513,7.8
12086,2020-06-01,NA,NA,120162,10.1
12087,2020-06-01,47287,42692,4595,9.7
12089,2020-06-01,38965,36155,2810,7.2
12091,2020-06-01,91408,85751,5657,6.2
12093,2020-06-01,15979,14896,1083,6.8
12095,2020-06-01,727696,605014,122682,16.9
12097,2020-06-01,187545,145635,41910,22.3
12099,2020-06-01,678697,609627,69070,10.2
12101,2020-06-01,227219,206532,20687,9.1
12103,2020-06-01,472347,430885,41462,8.8
12105,2020-06-01,303137,261848,41289,13.6
12107,2020-06-01,24537,22264,2273,9.3
12109,2020-06-01,125217,116751,8466,6.8
12111,2020-06-01,140230,126641,13589,9.7
12113,2020-06-01,76752,71893,4859,6.3
12115,2020-06-01,177767,162577,15190,8.5
12117,2020-06-01,225437,202781,22656,10
12119,2020-06-01,31064,28146,2918,9.4
12121,2020-06-01,17068,15909,1159,6.8
12123,2020-06-01,7786,7233,553,7.1
12125,2020-06-01,4122,3900,222,5.4
12127,2020-06-01,242623,219535,23088,9.5
12129,2020-06-01,13464,12707,757,5.6
12131,2020-06-01,29896,27853,2043,6.8
12133,2020-06-01,8899,8290,609,6.8
13001,2020-06-01,9236,8808,428,4.6
13003,2020-06-01,4260,4084,176,4.1
13005,2020-06-01,4714,4487,227,4.8
13007,2020-06-01,1102,1028,74,6.7
13009,2020-06-01,17398,16041,1357,7.8
13011,2020-06-01,9532,9080,452,4.7
13013,2020-06-01,38228,35927,2301,6
13015,2020-06-01,48244,44751,3493,7.2
13017,2020-06-01,5199,4836,363,7
13019,2020-06-01,7181,6787,394,5.5
13021,2020-06-01,64849,59263,5586,8.6
13023,2020-06-01,4235,3940,295,7
13025,2020-06-01,6232,5828,404,6.5
13027,2020-06-01,6566,6212,354,5.4
13029,2020-06-01,17233,16113,1120,6.5
13031,2020-06-01,36086,33368,2718,7.5
13033,2020-06-01,8701,8001,700,8
13035,2020-06-01,10269,9503,766,7.5
13037,2020-06-01,2231,2106,125,5.6
13039,2020-06-01,19963,18881,1082,5.4
13043,2020-06-01,5511,5249,262,4.8
13045,2020-06-01,52730,48745,3985,7.6
13047,2020-06-01,32529,30910,1619,5
13049,2020-06-01,4602,4416,186,4
13051,2020-06-01,135516,122732,12784,9.4
13053,2020-06-01,1855,1730,125,6.7
13055,2020-06-01,9923,8897,1026,10.3
13057,2020-06-01,128550,120718,7832,6.1
13059,2020-06-01,56931,52531,4400,7.7
13061,2020-06-01,921,794,127,13.8
13063,2020-06-01,138416,120847,17569,12.7
13065,2020-06-01,2430,2322,108,4.4
13067,2020-06-01,407524,377141,30383,7.5
13069,2020-06-01,18561,17452,1109,6
13071,2020-06-01,21023,20042,981,4.7
13073,2020-06-01,70362,66777,3585,5.1
13075,2020-06-01,7828,7454,374,4.8
13077,2020-06-01,72060,66265,5795,8
13079,2020-06-01,5228,4918,310,5.9
13081,2020-06-01,9544,8840,704,7.4
13083,2020-06-01,7814,7467,347,4.4
13085,2020-06-01,11566,10919,647,5.6
13087,2020-06-01,11045,10528,517,4.7
13089,2020-06-01,392160,352766,39394,10
13091,2020-06-01,6521,6116,405,6.2
13093,2020-06-01,4949,4586,363,7.3
13095,2020-06-01,37030,33488,3542,9.6
13097,2020-06-01,71293,64596,6697,9.4
13099,2020-06-01,4353,4098,255,5.9
13101,2020-06-01,1826,1743,83,4.5
13103,2020-06-01,29037,27294,1743,6
13105,2020-06-01,7760,7153,607,7.8
13107,2020-06-01,7951,7360,591,7.4
13109,2020-06-01,4749,4489,260,5.5
13111,2020-06-01,12119,11573,546,4.5
13113,2020-06-01,55436,51483,3953,7.1
13115,2020-06-01,44021,40951,3070,7
13117,2020-06-01,115322,108595,6727,5.8
13119,2020-06-01,9816,9142,674,6.9
13121,2020-06-01,547622,491723,55899,10.2
13123,2020-06-01,10951,10340,611,5.6
13125,2020-06-01,1191,1140,51,4.3
13127,2020-06-01,34434,31569,2865,8.3
13129,2020-06-01,28133,26512,1621,5.8
13131,2020-06-01,9981,9491,490,4.9
13133,2020-06-01,6974,6535,439,6.3
13135,2020-06-01,472240,433874,38366,8.1
13137,2020-06-01,18487,17334,1153,6.2
13139,2020-06-01,97315,91731,5584,5.7
13141,2020-06-01,2463,2226,237,9.6
13143,2020-06-01,11882,11085,797,6.7
13145,2020-06-01,15515,14588,927,6
13147,2020-06-01,10775,10116,659,6.1
13149,2020-06-01,5034,4641,393,7.8
13151,2020-06-01,112509,102110,10399,9.2
13153,2020-06-01,66014,61953,4061,6.2
13155,2020-06-01,3272,3083,189,5.8
13157,2020-06-01,36235,34367,1868,5.2
13159,2020-06-01,6507,6150,357,5.5
13161,2020-06-01,5732,5425,307,5.4
13163,2020-06-01,6442,5993,449,7
13165,2020-06-01,3004,2796,208,6.9
13167,2020-06-01,3899,3707,192,4.9
13169,2020-06-01,12704,12050,654,5.1
13171,2020-06-01,7788,7221,567,7.3
13173,2020-06-01,3535,3352,183,5.2
13175,2020-06-01,18712,17403,1309,7
13177,2020-06-01,13849,13085,764,5.5
13179,2020-06-01,25651,23875,1776,6.9
13181,2020-06-01,3338,3144,194,5.8
13183,2020-06-01,7814,7434,380,4.9
13185,2020-06-01,49507,46091,3416,6.9
13187,2020-06-01,15668,14740,928,5.9
13189,2020-06-01,8474,7717,757,8.9
13191,2020-06-01,5361,4988,373,7
13193,2020-06-01,4491,4170,321,7.1
13195,2020-06-01,12552,11838,714,5.7
13197,2020-06-01,3040,2859,181,6
13199,2020-06-01,8690,7777,913,10.5
13201,2020-06-01,2635,2523,112,4.3
13205,2020-06-01,8077,7528,549,6.8
13207,2020-06-01,12133,11409,724,6
13209,2020-06-01,3774,3548,226,6
13211,2020-06-01,8713,8175,538,6.2
13213,2020-06-01,14668,13521,1147,7.8
13215,2020-06-01,74141,66841,7300,9.8
13217,2020-06-01,50196,45934,4262,8.5
13219,2020-06-01,18315,17479,836,4.6
13221,2020-06-01,6535,6188,347,5.3
13223,2020-06-01,81961,76354,5607,6.8
13225,2020-06-01,11104,10335,769,6.9
13227,2020-06-01,14398,13554,844,5.9
13229,2020-06-01,8341,7925,416,5
13231,2020-06-01,8410,7884,526,6.3
13233,2020-06-01,17852,16599,1253,7
13235,2020-06-01,3728,3550,178,4.8
13237,2020-06-01,7931,7297,634,8
13239,2020-06-01,795,729,66,8.3
13241,2020-06-01,7028,6617,411,5.8
13243,2020-06-01,2493,2331,162,6.5
13245,2020-06-01,81800,74627,7173,8.8
13247,2020-06-01,43349,39381,3968,9.2
13249,2020-06-01,2191,2094,97,4.4
13251,2020-06-01,4988,4550,438,8.8
13253,2020-06-01,2931,2779,152,5.2
13255,2020-06-01,27635,25188,2447,8.9
13257,2020-06-01,10544,9775,769,7.3
13259,2020-06-01,2527,2374,153,6.1
13261,2020-06-01,12911,11988,923,7.1
13263,2020-06-01,2701,2471,230,8.5
13265,2020-06-01,559,522,37,6.6
13267,2020-06-01,9130,8717,413,4.5
13269,2020-06-01,2815,2632,183,6.5
13271,2020-06-01,3532,3171,361,10.2
13273,2020-06-01,3332,3058,274,8.2
13275,2020-06-01,16280,15191,1089,6.7
13277,2020-06-01,19568,18512,1056,5.4
13279,2020-06-01,11708,10861,847,7.2
13281,2020-06-01,3587,3288,299,8.3
13283,2020-06-01,2540,2379,161,6.3
13285,2020-06-01,38256,34776,3480,9.1
13287,2020-06-01,3112,2877,235,7.6
13289,2020-06-01,2699,2484,215,8
13291,2020-06-01,10010,9511,499,5
13293,2020-06-01,11083,10222,861,7.8
13295,2020-06-01,30422,28753,1669,5.5
13297,2020-06-01,43486,40826,2660,6.1
13299,2020-06-01,15045,14156,889,5.9
13301,2020-06-01,2734,2544,190,6.9
13303,2020-06-01,6545,6104,441,6.7
13305,2020-06-01,10831,10172,659,6.1
13307,2020-06-01,997,936,61,6.1
13309,2020-06-01,1547,1433,114,7.4
13311,2020-06-01,16328,15540,788,4.8
13313,2020-06-01,41302,38217,3085,7.5
13315,2020-06-01,2599,2444,155,6
13317,2020-06-01,3793,3535,258,6.8
13319,2020-06-01,3897,3676,221,5.7
13321,2020-06-01,8344,7862,482,5.8
15001,2020-06-01,88565,76886,11679,13.2
15003,2020-06-01,426792,374926,51866,12.2
15007,2020-06-01,35668,28762,6906,19.4
15009,2020-06-01,82147,64396,17751,21.6
16001,2020-06-01,263050,247938,15112,5.7
16003,2020-06-01,1833,1692,141,7.7
16005,2020-06-01,40977,38922,2055,5
16007,2020-06-01,3130,3011,119,3.8
16009,2020-06-01,4245,3967,278,6.5
16011,2020-06-01,24332,23438,894,3.7
16013,2020-06-01,13373,12212,1161,8.7
16015,2020-06-01,3674,3377,297,8.1
16017,2020-06-01,21376,19781,1595,7.5
16019,2020-06-01,61067,58748,2319,3.8
16021,2020-06-01,5600,5294,306,5.5
16023,2020-06-01,1479,1431,48,3.2
16025,2020-06-01,724,690,34,4.7
16027,2020-06-01,107960,101476,6484,6
16029,2020-06-01,4244,4106,138,3.3
16031,2020-06-01,12436,11975,461,3.7
16033,2020-06-01,389,375,14,3.6
16035,2020-06-01,2905,2680,225,7.7
16037,2020-06-01,2446,2351,95,3.9
16039,2020-06-01,12153,11564,589,4.8
16041,2020-06-01,7008,6742,266,3.8
16043,2020-06-01,7941,7682,259,3.3
16045,2020-06-01,8594,8083,511,5.9
16047,2020-06-01,8355,8058,297,3.6
16049,2020-06-01,6987,6547,440,6.3
16051,2020-06-01,14919,14434,485,3.3
16053,2020-06-01,12350,11896,454,3.7
16055,2020-06-01,80744,75156,5588,6.9
16057,2020-06-01,19187,18184,1003,5.2
16059,2020-06-01,3804,3570,234,6.2
16061,2020-06-01,1759,1639,120,6.8
16063,2020-06-01,2786,2640,146,5.2
16065,2020-06-01,22072,21430,642,2.9
16067,2020-06-01,11611,11157,454,3.9
16069,2020-06-01,19990,18971,1019,5.1
16071,2020-06-01,2459,2327,132,5.4
16073,2020-06-01,6090,5749,341,5.6
16075,2020-06-01,11961,11308,653,5.5
16077,2020-06-01,4055,3887,168,4.1
16079,2020-06-01,5210,4722,488,9.4
16081,2020-06-01,6962,6520,442,6.3
16083,2020-06-01,42072,39788,2284,5.4
16085,2020-06-01,6309,5877,432,6.8
16087,2020-06-01,4739,4474,265,5.6
17001,2020-06-01,32708,29820,2888,8.8
17003,2020-06-01,1991,1711,280,14.1
17005,2020-06-01,7776,6946,830,10.7
17007,2020-06-01,26246,22175,4071,15.5
17009,2020-06-01,2814,2643,171,6.1
17011,2020-06-01,17574,15827,1747,9.9
17013,2020-06-01,2331,2051,280,12
17015,2020-06-01,7759,7005,754,9.7
17017,2020-06-01,6233,5649,584,9.4
17019,2020-06-01,104238,93411,10827,10.4
17021,2020-06-01,14381,12800,1581,11
17023,2020-06-01,7620,6806,814,10.7
17025,2020-06-01,6333,5565,768,12.1
17027,2020-06-01,20038,18326,1712,8.5
17029,2020-06-01,23176,20498,2678,11.6
17031,2020-06-01,NA,NA,475801,17.4
17033,2020-06-01,8593,7783,810,9.4
17035,2020-06-01,6066,5569,497,8.2
17037,2020-06-01,53663,47137,6526,12.2
17039,2020-06-01,7010,6352,658,9.4
17041,2020-06-01,10232,9366,866,8.5
17043,2020-06-01,512705,445977,66728,13
17045,2020-06-01,8784,7985,799,9.1
17047,2020-06-01,2816,2556,260,9.2
17049,2020-06-01,19889,17883,2006,10.1
17051,2020-06-01,10137,9084,1053,10.4
17053,2020-06-01,6178,5591,587,9.5
17055,2020-06-01,16683,14287,2396,14.4
17057,2020-06-01,15035,13231,1804,12
17059,2020-06-01,2291,2031,260,11.3
17061,2020-06-01,6115,5580,535,8.7
17063,2020-06-01,25552,22012,3540,13.9
17065,2020-06-01,4241,3858,383,9
17067,2020-06-01,8527,7778,749,8.8
17069,2020-06-01,1361,1177,184,13.5
17071,2020-06-01,3826,3430,396,10.4
17073,2020-06-01,24843,22187,2656,10.7
17075,2020-06-01,14657,13518,1139,7.8
17077,2020-06-01,27527,24256,3271,11.9
17079,2020-06-01,4994,4589,405,8.1
17081,2020-06-01,17742,15361,2381,13.4
17083,2020-06-01,10954,9704,1250,11.4
17085,2020-06-01,11082,9854,1228,11.1
17087,2020-06-01,4168,3639,529,12.7
17089,2020-06-01,267987,232254,35733,13.3
17091,2020-06-01,56653,49848,6805,12
17093,2020-06-01,69608,60019,9589,13.8
17095,2020-06-01,21946,19343,2603,11.9
17097,2020-06-01,371406,328616,42790,11.5
17099,2020-06-01,55166,47678,7488,13.6
17101,2020-06-01,5941,5298,643,10.8
17103,2020-06-01,17497,15761,1736,9.9
17105,2020-06-01,16734,14937,1797,10.7
17107,2020-06-01,12448,11247,1201,9.6
17109,2020-06-01,12388,11011,1377,11.1
17111,2020-06-01,167202,144911,22291,13.3
17113,2020-06-01,83905,74972,8933,10.6
17115,2020-06-01,47944,41027,6917,14.4
17117,2020-06-01,22706,20376,2330,10.3
17119,2020-06-01,135537,119075,16462,12.1
17121,2020-06-01,17718,15534,2184,12.3
17123,2020-06-01,5040,4512,528,10.5
17125,2020-06-01,6398,5711,687,10.7
17127,2020-06-01,5656,4746,910,16.1
17129,2020-06-01,6312,5763,549,8.7
17131,2020-06-01,8052,7185,867,10.8
17133,2020-06-01,18462,16821,1641,8.9
17135,2020-06-01,11962,10487,1475,12.3
17137,2020-06-01,16570,15024,1546,9.3
17139,2020-06-01,7660,7109,551,7.2
17141,2020-06-01,25110,22294,2816,11.2
17143,2020-06-01,83848,70921,12927,15.4
17145,2020-06-01,8402,7357,1045,12.4
17147,2020-06-01,8089,7442,647,8
17149,2020-06-01,7169,6595,574,8
17151,2020-06-01,1708,1497,211,12.4
17153,2020-06-01,1990,1699,291,14.6
17155,2020-06-01,3208,2861,347,10.8
17157,2020-06-01,14194,12798,1396,9.8
17159,2020-06-01,7340,6664,676,9.2
17161,2020-06-01,72545,62995,9550,13.2
17163,2020-06-01,129914,111691,18223,14
17165,2020-06-01,9868,8519,1349,13.7
17167,2020-06-01,101070,89062,12008,11.9
17169,2020-06-01,3393,3108,285,8.4
17171,2020-06-01,2573,2374,199,7.7
17173,2020-06-01,10794,9819,975,9
17175,2020-06-01,2369,2137,232,9.8
17177,2020-06-01,22151,20053,2098,9.5
17179,2020-06-01,61309,53735,7574,12.4
17181,2020-06-01,7528,6682,846,11.2
17183,2020-06-01,33263,29172,4091,12.3
17185,2020-06-01,6163,5560,603,9.8
17187,2020-06-01,8504,7758,746,8.8
17189,2020-06-01,9180,8530,650,7.1
17191,2020-06-01,7251,6485,766,10.6
17193,2020-06-01,6566,5934,632,9.6
17195,2020-06-01,28579,25253,3326,11.6
17197,2020-06-01,366030,310742,55288,15.1
17199,2020-06-01,31610,27602,4008,12.7
17201,2020-06-01,140157,117706,22451,16
17203,2020-06-01,17569,15943,1626,9.3
18001,2020-06-01,17152,15825,1327,7.7
18003,2020-06-01,193140,170593,22547,11.7
18005,2020-06-01,45209,40427,4782,10.6
18007,2020-06-01,4383,4050,333,7.6
18009,2020-06-01,5014,4370,644,12.8
18011,2020-06-01,36123,33557,2566,7.1
18013,2020-06-01,7984,7126,858,10.7
18015,2020-06-01,9933,9089,844,8.5
18017,2020-06-01,18287,16343,1944,10.6
18019,2020-06-01,61634,54371,7263,11.8
18021,2020-06-01,11887,10751,1136,9.6
18023,2020-06-01,17583,15999,1584,9
18025,2020-06-01,4942,4423,519,10.5
18027,2020-06-01,16573,15624,949,5.7
18029,2020-06-01,26096,23163,2933,11.2
18031,2020-06-01,15727,14051,1676,10.7
18033,2020-06-01,22879,20608,2271,9.9
18035,2020-06-01,52975,47047,5928,11.2
18037,2020-06-01,23125,21489,1636,7.1
18039,2020-06-01,110145,98320,11825,10.7
18041,2020-06-01,8953,7591,1362,15.2
18043,2020-06-01,41205,36780,4425,10.7
18045,2020-06-01,8052,7268,784,9.7
18047,2020-06-01,11472,10516,956,8.3
18049,2020-06-01,10204,9156,1048,10.3
18051,2020-06-01,20072,18257,1815,9
18053,2020-06-01,31299,28174,3125,10
18055,2020-06-01,13453,12219,1234,9.2
18057,2020-06-01,183671,169463,14208,7.7
18059,2020-06-01,40762,37055,3707,9.1
18061,2020-06-01,19998,17952,2046,10.2
18063,2020-06-01,90426,82745,7681,8.5
18065,2020-06-01,22502,20250,2252,10
18067,2020-06-01,39285,32765,6520,16.6
18069,2020-06-01,18488,16679,1809,9.8
18071,2020-06-01,24143,21493,2650,11
18073,2020-06-01,16370,14661,1709,10.4
18075,2020-06-01,9039,8174,865,9.6
18077,2020-06-01,15178,13605,1573,10.4
18079,2020-06-01,13864,12428,1436,10.4
18081,2020-06-01,84146,76389,7757,9.2
18083,2020-06-01,18594,16897,1697,9.1
18085,2020-06-01,42315,38500,3815,9
18087,2020-06-01,19910,18347,1563,7.9
18089,2020-06-01,241800,204133,37667,15.6
18091,2020-06-01,51447,43479,7968,15.5
18093,2020-06-01,21138,19045,2093,9.9
18095,2020-06-01,61249,53944,7305,11.9
18097,2020-06-01,512899,448870,64029,12.5
18099,2020-06-01,24008,21337,2671,11.1
18101,2020-06-01,5466,5112,354,6.5
18103,2020-06-01,15475,13544,1931,12.5
18105,2020-06-01,67831,61590,6241,9.2
18107,2020-06-01,18699,17105,1594,8.5
18109,2020-06-01,36467,33405,3062,8.4
18111,2020-06-01,6985,6274,711,10.2
18113,2020-06-01,24373,21504,2869,11.8
18115,2020-06-01,3333,2859,474,14.2
18117,2020-06-01,9971,7998,1973,19.8
18119,2020-06-01,9097,8225,872,9.6
18121,2020-06-01,7103,6510,593,8.3
18123,2020-06-01,9428,8460,968,10.3
18125,2020-06-01,6143,5587,556,9.1
18127,2020-06-01,89692,77878,11814,13.2
18129,2020-06-01,13806,12786,1020,7.4
18131,2020-06-01,6784,6100,684,10.1
18133,2020-06-01,17052,15363,1689,9.9
18135,2020-06-01,11464,10379,1085,9.5
18137,2020-06-01,14321,12888,1433,10
18139,2020-06-01,9042,8160,882,9.8
18141,2020-06-01,134971,117006,17965,13.3
18143,2020-06-01,10639,9286,1353,12.7
18145,2020-06-01,24237,21304,2933,12.1
18147,2020-06-01,11478,10587,891,7.8
18149,2020-06-01,10353,9078,1275,12.3
18151,2020-06-01,20943,19072,1871,8.9
18153,2020-06-01,8260,7427,833,10.1
18155,2020-06-01,5291,4507,784,14.8
18157,2020-06-01,96122,86869,9253,9.6
18159,2020-06-01,9403,8492,911,9.7
18161,2020-06-01,3496,3206,290,8.3
18163,2020-06-01,99008,88220,10788,10.9
18165,2020-06-01,6860,6146,714,10.4
18167,2020-06-01,48276,42569,5707,11.8
18169,2020-06-01,14681,13286,1395,9.5
18171,2020-06-01,4135,3803,332,8
18173,2020-06-01,33680,30947,2733,8.1
18175,2020-06-01,13651,12197,1454,10.7
18177,2020-06-01,30946,27765,3181,10.3
18179,2020-06-01,14530,13345,1185,8.2
18181,2020-06-01,13964,12835,1129,8.1
18183,2020-06-01,17909,16363,1546,8.6
19001,2020-06-01,4014,3779,235,5.9
19003,2020-06-01,2070,1951,119,5.7
19005,2020-06-01,6931,6464,467,6.7
19007,2020-06-01,5852,5357,495,8.5
19009,2020-06-01,2920,2773,147,5
19011,2020-06-01,12772,11834,938,7.3
19013,2020-06-01,67773,61344,6429,9.5
19015,2020-06-01,14161,13252,909,6.4
19017,2020-06-01,13150,12358,792,6
19019,2020-06-01,10639,9940,699,6.6
19021,2020-06-01,11514,10749,765,6.6
19023,2020-06-01,7478,6988,490,6.6
19025,2020-06-01,4027,3765,262,6.5
19027,2020-06-01,10604,9917,687,6.5
19029,2020-06-01,6538,6164,374,5.7
19031,2020-06-01,10391,9759,632,6.1
19033,2020-06-01,23089,21232,1857,8
19035,2020-06-01,5926,5583,343,5.8
19037,2020-06-01,6237,5883,354,5.7
19039,2020-06-01,4733,4326,407,8.6
19041,2020-06-01,8198,7695,503,6.1
19043,2020-06-01,9492,8810,682,7.2
19045,2020-06-01,22610,20380,2230,9.9
19047,2020-06-01,7733,7185,548,7.1
19049,2020-06-01,46734,43899,2835,6.1
19051,2020-06-01,4009,3774,235,5.9
19053,2020-06-01,4091,3799,292,7.1
19055,2020-06-01,10013,9421,592,5.9
19057,2020-06-01,19333,17119,2214,11.5
19059,2020-06-01,9321,8652,669,7.2
19061,2020-06-01,53484,48629,4855,9.1
19063,2020-06-01,5205,4707,498,9.6
19065,2020-06-01,9850,9089,761,7.7
19067,2020-06-01,8259,7600,659,8
19069,2020-06-01,5353,5054,299,5.6
19071,2020-06-01,3463,3277,186,5.4
19073,2020-06-01,5265,4885,380,7.2
19075,2020-06-01,6136,5742,394,6.4
19077,2020-06-01,5279,4880,399,7.6
19079,2020-06-01,6532,6078,454,7
19081,2020-06-01,5806,5379,427,7.4
19083,2020-06-01,7594,7074,520,6.8
19085,2020-06-01,7029,6569,460,6.5
19087,2020-06-01,9601,8807,794,8.3
19089,2020-06-01,4908,4649,259,5.3
19091,2020-06-01,4867,4552,315,6.5
19093,2020-06-01,4036,3829,207,5.1
19095,2020-06-01,10198,9573,625,6.1
19097,2020-06-01,10669,9651,1018,9.5
19099,2020-06-01,19237,17679,1558,8.1
19101,2020-06-01,10272,9273,999,9.7
19103,2020-06-01,85738,78953,6785,7.9
19105,2020-06-01,10167,9330,837,8.2
19107,2020-06-01,5067,4717,350,6.9
19109,2020-06-01,8027,7586,441,5.5
19111,2020-06-01,15937,14467,1470,9.2
19113,2020-06-01,119530,107687,11843,9.9
19115,2020-06-01,5983,5584,399,6.7
19117,2020-06-01,4490,4230,260,5.8
19119,2020-06-01,6483,6264,219,3.4
19121,2020-06-01,8173,7456,717,8.8
19123,2020-06-01,11669,10754,915,7.8
19125,2020-06-01,17799,16616,1183,6.6
19127,2020-06-01,17451,15797,1654,9.5
19129,2020-06-01,7079,6619,460,6.5
19131,2020-06-01,6873,6594,279,4.1
19133,2020-06-01,4170,3894,276,6.6
19135,2020-06-01,3950,3630,320,8.1
19137,2020-06-01,4866,4479,387,8
19139,2020-06-01,22097,20069,2028,9.2
19141,2020-06-01,7854,7454,400,5.1
19143,2020-06-01,3292,3141,151,4.6
19145,2020-06-01,6424,5809,615,9.6
19147,2020-06-01,4587,4276,311,6.8
19149,2020-06-01,14147,13373,774,5.5
19151,2020-06-01,4333,4102,231,5.3
19153,2020-06-01,263144,236707,26437,10
19155,2020-06-01,47903,43634,4269,8.9
19157,2020-06-01,9204,8530,674,7.3
19159,2020-06-01,2328,2168,160,6.9
19161,2020-06-01,5088,4818,270,5.3
19163,2020-06-01,87458,78417,9041,10.3
19165,2020-06-01,6324,6015,309,4.9
19167,2020-06-01,19403,18646,757,3.9
19169,2020-06-01,54151,50713,3438,6.3
19171,2020-06-01,9021,8431,590,6.5
19173,2020-06-01,3133,2867,266,8.5
19175,2020-06-01,6133,5556,577,9.4
19177,2020-06-01,3570,3295,275,7.7
19179,2020-06-01,17502,15851,1651,9.4
19181,2020-06-01,26929,24979,1950,7.2
19183,2020-06-01,11477,10850,627,5.5
19185,2020-06-01,2739,2540,199,7.3
19187,2020-06-01,18991,17448,1543,8.1
19189,2020-06-01,5149,4612,537,10.4
19191,2020-06-01,9850,9046,804,8.2
19193,2020-06-01,55090,50429,4661,8.5
19195,2020-06-01,4125,3792,333,8.1
19197,2020-06-01,6752,6345,407,6
20001,2020-06-01,6468,6003,465,7.2
20003,2020-06-01,4287,4072,215,5
20005,2020-06-01,6886,6293,593,8.6
20007,2020-06-01,2396,2299,97,4
20009,2020-06-01,13977,13259,718,5.1
20011,2020-06-01,6969,6523,446,6.4
20013,2020-06-01,5207,4943,264,5.1
20015,2020-06-01,32513,29781,2732,8.4
20017,2020-06-01,1593,1504,89,5.6
20019,2020-06-01,1566,1442,124,7.9
20021,2020-06-01,10018,9341,677,6.8
20023,2020-06-01,1314,1284,30,2.3
20025,2020-06-01,1138,1116,22,1.9
20027,2020-06-01,3840,3620,220,5.7
20029,2020-06-01,3845,3662,183,4.8
20031,2020-06-01,3838,3593,245,6.4
20033,2020-06-01,893,852,41,4.6
20035,2020-06-01,17107,15639,1468,8.6
20037,2020-06-01,19253,17955,1298,6.7
20039,2020-06-01,1251,1198,53,4.2
20041,2020-06-01,8993,8464,529,5.9
20043,2020-06-01,4085,3837,248,6.1
20045,2020-06-01,62195,57007,5188,8.3
20047,2020-06-01,1502,1444,58,3.9
20049,2020-06-01,1224,1155,69,5.6
20051,2020-06-01,17439,16743,696,4
20053,2020-06-01,2745,2648,97,3.5
20055,2020-06-01,20932,20044,888,4.2
20057,2020-06-01,17338,16634,704,4.1
20059,2020-06-01,14420,13456,964,6.7
20061,2020-06-01,11660,10613,1047,9
20063,2020-06-01,1445,1401,44,3
20065,2020-06-01,1237,1168,69,5.6
20067,2020-06-01,3279,3118,161,4.9
20069,2020-06-01,3284,3213,71,2.2
20071,2020-06-01,813,796,17,2.1
20073,2020-06-01,3200,3002,198,6.2
20075,2020-06-01,1645,1614,31,1.9
20077,2020-06-01,2768,2614,154,5.6
20079,2020-06-01,16724,15636,1088,6.5
20081,2020-06-01,2322,2256,66,2.8
20083,2020-06-01,1018,988,30,2.9
20085,2020-06-01,7276,6698,578,7.9
20087,2020-06-01,10015,9422,593,5.9
20089,2020-06-01,1248,1195,53,4.2
20091,2020-06-01,339847,316587,23260,6.8
20093,2020-06-01,2107,2041,66,3.1
20095,2020-06-01,3376,3177,199,5.9
20097,2020-06-01,1234,1184,50,4.1
20099,2020-06-01,9769,9082,687,7
20101,2020-06-01,753,730,23,3.1
20103,2020-06-01,36594,33871,2723,7.4
20105,2020-06-01,1733,1679,54,3.1
20107,2020-06-01,4394,4023,371,8.4
20109,2020-06-01,1710,1666,44,2.6
20111,2020-06-01,16826,15874,952,5.7
20113,2020-06-01,17540,16844,696,4
20115,2020-06-01,6127,5844,283,4.6
20117,2020-06-01,5534,5337,197,3.6
20119,2020-06-01,2173,2109,64,2.9
20121,2020-06-01,17312,16246,1066,6.2
20123,2020-06-01,3376,3274,102,3
20125,2020-06-01,15507,14140,1367,8.8
20127,2020-06-01,3083,2942,141,4.6
20129,2020-06-01,1138,1100,38,3.3
20131,2020-06-01,5559,5368,191,3.4
20133,2020-06-01,6254,5788,466,7.5
20135,2020-06-01,1367,1312,55,4
20137,2020-06-01,2698,2619,79,2.9
20139,2020-06-01,7870,7399,471,6
20141,2020-06-01,1999,1934,65,3.3
20143,2020-06-01,2972,2831,141,4.7
20145,2020-06-01,2844,2726,118,4.1
20147,2020-06-01,2731,2617,114,4.2
20149,2020-06-01,10953,10263,690,6.3
20151,2020-06-01,5058,4827,231,4.6
20153,2020-06-01,1532,1487,45,2.9
20155,2020-06-01,30492,28514,1978,6.5
20157,2020-06-01,2333,2236,97,4.2
20159,2020-06-01,5097,4849,248,4.9
20161,2020-06-01,31211,28785,2426,7.8
20163,2020-06-01,2553,2425,128,5
20165,2020-06-01,1628,1547,81,5
20167,2020-06-01,3393,3209,184,5.4
20169,2020-06-01,29650,27617,2033,6.9
20171,2020-06-01,2874,2781,93,3.2
20173,2020-06-01,259175,229396,29779,11.5
20175,2020-06-01,9811,9269,542,5.5
20177,2020-06-01,90746,83961,6785,7.5
20179,2020-06-01,1438,1401,37,2.6
20181,2020-06-01,2883,2774,109,3.8
20183,2020-06-01,2021,1967,54,2.7
20185,2020-06-01,2019,1933,86,4.3
20187,2020-06-01,1095,1068,27,2.5
20189,2020-06-01,2848,2759,89,3.1
20191,2020-06-01,11175,10010,1165,10.4
20193,2020-06-01,4305,4164,141,3.3
20195,2020-06-01,1474,1420,54,3.7
20197,2020-06-01,3603,3415,188,5.2
20199,2020-06-01,846,828,18,2.1
20201,2020-06-01,3073,2989,84,2.7
20203,2020-06-01,1451,1426,25,1.7
20205,2020-06-01,4042,3709,333,8.2
20207,2020-06-01,1574,1457,117,7.4
20209,2020-06-01,79240,71066,8174,10.3
21001,2020-06-01,6597,6252,345,5.2
21003,2020-06-01,8154,7807,347,4.3
21005,2020-06-01,11697,11166,531,4.5
21007,2020-06-01,3191,3049,142,4.5
21009,2020-06-01,17164,16208,956,5.6
21011,2020-06-01,4416,4164,252,5.7
21013,2020-06-01,7869,7420,449,5.7
21015,2020-06-01,68184,65318,2866,4.2
21017,2020-06-01,9537,9173,364,3.8
21019,2020-06-01,17334,16248,1086,6.3
21021,2020-06-01,11314,10681,633,5.6
21023,2020-06-01,3638,3491,147,4
21025,2020-06-01,3166,2926,240,7.6
21027,2020-06-01,7654,7281,373,4.9
21029,2020-06-01,40305,38470,1835,4.6
21031,2020-06-01,4541,4318,223,4.9
21033,2020-06-01,5239,5005,234,4.5
21035,2020-06-01,17833,17053,780,4.4
21037,2020-06-01,48771,46665,2106,4.3
21039,2020-06-01,2178,2113,65,3
21041,2020-06-01,5084,4847,237,4.7
21043,2020-06-01,9247,8587,660,7.1
21045,2020-06-01,6390,6141,249,3.9
21047,2020-06-01,24708,23310,1398,5.7
21049,2020-06-01,16336,15526,810,5
21051,2020-06-01,4832,4540,292,6
21053,2020-06-01,3863,3725,138,3.6
21055,2020-06-01,3606,3474,132,3.7
21057,2020-06-01,3127,3023,104,3.3
21059,2020-06-01,45756,43799,1957,4.3
21061,2020-06-01,4286,4043,243,5.7
21063,2020-06-01,1914,1778,136,7.1
21065,2020-06-01,5021,4734,287,5.7
21067,2020-06-01,166493,159046,7447,4.5
21069,2020-06-01,5861,5548,313,5.3
21071,2020-06-01,10193,9459,734,7.2
21073,2020-06-01,24580,23386,1194,4.9
21075,2020-06-01,2054,1948,106,5.2
21077,2020-06-01,3945,3772,173,4.4
21079,2020-06-01,7132,6804,328,4.6
21081,2020-06-01,11311,10743,568,5
21083,2020-06-01,14841,14190,651,4.4
21085,2020-06-01,10774,10237,537,5
21087,2020-06-01,4772,4587,185,3.9
21089,2020-06-01,12981,12124,857,6.6
21091,2020-06-01,3826,3680,146,3.8
21093,2020-06-01,46894,44471,2423,5.2
21095,2020-06-01,5973,5429,544,9.1
21097,2020-06-01,8447,8126,321,3.8
21099,2020-06-01,7628,7305,323,4.2
21101,2020-06-01,21860,20976,884,4
21103,2020-06-01,7847,7528,319,4.1
21105,2020-06-01,1738,1673,65,3.7
21107,2020-06-01,16437,15447,990,6
21109,2020-06-01,3740,3506,234,6.3
21111,2020-06-01,379864,359647,20217,5.3
21113,2020-06-01,25087,24009,1078,4.3
21115,2020-06-01,6259,5861,398,6.4
21117,2020-06-01,84432,80660,3772,4.5
21119,2020-06-01,4064,3804,260,6.4
21121,2020-06-01,9495,8870,625,6.6
21123,2020-06-01,5716,5433,283,5
21125,2020-06-01,23432,22264,1168,5
21127,2020-06-01,4924,4622,302,6.1
21129,2020-06-01,1961,1856,105,5.4
21131,2020-06-01,2443,2254,189,7.7
21133,2020-06-01,5828,5387,441,7.6
21135,2020-06-01,4273,3981,292,6.8
21137,2020-06-01,8403,7919,484,5.8
21139,2020-06-01,3325,3150,175,5.3
21141,2020-06-01,11871,11404,467,3.9
21143,2020-06-01,2927,2823,104,3.6
21145,2020-06-01,26688,25244,1444,5.4
21147,2020-06-01,4467,4226,241,5.4
21149,2020-06-01,4085,3924,161,3.9
21151,2020-06-01,42511,40478,2033,4.8
21153,2020-06-01,3044,2685,359,11.8
21155,2020-06-01,9418,8983,435,4.6
21157,2020-06-01,14414,13813,601,4.2
21159,2020-06-01,2702,2477,225,8.3
21161,2020-06-01,6662,6293,369,5.5
21163,2020-06-01,11692,11114,578,4.9
21165,2020-06-01,2168,2046,122,5.6
21167,2020-06-01,9305,8804,501,5.4
21169,2020-06-01,3778,3587,191,5.1
21171,2020-06-01,4454,4298,156,3.5
21173,2020-06-01,11087,10472,615,5.5
21175,2020-06-01,4374,4168,206,4.7
21177,2020-06-01,9885,9276,609,6.2
21179,2020-06-01,22853,21752,1101,4.8
21181,2020-06-01,3187,3041,146,4.6
21183,2020-06-01,9575,9114,461,4.8
21185,2020-06-01,31412,30258,1154,3.7
21187,2020-06-01,4956,4725,231,4.7
21189,2020-06-01,1081,1025,56,5.2
21191,2020-06-01,6650,6421,229,3.4
21193,2020-06-01,7579,7043,536,7.1
21195,2020-06-01,17421,16233,1188,6.8
21197,2020-06-01,4809,4551,258,5.4
21199,2020-06-01,25198,23830,1368,5.4
21201,2020-06-01,794,765,29,3.7
21203,2020-06-01,5979,5669,310,5.2
21205,2020-06-01,9602,9067,535,5.6
21207,2020-06-01,6014,5649,365,6.1
21209,2020-06-01,27578,26461,1117,4.1
21211,2020-06-01,24261,23301,960,4
21213,2020-06-01,8581,8120,461,5.4
21215,2020-06-01,9644,9239,405,4.2
21217,2020-06-01,11289,10782,507,4.5
21219,2020-06-01,5254,5080,174,3.3
21221,2020-06-01,5977,5696,281,4.7
21223,2020-06-01,3667,3511,156,4.3
21225,2020-06-01,5697,5422,275,4.8
21227,2020-06-01,57914,54857,3057,5.3
21229,2020-06-01,6149,5923,226,3.7
21231,2020-06-01,7176,6848,328,4.6
21233,2020-06-01,5477,5218,259,4.7
21235,2020-06-01,13046,12347,699,5.4
21237,2020-06-01,1910,1806,104,5.4
21239,2020-06-01,14529,13987,542,3.7
22001,2020-06-01,23048,21042,2006,8.7
22003,2020-06-01,8595,7668,927,10.8
22005,2020-06-01,60691,55435,5256,8.7
22007,2020-06-01,8730,7705,1025,11.7
22009,2020-06-01,14560,13223,1337,9.2
22011,2020-06-01,13980,12921,1059,7.6
22013,2020-06-01,5195,4731,464,8.9
22015,2020-06-01,55502,51138,4364,7.9
22017,2020-06-01,102147,90812,11335,11.1
22019,2020-06-01,100020,90046,9974,10
22021,2020-06-01,3603,3303,300,8.3
22023,2020-06-01,3573,3349,224,6.3
22025,2020-06-01,3296,3012,284,8.6
22027,2020-06-01,5406,5031,375,6.9
22029,2020-06-01,6782,6122,660,9.7
22031,2020-06-01,10323,9452,871,8.4
22033,2020-06-01,221397,199222,22175,10
22035,2020-06-01,1757,1525,232,13.2
22037,2020-06-01,7501,6883,618,8.2
22039,2020-06-01,11281,10171,1110,9.8
22041,2020-06-01,7071,6395,676,9.6
22043,2020-06-01,7815,7212,603,7.7
22045,2020-06-01,27868,24824,3044,10.9
22047,2020-06-01,13525,11914,1611,11.9
22049,2020-06-01,6371,5961,410,6.4
22051,2020-06-01,206008,180435,25573,12.4
22053,2020-06-01,12574,11426,1148,9.1
22055,2020-06-01,111517,101689,9828,8.8
22057,2020-06-01,40166,36964,3202,8
22059,2020-06-01,6424,6049,375,5.8
22061,2020-06-01,19749,18191,1558,7.9
22063,2020-06-01,65109,59618,5491,8.4
22065,2020-06-01,3341,3001,340,10.2
22067,2020-06-01,9607,8540,1067,11.1
22069,2020-06-01,15172,13887,1285,8.5
22071,2020-06-01,178420,150047,28373,15.9
22073,2020-06-01,70804,64737,6067,8.6
22075,2020-06-01,9306,8457,849,9.1
22077,2020-06-01,9335,8435,900,9.6
22079,2020-06-01,52889,48935,3954,7.5
22081,2020-06-01,3525,3293,232,6.6
22083,2020-06-01,7851,7160,691,8.8
22085,2020-06-01,8596,8020,576,6.7
22087,2020-06-01,19200,16672,2528,13.2
22089,2020-06-01,23637,21183,2454,10.4
22091,2020-06-01,4247,3627,620,14.6
22093,2020-06-01,8640,7619,1021,11.8
22095,2020-06-01,19001,16318,2683,14.1
22097,2020-06-01,30928,27723,3205,10.4
22099,2020-06-01,21765,19645,2120,9.7
22101,2020-06-01,19067,16944,2123,11.1
22103,2020-06-01,110812,100915,9897,8.9
22105,2020-06-01,54033,47239,6794,12.6
22107,2020-06-01,1288,1160,128,9.9
22109,2020-06-01,44835,40605,4230,9.4
22111,2020-06-01,9061,8323,738,8.1
22113,2020-06-01,23429,21389,2040,8.7
22115,2020-06-01,14916,13689,1227,8.2
22117,2020-06-01,16174,14528,1646,10.2
22119,2020-06-01,13834,12621,1213,8.8
22121,2020-06-01,12959,11779,1180,9.1
22123,2020-06-01,3390,3002,388,11.4
22125,2020-06-01,4993,4659,334,6.7
22127,2020-06-01,4513,4163,350,7.8
23001,2020-06-01,54178,50459,3719,6.9
23003,2020-06-01,29752,28033,1719,5.8
23005,2020-06-01,159839,148766,11073,6.9
23007,2020-06-01,14145,13097,1048,7.4
23009,2020-06-01,28395,26701,1694,6
23011,2020-06-01,62770,59288,3482,5.5
23013,2020-06-01,20518,19277,1241,6
23015,2020-06-01,17126,16142,984,5.7
23017,2020-06-01,26578,24421,2157,8.1
23019,2020-06-01,73656,68956,4700,6.4
23021,2020-06-01,7259,6847,412,5.7
23023,2020-06-01,19763,18655,1108,5.6
23025,2020-06-01,22974,21256,1718,7.5
23027,2020-06-01,20476,19337,1139,5.6
23029,2020-06-01,13769,12947,822,6
23031,2020-06-01,109348,102000,7348,6.7
24001,2020-06-01,31307,28262,3045,9.7
24003,2020-06-01,314864,291054,23810,7.6
24005,2020-06-01,455256,416420,38836,8.5
24009,2020-06-01,49637,46451,3186,6.4
24011,2020-06-01,17244,16133,1111,6.4
24013,2020-06-01,94246,88152,6094,6.5
24015,2020-06-01,51108,47415,3693,7.2
24017,2020-06-01,88319,80817,7502,8.5
24019,2020-06-01,15123,13866,1257,8.3
24021,2020-06-01,134591,124235,10356,7.7
24023,2020-06-01,14972,13820,1152,7.7
24025,2020-06-01,140020,129814,10206,7.3
24027,2020-06-01,186593,173808,12785,6.9
24029,2020-06-01,9638,8857,781,8.1
24031,2020-06-01,565295,518736,46559,8.2
24033,2020-06-01,523242,470322,52920,10.1
24035,2020-06-01,27384,25459,1925,7
24037,2020-06-01,55875,52509,3366,6
24039,2020-06-01,9012,8181,831,9.2
24041,2020-06-01,18125,16834,1291,7.1
24043,2020-06-01,73247,67117,6130,8.4
24045,2020-06-01,51495,47061,4434,8.6
24047,2020-06-01,25588,22716,2872,11.2
24510,2020-06-01,291678,261071,30607,10.5
25001,2020-06-01,113171,91825,21346,18.9
25003,2020-06-01,63963,53387,10576,16.5
25005,2020-06-01,305435,245371,60064,19.7
25007,2020-06-01,11050,9513,1537,13.9
25009,2020-06-01,427341,342491,84850,19.9
25011,2020-06-01,39601,33839,5762,14.6
25013,2020-06-01,223636,178420,45216,20.2
25015,2020-06-01,83988,71490,12498,14.9
25017,2020-06-01,879601,747574,132027,15
25019,2020-06-01,9096,7832,1264,13.9
25021,2020-06-01,382653,316763,65890,17.2
25023,2020-06-01,281855,228262,53593,19
25025,2020-06-01,462171,368579,93592,20.3
25027,2020-06-01,442695,366495,76200,17.2
26001,2020-06-01,4102,3538,564,13.7
26003,2020-06-01,3356,2706,650,19.4
26005,2020-06-01,65507,58063,7444,11.4
26007,2020-06-01,13964,12400,1564,11.2
26009,2020-06-01,10777,9284,1493,13.9
26011,2020-06-01,6563,5576,987,15
26013,2020-06-01,3358,2693,665,19.8
26015,2020-06-01,33062,29390,3672,11.1
26017,2020-06-01,51566,44495,7071,13.7
26019,2020-06-01,9601,8464,1137,11.8
26021,2020-06-01,79290,68328,10962,13.8
26023,2020-06-01,20557,18030,2527,12.3
26025,2020-06-01,65624,55583,10041,15.3
26027,2020-06-01,25842,22491,3351,13
26029,2020-06-01,13633,11702,1931,14.2
26031,2020-06-01,10919,9079,1840,16.9
26033,2020-06-01,17497,15405,2092,12
26035,2020-06-01,12444,10414,2030,16.3
26037,2020-06-01,41455,37336,4119,9.9
26039,2020-06-01,5832,4926,906,15.5
26041,2020-06-01,18659,16492,2167,11.6
26043,2020-06-01,13800,12491,1309,9.5
26045,2020-06-01,58197,51448,6749,11.6
26047,2020-06-01,19255,16707,2548,13.2
26049,2020-06-01,196995,165028,31967,16.2
26051,2020-06-01,10269,8814,1455,14.2
26053,2020-06-01,6501,5811,690,10.6
26055,2020-06-01,54847,48214,6633,12.1
26057,2020-06-01,19378,17210,2168,11.2
26059,2020-06-01,21731,18833,2898,13.3
26061,2020-06-01,16878,14933,1945,11.5
26063,2020-06-01,17180,15058,2122,12.4
26065,2020-06-01,153834,135755,18079,11.8
26067,2020-06-01,31212,27361,3851,12.3
26069,2020-06-01,11085,9457,1628,14.7
26071,2020-06-01,5726,5159,567,9.9
26073,2020-06-01,38236,33583,4653,12.2
26075,2020-06-01,79073,67676,11397,14.4
26077,2020-06-01,140475,123978,16497,11.7
26079,2020-06-01,8844,7507,1337,15.1
26081,2020-06-01,381256,334022,47234,12.4
26083,2020-06-01,932,804,128,13.7
26085,2020-06-01,4163,3530,633,15.2
26087,2020-06-01,39340,32193,7147,18.2
26089,2020-06-01,11479,10206,1273,11.1
26091,2020-06-01,48889,42493,6396,13.1
26093,2020-06-01,95834,82422,13412,14
26095,2020-06-01,2521,2251,270,10.7
26097,2020-06-01,4885,4151,734,15
26099,2020-06-01,431754,352571,79183,18.3
26101,2020-06-01,10753,9037,1716,16
26103,2020-06-01,34646,30116,4530,13.1
26105,2020-06-01,14376,12530,1846,12.8
26107,2020-06-01,19852,17196,2656,13.4
26109,2020-06-01,11581,10534,1047,9
26111,2020-06-01,41776,37146,4630,11.1
26113,2020-06-01,7729,6757,972,12.6
26115,2020-06-01,77657,67261,10396,13.4
26117,2020-06-01,30299,26086,4213,13.9
26119,2020-06-01,3179,2586,593,18.7
26121,2020-06-01,85363,70241,15122,17.7
26123,2020-06-01,24933,21710,3223,12.9
26125,2020-06-01,630512,536646,93866,14.9
26127,2020-06-01,12657,10786,1871,14.8
26129,2020-06-01,8765,7505,1260,14.4
26131,2020-06-01,2186,1860,326,14.9
26133,2020-06-01,12581,11156,1425,11.3
26135,2020-06-01,3216,2710,506,15.7
26137,2020-06-01,12411,10518,1893,15.3
26139,2020-06-01,168773,150090,18683,11.1
26141,2020-06-01,5145,4406,739,14.4
26143,2020-06-01,8220,6903,1317,16
26145,2020-06-01,90918,77611,13307,14.6
26147,2020-06-01,72275,59350,12925,17.9
26149,2020-06-01,30501,26507,3994,13.1
26151,2020-06-01,21127,18182,2945,13.9
26153,2020-06-01,3718,3265,453,12.2
26155,2020-06-01,36365,31677,4688,12.9
26157,2020-06-01,25735,22017,3718,14.4
26159,2020-06-01,37188,32516,4672,12.6
26161,2020-06-01,207910,185714,22196,10.7
26163,2020-06-01,780788,618863,161925,20.7
26165,2020-06-01,16676,14288,2388,14.3
27001,2020-06-01,7260,6596,664,9.1
27003,2020-06-01,199990,182210,17780,8.9
27005,2020-06-01,19080,17631,1449,7.6
27007,2020-06-01,24629,22741,1888,7.7
27009,2020-06-01,22966,21165,1801,7.8
27011,2020-06-01,2441,2316,125,5.1
27013,2020-06-01,41548,38348,3200,7.7
27015,2020-06-01,14477,13609,868,6
27017,2020-06-01,17709,16008,1701,9.6
27019,2020-06-01,58626,54330,4296,7.3
27021,2020-06-01,14594,12996,1598,10.9
27023,2020-06-01,6855,6479,376,5.5
27025,2020-06-01,29992,27537,2455,8.2
27027,2020-06-01,36383,34290,2093,5.8
27029,2020-06-01,4317,3928,389,9
27031,2020-06-01,3130,2799,331,10.6
27033,2020-06-01,6149,5776,373,6.1
27035,2020-06-01,32583,29818,2765,8.5
27037,2020-06-01,245304,223129,22175,9
27039,2020-06-01,12032,11157,875,7.3
27041,2020-06-01,21144,19922,1222,5.8
27043,2020-06-01,7040,6513,527,7.5
27045,2020-06-01,11704,10951,753,6.4
27047,2020-06-01,16576,15293,1283,7.7
27049,2020-06-01,27408,25191,2217,8.1
27051,2020-06-01,3361,3168,193,5.7
27053,2020-06-01,724753,653775,70978,9.8
27055,2020-06-01,10167,9633,534,5.3
27057,2020-06-01,9883,9083,800,8.1
27059,2020-06-01,21220,19482,1738,8.2
27061,2020-06-01,21699,19315,2384,11
27063,2020-06-01,5921,5491,430,7.3
27065,2020-06-01,8944,8269,675,7.5
27067,2020-06-01,24286,22877,1409,5.8
27069,2020-06-01,2353,2228,125,5.3
27071,2020-06-01,5777,5269,508,8.8
27073,2020-06-01,3588,3412,176,4.9
27075,2020-06-01,5531,4921,610,11
27077,2020-06-01,2413,2220,193,8
27079,2020-06-01,15996,14796,1200,7.5
27081,2020-06-01,3236,3104,132,4.1
27083,2020-06-01,14514,13717,797,5.5
27085,2020-06-01,19206,17866,1340,7
27087,2020-06-01,2562,2141,421,16.4
27089,2020-06-01,5308,4974,334,6.3
27091,2020-06-01,10212,9467,745,7.3
27093,2020-06-01,13243,12519,724,5.5
27095,2020-06-01,12890,11688,1202,9.3
27097,2020-06-01,17660,16481,1179,6.7
27099,2020-06-01,20933,19471,1462,7
27101,2020-06-01,4663,4435,228,4.9
27103,2020-06-01,21321,19901,1420,6.7
27105,2020-06-01,11550,10862,688,6
27107,2020-06-01,3321,3073,248,7.5
27109,2020-06-01,91062,83208,7854,8.6
27111,2020-06-01,31058,29138,1920,6.2
27113,2020-06-01,8488,7950,538,6.3
27115,2020-06-01,15000,13625,1375,9.2
27117,2020-06-01,4760,4558,202,4.2
27119,2020-06-01,16676,15537,1139,6.8
27121,2020-06-01,6496,6178,318,4.9
27123,2020-06-01,297548,267348,30200,10.1
27125,2020-06-01,2181,2048,133,6.1
27127,2020-06-01,7756,7249,507,6.5
27129,2020-06-01,8525,7971,554,6.5
27131,2020-06-01,37750,35052,2698,7.1
27133,2020-06-01,5739,5496,243,4.2
27135,2020-06-01,8130,7363,767,9.4
27137,2020-06-01,101933,91657,10276,10.1
27139,2020-06-01,84410,77285,7125,8.4
27141,2020-06-01,52212,48158,4054,7.8
27143,2020-06-01,8538,8008,530,6.2
27145,2020-06-01,94678,87771,6907,7.3
27147,2020-06-01,21538,20070,1468,6.8
27149,2020-06-01,5336,5132,204,3.8
27151,2020-06-01,4866,4595,271,5.6
27153,2020-06-01,13821,12984,837,6.1
27155,2020-06-01,1809,1720,89,4.9
27157,2020-06-01,12546,11655,891,7.1
27159,2020-06-01,6092,5622,470,7.7
27161,2020-06-01,9184,8456,728,7.9
27163,2020-06-01,144109,132470,11639,8.1
27165,2020-06-01,6590,6184,406,6.2
27167,2020-06-01,3503,3323,180,5.1
27169,2020-06-01,28972,27084,1888,6.5
27171,2020-06-01,75159,69851,5308,7.1
27173,2020-06-01,5349,5077,272,5.1
28001,2020-06-01,10632,9301,1331,12.5
28003,2020-06-01,14936,13888,1048,7
28005,2020-06-01,4327,3909,418,9.7
28007,2020-06-01,6764,6117,647,9.6
28009,2020-06-01,2851,2559,292,10.2
28011,2020-06-01,11905,10729,1176,9.9
28013,2020-06-01,5670,5180,490,8.6
28015,2020-06-01,3298,3002,296,9
28017,2020-06-01,6787,5922,865,12.7
28019,2020-06-01,3568,3310,258,7.2
28021,2020-06-01,3015,2450,565,18.7
28023,2020-06-01,5613,5035,578,10.3
28025,2020-06-01,7771,6643,1128,14.5
28027,2020-06-01,8505,7301,1204,14.2
28029,2020-06-01,10658,9642,1016,9.5
28031,2020-06-01,7719,7026,693,9
28033,2020-06-01,84001,77652,6349,7.6
28035,2020-06-01,31657,28490,3167,10
28037,2020-06-01,2721,2476,245,9
28039,2020-06-01,8615,7713,902,10.5
28041,2020-06-01,4228,3763,465,11
28043,2020-06-01,8981,8193,788,8.8
28045,2020-06-01,18101,16357,1744,9.6
28047,2020-06-01,84908,75626,9282,10.9
28049,2020-06-01,103689,91471,12218,11.8
28051,2020-06-01,5746,4588,1158,20.2
28053,2020-06-01,2394,2016,378,15.8
28055,2020-06-01,364,337,27,7.4
28057,2020-06-01,9859,9084,775,7.9
28059,2020-06-01,56982,50735,6247,11
28061,2020-06-01,5932,5306,626,10.6
28063,2020-06-01,1975,1566,409,20.7
28065,2020-06-01,3957,3487,470,11.9
28067,2020-06-01,24715,22591,2124,8.6
28069,2020-06-01,3484,3052,432,12.4
28071,2020-06-01,25971,23856,2115,8.1
28073,2020-06-01,28564,26454,2110,7.4
28075,2020-06-01,28289,25724,2565,9.1
28077,2020-06-01,4457,4010,447,10
28079,2020-06-01,7973,7187,786,9.9
28081,2020-06-01,39168,35139,4029,10.3
28083,2020-06-01,9654,8443,1211,12.5
28085,2020-06-01,13892,12675,1217,8.8
28087,2020-06-01,23801,21265,2536,10.7
28089,2020-06-01,50083,45989,4094,8.2
28091,2020-06-01,9284,8486,798,8.6
28093,2020-06-01,13535,12228,1307,9.7
28095,2020-06-01,14691,13044,1647,11.2
28097,2020-06-01,3804,3445,359,9.4
28099,2020-06-01,10511,9093,1418,13.5
28101,2020-06-01,8343,7530,813,9.7
28103,2020-06-01,3839,3283,556,14.5
28105,2020-06-01,21325,19195,2130,10
28107,2020-06-01,12105,10600,1505,12.4
28109,2020-06-01,21936,20089,1847,8.4
28111,2020-06-01,4047,3656,391,9.7
28113,2020-06-01,14037,12543,1494,10.6
28115,2020-06-01,13950,12711,1239,8.9
28117,2020-06-01,10686,9829,857,8
28119,2020-06-01,2379,2081,298,12.5
28121,2020-06-01,70454,66004,4450,6.3
28123,2020-06-01,12299,11431,868,7.1
28125,2020-06-01,1614,1429,185,11.5
28127,2020-06-01,10165,9355,810,8
28129,2020-06-01,6514,6102,412,6.3
28131,2020-06-01,6553,5959,594,9.1
28133,2020-06-01,7739,6856,883,11.4
28135,2020-06-01,5089,4662,427,8.4
28137,2020-06-01,11671,10591,1080,9.3
28139,2020-06-01,8741,8039,702,8
28141,2020-06-01,8061,7482,579,7.2
28143,2020-06-01,4688,3869,819,17.5
28145,2020-06-01,13424,12333,1091,8.1
28147,2020-06-01,4659,4189,470,10.1
28149,2020-06-01,19168,17099,2069,10.8
28151,2020-06-01,16490,14465,2025,12.3
28153,2020-06-01,7450,6639,811,10.9
28155,2020-06-01,3759,3433,326,8.7
28157,2020-06-01,2635,2265,370,14
28159,2020-06-01,7140,6354,786,11
28161,2020-06-01,4574,4091,483,10.6
28163,2020-06-01,9437,8277,1160,12.3
29001,2020-06-01,10277,9603,674,6.6
29003,2020-06-01,9564,9095,469,4.9
29005,2020-06-01,2831,2672,159,5.6
29007,2020-06-01,10844,9942,902,8.3
29009,2020-06-01,16320,14819,1501,9.2
29011,2020-06-01,5298,4974,324,6.1
29013,2020-06-01,7817,7344,473,6.1
29015,2020-06-01,7348,6701,647,8.8
29017,2020-06-01,5184,4854,330,6.4
29019,2020-06-01,95258,89815,5443,5.7
29021,2020-06-01,43786,41148,2638,6
29023,2020-06-01,17985,16735,1250,7
29025,2020-06-01,4335,4110,225,5.2
29027,2020-06-01,21315,20066,1249,5.9
29029,2020-06-01,18483,17064,1419,7.7
29031,2020-06-01,38303,35691,2612,6.8
29033,2020-06-01,4737,4486,251,5.3
29035,2020-06-01,2561,2384,177,6.9
29037,2020-06-01,53905,50487,3418,6.3
29039,2020-06-01,5842,5541,301,5.2
29041,2020-06-01,3791,3610,181,4.8
29043,2020-06-01,44760,41682,3078,6.9
29045,2020-06-01,3239,3049,190,5.9
29047,2020-06-01,135516,125434,10082,7.4
29049,2020-06-01,10670,9967,703,6.6
29051,2020-06-01,38779,36600,2179,5.6
29053,2020-06-01,7376,6874,502,6.8
29055,2020-06-01,11044,10129,915,8.3
29057,2020-06-01,3664,3461,203,5.5
29059,2020-06-01,7096,6556,540,7.6
29061,2020-06-01,4278,4085,193,4.5
29063,2020-06-01,4779,4556,223,4.7
29065,2020-06-01,6319,5969,350,5.5
29067,2020-06-01,5360,4734,626,11.7
29069,2020-06-01,11739,10762,977,8.3
29071,2020-06-01,52206,47819,4387,8.4
29073,2020-06-01,7879,7239,640,8.1
29075,2020-06-01,3564,3430,134,3.8
29077,2020-06-01,151834,140425,11409,7.5
29079,2020-06-01,4501,4227,274,6.1
29081,2020-06-01,3929,3741,188,4.8
29083,2020-06-01,9940,9096,844,8.5
29085,2020-06-01,3896,3689,207,5.3
29087,2020-06-01,2621,2517,104,4
29089,2020-06-01,4797,4547,250,5.2
29091,2020-06-01,16666,15314,1352,8.1
29093,2020-06-01,3573,3271,302,8.5
29095,2020-06-01,362360,330393,31967,8.8
29097,2020-06-01,57082,52918,4164,7.3
29099,2020-06-01,115307,105804,9503,8.2
29101,2020-06-01,23698,22081,1617,6.8
29103,2020-06-01,1804,1727,77,4.3
29105,2020-06-01,17538,15711,1827,10.4
29107,2020-06-01,16645,15665,980,5.9
29109,2020-06-01,18518,17014,1504,8.1
29111,2020-06-01,5116,4802,314,6.1
29113,2020-06-01,27791,25601,2190,7.9
29115,2020-06-01,5118,4786,332,6.5
29117,2020-06-01,7444,7137,307,4.1
29119,2020-06-01,10680,10059,621,5.8
29121,2020-06-01,7540,7129,411,5.5
29123,2020-06-01,5629,5193,436,7.7
29125,2020-06-01,3939,3696,243,6.2
29127,2020-06-01,14552,13682,870,6
29129,2020-06-01,2007,1934,73,3.6
29131,2020-06-01,12262,11477,785,6.4
29133,2020-06-01,5843,5491,352,6
29135,2020-06-01,7387,6992,395,5.3
29137,2020-06-01,3845,3562,283,7.4
29139,2020-06-01,5810,5457,353,6.1
29141,2020-06-01,8342,7553,789,9.5
29143,2020-06-01,8585,8010,575,6.7
29145,2020-06-01,27288,25389,1899,7
29147,2020-06-01,11367,10779,588,5.2
29149,2020-06-01,4144,3811,333,8
29151,2020-06-01,7100,6785,315,4.4
29153,2020-06-01,3564,3243,321,9
29155,2020-06-01,6567,5969,598,9.1
29157,2020-06-01,9861,9305,556,5.6
29159,2020-06-01,21666,19717,1949,9
29161,2020-06-01,19617,18447,1170,6
29163,2020-06-01,7583,7037,546,7.2
29165,2020-06-01,58352,54143,4209,7.2
29167,2020-06-01,14491,13583,908,6.3
29169,2020-06-01,14686,13635,1051,7.2
29171,2020-06-01,2335,2210,125,5.4
29173,2020-06-01,5687,5362,325,5.7
29175,2020-06-01,10339,9600,739,7.1
29177,2020-06-01,10902,10105,797,7.3
29179,2020-06-01,3033,2809,224,7.4
29181,2020-06-01,5112,4630,482,9.4
29183,2020-06-01,221004,204942,16062,7.3
29185,2020-06-01,3851,3558,293,7.6
29186,2020-06-01,9101,8568,533,5.9
29187,2020-06-01,26864,24482,2382,8.9
29189,2020-06-01,524347,477806,46541,8.9
29195,2020-06-01,11040,10402,638,5.8
29197,2020-06-01,2034,1857,177,8.7
29199,2020-06-01,2420,2336,84,3.5
29201,2020-06-01,19701,18420,1281,6.5
29203,2020-06-01,3347,3073,274,8.2
29205,2020-06-01,3191,3024,167,5.2
29207,2020-06-01,13322,12467,855,6.4
29209,2020-06-01,14026,12537,1489,10.6
29211,2020-06-01,2734,2629,105,3.8
29213,2020-06-01,28613,24437,4176,14.6
29215,2020-06-01,8974,8395,579,6.5
29217,2020-06-01,9564,9090,474,5
29219,2020-06-01,17539,16234,1305,7.4
29221,2020-06-01,10337,9398,939,9.1
29223,2020-06-01,5039,4691,348,6.9
29225,2020-06-01,17326,16104,1222,7.1
29227,2020-06-01,1229,1163,66,5.4
29229,2020-06-01,7702,7056,646,8.4
29510,2020-06-01,154437,135985,18452,11.9
30001,2020-06-01,4954,4731,223,4.5
30003,2020-06-01,4670,4291,379,8.1
30005,2020-06-01,2208,2098,110,5
30007,2020-06-01,2553,2366,187,7.3
30009,2020-06-01,5528,5153,375,6.8
30011,2020-06-01,605,586,19,3.1
30013,2020-06-01,38652,35959,2693,7
30015,2020-06-01,2433,2335,98,4
30017,2020-06-01,6050,5669,381,6.3
30019,2020-06-01,831,808,23,2.8
30021,2020-06-01,4540,4181,359,7.9
30023,2020-06-01,4981,4701,280,5.6
30025,2020-06-01,1645,1564,81,4.9
30027,2020-06-01,5627,5342,285,5.1
30029,2020-06-01,50438,45788,4650,9.2
30031,2020-06-01,70586,65887,4699,6.7
30033,2020-06-01,665,645,20,3
30035,2020-06-01,5927,5344,583,9.8
30037,2020-06-01,360,337,23,6.4
30039,2020-06-01,1642,1516,126,7.7
30041,2020-06-01,7312,6893,419,5.7
30043,2020-06-01,5641,5280,361,6.4
30045,2020-06-01,933,887,46,4.9
30047,2020-06-01,13757,12769,988,7.2
30049,2020-06-01,35608,33467,2141,6
30051,2020-06-01,897,872,25,2.8
30053,2020-06-01,8229,7393,836,10.2
30055,2020-06-01,877,843,34,3.9
30057,2020-06-01,4282,4039,243,5.7
30059,2020-06-01,900,847,53,5.9
30061,2020-06-01,1847,1634,213,11.5
30063,2020-06-01,67005,62068,4937,7.4
30065,2020-06-01,2283,2124,159,7
30067,2020-06-01,9510,8743,767,8.1
30069,2020-06-01,262,251,11,4.2
30071,2020-06-01,1798,1691,107,6
30073,2020-06-01,2585,2415,170,6.6
30075,2020-06-01,929,894,35,3.8
30077,2020-06-01,2848,2692,156,5.5
30079,2020-06-01,446,409,37,8.3
30081,2020-06-01,20487,19175,1312,6.4
30083,2020-06-01,5832,5321,511,8.8
30085,2020-06-01,4430,4083,347,7.8
30087,2020-06-01,3735,3474,261,7
30089,2020-06-01,5019,4629,390,7.8
30091,2020-06-01,1753,1652,101,5.8
30093,2020-06-01,17224,15820,1404,8.2
30095,2020-06-01,5205,4904,301,5.8
30097,2020-06-01,1780,1706,74,4.2
30099,2020-06-01,2683,2545,138,5.1
30101,2020-06-01,2080,1931,149,7.2
30103,2020-06-01,308,292,16,5.2
30105,2020-06-01,3981,3791,190,4.8
30107,2020-06-01,734,677,57,7.8
30109,2020-06-01,456,425,31,6.8
30111,2020-06-01,83337,77731,5606,6.7
31001,2020-06-01,16849,15964,885,5.3
31003,2020-06-01,3664,3561,103,2.8
31005,2020-06-01,242,230,12,5
31007,2020-06-01,393,382,11,2.8
31009,2020-06-01,269,263,6,2.2
31011,2020-06-01,2984,2904,80,2.7
31013,2020-06-01,5561,5199,362,6.5
31015,2020-06-01,1121,1083,38,3.4
31017,2020-06-01,1421,1378,43,3
31019,2020-06-01,27524,25995,1529,5.6
31021,2020-06-01,3567,3406,161,4.5
31023,2020-06-01,4674,4462,212,4.5
31025,2020-06-01,13785,12986,799,5.8
31027,2020-06-01,4645,4505,140,3
31029,2020-06-01,2324,2273,51,2.2
31031,2020-06-01,3466,3364,102,2.9
31033,2020-06-01,4326,4078,248,5.7
31035,2020-06-01,3343,3224,119,3.6
31037,2020-06-01,5540,5328,212,3.8
31039,2020-06-01,4813,4657,156,3.2
31041,2020-06-01,6549,6259,290,4.4
31043,2020-06-01,11067,10384,683,6.2
31045,2020-06-01,5071,4862,209,4.1
31047,2020-06-01,13214,12565,649,4.9
31049,2020-06-01,992,962,30,3
31051,2020-06-01,3075,2965,110,3.6
31053,2020-06-01,19806,18885,921,4.7
31055,2020-06-01,308528,286414,22114,7.2
31057,2020-06-01,1199,1171,28,2.3
31059,2020-06-01,3228,3112,116,3.6
31061,2020-06-01,1536,1466,70,4.6
31063,2020-06-01,1585,1521,64,4
31065,2020-06-01,2624,2524,100,3.8
31067,2020-06-01,11010,10443,567,5.1
31069,2020-06-01,1107,1060,47,4.2
31071,2020-06-01,1146,1113,33,2.9
31073,2020-06-01,1122,1080,42,3.7
31075,2020-06-01,432,424,8,1.9
31077,2020-06-01,1305,1251,54,4.1
31079,2020-06-01,32664,30406,2258,6.9
31081,2020-06-01,4828,4592,236,4.9
31083,2020-06-01,1871,1804,67,3.6
31085,2020-06-01,646,630,16,2.5
31087,2020-06-01,1296,1242,54,4.2
31089,2020-06-01,5803,5621,182,3.1
31091,2020-06-01,470,458,12,2.6
31093,2020-06-01,3351,3223,128,3.8
31095,2020-06-01,4139,3990,149,3.6
31097,2020-06-01,2082,1995,87,4.2
31099,2020-06-01,3854,3674,180,4.7
31101,2020-06-01,4662,4486,176,3.8
31103,2020-06-01,615,604,11,1.8
31105,2020-06-01,2020,1930,90,4.5
31107,2020-06-01,4761,4596,165,3.5
31109,2020-06-01,183746,173253,10493,5.7
31111,2020-06-01,18545,17515,1030,5.6
31113,2020-06-01,485,468,17,3.5
31115,2020-06-01,423,410,13,3.1
31117,2020-06-01,459,447,12,2.6
31119,2020-06-01,19634,18688,946,4.8
31121,2020-06-01,4036,3858,178,4.4
31123,2020-06-01,2695,2581,114,4.2
31125,2020-06-01,2011,1934,77,3.8
31127,2020-06-01,3579,3400,179,5
31129,2020-06-01,2396,2319,77,3.2
31131,2020-06-01,8482,8075,407,4.8
31133,2020-06-01,1486,1428,58,3.9
31135,2020-06-01,1857,1819,38,2
31137,2020-06-01,5020,4806,214,4.3
31139,2020-06-01,4130,3981,149,3.6
31141,2020-06-01,17439,16583,856,4.9
31143,2020-06-01,3003,2878,125,4.2
31145,2020-06-01,5892,5603,289,4.9
31147,2020-06-01,4308,4133,175,4.1
31149,2020-06-01,904,883,21,2.3
31151,2020-06-01,7445,7081,364,4.9
31153,2020-06-01,98246,92695,5551,5.7
31155,2020-06-01,11291,10766,525,4.6
31157,2020-06-01,17986,17013,973,5.4
31159,2020-06-01,9234,8745,489,5.3
31161,2020-06-01,2690,2611,79,2.9
31163,2020-06-01,1673,1603,70,4.2
31165,2020-06-01,778,759,19,2.4
31167,2020-06-01,3503,3364,139,4
31169,2020-06-01,2781,2686,95,3.4
31171,2020-06-01,441,421,20,4.5
31173,2020-06-01,3216,2970,246,7.6
31175,2020-06-01,2201,2123,78,3.5
31177,2020-06-01,11372,10848,524,4.6
31179,2020-06-01,5504,5298,206,3.7
31181,2020-06-01,1711,1630,81,4.7
31183,2020-06-01,586,572,14,2.4
31185,2020-06-01,7432,7005,427,5.7
32001,2020-06-01,10710,10097,613,5.7
32003,2020-06-01,NA,912494,198080,17.8
32005,2020-06-01,22740,20667,2073,9.1
32007,2020-06-01,25724,24354,1370,5.3
32009,2020-06-01,420,405,15,3.6
32011,2020-06-01,1006,970,36,3.6
32013,2020-06-01,7796,7399,397,5.1
32015,2020-06-01,3042,2909,133,4.4
32017,2020-06-01,1971,1876,95,4.8
32019,2020-06-01,22228,20334,1894,8.5
32021,2020-06-01,1923,1815,108,5.6
32023,2020-06-01,17095,15463,1632,9.5
32027,2020-06-01,2376,2275,101,4.3
32029,2020-06-01,1936,1763,173,8.9
32031,2020-06-01,243829,222579,21250,8.7
32033,2020-06-01,4397,4223,174,4
32510,2020-06-01,24966,22779,2187,8.8
33001,2020-06-01,29388,26745,2643,9
33003,2020-06-01,22017,19757,2260,10.3
33005,2020-06-01,38122,34980,3142,8.2
33007,2020-06-01,13903,12487,1416,10.2
33009,2020-06-01,46626,42801,3825,8.2
33011,2020-06-01,233046,211036,22010,9.4
33013,2020-06-01,78976,72688,6288,8
33015,2020-06-01,178467,161287,17180,9.6
33017,2020-06-01,69515,63423,6092,8.8
33019,2020-06-01,21780,20142,1638,7.5
34001,2020-06-01,130190,85419,44771,34.4
34003,2020-06-01,493158,411987,81171,16.5
34005,2020-06-01,234617,201838,32779,14
34007,2020-06-01,263563,219741,43822,16.6
34009,2020-06-01,46891,37438,9453,20.2
34011,2020-06-01,67884,56555,11329,16.7
34013,2020-06-01,383713,311326,72387,18.9
34015,2020-06-01,154839,130520,24319,15.7
34017,2020-06-01,374136,307463,66673,17.8
34019,2020-06-01,63318,55447,7871,12.4
34021,2020-06-01,202832,177710,25122,12.4
34023,2020-06-01,438149,372705,65444,14.9
34025,2020-06-01,330084,279131,50953,15.4
34027,2020-06-01,254772,220436,34336,13.5
34029,2020-06-01,278682,232361,46321,16.6
34031,2020-06-01,256795,203941,52854,20.6
34033,2020-06-01,29649,25229,4420,14.9
34035,2020-06-01,169215,146841,22374,13.2
34037,2020-06-01,74999,63129,11870,15.8
34039,2020-06-01,281299,235116,46183,16.4
34041,2020-06-01,57987,49969,8018,13.8
35001,2020-06-01,322865,294116,28749,8.9
35003,2020-06-01,1073,995,78,7.3
35005,2020-06-01,27379,25026,2353,8.6
35006,2020-06-01,9014,8121,893,9.9
35007,2020-06-01,5245,4865,380,7.2
35009,2020-06-01,21235,20016,1219,5.7
35011,2020-06-01,684,652,32,4.7
35013,2020-06-01,91970,83780,8190,8.9
35015,2020-06-01,35421,33016,2405,6.8
35017,2020-06-01,12367,11160,1207,9.8
35019,2020-06-01,1472,1372,100,6.8
35021,2020-06-01,273,264,9,3.3
35023,2020-06-01,2094,1979,115,5.5
35025,2020-06-01,32651,29146,3505,10.7
35027,2020-06-01,8856,7976,880,9.9
35028,2020-06-01,9207,8829,378,4.1
35029,2020-06-01,11631,10071,1560,13.4
35031,2020-06-01,24248,21791,2457,10.1
35033,2020-06-01,2089,1922,167,8
35035,2020-06-01,25161,22743,2418,9.6
35037,2020-06-01,3097,2866,231,7.5
35039,2020-06-01,16156,14808,1348,8.3
35041,2020-06-01,7795,7271,524,6.7
35043,2020-06-01,64221,58114,6107,9.5
35045,2020-06-01,47248,41878,5370,11.4
35047,2020-06-01,10679,9790,889,8.3
35049,2020-06-01,70521,63853,6668,9.5
35051,2020-06-01,3842,3481,361,9.4
35053,2020-06-01,6176,5718,458,7.4
35055,2020-06-01,16084,14152,1932,12
35057,2020-06-01,5232,4708,524,10
35059,2020-06-01,1670,1581,89,5.3
35061,2020-06-01,29450,26796,2654,9
36001,2020-06-01,157903,141474,16429,10.4
36003,2020-06-01,18546,16533,2013,10.9
36005,2020-06-01,607890,457989,149901,24.7
36007,2020-06-01,85532,75882,9650,11.3
36009,2020-06-01,34452,29964,4488,13
36011,2020-06-01,36063,32280,3783,10.5
36013,2020-06-01,54055,47867,6188,11.4
36015,2020-06-01,37439,33001,4438,11.9
36017,2020-06-01,22102,20252,1850,8.4
36019,2020-06-01,37545,33739,3806,10.1
36021,2020-06-01,30699,28011,2688,8.8
36023,2020-06-01,22370,20089,2281,10.2
36025,2020-06-01,19341,17583,1758,9.1
36027,2020-06-01,142978,126681,16297,11.4
36029,2020-06-01,452385,392436,59949,13.3
36031,2020-06-01,16855,15120,1735,10.3
36033,2020-06-01,20071,17863,2208,11
36035,2020-06-01,22655,20104,2551,11.3
36037,2020-06-01,29572,26771,2801,9.5
36039,2020-06-01,20800,18430,2370,11.4
36041,2020-06-01,2434,2249,185,7.6
36043,2020-06-01,27526,24823,2703,9.8
36045,2020-06-01,42711,37935,4776,11.2
36047,2020-06-01,NA,931835,240515,20.5
36049,2020-06-01,11340,10307,1033,9.1
36051,2020-06-01,29879,27076,2803,9.4
36053,2020-06-01,31888,28547,3341,10.5
36055,2020-06-01,362315,319353,42962,11.9
36057,2020-06-01,22033,19493,2540,11.5
36059,2020-06-01,713885,622021,91864,12.9
36061,2020-06-01,848862,713347,135515,16
36063,2020-06-01,101748,87159,14589,14.3
36065,2020-06-01,101736,90581,11155,11
36067,2020-06-01,219940,193573,26367,12
36069,2020-06-01,54571,49049,5522,10.1
36071,2020-06-01,182339,159284,23055,12.6
36073,2020-06-01,17229,15365,1864,10.8
36075,2020-06-01,51788,45749,6039,11.7
36077,2020-06-01,27133,24627,2506,9.2
36079,2020-06-01,50653,45039,5614,11.1
36081,2020-06-01,NA,891380,246219,21.6
36083,2020-06-01,80761,72776,7985,9.9
36085,2020-06-01,210953,172817,38136,18.1
36087,2020-06-01,153053,134356,18697,12.2
36089,2020-06-01,44309,39666,4643,10.5
36091,2020-06-01,119327,107187,12140,10.2
36093,2020-06-01,77192,68186,9006,11.7
36095,2020-06-01,14303,12983,1320,9.2
36097,2020-06-01,8302,7389,913,11
36099,2020-06-01,16116,14365,1751,10.9
36101,2020-06-01,43183,38437,4746,11
36103,2020-06-01,780672,681225,99447,12.7
36105,2020-06-01,38772,34090,4682,12.1
36107,2020-06-01,23116,20732,2384,10.3
36109,2020-06-01,49275,44934,4341,8.8
36111,2020-06-01,90331,80191,10140,11.2
36113,2020-06-01,31326,27717,3609,11.5
36115,2020-06-01,27292,24701,2591,9.5
36117,2020-06-01,42839,38678,4161,9.7
36119,2020-06-01,478581,418790,59791,12.5
36121,2020-06-01,17907,16293,1614,9
36123,2020-06-01,11430,10470,960,8.4
37001,2020-06-01,78649,72606,6043,7.7
37003,2020-06-01,16655,15411,1244,7.5
37005,2020-06-01,4411,4133,278,6.3
37007,2020-06-01,10256,9468,788,7.7
37009,2020-06-01,12664,11976,688,5.4
37011,2020-06-01,7907,7460,447,5.7
37013,2020-06-01,18681,17475,1206,6.5
37015,2020-06-01,7564,7121,443,5.9
37017,2020-06-01,14993,13948,1045,7
37019,2020-06-01,52219,47881,4338,8.3
37021,2020-06-01,133498,120507,12991,9.7
37023,2020-06-01,37714,35023,2691,7.1
37025,2020-06-01,104516,96597,7919,7.6
37027,2020-06-01,33958,31157,2801,8.2
37029,2020-06-01,4459,4218,241,5.4
37031,2020-06-01,31890,30074,1816,5.7
37033,2020-06-01,9410,8711,699,7.4
37035,2020-06-01,73636,67518,6118,8.3
37037,2020-06-01,32913,31000,1913,5.8
37039,2020-06-01,11341,10483,858,7.6
37041,2020-06-01,5553,5237,316,5.7
37043,2020-06-01,4212,3920,292,6.9
37045,2020-06-01,48407,44675,3732,7.7
37047,2020-06-01,22951,21185,1766,7.7
37049,2020-06-01,39774,37133,2641,6.6
37051,2020-06-01,120366,108408,11958,9.9
37053,2020-06-01,13425,12613,812,6
37055,2020-06-01,19933,18345,1588,8
37057,2020-06-01,76126,70595,5531,7.3
37059,2020-06-01,19495,18044,1451,7.4
37061,2020-06-01,24210,22922,1288,5.3
37063,2020-06-01,160750,148748,12002,7.5
37065,2020-06-01,20148,17914,2234,11.1
37067,2020-06-01,178260,163857,14403,8.1
37069,2020-06-01,29197,27123,2074,7.1
37071,2020-06-01,107039,98149,8890,8.3
37073,2020-06-01,5023,4740,283,5.6
37075,2020-06-01,3471,3164,307,8.8
37077,2020-06-01,28973,27221,1752,6
37079,2020-06-01,9105,8579,526,5.8
37081,2020-06-01,251481,228010,23471,9.3
37083,2020-06-01,19761,18011,1750,8.9
37085,2020-06-01,51008,47140,3868,7.6
37087,2020-06-01,27813,25569,2244,8.1
37089,2020-06-01,50875,47048,3827,7.5
37091,2020-06-01,9155,8538,617,6.7
37093,2020-06-01,18764,17090,1674,8.9
37095,2020-06-01,1866,1712,154,8.3
37097,2020-06-01,85868,79233,6635,7.7
37099,2020-06-01,19910,18326,1584,8
37101,2020-06-01,92338,86106,6232,6.7
37103,2020-06-01,4092,3853,239,5.8
37105,2020-06-01,25660,23559,2101,8.2
37107,2020-06-01,27501,25803,1698,6.2
37109,2020-06-01,41257,38534,2723,6.6
37111,2020-06-01,20642,19252,1390,6.7
37113,2020-06-01,15696,14681,1015,6.5
37115,2020-06-01,9345,8656,689,7.4
37117,2020-06-01,8577,7962,615,7.2
37119,2020-06-01,601919,551051,50868,8.5
37121,2020-06-01,5935,5475,460,7.8
37123,2020-06-01,11049,10326,723,6.5
37125,2020-06-01,41289,38294,2995,7.3
37127,2020-06-01,40492,36936,3556,8.8
37129,2020-06-01,118520,109759,8761,7.4
37131,2020-06-01,7363,6852,511,6.9
37133,2020-06-01,61681,57246,4435,7.2
37135,2020-06-01,72987,68688,4299,5.9
37137,2020-06-01,5014,4739,275,5.5
37139,2020-06-01,16330,15177,1153,7.1
37141,2020-06-01,27111,25356,1755,6.5
37143,2020-06-01,4748,4439,309,6.5
37145,2020-06-01,17147,15852,1295,7.6
37147,2020-06-01,84610,78594,6016,7.1
37149,2020-06-01,8756,8212,544,6.2
37151,2020-06-01,62387,57624,4763,7.6
37153,2020-06-01,16802,15265,1537,9.1
37155,2020-06-01,49511,45150,4361,8.8
37157,2020-06-01,38080,34710,3370,8.8
37159,2020-06-01,63612,58379,5233,8.2
37161,2020-06-01,24750,22399,2351,9.5
37163,2020-06-01,28088,26500,1588,5.7
37165,2020-06-01,11815,10474,1341,11.3
37167,2020-06-01,29926,28088,1838,6.1
37169,2020-06-01,20337,18965,1372,6.7
37171,2020-06-01,33012,30796,2216,6.7
37173,2020-06-01,7822,7211,611,7.8
37175,2020-06-01,14616,13757,859,5.9
37177,2020-06-01,1404,1300,104,7.4
37179,2020-06-01,116977,109787,7190,6.1
37181,2020-06-01,17657,15970,1687,9.6
37183,2020-06-01,560081,520345,39736,7.1
37185,2020-06-01,6742,6070,672,10
37187,2020-06-01,4236,3906,330,7.8
37189,2020-06-01,29763,27974,1789,6
37191,2020-06-01,47117,43863,3254,6.9
37193,2020-06-01,28890,26993,1897,6.6
37195,2020-06-01,34232,31276,2956,8.6
37197,2020-06-01,16710,15447,1263,7.6
37199,2020-06-01,7970,7413,557,7
38001,2020-06-01,1035,986,49,4.7
38003,2020-06-01,5052,4766,286,5.7
38005,2020-06-01,2375,2150,225,9.5
38007,2020-06-01,366,342,24,6.6
38009,2020-06-01,2876,2661,215,7.5
38011,2020-06-01,1589,1524,65,4.1
38013,2020-06-01,1049,973,76,7.2
38015,2020-06-01,50489,47487,3002,5.9
38017,2020-06-01,106461,99442,7019,6.6
38019,2020-06-01,1838,1758,80,4.4
38021,2020-06-01,2261,2161,100,4.4
38023,2020-06-01,1380,1312,68,4.9
38025,2020-06-01,3402,3176,226,6.6
38027,2020-06-01,1199,1126,73,6.1
38029,2020-06-01,1392,1315,77,5.5
38031,2020-06-01,1452,1388,64,4.4
38033,2020-06-01,830,790,40,4.8
38035,2020-06-01,38240,35537,2703,7.1
38037,2020-06-01,1180,1141,39,3.3
38039,2020-06-01,1010,970,40,4
38041,2020-06-01,1373,1303,70,5.1
38043,2020-06-01,1246,1172,74,5.9
38045,2020-06-01,2004,1937,67,3.3
38047,2020-06-01,864,830,34,3.9
38049,2020-06-01,3044,2849,195,6.4
38051,2020-06-01,1069,1036,33,3.1
38053,2020-06-01,10396,9233,1163,11.2
38055,2020-06-01,4620,4347,273,5.9
38057,2020-06-01,3478,3207,271,7.8
38059,2020-06-01,16646,15514,1132,6.8
38061,2020-06-01,7517,6951,566,7.5
38063,2020-06-01,1342,1270,72,5.4
38065,2020-06-01,868,820,48,5.5
38067,2020-06-01,3280,3044,236,7.2
38069,2020-06-01,1639,1545,94,5.7
38071,2020-06-01,5486,5124,362,6.6
38073,2020-06-01,2792,2654,138,4.9
38075,2020-06-01,1221,1129,92,7.5
38077,2020-06-01,8403,7962,441,5.2
38079,2020-06-01,4846,3971,875,18.1
38081,2020-06-01,2707,2570,137,5.1
38083,2020-06-01,649,613,36,5.5
38085,2020-06-01,1243,1176,67,5.4
38087,2020-06-01,393,372,21,5.3
38089,2020-06-01,19426,17215,2211,11.4
38091,2020-06-01,977,936,41,4.2
38093,2020-06-01,10151,9663,488,4.8
38095,2020-06-01,1073,1036,37,3.4
38097,2020-06-01,4354,4116,238,5.5
38099,2020-06-01,5079,4725,354,7
38101,2020-06-01,31939,29112,2827,8.9
38103,2020-06-01,1869,1774,95,5.1
38105,2020-06-01,25617,21813,3804,14.8
39001,2020-06-01,10870,9702,1168,10.7
39003,2020-06-01,48582,43262,5320,11
39005,2020-06-01,26595,24387,2208,8.3
39007,2020-06-01,44187,39461,4726,10.7
39009,2020-06-01,27546,24846,2700,9.8
39011,2020-06-01,25378,22984,2394,9.4
39013,2020-06-01,29475,25759,3716,12.6
39015,2020-06-01,19803,17776,2027,10.2
39017,2020-06-01,198415,178874,19541,9.8
39019,2020-06-01,13054,11543,1511,11.6
39021,2020-06-01,19937,18101,1836,9.2
39023,2020-06-01,64938,58192,6746,10.4
39025,2020-06-01,108166,98071,10095,9.3
39027,2020-06-01,18067,16048,2019,11.2
39029,2020-06-01,47725,41958,5767,12.1
39031,2020-06-01,14231,12518,1713,12
39033,2020-06-01,18488,16157,2331,12.6
39035,2020-06-01,634272,537648,96624,15.2
39037,2020-06-01,25777,23647,2130,8.3
39039,2020-06-01,18136,16325,1811,10
39041,2020-06-01,108077,99933,8144,7.5
39043,2020-06-01,37257,32465,4792,12.9
39045,2020-06-01,77159,70180,6979,9
39047,2020-06-01,13928,12571,1357,9.7
39049,2020-06-01,703560,628734,74826,10.6
39051,2020-06-01,22020,19988,2032,9.2
39053,2020-06-01,12683,11448,1235,9.7
39055,2020-06-01,48241,43669,4572,9.5
39057,2020-06-01,83579,76277,7302,8.7
39059,2020-06-01,18757,16782,1975,10.5
39061,2020-06-01,427951,381698,46253,10.8
39063,2020-06-01,42559,38722,3837,9
39065,2020-06-01,14164,12693,1471,10.4
39067,2020-06-01,6806,6001,805,11.8
39069,2020-06-01,12856,11631,1225,9.5
39071,2020-06-01,17091,15185,1906,11.2
39073,2020-06-01,12895,11677,1218,9.4
39075,2020-06-01,20921,19867,1054,5
39077,2020-06-01,28020,24987,3033,10.8
39079,2020-06-01,13017,11589,1428,11
39081,2020-06-01,28287,24676,3611,12.8
39083,2020-06-01,31402,28897,2505,8
39085,2020-06-01,126550,111415,15135,12
39087,2020-06-01,24670,21880,2790,11.3
39089,2020-06-01,89738,81511,8227,9.2
39091,2020-06-01,22689,20514,2175,9.6
39093,2020-06-01,156051,134712,21339,13.7
39095,2020-06-01,214828,185953,28875,13.4
39097,2020-06-01,20360,18768,1592,7.8
39099,2020-06-01,101898,88443,13455,13.2
39101,2020-06-01,28415,25674,2741,9.6
39103,2020-06-01,97117,86342,10775,11.1
39105,2020-06-01,8940,7892,1048,11.7
39107,2020-06-01,23587,21726,1861,7.9
39109,2020-06-01,54531,49586,4945,9.1
39111,2020-06-01,5314,4589,725,13.6
39113,2020-06-01,260218,230306,29912,11.5
39115,2020-06-01,6636,5896,740,11.2
39117,2020-06-01,16556,15087,1469,8.9
39119,2020-06-01,40130,36243,3887,9.7
39121,2020-06-01,4728,4213,515,10.9
39123,2020-06-01,20572,18379,2193,10.7
39125,2020-06-01,8614,7782,832,9.7
39127,2020-06-01,15747,14093,1654,10.5
39129,2020-06-01,26106,23745,2361,9
39131,2020-06-01,10959,9632,1327,12.1
39133,2020-06-01,84895,76645,8250,9.7
39135,2020-06-01,21027,19115,1912,9.1
39137,2020-06-01,18701,17336,1365,7.3
39139,2020-06-01,53192,47203,5989,11.3
39141,2020-06-01,35749,32028,3721,10.4
39143,2020-06-01,30551,27454,3097,10.1
39145,2020-06-01,29541,26340,3201,10.8
39147,2020-06-01,27756,24943,2813,10.1
39149,2020-06-01,24530,22034,2496,10.2
39151,2020-06-01,185955,166029,19926,10.7
39153,2020-06-01,269582,238773,30809,11.4
39155,2020-06-01,85839,74173,11666,13.6
39157,2020-06-01,45568,41270,4298,9.4
39159,2020-06-01,28310,26243,2067,7.3
39161,2020-06-01,15310,13318,1992,13
39163,2020-06-01,5625,4986,639,11.4
39165,2020-06-01,120138,109625,10513,8.8
39167,2020-06-01,28254,25303,2951,10.4
39169,2020-06-01,62231,57353,4878,7.8
39171,2020-06-01,19213,17454,1759,9.2
39173,2020-06-01,70192,63604,6588,9.4
39175,2020-06-01,13131,12083,1048,8
40001,2020-06-01,7806,7336,470,6
40003,2020-06-01,2669,2551,118,4.4
40005,2020-06-01,4814,4459,355,7.4
40007,2020-06-01,2704,2630,74,2.7
40009,2020-06-01,9372,8616,756,8.1
40011,2020-06-01,4500,4216,284,6.3
40013,2020-06-01,20849,19718,1131,5.4
40015,2020-06-01,11439,10745,694,6.1
40017,2020-06-01,72710,67797,4913,6.8
40019,2020-06-01,20575,19089,1486,7.2
40021,2020-06-01,18245,17156,1089,6
40023,2020-06-01,5257,4854,403,7.7
40025,2020-06-01,1319,1282,37,2.8
40027,2020-06-01,139405,130217,9188,6.6
40029,2020-06-01,2319,2182,137,5.9
40031,2020-06-01,46725,43519,3206,6.9
40033,2020-06-01,2698,2505,193,7.2
40035,2020-06-01,5638,5294,344,6.1
40037,2020-06-01,30022,27977,2045,6.8
40039,2020-06-01,15170,14309,861,5.7
40041,2020-06-01,17594,16692,902,5.1
40043,2020-06-01,2843,2711,132,4.6
40045,2020-06-01,2014,1920,94,4.7
40047,2020-06-01,25559,24001,1558,6.1
40049,2020-06-01,12041,11267,774,6.4
40051,2020-06-01,25867,24231,1636,6.3
40053,2020-06-01,2551,2442,109,4.3
40055,2020-06-01,1832,1683,149,8.1
40057,2020-06-01,1164,1122,42,3.6
40059,2020-06-01,1710,1640,70,4.1
40061,2020-06-01,4101,3780,321,7.8
40063,2020-06-01,5184,4831,353,6.8
40065,2020-06-01,10369,9900,469,4.5
40067,2020-06-01,2450,2281,169,6.9
40069,2020-06-01,3195,2916,279,8.7
40071,2020-06-01,17430,16187,1243,7.1
40073,2020-06-01,8624,8204,420,4.9
40075,2020-06-01,3298,3113,185,5.6
40077,2020-06-01,3003,2721,282,9.4
40079,2020-06-01,18314,17062,1252,6.8
40081,2020-06-01,15204,14386,818,5.4
40083,2020-06-01,21415,20210,1205,5.6
40085,2020-06-01,5874,5619,255,4.3
40087,2020-06-01,19314,18070,1244,6.4
40089,2020-06-01,14289,13446,843,5.9
40091,2020-06-01,6958,6449,509,7.3
40093,2020-06-01,3685,3506,179,4.9
40095,2020-06-01,6695,6301,394,5.9
40097,2020-06-01,18631,17659,972,5.2
40099,2020-06-01,6198,5779,419,6.8
40101,2020-06-01,28635,26928,1707,6
40103,2020-06-01,5356,5112,244,4.6
40105,2020-06-01,4450,4219,231,5.2
40107,2020-06-01,4323,4063,260,6
40109,2020-06-01,377095,349925,27170,7.2
40111,2020-06-01,14763,13755,1008,6.8
40113,2020-06-01,19527,18309,1218,6.2
40115,2020-06-01,13930,13146,784,5.6
40117,2020-06-01,6967,6536,431,6.2
40119,2020-06-01,37203,34831,2372,6.4
40121,2020-06-01,16411,15215,1196,7.3
40123,2020-06-01,18629,17503,1126,6
40125,2020-06-01,31340,29383,1957,6.2
40127,2020-06-01,4136,3877,259,6.3
40129,2020-06-01,1771,1681,90,5.1
40131,2020-06-01,42772,40047,2725,6.4
40133,2020-06-01,9108,8505,603,6.6
40135,2020-06-01,15566,14594,972,6.2
40137,2020-06-01,18072,16704,1368,7.6
40139,2020-06-01,11411,11075,336,2.9
40141,2020-06-01,2937,2766,171,5.8
40143,2020-06-01,310260,287278,22982,7.4
40145,2020-06-01,36050,33745,2305,6.4
40147,2020-06-01,21296,19916,1380,6.5
40149,2020-06-01,4930,4598,332,6.7
40151,2020-06-01,4546,4305,241,5.3
40153,2020-06-01,8551,7948,603,7.1
41001,2020-06-01,7200,6446,754,10.5
41003,2020-06-01,48369,44139,4230,8.7
41005,2020-06-01,224422,199206,25216,11.2
41007,2020-06-01,19631,16601,3030,15.4
41009,2020-06-01,24780,21902,2878,11.6
41011,2020-06-01,26659,23225,3434,12.9
41013,2020-06-01,10374,9031,1343,12.9
41015,2020-06-01,8842,7670,1172,13.3
41017,2020-06-01,99338,87130,12208,12.3
41019,2020-06-01,47765,42578,5187,10.9
41021,2020-06-01,1082,989,93,8.6
41023,2020-06-01,3322,2997,325,9.8
41025,2020-06-01,3623,3355,268,7.4
41027,2020-06-01,14430,12997,1433,9.9
41029,2020-06-01,106434,93792,12642,11.9
41031,2020-06-01,10284,9010,1274,12.4
41033,2020-06-01,36255,32103,4152,11.5
41035,2020-06-01,29716,26292,3424,11.5
41037,2020-06-01,3747,3468,279,7.4
41039,2020-06-01,190043,167744,22299,11.7
41041,2020-06-01,21682,17989,3693,17
41043,2020-06-01,60898,54144,6754,11.1
41045,2020-06-01,12783,11857,926,7.2
41047,2020-06-01,165455,148077,17378,10.5
41049,2020-06-01,5937,5537,400,6.7
41051,2020-06-01,479925,412610,67315,14
41053,2020-06-01,40123,36149,3974,9.9
41055,2020-06-01,980,896,84,8.6
41057,2020-06-01,11901,10416,1485,12.5
41059,2020-06-01,38545,35437,3108,8.1
41061,2020-06-01,12089,10882,1207,10
41063,2020-06-01,3579,3251,328,9.2
41065,2020-06-01,16099,14599,1500,9.3
41067,2020-06-01,330029,295860,34169,10.4
41069,2020-06-01,716,674,42,5.9
41071,2020-06-01,55957,50223,5734,10.2
42001,2020-06-01,55715,49936,5779,10.4
42003,2020-06-01,635922,554270,81652,12.8
42005,2020-06-01,31295,27406,3889,12.4
42007,2020-06-01,83985,71548,12437,14.8
42009,2020-06-01,23193,20385,2808,12.1
42011,2020-06-01,225603,195854,29749,13.2
42013,2020-06-01,59044,52038,7006,11.9
42015,2020-06-01,28001,25203,2798,10
42017,2020-06-01,336648,292659,43989,13.1
42019,2020-06-01,96107,85692,10415,10.8
42021,2020-06-01,55588,48407,7181,12.9
42023,2020-06-01,2082,1751,331,15.9
42025,2020-06-01,31741,27466,4275,13.5
42027,2020-06-01,73589,67272,6317,8.6
42029,2020-06-01,274539,246378,28161,10.3
42031,2020-06-01,16383,14666,1717,10.5
42033,2020-06-01,35479,31310,4169,11.8
42035,2020-06-01,17487,15552,1935,11.1
42037,2020-06-01,33450,29862,3588,10.7
42039,2020-06-01,37067,32471,4596,12.4
42041,2020-06-01,130927,117832,13095,10
42043,2020-06-01,147338,127534,19804,13.4
42045,2020-06-01,299862,257776,42086,14
42047,2020-06-01,16023,13162,2861,17.9
42049,2020-06-01,125679,107365,18314,14.6
42051,2020-06-01,56763,48040,8723,15.4
42053,2020-06-01,1783,1540,243,13.6
42055,2020-06-01,77058,68162,8896,11.5
42057,2020-06-01,8361,7015,1346,16.1
42059,2020-06-01,16376,14147,2229,13.6
42061,2020-06-01,19501,16763,2738,14
42063,2020-06-01,37632,32922,4710,12.5
42065,2020-06-01,20033,17675,2358,11.8
42067,2020-06-01,12069,11011,1058,8.8
42069,2020-06-01,100894,86245,14649,14.5
42071,2020-06-01,292019,258721,33298,11.4
42073,2020-06-01,39571,34243,5328,13.5
42075,2020-06-01,72919,64221,8698,11.9
42077,2020-06-01,194395,166077,28318,14.6
42079,2020-06-01,152876,128233,24643,16.1
42081,2020-06-01,52529,45994,6535,12.4
42083,2020-06-01,17008,14777,2231,13.1
42085,2020-06-01,47400,41039,6361,13.4
42087,2020-06-01,20482,18372,2110,10.3
42089,2020-06-01,81614,66711,14903,18.3
42091,2020-06-01,441078,387700,53378,12.1
42093,2020-06-01,8954,8219,735,8.2
42095,2020-06-01,161339,139072,22267,13.8
42097,2020-06-01,41711,36515,5196,12.5
42099,2020-06-01,24222,21899,2323,9.6
42101,2020-06-01,742588,607231,135357,18.2
42103,2020-06-01,24698,20791,3907,15.8
42105,2020-06-01,6973,6165,808,11.6
42107,2020-06-01,66264,57670,8594,13
42109,2020-06-01,19167,17300,1867,9.7
42111,2020-06-01,32325,28289,4036,12.5
42113,2020-06-01,2508,2239,269,10.7
42115,2020-06-01,19340,17458,1882,9.7
42117,2020-06-01,18803,16414,2389,12.7
42119,2020-06-01,18691,16844,1847,9.9
42121,2020-06-01,21744,19222,2522,11.6
42123,2020-06-01,18412,16379,2033,11
42125,2020-06-01,104884,91320,13564,12.9
42127,2020-06-01,21362,18625,2737,12.8
42129,2020-06-01,176449,154496,21953,12.4
42131,2020-06-01,12782,11266,1516,11.9
42133,2020-06-01,235823,208294,27529,11.7
44001,2020-06-01,25383,22932,2451,9.7
44003,2020-06-01,90136,79832,10304,11.4
44005,2020-06-01,43590,39004,4586,10.5
44007,2020-06-01,328766,284477,44289,13.5
44009,2020-06-01,67361,60705,6656,9.9
45001,2020-06-01,10472,9478,994,9.5
45003,2020-06-01,76443,71071,5372,7
45005,2020-06-01,2713,2388,325,12
45007,2020-06-01,95729,87545,8184,8.5
45009,2020-06-01,5176,4554,622,12
45011,2020-06-01,8271,7507,764,9.2
45013,2020-06-01,82484,76343,6141,7.4
45015,2020-06-01,106754,97893,8861,8.3
45017,2020-06-01,6735,6144,591,8.8
45019,2020-06-01,220362,199380,20982,9.5
45021,2020-06-01,27105,24117,2988,11
45023,2020-06-01,14155,12294,1861,13.1
45025,2020-06-01,22867,20886,1981,8.7
45027,2020-06-01,13200,11977,1223,9.3
45029,2020-06-01,17389,15962,1427,8.2
45031,2020-06-01,32484,29482,3002,9.2
45033,2020-06-01,13563,12483,1080,8
45035,2020-06-01,80566,73541,7025,8.7
45037,2020-06-01,10912,10126,786,7.2
45039,2020-06-01,9981,8890,1091,10.9
45041,2020-06-01,70832,65361,5471,7.7
45043,2020-06-01,27372,24603,2769,10.1
45045,2020-06-01,267657,245417,22240,8.3
45047,2020-06-01,32551,29620,2931,9
45049,2020-06-01,8663,8038,625,7.2
45051,2020-06-01,157102,139208,17894,11.4
45053,2020-06-01,13358,12388,970,7.3
45055,2020-06-01,29736,27498,2238,7.5
45057,2020-06-01,42668,38140,4528,10.6
45059,2020-06-01,31945,28844,3101,9.7
45061,2020-06-01,6930,6215,715,10.3
45063,2020-06-01,151974,142104,9870,6.5
45065,2020-06-01,3486,3161,325,9.3
45067,2020-06-01,13681,12199,1482,10.8
45069,2020-06-01,9943,8545,1398,14.1
45071,2020-06-01,19244,17929,1315,6.8
45073,2020-06-01,36381,33635,2746,7.5
45075,2020-06-01,37315,32793,4522,12.1
45077,2020-06-01,59675,55096,4579,7.7
45079,2020-06-01,205610,187809,17801,8.7
45081,2020-06-01,8816,8271,545,6.2
45083,2020-06-01,160884,144975,15909,9.9
45085,2020-06-01,45943,41918,4025,8.8
45087,2020-06-01,12579,10924,1655,13.2
45089,2020-06-01,12708,11302,1406,11.1
45091,2020-06-01,144453,130555,13898,9.6
46003,2020-06-01,1543,1467,76,4.9
46005,2020-06-01,9966,9384,582,5.8
46007,2020-06-01,1072,981,91,8.5
46009,2020-06-01,2917,2747,170,5.8
46011,2020-06-01,19072,17728,1344,7
46013,2020-06-01,21399,19872,1527,7.1
46015,2020-06-01,2557,2381,176,6.9
46017,2020-06-01,723,618,105,14.5
46019,2020-06-01,5248,4833,415,7.9
46021,2020-06-01,761,727,34,4.5
46023,2020-06-01,4039,3612,427,10.6
46025,2020-06-01,1961,1829,132,6.7
46027,2020-06-01,7141,6589,552,7.7
46029,2020-06-01,15985,14804,1181,7.4
46031,2020-06-01,1307,1212,95,7.3
46033,2020-06-01,4051,3688,363,9
46035,2020-06-01,11416,10695,721,6.3
46037,2020-06-01,2830,2643,187,6.6
46039,2020-06-01,2217,2075,142,6.4
46041,2020-06-01,2276,1980,296,13
46043,2020-06-01,1561,1502,59,3.8
46045,2020-06-01,1990,1914,76,3.8
46047,2020-06-01,3231,2968,263,8.1
46049,2020-06-01,1050,997,53,5
46051,2020-06-01,4454,4239,215,4.8
46053,2020-06-01,2059,1949,110,5.3
46055,2020-06-01,1017,986,31,3
46057,2020-06-01,3353,3187,166,5
46059,2020-06-01,1755,1681,74,4.2
46061,2020-06-01,1748,1625,123,7
46063,2020-06-01,707,669,38,5.4
46065,2020-06-01,10410,9866,544,5.2
46067,2020-06-01,3625,3420,205,5.7
46069,2020-06-01,655,626,29,4.4
46071,2020-06-01,1333,1270,63,4.7
46073,2020-06-01,1110,1062,48,4.3
46075,2020-06-01,564,535,29,5.1
46077,2020-06-01,2740,2590,150,5.5
46079,2020-06-01,6683,6292,391,5.9
46081,2020-06-01,14172,12888,1284,9.1
46083,2020-06-01,35571,33534,2037,5.7
46085,2020-06-01,1753,1602,151,8.6
46087,2020-06-01,3110,2929,181,5.8
46089,2020-06-01,986,916,70,7.1
46091,2020-06-01,2440,2304,136,5.6
46093,2020-06-01,14403,13294,1109,7.7
46095,2020-06-01,721,660,61,8.5
46097,2020-06-01,1197,1112,85,7.1
46099,2020-06-01,117686,109395,8291,7
46101,2020-06-01,4143,3839,304,7.3
46102,2020-06-01,3587,3108,479,13.4
46103,2020-06-01,58437,53580,4857,8.3
46105,2020-06-01,1414,1336,78,5.5
46107,2020-06-01,1062,1014,48,4.5
46109,2020-06-01,4917,4537,380,7.7
46111,2020-06-01,1160,1088,72,6.2
46115,2020-06-01,3214,3038,176,5.5
46117,2020-06-01,1887,1782,105,5.6
46119,2020-06-01,779,748,31,4
46121,2020-06-01,3091,2829,262,8.5
46123,2020-06-01,3046,2891,155,5.1
46125,2020-06-01,4771,4466,305,6.4
46127,2020-06-01,8633,8007,626,7.3
46129,2020-06-01,2180,2005,175,8
46135,2020-06-01,12395,11606,789,6.4
46137,2020-06-01,919,845,74,8.1
47001,2020-06-01,33266,30439,2827,8.5
47003,2020-06-01,20788,18584,2204,10.6
47005,2020-06-01,6547,5920,627,9.6
47007,2020-06-01,4095,3704,391,9.5
47009,2020-06-01,61431,56121,5310,8.6
47011,2020-06-01,51309,46971,4338,8.5
47013,2020-06-01,14161,12920,1241,8.8
47015,2020-06-01,6289,5728,561,8.9
47017,2020-06-01,11264,10233,1031,9.2
47019,2020-06-01,22713,20643,2070,9.1
47021,2020-06-01,20667,19069,1598,7.7
47023,2020-06-01,8033,7436,597,7.4
47025,2020-06-01,12267,11261,1006,8.2
47027,2020-06-01,2517,2276,241,9.6
47029,2020-06-01,14689,12842,1847,12.6
47031,2020-06-01,25082,22475,2607,10.4
47033,2020-06-01,6575,6131,444,6.8
47035,2020-06-01,22407,20341,2066,9.2
47037,2020-06-01,399997,351860,48137,12
47039,2020-06-01,4395,3942,453,10.3
47041,2020-06-01,7328,6485,843,11.5
47043,2020-06-01,25369,23454,1915,7.5
47045,2020-06-01,16047,14462,1585,9.9
47047,2020-06-01,18078,16544,1534,8.5
47049,2020-06-01,7194,6619,575,8
47051,2020-06-01,19671,17677,1994,10.1
47053,2020-06-01,21110,19262,1848,8.8
47055,2020-06-01,14323,12806,1517,10.6
47057,2020-06-01,9191,8361,830,9
47059,2020-06-01,28264,25370,2894,10.2
47061,2020-06-01,4861,4232,629,12.9
47063,2020-06-01,27229,24743,2486,9.1
47065,2020-06-01,182521,165826,16695,9.1
47067,2020-06-01,1993,1780,213,10.7
47069,2020-06-01,9148,8263,885,9.7
47071,2020-06-01,9988,9141,847,8.5
47073,2020-06-01,22718,20328,2390,10.5
47075,2020-06-01,7507,6618,889,11.8
47077,2020-06-01,11880,10605,1275,10.7
47079,2020-06-01,13477,12276,1201,8.9
47081,2020-06-01,10729,9938,791,7.4
47083,2020-06-01,3064,2780,284,9.3
47085,2020-06-01,8238,7633,605,7.3
47087,2020-06-01,4478,4034,444,9.9
47089,2020-06-01,23972,21651,2321,9.7
47091,2020-06-01,7197,6617,580,8.1
47093,2020-06-01,234455,215964,18491,7.9
47095,2020-06-01,1684,1523,161,9.6
47097,2020-06-01,9449,8348,1101,11.7
47099,2020-06-01,18452,16580,1872,10.1
47101,2020-06-01,4856,4414,442,9.1
47103,2020-06-01,15221,13567,1654,10.9
47105,2020-06-01,22564,20774,1790,7.9
47107,2020-06-01,23396,21101,2295,9.8
47109,2020-06-01,8091,7275,816,10.1
47111,2020-06-01,10799,9885,914,8.5
47113,2020-06-01,47086,42358,4728,10
47115,2020-06-01,12293,11144,1149,9.3
47117,2020-06-01,15351,13422,1929,12.6
47119,2020-06-01,48196,42842,5354,11.1
47121,2020-06-01,5019,4484,535,10.7
47123,2020-06-01,19657,17705,1952,9.9
47125,2020-06-01,83503,75150,8353,10
47127,2020-06-01,3464,3204,260,7.5
47129,2020-06-01,7490,6916,574,7.7
47131,2020-06-01,11981,11022,959,8
47133,2020-06-01,9588,8890,698,7.3
47135,2020-06-01,2844,2539,305,10.7
47137,2020-06-01,2200,2045,155,7
47139,2020-06-01,7363,6751,612,8.3
47141,2020-06-01,33795,30967,2828,8.4
47143,2020-06-01,12874,11483,1391,10.8
47145,2020-06-01,22218,20497,1721,7.7
47147,2020-06-01,36295,33129,3166,8.7
47149,2020-06-01,179002,160240,18762,10.5
47151,2020-06-01,8026,7192,834,10.4
47153,2020-06-01,6086,5534,552,9.1
47155,2020-06-01,53438,46812,6626,12.4
47157,2020-06-01,437288,380000,57288,13.1
47159,2020-06-01,8924,8228,696,7.8
47161,2020-06-01,5207,4821,386,7.4
47163,2020-06-01,66620,60368,6252,9.4
47165,2020-06-01,98087,89045,9042,9.2
47167,2020-06-01,26429,24134,2295,8.7
47169,2020-06-01,5126,4715,411,8
47171,2020-06-01,6768,6095,673,9.9
47173,2020-06-01,7315,6676,639,8.7
47175,2020-06-01,1924,1712,212,11
47177,2020-06-01,15544,13616,1928,12.4
47179,2020-06-01,57164,52225,4939,8.6
47181,2020-06-01,5890,5361,529,9
47183,2020-06-01,14365,13238,1127,7.8
47185,2020-06-01,11708,10698,1010,8.6
47187,2020-06-01,120069,112048,8021,6.7
47189,2020-06-01,73496,66726,6770,9.2
48001,2020-06-01,22846,21399,1447,6.3
48003,2020-06-01,9849,8897,952,9.7
48005,2020-06-01,34663,31671,2992,8.6
48007,2020-06-01,9029,8225,804,8.9
48009,2020-06-01,3891,3660,231,5.9
48011,2020-06-01,864,826,38,4.4
48013,2020-06-01,21687,19605,2082,9.6
48015,2020-06-01,13557,12588,969,7.1
48017,2020-06-01,2245,2122,123,5.5
48019,2020-06-01,9742,9118,624,6.4
48021,2020-06-01,41835,38895,2940,7
48023,2020-06-01,1710,1642,68,4
48025,2020-06-01,9814,8689,1125,11.5
48027,2020-06-01,139840,128851,10989,7.9
48029,2020-06-01,944275,863104,81171,8.6
48031,2020-06-01,6206,5944,262,4.2
48033,2020-06-01,392,377,15,3.8
48035,2020-06-01,7949,7468,481,6.1
48037,2020-06-01,39105,36030,3075,7.9
48039,2020-06-01,175492,159233,16259,9.3
48041,2020-06-01,116152,108884,7268,6.3
48043,2020-06-01,4098,3785,313,7.6
48045,2020-06-01,532,507,25,4.7
48047,2020-06-01,2617,2309,308,11.8
48049,2020-06-01,14729,13662,1067,7.2
48051,2020-06-01,8153,7604,549,6.7
48053,2020-06-01,22365,21195,1170,5.2
48055,2020-06-01,19158,17773,1385,7.2
48057,2020-06-01,11713,10986,727,6.2
48059,2020-06-01,5908,5541,367,6.2
48061,2020-06-01,163091,145350,17741,10.9
48063,2020-06-01,4817,4407,410,8.5
48065,2020-06-01,2822,2682,140,5
48067,2020-06-01,12065,11038,1027,8.5
48069,2020-06-01,3169,3042,127,4
48071,2020-06-01,19220,17221,1999,10.4
48073,2020-06-01,20296,18476,1820,9
48075,2020-06-01,2719,2600,119,4.4
48077,2020-06-01,4629,4349,280,6
48079,2020-06-01,1065,972,93,8.7
48081,2020-06-01,1377,1290,87,6.3
48083,2020-06-01,2740,2513,227,8.3
48085,2020-06-01,557776,516649,41127,7.4
48087,2020-06-01,1026,980,46,4.5
48089,2020-06-01,9319,8754,565,6.1
48091,2020-06-01,71822,66684,5138,7.2
48093,2020-06-01,5347,5016,331,6.2
48095,2020-06-01,1253,1191,62,4.9
48097,2020-06-01,19533,18095,1438,7.4
48099,2020-06-01,23284,21575,1709,7.3
48101,2020-06-01,489,463,26,5.3
48103,2020-06-01,1602,1323,279,17.4
48105,2020-06-01,1601,1445,156,9.7
48107,2020-06-01,2330,2212,118,5.1
48109,2020-06-01,974,888,86,8.8
48111,2020-06-01,3522,3414,108,3.1
48113,2020-06-01,NA,NA,119468,8.8
48115,2020-06-01,4594,4150,444,9.7
48117,2020-06-01,7887,7580,307,3.9
48119,2020-06-01,2310,2170,140,6.1
48121,2020-06-01,491698,454075,37623,7.7
48123,2020-06-01,9510,8893,617,6.5
48125,2020-06-01,631,585,46,7.3
48127,2020-06-01,7018,6537,481,6.9
48129,2020-06-01,1269,1195,74,5.8
48131,2020-06-01,4937,4276,661,13.4
48133,2020-06-01,7432,6867,565,7.6
48135,2020-06-01,85354,74552,10802,12.7
48137,2020-06-01,1055,1012,43,4.1
48139,2020-06-01,91207,84900,6307,6.9
48141,2020-06-01,355288,321420,33868,9.5
48143,2020-06-01,19924,18621,1303,6.5
48145,2020-06-01,6464,6039,425,6.6
48147,2020-06-01,16951,16089,862,5.1
48149,2020-06-01,11308,10737,571,5
48151,2020-06-01,1504,1426,78,5.2
48153,2020-06-01,2384,2231,153,6.4
48155,2020-06-01,555,529,26,4.7
48157,2020-06-01,384162,350448,33714,8.8
48159,2020-06-01,4406,4135,271,6.2
48161,2020-06-01,6119,5530,589,9.6
48163,2020-06-01,9938,9336,602,6.1
48165,2020-06-01,9393,8788,605,6.4
48167,2020-06-01,162412,146970,15442,9.5
48169,2020-06-01,2088,1923,165,7.9
48171,2020-06-01,12792,12101,691,5.4
48173,2020-06-01,731,699,32,4.4
48175,2020-06-01,3119,2856,263,8.4
48177,2020-06-01,9117,8564,553,6.1
48179,2020-06-01,7862,7126,736,9.4
48181,2020-06-01,63096,58946,4150,6.6
48183,2020-06-01,55850,50633,5217,9.3
48185,2020-06-01,10911,9955,956,8.8
48187,2020-06-01,79725,74234,5491,6.9
48189,2020-06-01,11383,10470,913,8
48191,2020-06-01,981,916,65,6.6
48193,2020-06-01,3431,3256,175,5.1
48195,2020-06-01,2485,2389,96,3.9
48197,2020-06-01,1643,1560,83,5.1
48199,2020-06-01,24013,21569,2444,10.2
48201,2020-06-01,NA,NA,230319,10
48203,2020-06-01,28007,25486,2521,9
48205,2020-06-01,2528,2470,58,2.3
48207,2020-06-01,2118,1995,123,5.8
48209,2020-06-01,118074,109032,9042,7.7
48211,2020-06-01,1710,1623,87,5.1
48213,2020-06-01,35564,32941,2623,7.4
48215,2020-06-01,352048,308536,43512,12.4
48217,2020-06-01,15919,14781,1138,7.1
48219,2020-06-01,10946,9924,1022,9.3
48221,2020-06-01,26924,24902,2022,7.5
48223,2020-06-01,16604,15665,939,5.7
48225,2020-06-01,9614,9068,546,5.7
48227,2020-06-01,13929,12658,1271,9.1
48229,2020-06-01,1770,1608,162,9.2
48231,2020-06-01,42732,39562,3170,7.4
48233,2020-06-01,8256,7571,685,8.3
48235,2020-06-01,717,664,53,7.4
48237,2020-06-01,3228,2967,261,8.1
48239,2020-06-01,7229,6780,449,6.2
48241,2020-06-01,12373,10887,1486,12
48243,2020-06-01,928,877,51,5.5
48245,2020-06-01,103722,89952,13770,13.3
48247,2020-06-01,1759,1565,194,11
48249,2020-06-01,17040,14672,2368,13.9
48251,2020-06-01,80585,74511,6074,7.5
48253,2020-06-01,5569,5141,428,7.7
48255,2020-06-01,7098,6608,490,6.9
48257,2020-06-01,64022,59111,4911,7.7
48259,2020-06-01,21371,20147,1224,5.7
48261,2020-06-01,181,170,11,6.1
48263,2020-06-01,446,427,19,4.3
48265,2020-06-01,21317,19948,1369,6.4
48267,2020-06-01,1713,1619,94,5.5
48269,2020-06-01,217,213,4,1.8
48271,2020-06-01,1304,1223,81,6.2
48273,2020-06-01,13145,11913,1232,9.4
48275,2020-06-01,1351,1259,92,6.8
48277,2020-06-01,23559,21777,1782,7.6
48279,2020-06-01,4970,4689,281,5.7
48281,2020-06-01,8793,8284,509,5.8
48283,2020-06-01,4123,3827,296,7.2
48285,2020-06-01,7910,7437,473,6
48287,2020-06-01,9494,9019,475,5
48289,2020-06-01,6046,5549,497,8.2
48291,2020-06-01,32834,29082,3752,11.4
48293,2020-06-01,8336,7683,653,7.8
48295,2020-06-01,1482,1415,67,4.5
48297,2020-06-01,5430,5015,415,7.6
48299,2020-06-01,8259,7772,487,5.9
48301,2020-06-01,670,665,5,0.7
48303,2020-06-01,152121,141956,10165,6.7
48305,2020-06-01,2649,2482,167,6.3
48307,2020-06-01,3119,2872,247,7.9
48309,2020-06-01,118159,110034,8125,6.9
48311,2020-06-01,825,804,21,2.5
48313,2020-06-01,4322,3968,354,8.2
48315,2020-06-01,4046,3662,384,9.5
48317,2020-06-01,2599,2428,171,6.6
48319,2020-06-01,1653,1557,96,5.8
48321,2020-06-01,16566,14704,1862,11.2
48323,2020-06-01,23975,20171,3804,15.9
48325,2020-06-01,21328,19814,1514,7.1
48327,2020-06-01,815,763,52,6.4
48329,2020-06-01,99933,90369,9564,9.6
48331,2020-06-01,9255,8516,739,8
48333,2020-06-01,1761,1683,78,4.4
48335,2020-06-01,2270,2062,208,9.2
48337,2020-06-01,9023,8355,668,7.4
48339,2020-06-01,277495,253878,23617,8.5
48341,2020-06-01,10108,9662,446,4.4
48343,2020-06-01,4754,4177,577,12.1
48345,2020-06-01,434,413,21,4.8
48347,2020-06-01,26597,24563,2034,7.6
48349,2020-06-01,23208,21601,1607,6.9
48351,2020-06-01,4927,4338,589,12
48353,2020-06-01,6908,6493,415,6
48355,2020-06-01,162175,146407,15768,9.7
48357,2020-06-01,3972,3708,264,6.6
48359,2020-06-01,842,813,29,3.4
48361,2020-06-01,34947,30823,4124,11.8
48363,2020-06-01,13208,12159,1049,7.9
48365,2020-06-01,9650,8805,845,8.8
48367,2020-06-01,65624,61207,4417,6.7
48369,2020-06-01,4428,4306,122,2.8
48371,2020-06-01,6151,5549,602,9.8
48373,2020-06-01,17548,15878,1670,9.5
48375,2020-06-01,52572,49112,3460,6.6
48377,2020-06-01,3180,2651,529,16.6
48379,2020-06-01,5854,5556,298,5.1
48381,2020-06-01,68067,64363,3704,5.4
48383,2020-06-01,1917,1711,206,10.7
48385,2020-06-01,943,869,74,7.8
48387,2020-06-01,4823,4471,352,7.3
48389,2020-06-01,11992,11261,731,6.1
48391,2020-06-01,3050,2770,280,9.2
48393,2020-06-01,385,367,18,4.7
48395,2020-06-01,7429,6927,502,6.8
48397,2020-06-01,51340,47717,3623,7.1
48399,2020-06-01,4337,4085,252,5.8
48401,2020-06-01,21771,20059,1712,7.9
48403,2020-06-01,3553,3125,428,12
48405,2020-06-01,3368,3072,296,8.8
48407,2020-06-01,11316,10331,985,8.7
48409,2020-06-01,28910,25792,3118,10.8
48411,2020-06-01,2367,2252,115,4.9
48413,2020-06-01,1206,1105,101,8.4
48415,2020-06-01,6429,5828,601,9.3
48417,2020-06-01,1776,1667,109,6.1
48419,2020-06-01,10649,9797,852,8
48421,2020-06-01,1273,1233,40,3.1
48423,2020-06-01,105750,97518,8232,7.8
48425,2020-06-01,4255,3940,315,7.4
48427,2020-06-01,25208,20670,4538,18
48429,2020-06-01,3841,3576,265,6.9
48431,2020-06-01,549,506,43,7.8
48433,2020-06-01,533,500,33,6.2
48435,2020-06-01,1279,1145,134,10.5
48437,2020-06-01,2419,2287,132,5.5
48439,2020-06-01,NA,981022,91801,8.6
48441,2020-06-01,64956,60936,4020,6.2
48443,2020-06-01,348,327,21,6
48445,2020-06-01,4698,4285,413,8.8
48447,2020-06-01,588,554,34,5.8
48449,2020-06-01,12558,11554,1004,8
48451,2020-06-01,51096,47181,3915,7.7
48453,2020-06-01,729512,675161,54351,7.5
48455,2020-06-01,5085,4644,441,8.7
48457,2020-06-01,6903,6136,767,11.1
48459,2020-06-01,17027,15552,1475,8.7
48461,2020-06-01,1621,1499,122,7.5
48463,2020-06-01,10806,10033,773,7.2
48465,2020-06-01,21976,19860,2116,9.6
48467,2020-06-01,25228,23447,1781,7.1
48469,2020-06-01,40978,37373,3605,8.8
48471,2020-06-01,23291,21476,1815,7.8
48473,2020-06-01,22868,20905,1963,8.6
48475,2020-06-01,7787,7100,687,8.8
48477,2020-06-01,14618,13691,927,6.3
48479,2020-06-01,114967,103736,11231,9.8
48481,2020-06-01,20897,19361,1536,7.4
48483,2020-06-01,2131,2002,129,6.1
48485,2020-06-01,53522,49608,3914,7.3
48487,2020-06-01,4722,4436,286,6.1
48489,2020-06-01,6571,5744,827,12.6
48491,2020-06-01,306446,285536,20910,6.8
48493,2020-06-01,24254,22666,1588,6.5
48495,2020-06-01,3898,3455,443,11.4
48497,2020-06-01,31249,28889,2360,7.6
48499,2020-06-01,17036,15780,1256,7.4
48501,2020-06-01,3892,3336,556,14.3
48503,2020-06-01,7625,7175,450,5.9
48505,2020-06-01,4761,4136,625,13.1
48507,2020-06-01,3209,2678,531,16.5
49001,2020-06-01,2883,2758,125,4.3
49003,2020-06-01,26855,25408,1447,5.4
49005,2020-06-01,63301,61038,2263,3.6
49007,2020-06-01,8675,8180,495,5.7
49009,2020-06-01,430,412,18,4.2
49011,2020-06-01,179478,170868,8610,4.8
49013,2020-06-01,8151,7454,697,8.6
49015,2020-06-01,4484,4274,210,4.7
49017,2020-06-01,3166,2941,225,7.1
49019,2020-06-01,6711,6134,577,8.6
49021,2020-06-01,23464,22164,1300,5.5
49023,2020-06-01,5697,5517,180,3.2
49025,2020-06-01,3942,3709,233,5.9
49027,2020-06-01,6107,5901,206,3.4
49029,2020-06-01,5678,5467,211,3.7
49031,2020-06-01,493,463,30,6.1
49033,2020-06-01,1394,1354,40,2.9
49035,2020-06-01,636106,595065,41041,6.5
49037,2020-06-01,6255,5634,621,9.9
49039,2020-06-01,12651,12109,542,4.3
49041,2020-06-01,9968,9515,453,4.5
49043,2020-06-01,24592,22183,2409,9.8
49045,2020-06-01,33767,31756,2011,6
49047,2020-06-01,14377,12993,1384,9.6
49049,2020-06-01,310957,297078,13879,4.5
49051,2020-06-01,16736,15349,1387,8.3
49053,2020-06-01,77737,72878,4859,6.3
49055,2020-06-01,1517,1418,99,6.5
49057,2020-06-01,131813,124765,7048,5.3
50001,2020-06-01,21125,19652,1473,7
50003,2020-06-01,18281,16350,1931,10.6
50005,2020-06-01,15133,13722,1411,9.3
50007,2020-06-01,96093,87695,8398,8.7
50009,2020-06-01,2819,2533,286,10.1
50011,2020-06-01,27404,25053,2351,8.6
50013,2020-06-01,4005,3635,370,9.2
50015,2020-06-01,14399,12450,1949,13.5
50017,2020-06-01,16174,15019,1155,7.1
50019,2020-06-01,13428,11920,1508,11.2
50021,2020-06-01,31042,27418,3624,11.7
50023,2020-06-01,33421,30576,2845,8.5
50025,2020-06-01,22845,20267,2578,11.3
50027,2020-06-01,29513,26523,2990,10.1
51001,2020-06-01,16807,15518,1289,7.7
51003,2020-06-01,56828,52594,4234,7.5
51005,2020-06-01,6757,6169,588,8.7
51007,2020-06-01,6134,5696,438,7.1
51009,2020-06-01,14448,13396,1052,7.3
51011,2020-06-01,6852,6370,482,7
51013,2020-06-01,151320,142542,8778,5.8
51015,2020-06-01,38204,35986,2218,5.8
51017,2020-06-01,2828,2429,399,14.1
51019,2020-06-01,36874,34497,2377,6.4
51021,2020-06-01,2749,2554,195,7.1
51023,2020-06-01,16500,15522,978,5.9
51025,2020-06-01,5883,5321,562,9.6
51027,2020-06-01,6543,5860,683,10.4
51029,2020-06-01,6394,5810,584,9.1
51031,2020-06-01,25136,23183,1953,7.8
51033,2020-06-01,15087,13766,1321,8.8
51035,2020-06-01,13616,12316,1300,9.5
51036,2020-06-01,3630,3298,332,9.1
51037,2020-06-01,5146,4791,355,6.9
51041,2020-06-01,184356,169794,14562,7.9
51043,2020-06-01,7476,7028,448,6
51045,2020-06-01,2190,2050,140,6.4
51047,2020-06-01,24325,22754,1571,6.5
51049,2020-06-01,4550,4186,364,8
51051,2020-06-01,4681,4260,421,9
51053,2020-06-01,13482,12396,1086,8.1
51057,2020-06-01,5469,5011,458,8.4
51059,2020-06-01,635520,585682,49838,7.8
51061,2020-06-01,36646,34372,2274,6.2
51063,2020-06-01,7618,7118,500,6.6
51065,2020-06-01,13809,12793,1016,7.4
51067,2020-06-01,25334,23551,1783,7
51069,2020-06-01,46280,43264,3016,6.5
51071,2020-06-01,7322,6718,604,8.2
51073,2020-06-01,19338,17984,1354,7
51075,2020-06-01,10958,10238,720,6.6
51077,2020-06-01,8104,7563,541,6.7
51079,2020-06-01,10457,9674,783,7.5
51081,2020-06-01,4241,3892,349,8.2
51083,2020-06-01,15530,14264,1266,8.2
51085,2020-06-01,57523,53855,3668,6.4
51087,2020-06-01,180363,164599,15764,8.7
51089,2020-06-01,24150,21895,2255,9.3
51091,2020-06-01,1213,1154,59,4.9
51093,2020-06-01,19040,17836,1204,6.3
51095,2020-06-01,37120,33576,3544,9.5
51097,2020-06-01,3817,3562,255,6.7
51099,2020-06-01,12871,12108,763,5.9
51101,2020-06-01,8990,8361,629,7
51103,2020-06-01,5592,5130,462,8.3
51105,2020-06-01,8076,7452,624,7.7
51107,2020-06-01,221061,204578,16483,7.5
51109,2020-06-01,19945,18573,1372,6.9
51111,2020-06-01,5113,4771,342,6.7
51113,2020-06-01,7375,7009,366,5
51115,2020-06-01,4041,3795,246,6.1
51117,2020-06-01,12362,11322,1040,8.4
51119,2020-06-01,5320,4972,348,6.5
51121,2020-06-01,45500,42493,3007,6.6
51125,2020-06-01,7475,6915,560,7.5
51127,2020-06-01,12168,11373,795,6.5
51131,2020-06-01,5495,4984,511,9.3
51133,2020-06-01,5797,5393,404,7
51135,2020-06-01,6934,6496,438,6.3
51137,2020-06-01,17529,16265,1264,7.2
51139,2020-06-01,12174,11081,1093,9
51141,2020-06-01,7197,6674,523,7.3
51143,2020-06-01,29263,26974,2289,7.8
51145,2020-06-01,13793,12889,904,6.6
51147,2020-06-01,10227,9408,819,8
51149,2020-06-01,14806,13557,1249,8.4
51153,2020-06-01,247201,225194,22007,8.9
51155,2020-06-01,15018,13590,1428,9.5
51157,2020-06-01,3675,3462,213,5.8
51159,2020-06-01,4030,3779,251,6.2
51161,2020-06-01,47195,43982,3213,6.8
51163,2020-06-01,10857,10139,718,6.6
51165,2020-06-01,39834,37123,2711,6.8
51167,2020-06-01,11057,10163,894,8.1
51169,2020-06-01,8824,8258,566,6.4
51171,2020-06-01,22354,20817,1537,6.9
51173,2020-06-01,13471,12326,1145,8.5
51175,2020-06-01,8846,8313,533,6
51177,2020-06-01,66698,61320,5378,8.1
51179,2020-06-01,71152,65782,5370,7.5
51181,2020-06-01,3555,3287,268,7.5
51183,2020-06-01,3804,3409,395,10.4
51185,2020-06-01,15524,14104,1420,9.1
51187,2020-06-01,20319,18777,1542,7.6
51191,2020-06-01,26121,24122,1999,7.7
51193,2020-06-01,9470,8801,669,7.1
51195,2020-06-01,12951,11792,1159,8.9
51197,2020-06-01,13522,12221,1301,9.6
51199,2020-06-01,32437,29957,2480,7.6
51510,2020-06-01,101457,93407,8050,7.9
51520,2020-06-01,7202,6499,703,9.8
51530,2020-06-01,3499,3274,225,6.4
51540,2020-06-01,26589,24189,2400,9
51550,2020-06-01,121569,111812,9757,8
51570,2020-06-01,8718,7937,781,9
51580,2020-06-01,2446,2129,317,13
51590,2020-06-01,18909,16730,2179,11.5
51595,2020-06-01,2397,2060,337,14.1
51600,2020-06-01,13484,12428,1056,7.8
51610,2020-06-01,8355,7952,403,4.8
51620,2020-06-01,3644,3265,379,10.4
51630,2020-06-01,14183,12850,1333,9.4
51640,2020-06-01,2997,2711,286,9.5
51650,2020-06-01,65219,58110,7109,10.9
51660,2020-06-01,24027,21797,2230,9.3
51670,2020-06-01,9973,8599,1374,13.8
51678,2020-06-01,2053,1865,188,9.2
51680,2020-06-01,35521,32116,3405,9.6
51683,2020-06-01,22210,20257,1953,8.8
51685,2020-06-01,9567,8643,924,9.7
51690,2020-06-01,5800,5015,785,13.5
51700,2020-06-01,90718,80386,10332,11.4
51710,2020-06-01,113603,101044,12559,11.1
51720,2020-06-01,1670,1517,153,9.2
51730,2020-06-01,13793,11435,2358,17.1
51735,2020-06-01,6218,5873,345,5.5
51740,2020-06-01,45209,39925,5284,11.7
51750,2020-06-01,7938,7233,705,8.9
51760,2020-06-01,120950,106635,14315,11.8
51770,2020-06-01,48575,43573,5002,10.3
51775,2020-06-01,12456,11497,959,7.7
51790,2020-06-01,12782,11702,1080,8.4
51800,2020-06-01,44293,40576,3717,8.4
51810,2020-06-01,232107,213158,18949,8.2
51820,2020-06-01,11169,10195,974,8.7
51830,2020-06-01,6825,6048,777,11.4
51840,2020-06-01,14433,13270,1163,8.1
53001,2020-06-01,8725,8090,635,7.3
53003,2020-06-01,9862,9323,539,5.5
53005,2020-06-01,105693,95786,9907,9.4
53007,2020-06-01,44213,39826,4387,9.9
53009,2020-06-01,30186,26989,3197,10.6
53011,2020-06-01,242653,217766,24887,10.3
53013,2020-06-01,1702,1579,123,7.2
53015,2020-06-01,48978,44150,4828,9.9
53017,2020-06-01,20902,18924,1978,9.5
53019,2020-06-01,2579,2296,283,11
53021,2020-06-01,42824,38529,4295,10
53023,2020-06-01,785,721,64,8.2
53025,2020-06-01,45539,41460,4079,9
53027,2020-06-01,29842,26201,3641,12.2
53029,2020-06-01,35305,32117,3188,9
53031,2020-06-01,13002,11629,1373,10.6
53033,2020-06-01,NA,NA,122185,9.6
53035,2020-06-01,132005,121208,10797,8.2
53037,2020-06-01,22223,20168,2055,9.2
53039,2020-06-01,9842,8936,906,9.2
53041,2020-06-01,34920,31393,3527,10.1
53043,2020-06-01,4491,4197,294,6.5
53045,2020-06-01,25765,23091,2674,10.4
53047,2020-06-01,18057,16288,1769,9.8
53049,2020-06-01,8380,7340,1040,12.4
53051,2020-06-01,4829,4320,509,10.5
53053,2020-06-01,454079,402803,51276,11.3
53055,2020-06-01,7606,6844,762,10
53057,2020-06-01,63673,56584,7089,11.1
53059,2020-06-01,5495,4927,568,10.3
53061,2020-06-01,436972,392552,44420,10.2
53063,2020-06-01,252227,227720,24507,9.7
53065,2020-06-01,17970,16350,1620,9
53067,2020-06-01,145372,132471,12901,8.9
53069,2020-06-01,1371,1243,128,9.3
53071,2020-06-01,29524,27536,1988,6.7
53073,2020-06-01,118358,106174,12184,10.3
53075,2020-06-01,20135,18936,1199,6
53077,2020-06-01,131160,116744,14416,11
54001,2020-06-01,6850,6145,705,10.3
54003,2020-06-01,56884,51791,5093,9
54005,2020-06-01,7547,6578,969,12.8
54007,2020-06-01,4779,4226,553,11.6
54009,2020-06-01,9870,8822,1048,10.6
54011,2020-06-01,42402,38081,4321,10.2
54013,2020-06-01,2134,1771,363,17
54015,2020-06-01,3146,2695,451,14.3
54017,2020-06-01,3777,3509,268,7.1
54019,2020-06-01,16569,14649,1920,11.6
54021,2020-06-01,2298,2026,272,11.8
54023,2020-06-01,5680,5222,458,8.1
54025,2020-06-01,15317,13936,1381,9
54027,2020-06-01,10368,9646,722,7
54029,2020-06-01,13167,11541,1626,12.3
54031,2020-06-01,5702,5175,527,9.2
54033,2020-06-01,33971,30730,3241,9.5
54035,2020-06-01,12430,11179,1251,10.1
54037,2020-06-01,29784,27268,2516,8.4
54039,2020-06-01,83029,73538,9491,11.4
54041,2020-06-01,6266,5438,828,13.2
54043,2020-06-01,7294,6451,843,11.6
54045,2020-06-01,10525,8880,1645,15.6
54047,2020-06-01,4340,3716,624,14.4
54049,2020-06-01,24502,21664,2838,11.6
54051,2020-06-01,13471,11901,1570,11.7
54053,2020-06-01,9592,8604,988,10.3
54055,2020-06-01,20154,17716,2438,12.1
54057,2020-06-01,11989,10846,1143,9.5
54059,2020-06-01,6400,5212,1188,18.6
54061,2020-06-01,53350,48386,4964,9.3
54063,2020-06-01,5652,5167,485,8.6
54065,2020-06-01,7786,7132,654,8.4
54067,2020-06-01,8872,7746,1126,12.7
54069,2020-06-01,20328,18165,2163,10.6
54071,2020-06-01,3537,3305,232,6.6
54073,2020-06-01,2888,2535,353,12.2
54075,2020-06-01,3964,3465,499,12.6
54077,2020-06-01,15145,13715,1430,9.4
54079,2020-06-01,26922,24469,2453,9.1
54081,2020-06-01,31143,27741,3402,10.9
54083,2020-06-01,11872,10493,1379,11.6
54085,2020-06-01,4146,3756,390,9.4
54087,2020-06-01,4858,4118,740,15.2
54089,2020-06-01,4118,3718,400,9.7
54091,2020-06-01,7422,6718,704,9.5
54093,2020-06-01,3182,2849,333,10.5
54095,2020-06-01,2967,2601,366,12.3
54097,2020-06-01,8694,7519,1175,13.5
54099,2020-06-01,15888,14304,1584,10
54101,2020-06-01,3020,2681,339,11.2
54103,2020-06-01,6259,5536,723,11.6
54105,2020-06-01,2267,2040,227,10
54107,2020-06-01,37456,33610,3846,10.3
54109,2020-06-01,6178,5381,797,12.9
55001,2020-06-01,8213,7251,962,11.7
55003,2020-06-01,7869,7021,848,10.8
55005,2020-06-01,23952,22213,1739,7.3
55007,2020-06-01,7472,6691,781,10.5
55009,2020-06-01,142777,130164,12613,8.8
55011,2020-06-01,6620,5997,623,9.4
55013,2020-06-01,7120,6326,794,11.2
55015,2020-06-01,27147,25321,1826,6.7
55017,2020-06-01,32469,29808,2661,8.2
55019,2020-06-01,17952,16836,1116,6.2
55021,2020-06-01,30692,28100,2592,8.4
55023,2020-06-01,7628,6946,682,8.9
55025,2020-06-01,309298,286290,23008,7.4
55027,2020-06-01,47487,43960,3527,7.4
55029,2020-06-01,13995,12784,1211,8.7
55031,2020-06-01,23203,20369,2834,12.2
55033,2020-06-01,23646,21764,1882,8
55035,2020-06-01,57969,53013,4956,8.5
55037,2020-06-01,2321,2082,239,10.3
55039,2020-06-01,59476,54550,4926,8.3
55041,2020-06-01,4534,3684,850,18.7
55043,2020-06-01,27832,25829,2003,7.2
55045,2020-06-01,20265,18900,1365,6.7
55047,2020-06-01,9430,8680,750,8
55049,2020-06-01,13427,12411,1016,7.6
55051,2020-06-01,2664,2284,380,14.3
55053,2020-06-01,10843,9383,1460,13.5
55055,2020-06-01,46388,42987,3401,7.3
55057,2020-06-01,13882,12508,1374,9.9
55059,2020-06-01,89069,80154,8915,10
55061,2020-06-01,10996,10267,729,6.6
55063,2020-06-01,65211,60061,5150,7.9
55065,2020-06-01,10137,9542,595,5.9
55067,2020-06-01,9435,8668,767,8.1
55069,2020-06-01,15006,13932,1074,7.2
55071,2020-06-01,41755,38309,3446,8.3
55073,2020-06-01,74270,69133,5137,6.9
55075,2020-06-01,19705,17652,2053,10.4
55077,2020-06-01,7705,7058,647,8.4
55078,2020-06-01,1826,1449,377,20.6
55079,2020-06-01,478513,422363,56150,11.7
55081,2020-06-01,23636,21860,1776,7.5
55083,2020-06-01,20602,18889,1713,8.3
55085,2020-06-01,17120,15616,1504,8.8
55087,2020-06-01,102015,94031,7984,7.8
55089,2020-06-01,48849,44953,3896,8
55091,2020-06-01,4149,3812,337,8.1
55093,2020-06-01,25681,23065,2616,10.2
55095,2020-06-01,24455,22325,2130,8.7
55097,2020-06-01,38953,35972,2981,7.7
55099,2020-06-01,6490,5938,552,8.5
55101,2020-06-01,102241,92609,9632,9.4
55103,2020-06-01,9260,8666,594,6.4
55105,2020-06-01,84555,76223,8332,9.9
55107,2020-06-01,6734,6173,561,8.3
55109,2020-06-01,50654,45710,4944,9.8
55111,2020-06-01,36173,32450,3723,10.3
55113,2020-06-01,7632,6972,660,8.6
55115,2020-06-01,21423,19625,1798,8.4
55117,2020-06-01,63542,58459,5083,8
55119,2020-06-01,10960,10280,680,6.2
55121,2020-06-01,16213,14777,1436,8.9
55123,2020-06-01,15442,14376,1066,6.9
55125,2020-06-01,9597,8732,865,9
55127,2020-06-01,57263,52454,4809,8.4
55129,2020-06-01,7879,7252,627,8
55131,2020-06-01,76978,70772,6206,8.1
55133,2020-06-01,223656,205538,18118,8.1
55135,2020-06-01,25904,24038,1866,7.2
55137,2020-06-01,11621,10734,887,7.6
55139,2020-06-01,91277,84116,7161,7.8
55141,2020-06-01,35920,32761,3159,8.8
56001,2020-06-01,22019,21026,993,4.5
56003,2020-06-01,5400,5099,301,5.6
56005,2020-06-01,24562,22210,2352,9.6
56007,2020-06-01,7949,7488,461,5.8
56009,2020-06-01,9347,8660,687,7.3
56011,2020-06-01,3872,3681,191,4.9
56013,2020-06-01,19578,18043,1535,7.8
56015,2020-06-01,6756,6426,330,4.9
56017,2020-06-01,2249,2111,138,6.1
56019,2020-06-01,4258,3962,296,7
56021,2020-06-01,49919,46571,3348,6.7
56023,2020-06-01,9051,8448,603,6.7
56025,2020-06-01,40362,35972,4390,10.9
56027,2020-06-01,1281,1219,62,4.8
56029,2020-06-01,15277,14301,976,6.4
56031,2020-06-01,4896,4623,273,5.6
56033,2020-06-01,16220,15285,935,5.8
56035,2020-06-01,4215,3860,355,8.4
56037,2020-06-01,21895,19836,2059,9.4
56039,2020-06-01,14722,13343,1379,9.4
56041,2020-06-01,9268,8489,779,8.4
56043,2020-06-01,3961,3699,262,6.6
56045,2020-06-01,3903,3708,195,5
72001,2020-06-01,3788,3393,395,10.4
72003,2020-06-01,11500,10442,1058,9.2
72005,2020-06-01,14004,12697,1307,9.3
72007,2020-06-01,6346,5717,629,9.9
72009,2020-06-01,6038,5511,527,8.7
72011,2020-06-01,8541,7870,671,7.9
72013,2020-06-01,23979,21812,2167,9
72015,2020-06-01,4372,3991,381,8.7
72017,2020-06-01,5690,5030,660,11.6
72019,2020-06-01,7078,6334,744,10.5
72021,2020-06-01,65000,59258,5742,8.8
72023,2020-06-01,13290,12170,1120,8.4
72025,2020-06-01,46630,42980,3650,7.8
72027,2020-06-01,9516,8748,768,8.1
72029,2020-06-01,15803,14444,1359,8.6
72031,2020-06-01,61104,55833,5271,8.6
72033,2020-06-01,7853,7067,786,10
72035,2020-06-01,15629,14528,1101,7
72037,2020-06-01,3588,3252,336,9.4
72039,2020-06-01,3618,3191,427,11.8
72041,2020-06-01,14873,13936,937,6.3
72043,2020-06-01,9358,8486,872,9.3
72045,2020-06-01,4736,4273,463,9.8
72047,2020-06-01,8751,7714,1037,11.9
72049,2020-06-01,940,870,70,7.4
72051,2020-06-01,12959,12020,939,7.2
72053,2020-06-01,10563,9510,1053,10
72054,2020-06-01,3191,2824,367,11.5
72055,2020-06-01,3703,3314,389,10.5
72057,2020-06-01,10423,9599,824,7.9
72059,2020-06-01,4893,4468,425,8.7
72061,2020-06-01,37352,35211,2141,5.7
72063,2020-06-01,17408,16382,1026,5.9
72065,2020-06-01,12976,11968,1008,7.8
72067,2020-06-01,5181,4748,433,8.4
72069,2020-06-01,16353,15056,1297,7.9
72071,2020-06-01,11270,10317,953,8.5
72073,2020-06-01,3793,3511,282,7.4
72075,2020-06-01,14656,13598,1058,7.2
72077,2020-06-01,11788,10745,1043,8.8
72079,2020-06-01,4927,4417,510,10.4
72081,2020-06-01,6401,5661,740,11.6
72083,2020-06-01,2525,2248,277,11
72085,2020-06-01,10791,9896,895,8.3
72087,2020-06-01,8192,7463,729,8.9
72089,2020-06-01,6039,5434,605,10
72091,2020-06-01,11056,10114,942,8.5
72093,2020-06-01,1679,1552,127,7.6
72095,2020-06-01,2658,2411,247,9.3
72097,2020-06-01,20683,18891,1792,8.7
72099,2020-06-01,10055,9089,966,9.6
72101,2020-06-01,7757,6911,846,10.9
72103,2020-06-01,7791,7184,607,7.8
72105,2020-06-01,7092,6150,942,13.3
72107,2020-06-01,4801,4217,584,12.2
72109,2020-06-01,3954,3577,377,9.5
72111,2020-06-01,5458,4937,521,9.5
72113,2020-06-01,44045,40393,3652,8.3
72115,2020-06-01,6058,5446,612,10.1
72117,2020-06-01,4445,3999,446,10
72119,2020-06-01,16625,15048,1577,9.5
72121,2020-06-01,5628,5132,496,8.8
72123,2020-06-01,6571,5923,648,9.9
72125,2020-06-01,9242,8490,752,8.1
72127,2020-06-01,134794,124145,10649,7.9
72129,2020-06-01,11103,10218,885,8
72131,2020-06-01,9618,8589,1029,10.7
72133,2020-06-01,7863,7348,515,6.5
72135,2020-06-01,26603,24590,2013,7.6
72137,2020-06-01,28698,26451,2247,7.8
72139,2020-06-01,26553,24883,1670,6.3
72141,2020-06-01,6194,5656,538,8.7
72143,2020-06-01,9516,8536,980,10.3
72145,2020-06-01,12967,11406,1561,12
72147,2020-06-01,2538,2296,242,9.5
72149,2020-06-01,6740,6159,581,8.6
72151,2020-06-01,8158,7395,763,9.4
72153,2020-06-01,9037,8125,912,10.1
01001,2020-07-01,25337,23666,1671,6.6
01003,2020-07-01,98731,91433,7298,7.4
01005,2020-07-01,9284,8406,878,9.5
01007,2020-07-01,8640,7903,737,8.5
01009,2020-07-01,24579,23234,1345,5.5
01011,2020-07-01,4927,4557,370,7.5
01013,2020-07-01,9789,8661,1128,11.5
01015,2020-07-01,44787,40543,4244,9.5
01017,2020-07-01,16373,14961,1412,8.6
01019,2020-07-01,11647,11019,628,5.4
01021,2020-07-01,19466,18159,1307,6.7
01023,2020-07-01,4569,4152,417,9.1
01025,2020-07-01,8215,7169,1046,12.7
01027,2020-07-01,6330,6029,301,4.8
01029,2020-07-01,5738,5421,317,5.5
01031,2020-07-01,22060,20814,1246,5.6
01033,2020-07-01,23281,21250,2031,8.7
01035,2020-07-01,4861,4379,482,9.9
01037,2020-07-01,4662,4359,303,6.5
01039,2020-07-01,15852,14854,998,6.3
01041,2020-07-01,6662,6188,474,7.1
01043,2020-07-01,39303,37305,1998,5.1
01045,2020-07-01,21168,19780,1388,6.6
01047,2020-07-01,15619,13346,2273,14.6
01049,2020-07-01,32339,30570,1769,5.5
01051,2020-07-01,36414,33965,2449,6.7
01053,2020-07-01,15375,14115,1260,8.2
01055,2020-07-01,41201,37075,4126,10
01057,2020-07-01,6651,6239,412,6.2
01059,2020-07-01,14893,14069,824,5.5
01061,2020-07-01,10920,10299,621,5.7
01063,2020-07-01,3165,2710,455,14.4
01065,2020-07-01,6289,5515,774,12.3
01067,2020-07-01,6798,6398,400,5.9
01069,2020-07-01,46085,42577,3508,7.6
01071,2020-07-01,23583,22086,1497,6.3
01073,2020-07-01,318901,290106,28795,9
01075,2020-07-01,5928,5571,357,6
01077,2020-07-01,41500,38484,3016,7.3
01079,2020-07-01,13882,12946,936,6.7
01081,2020-07-01,73471,68141,5330,7.3
01083,2020-07-01,42347,40035,2312,5.5
01085,2020-07-01,3880,3153,727,18.7
01087,2020-07-01,8401,7214,1187,14.1
01089,2020-07-01,180773,168911,11862,6.6
01091,2020-07-01,8053,7372,681,8.5
01093,2020-07-01,13571,12675,896,6.6
01095,2020-07-01,45612,43207,2405,5.3
01097,2020-07-01,190864,167461,23403,12.3
01099,2020-07-01,8040,7175,865,10.8
01101,2020-07-01,107576,95003,12573,11.7
01103,2020-07-01,56357,52796,3561,6.3
01105,2020-07-01,3696,3164,532,14.4
01107,2020-07-01,7744,7111,633,8.2
01109,2020-07-01,16068,14951,1117,7
01111,2020-07-01,9762,9240,522,5.3
01113,2020-07-01,23013,21410,1603,7
01115,2020-07-01,39581,37013,2568,6.5
01117,2020-07-01,112226,106292,5934,5.3
01119,2020-07-01,4941,4485,456,9.2
01121,2020-07-01,36915,33767,3148,8.5
01123,2020-07-01,19654,17960,1694,8.6
01125,2020-07-01,103405,94153,9252,8.9
01127,2020-07-01,24975,23042,1933,7.7
01129,2020-07-01,7153,6287,866,12.1
01131,2020-07-01,3166,2561,605,19.1
01133,2020-07-01,10212,9607,605,5.9
02013,2020-07-01,3580,3470,110,3.1
02016,2020-07-01,3791,3635,156,4.1
02020,2020-07-01,146237,130508,15729,10.8
02050,2020-07-01,6788,5694,1094,16.1
02060,2020-07-01,1204,1169,35,2.9
02068,2020-07-01,1467,1328,139,9.5
02070,2020-07-01,2677,2479,198,7.4
02090,2020-07-01,45026,41007,4019,8.9
02100,2020-07-01,1355,1137,218,16.1
02105,2020-07-01,1284,1098,186,14.5
02110,2020-07-01,16767,15040,1727,10.3
02122,2020-07-01,27741,24506,3235,11.7
02130,2020-07-01,7132,6214,918,12.9
02150,2020-07-01,5838,5352,486,8.3
02158,2020-07-01,2330,1741,589,25.3
02164,2020-07-01,987,897,90,9.1
02170,2020-07-01,46373,40900,5473,11.8
02180,2020-07-01,3826,3237,589,15.4
02185,2020-07-01,2976,2732,244,8.2
02188,2020-07-01,2926,2435,491,16.8
02195,2020-07-01,1457,1321,136,9.3
02198,2020-07-01,2635,2283,352,13.4
02220,2020-07-01,4527,4118,409,9
02230,2020-07-01,1016,819,197,19.4
02240,2020-07-01,2834,2574,260,9.2
02261,2020-07-01,5465,5013,452,8.3
02275,2020-07-01,1016,906,110,10.8
02282,2020-07-01,250,223,27,10.8
02290,2020-07-01,2486,2092,394,15.8
04001,2020-07-01,19506,15976,3530,18.1
04003,2020-07-01,51701,46865,4836,9.4
04005,2020-07-01,70061,60444,9617,13.7
04007,2020-07-01,20609,18465,2144,10.4
04009,2020-07-01,14490,13043,1447,10
04011,2020-07-01,4666,4288,378,8.1
04012,2020-07-01,8711,7924,787,9
04013,2020-07-01,NA,NA,242136,10.4
04015,2020-07-01,87932,76805,11127,12.7
04017,2020-07-01,40011,34486,5525,13.8
04019,2020-07-01,500705,447530,53175,10.6
04021,2020-07-01,185915,166103,19812,10.7
04023,2020-07-01,18517,15509,3008,16.2
04025,2020-07-01,109601,99063,10538,9.6
04027,2020-07-01,97783,73194,24589,25.1
05001,2020-07-01,9034,8578,456,5
05003,2020-07-01,7296,6487,809,11.1
05005,2020-07-01,15768,14665,1103,7
05007,2020-07-01,133584,125977,7607,5.7
05009,2020-07-01,15596,14670,926,5.9
05011,2020-07-01,4288,3994,294,6.9
05013,2020-07-01,2325,2188,137,5.9
05015,2020-07-01,12442,11617,825,6.6
05017,2020-07-01,3108,2703,405,13
05019,2020-07-01,9400,8704,696,7.4
05021,2020-07-01,5368,4985,383,7.1
05023,2020-07-01,8896,8143,753,8.5
05025,2020-07-01,3051,2838,213,7
05027,2020-07-01,9095,8344,751,8.3
05029,2020-07-01,7994,7417,577,7.2
05031,2020-07-01,55784,51998,3786,6.8
05033,2020-07-01,25836,24111,1725,6.7
05035,2020-07-01,21064,18748,2316,11
05037,2020-07-01,7176,6648,528,7.4
05039,2020-07-01,2654,2478,176,6.6
05041,2020-07-01,5196,4714,482,9.3
05043,2020-07-01,7474,6883,591,7.9
05045,2020-07-01,59418,55400,4018,6.8
05047,2020-07-01,7277,6772,505,6.9
05049,2020-07-01,4901,4611,290,5.9
05051,2020-07-01,41629,37626,4003,9.6
05053,2020-07-01,7942,7418,524,6.6
05055,2020-07-01,19567,18169,1398,7.1
05057,2020-07-01,9423,8841,582,6.2
05059,2020-07-01,13624,12637,987,7.2
05061,2020-07-01,5353,5017,336,6.3
05063,2020-07-01,16236,15162,1074,6.6
05065,2020-07-01,4748,4309,439,9.2
05067,2020-07-01,5407,4938,469,8.7
05069,2020-07-01,26761,24085,2676,10
05071,2020-07-01,9932,9124,808,8.1
05073,2020-07-01,2397,2182,215,9
05075,2020-07-01,6771,6269,502,7.4
05077,2020-07-01,2667,2422,245,9.2
05079,2020-07-01,3725,3468,257,6.9
05081,2020-07-01,5402,4983,419,7.8
05083,2020-07-01,8128,7440,688,8.5
05085,2020-07-01,32786,30468,2318,7.1
05087,2020-07-01,7125,6788,337,4.7
05089,2020-07-01,6474,5997,477,7.4
05091,2020-07-01,19509,17913,1596,8.2
05093,2020-07-01,17144,15172,1972,11.5
05095,2020-07-01,2656,2434,222,8.4
05097,2020-07-01,2821,2580,241,8.5
05099,2020-07-01,3527,3256,271,7.7
05101,2020-07-01,3204,3037,167,5.2
05103,2020-07-01,9449,8746,703,7.4
05105,2020-07-01,4017,3755,262,6.5
05107,2020-07-01,6149,5445,704,11.4
05109,2020-07-01,4125,3827,298,7.2
05111,2020-07-01,10153,9495,658,6.5
05113,2020-07-01,7816,7205,611,7.8
05115,2020-07-01,28147,26157,1990,7.1
05117,2020-07-01,3440,3219,221,6.4
05119,2020-07-01,186082,168084,17998,9.7
05121,2020-07-01,7219,6701,518,7.2
05123,2020-07-01,7970,7218,752,9.4
05125,2020-07-01,56316,52557,3759,6.7
05127,2020-07-01,4180,3948,232,5.6
05129,2020-07-01,2797,2597,200,7.2
05131,2020-07-01,54773,50855,3918,7.2
05133,2020-07-01,5296,4939,357,6.7
05135,2020-07-01,5643,5177,466,8.3
05137,2020-07-01,4550,4190,360,7.9
05139,2020-07-01,15373,13816,1557,10.1
05141,2020-07-01,5581,5141,440,7.9
05143,2020-07-01,122143,115005,7138,5.8
05145,2020-07-01,32737,30273,2464,7.5
05147,2020-07-01,2593,2404,189,7.3
05149,2020-07-01,8091,7613,478,5.9
06001,2020-07-01,819060,719097,99963,12.2
06003,2020-07-01,464,397,67,14.4
06005,2020-07-01,14239,12542,1697,11.9
06007,2020-07-01,92846,82422,10424,11.2
06009,2020-07-01,20627,18641,1986,9.6
06011,2020-07-01,9920,8430,1490,15
06013,2020-07-01,544219,477908,66311,12.2
06015,2020-07-01,9308,8242,1066,11.5
06017,2020-07-01,89430,80199,9231,10.3
06019,2020-07-01,446614,386572,60042,13.4
06021,2020-07-01,11928,10633,1295,10.9
06023,2020-07-01,59255,52991,6264,10.6
06025,2020-07-01,71720,52355,19365,27
06027,2020-07-01,8266,7479,787,9.5
06029,2020-07-01,370501,309579,60922,16.4
06031,2020-07-01,56774,49415,7359,13
06033,2020-07-01,26961,23799,3162,11.7
06035,2020-07-01,8874,8113,761,8.6
06037,2020-07-01,NA,NA,899935,18.2
06039,2020-07-01,61219,53334,7885,12.9
06041,2020-07-01,133824,121809,12015,9
06043,2020-07-01,7975,7115,860,10.8
06045,2020-07-01,36914,32806,4108,11.1
06047,2020-07-01,112252,96060,16192,14.4
06049,2020-07-01,3013,2752,261,8.7
06051,2020-07-01,6893,5750,1143,16.6
06053,2020-07-01,199253,175281,23972,12
06055,2020-07-01,72764,65077,7687,10.6
06057,2020-07-01,43925,39189,4736,10.8
06059,2020-07-01,NA,NA,196775,12.4
06061,2020-07-01,182326,164487,17839,9.8
06063,2020-07-01,7315,6494,821,11.2
06065,2020-07-01,NA,951770,151281,13.7
06067,2020-07-01,708988,620122,88866,12.5
06069,2020-07-01,31043,27370,3673,11.8
06071,2020-07-01,963012,836716,126296,13.1
06073,2020-07-01,NA,NA,196061,12.4
06075,2020-07-01,573467,510017,63450,11.1
06077,2020-07-01,323788,276136,47652,14.7
06079,2020-07-01,132307,119043,13264,10
06081,2020-07-01,444450,402910,41540,9.3
06083,2020-07-01,210830,189168,21662,10.3
06085,2020-07-01,NA,937901,97590,9.4
06087,2020-07-01,131221,116438,14783,11.3
06089,2020-07-01,72340,64821,7519,10.4
06091,2020-07-01,1213,1099,114,9.4
06093,2020-07-01,16213,14395,1818,11.2
06095,2020-07-01,202721,177359,25362,12.5
06097,2020-07-01,253058,227820,25238,10
06099,2020-07-01,237490,205157,32333,13.6
06101,2020-07-01,42267,36552,5715,13.5
06103,2020-07-01,24109,21440,2669,11.1
06105,2020-07-01,4460,4073,387,8.7
06107,2020-07-01,191624,160726,30898,16.1
06109,2020-07-01,19814,17303,2511,12.7
06111,2020-07-01,412738,365714,47024,11.4
06113,2020-07-01,104473,94543,9930,9.5
06115,2020-07-01,28264,24446,3818,13.5
08001,2020-07-01,275868,252925,22943,8.3
08003,2020-07-01,7785,7307,478,6.1
08005,2020-07-01,370440,339606,30834,8.3
08007,2020-07-01,7147,6620,527,7.4
08009,2020-07-01,1938,1899,39,2
08011,2020-07-01,1716,1645,71,4.1
08013,2020-07-01,189711,177051,12660,6.7
08014,2020-07-01,40135,37364,2771,6.9
08015,2020-07-01,10331,9763,568,5.5
08017,2020-07-01,1074,1051,23,2.1
08019,2020-07-01,6192,5651,541,8.7
08021,2020-07-01,3704,3520,184,5
08023,2020-07-01,1748,1605,143,8.2
08025,2020-07-01,1310,1252,58,4.4
08027,2020-07-01,2001,1907,94,4.7
08029,2020-07-01,13539,12693,846,6.2
08031,2020-07-01,425691,388220,37471,8.8
08033,2020-07-01,1112,1041,71,6.4
08035,2020-07-01,192521,181344,11177,5.8
08037,2020-07-01,35913,32499,3414,9.5
08039,2020-07-01,14911,14246,665,4.5
08041,2020-07-01,343703,319812,23891,7
08043,2020-07-01,14075,13020,1055,7.5
08045,2020-07-01,31704,29716,1988,6.3
08047,2020-07-01,4027,3543,484,12
08049,2020-07-01,9522,8700,822,8.6
08051,2020-07-01,11245,10563,682,6.1
08053,2020-07-01,437,423,14,3.2
08055,2020-07-01,2363,2128,235,9.9
08057,2020-07-01,965,933,32,3.3
08059,2020-07-01,337220,312846,24374,7.2
08061,2020-07-01,880,861,19,2.2
08063,2020-07-01,3965,3855,110,2.8
08065,2020-07-01,4803,4409,394,8.2
08067,2020-07-01,30522,28560,1962,6.4
08069,2020-07-01,198167,185831,12336,6.2
08071,2020-07-01,5985,5532,453,7.6
08073,2020-07-01,2037,1950,87,4.3
08075,2020-07-01,9658,9171,487,5
08077,2020-07-01,76678,71338,5340,7
08079,2020-07-01,514,488,26,5.1
08081,2020-07-01,6508,6115,393,6
08083,2020-07-01,11373,10605,768,6.8
08085,2020-07-01,19647,18372,1275,6.5
08087,2020-07-01,14909,13988,921,6.2
08089,2020-07-01,7548,7093,455,6
08091,2020-07-01,2639,2452,187,7.1
08093,2020-07-01,11128,10503,625,5.6
08095,2020-07-01,2439,2383,56,2.3
08097,2020-07-01,11363,10290,1073,9.4
08099,2020-07-01,5821,5579,242,4.2
08101,2020-07-01,75076,69131,5945,7.9
08103,2020-07-01,2768,2625,143,5.2
08105,2020-07-01,5078,4732,346,6.8
08107,2020-07-01,15825,14544,1281,8.1
08109,2020-07-01,3389,3132,257,7.6
08111,2020-07-01,677,648,29,4.3
08113,2020-07-01,5867,5318,549,9.4
08115,2020-07-01,1136,1099,37,3.3
08117,2020-07-01,22247,19982,2265,10.2
08119,2020-07-01,12869,12041,828,6.4
08121,2020-07-01,2506,2415,91,3.6
08123,2020-07-01,165831,153779,12052,7.3
08125,2020-07-01,5103,4959,144,2.8
09001,2020-07-01,482093,431490,50603,10.5
09003,2020-07-01,492927,440111,52816,10.7
09005,2020-07-01,105254,96093,9161,8.7
09007,2020-07-01,94569,86613,7956,8.4
09009,2020-07-01,468382,419021,49361,10.5
09011,2020-07-01,139600,122810,16790,12
09013,2020-07-01,86905,79973,6932,8
09015,2020-07-01,64877,58497,6380,9.8
10001,2020-07-01,86081,76088,9993,11.6
10003,2020-07-01,310296,276209,34087,11
10005,2020-07-01,114418,104002,10416,9.1
11001,2020-07-01,407168,368356,38812,9.5
12001,2020-07-01,129876,119985,9891,7.6
12003,2020-07-01,11298,10551,747,6.6
12005,2020-07-01,81371,75115,6256,7.7
12007,2020-07-01,10468,9703,765,7.3
12009,2020-07-01,282254,256119,26135,9.3
12011,2020-07-01,NA,884312,135070,13.3
12013,2020-07-01,4371,4065,306,7
12015,2020-07-01,70479,63400,7079,10
12017,2020-07-01,45315,40237,5078,11.2
12019,2020-07-01,103425,95923,7502,7.3
12021,2020-07-01,170840,152987,17853,10.5
12023,2020-07-01,28050,25754,2296,8.2
12027,2020-07-01,13906,12975,931,6.7
12029,2020-07-01,5352,4929,423,7.9
12031,2020-07-01,483668,437160,46508,9.6
12033,2020-07-01,142533,129349,13184,9.2
12035,2020-07-01,45620,40956,4664,10.2
12037,2020-07-01,4237,3936,301,7.1
12039,2020-07-01,17847,16157,1690,9.5
12041,2020-07-01,6565,6134,431,6.6
12043,2020-07-01,4665,4271,394,8.4
12045,2020-07-01,5514,5092,422,7.7
12047,2020-07-01,4071,3639,432,10.6
12049,2020-07-01,7760,6982,778,10
12051,2020-07-01,14444,12555,1889,13.1
12053,2020-07-01,70270,62582,7688,10.9
12055,2020-07-01,35155,31546,3609,10.3
12057,2020-07-01,733895,657523,76372,10.4
12059,2020-07-01,6458,5967,491,7.6
12061,2020-07-01,63213,56665,6548,10.4
12063,2020-07-01,15864,14665,1199,7.6
12065,2020-07-01,5199,4796,403,7.8
12067,2020-07-01,2594,2430,164,6.3
12069,2020-07-01,152936,133871,19065,12.5
12071,2020-07-01,335120,299096,36024,10.7
12073,2020-07-01,144864,132492,12372,8.5
12075,2020-07-01,15633,14397,1236,7.9
12077,2020-07-01,2402,2237,165,6.9
12079,2020-07-01,7216,6553,663,9.2
12081,2020-07-01,171340,155144,16196,9.5
12083,2020-07-01,137231,124423,12808,9.3
12085,2020-07-01,71394,65261,6133,8.6
12086,2020-07-01,NA,NA,192170,15.2
12087,2020-07-01,48178,43344,4834,10
12089,2020-07-01,39740,36703,3037,7.6
12091,2020-07-01,92909,86457,6452,6.9
12093,2020-07-01,16313,15021,1292,7.9
12095,2020-07-01,767160,642866,124294,16.2
12097,2020-07-01,194109,154681,39428,20.3
12099,2020-07-01,693654,612713,80941,11.7
12101,2020-07-01,231862,208434,23428,10.1
12103,2020-07-01,483129,435202,47927,9.9
12105,2020-07-01,305207,264798,40409,13.2
12107,2020-07-01,25145,22414,2731,10.9
12109,2020-07-01,127783,118259,9524,7.5
12111,2020-07-01,142257,126585,15672,11
12113,2020-07-01,79377,73715,5662,7.1
12115,2020-07-01,180413,163242,17171,9.5
12117,2020-07-01,240775,215415,25360,10.5
12119,2020-07-01,31663,28516,3147,9.9
12121,2020-07-01,17014,15637,1377,8.1
12123,2020-07-01,8064,7344,720,8.9
12125,2020-07-01,4124,3839,285,6.9
12127,2020-07-01,248733,222394,26339,10.6
12129,2020-07-01,13624,12760,864,6.3
12131,2020-07-01,30398,28139,2259,7.4
12133,2020-07-01,9006,8309,697,7.7
13001,2020-07-01,9224,8771,453,4.9
13003,2020-07-01,4138,3968,170,4.1
13005,2020-07-01,4605,4349,256,5.6
13007,2020-07-01,1072,993,79,7.4
13009,2020-07-01,17806,16356,1450,8.1
13011,2020-07-01,9468,9023,445,4.7
13013,2020-07-01,38957,36647,2310,5.9
13015,2020-07-01,49179,45615,3564,7.2
13017,2020-07-01,5311,4913,398,7.5
13019,2020-07-01,7118,6701,417,5.9
13021,2020-07-01,66714,60401,6313,9.5
13023,2020-07-01,4258,3927,331,7.8
13025,2020-07-01,6355,5960,395,6.2
13027,2020-07-01,6602,6177,425,6.4
13029,2020-07-01,17485,16395,1090,6.2
13031,2020-07-01,36626,33660,2966,8.1
13033,2020-07-01,8812,8007,805,9.1
13035,2020-07-01,10474,9681,793,7.6
13037,2020-07-01,2164,2027,137,6.3
13039,2020-07-01,20129,19063,1066,5.3
13043,2020-07-01,5520,5199,321,5.8
13045,2020-07-01,53764,49757,4007,7.5
13047,2020-07-01,33085,31479,1606,4.9
13049,2020-07-01,4623,4422,201,4.3
13051,2020-07-01,137719,124927,12792,9.3
13053,2020-07-01,1883,1745,138,7.3
13055,2020-07-01,9849,8990,859,8.7
13057,2020-07-01,130968,123454,7514,5.7
13059,2020-07-01,57555,53036,4519,7.9
13061,2020-07-01,929,779,150,16.1
13063,2020-07-01,141911,123286,18625,13.1
13065,2020-07-01,2372,2246,126,5.3
13067,2020-07-01,415800,385573,30227,7.3
13069,2020-07-01,18700,17467,1233,6.6
13071,2020-07-01,20500,19432,1068,5.2
13073,2020-07-01,71124,67586,3538,5
13075,2020-07-01,7890,7441,449,5.7
13077,2020-07-01,73684,67624,6060,8.2
13079,2020-07-01,5283,4977,306,5.8
13081,2020-07-01,9671,8811,860,8.9
13083,2020-07-01,8014,7653,361,4.5
13085,2020-07-01,11792,11160,632,5.4
13087,2020-07-01,11065,10446,619,5.6
13089,2020-07-01,401057,360517,40540,10.1
13091,2020-07-01,6666,6208,458,6.9
13093,2020-07-01,5020,4567,453,9
13095,2020-07-01,38149,34073,4076,10.7
13097,2020-07-01,72768,66022,6746,9.3
13099,2020-07-01,4414,4090,324,7.3
13101,2020-07-01,1786,1700,86,4.8
13103,2020-07-01,29477,27736,1741,5.9
13105,2020-07-01,7828,7177,651,8.3
13107,2020-07-01,8012,7259,753,9.4
13109,2020-07-01,4778,4479,299,6.3
13111,2020-07-01,12253,11700,553,4.5
13113,2020-07-01,56297,52568,3729,6.6
13115,2020-07-01,44313,41167,3146,7.1
13117,2020-07-01,116991,110891,6100,5.2
13119,2020-07-01,9838,9195,643,6.5
13121,2020-07-01,560013,502282,57731,10.3
13123,2020-07-01,11105,10527,578,5.2
13125,2020-07-01,1191,1133,58,4.9
13127,2020-07-01,35418,32470,2948,8.3
13129,2020-07-01,28492,26799,1693,5.9
13131,2020-07-01,9891,9398,493,5
13133,2020-07-01,7074,6607,467,6.6
13135,2020-07-01,481497,443763,37734,7.8
13137,2020-07-01,18457,17365,1092,5.9
13139,2020-07-01,98654,93117,5537,5.6
13141,2020-07-01,2482,2215,267,10.8
13143,2020-07-01,12138,11341,797,6.6
13145,2020-07-01,15704,14833,871,5.5
13147,2020-07-01,10795,10118,677,6.3
13149,2020-07-01,5123,4726,397,7.7
13151,2020-07-01,114688,104098,10590,9.2
13153,2020-07-01,66551,62397,4154,6.2
13155,2020-07-01,3296,3100,196,5.9
13157,2020-07-01,36558,34669,1889,5.2
13159,2020-07-01,6630,6259,371,5.6
13161,2020-07-01,5724,5388,336,5.9
13163,2020-07-01,6574,5968,606,9.2
13165,2020-07-01,3094,2844,250,8.1
13167,2020-07-01,3890,3668,222,5.7
13169,2020-07-01,12915,12244,671,5.2
13171,2020-07-01,7988,7393,595,7.4
13173,2020-07-01,3609,3400,209,5.8
13175,2020-07-01,18787,17328,1459,7.8
13177,2020-07-01,14082,13307,775,5.5
13179,2020-07-01,26160,24290,1870,7.1
13181,2020-07-01,3360,3138,222,6.6
13183,2020-07-01,7888,7507,381,4.8
13185,2020-07-01,50643,46798,3845,7.6
13187,2020-07-01,15833,14950,883,5.6
13189,2020-07-01,8660,7788,872,10.1
13191,2020-07-01,5443,5054,389,7.1
13193,2020-07-01,4409,4065,344,7.8
13195,2020-07-01,12717,11972,745,5.9
13197,2020-07-01,3088,2906,182,5.9
13199,2020-07-01,8882,7920,962,10.8
13201,2020-07-01,2597,2462,135,5.2
13205,2020-07-01,8090,7471,619,7.7
13207,2020-07-01,12346,11608,738,6
13209,2020-07-01,3762,3516,246,6.5
13211,2020-07-01,8883,8304,579,6.5
13213,2020-07-01,14781,13586,1195,8.1
13215,2020-07-01,75731,68170,7561,10
13217,2020-07-01,51365,46847,4518,8.8
13219,2020-07-01,18442,17679,763,4.1
13221,2020-07-01,6550,6196,354,5.4
13223,2020-07-01,83365,77886,5479,6.6
13225,2020-07-01,11177,10351,826,7.4
13227,2020-07-01,14621,13844,777,5.3
13229,2020-07-01,8348,7927,421,5
13231,2020-07-01,8574,8047,527,6.1
13233,2020-07-01,18027,16829,1198,6.6
13235,2020-07-01,3730,3550,180,4.8
13237,2020-07-01,7994,7366,628,7.9
13239,2020-07-01,827,749,78,9.4
13241,2020-07-01,7222,6808,414,5.7
13243,2020-07-01,2479,2301,178,7.2
13245,2020-07-01,83443,75382,8061,9.7
13247,2020-07-01,44366,40237,4129,9.3
13249,2020-07-01,2158,2067,91,4.2
13251,2020-07-01,5077,4532,545,10.7
13253,2020-07-01,2937,2765,172,5.9
13255,2020-07-01,28395,25700,2695,9.5
13257,2020-07-01,10643,9881,762,7.2
13259,2020-07-01,2542,2372,170,6.7
13261,2020-07-01,12887,11784,1103,8.6
13263,2020-07-01,2722,2501,221,8.1
13265,2020-07-01,568,525,43,7.6
13267,2020-07-01,9136,8694,442,4.8
13269,2020-07-01,2835,2636,199,7
13271,2020-07-01,3577,3166,411,11.5
13273,2020-07-01,3427,3099,328,9.6
13275,2020-07-01,16561,15315,1246,7.5
13277,2020-07-01,19652,18431,1221,6.2
13279,2020-07-01,11696,10793,903,7.7
13281,2020-07-01,3654,3379,275,7.5
13283,2020-07-01,2537,2361,176,6.9
13285,2020-07-01,38427,35170,3257,8.5
13287,2020-07-01,3125,2869,256,8.2
13289,2020-07-01,2748,2513,235,8.6
13291,2020-07-01,9977,9490,487,4.9
13293,2020-07-01,11266,10356,910,8.1
13295,2020-07-01,30844,29225,1619,5.2
13297,2020-07-01,44414,41649,2765,6.2
13299,2020-07-01,15105,14159,946,6.3
13301,2020-07-01,2782,2571,211,7.6
13303,2020-07-01,6616,6074,542,8.2
13305,2020-07-01,10877,10187,690,6.3
13307,2020-07-01,992,927,65,6.6
13309,2020-07-01,1526,1408,118,7.7
13311,2020-07-01,16358,15645,713,4.4
13313,2020-07-01,41821,38497,3324,7.9
13315,2020-07-01,2560,2364,196,7.7
13317,2020-07-01,3821,3538,283,7.4
13319,2020-07-01,4006,3768,238,5.9
13321,2020-07-01,8423,7922,501,5.9
15001,2020-07-01,89038,77384,11654,13.1
15003,2020-07-01,434103,384325,49778,11.5
15007,2020-07-01,35428,28654,6774,19.1
15009,2020-07-01,82697,64644,18053,21.8
16001,2020-07-01,264465,250994,13471,5.1
16003,2020-07-01,1904,1776,128,6.7
16005,2020-07-01,41173,39275,1898,4.6
16007,2020-07-01,3175,3071,104,3.3
16009,2020-07-01,4254,4021,233,5.5
16011,2020-07-01,24200,23377,823,3.4
16013,2020-07-01,13933,13112,821,5.9
16015,2020-07-01,3675,3417,258,7
16017,2020-07-01,22162,20802,1360,6.1
16019,2020-07-01,61435,59439,1996,3.2
16021,2020-07-01,5735,5469,266,4.6
16023,2020-07-01,1490,1448,42,2.8
16025,2020-07-01,752,724,28,3.7
16027,2020-07-01,109144,103179,5965,5.5
16029,2020-07-01,4219,4102,117,2.8
16031,2020-07-01,12686,12280,406,3.2
16033,2020-07-01,401,387,14,3.5
16035,2020-07-01,3110,2917,193,6.2
16037,2020-07-01,2590,2506,84,3.2
16039,2020-07-01,12239,11728,511,4.2
16041,2020-07-01,6873,6671,202,2.9
16043,2020-07-01,7986,7764,222,2.8
16045,2020-07-01,8619,8170,449,5.2
16047,2020-07-01,8473,8200,273,3.2
16049,2020-07-01,6953,6564,389,5.6
16051,2020-07-01,15017,14611,406,2.7
16053,2020-07-01,12484,12062,422,3.4
16055,2020-07-01,80782,75899,4883,6
16057,2020-07-01,19170,18313,857,4.5
16059,2020-07-01,3993,3795,198,5
16061,2020-07-01,1756,1649,107,6.1
16063,2020-07-01,2916,2798,118,4
16065,2020-07-01,22377,21823,554,2.5
16067,2020-07-01,11839,11424,415,3.5
16069,2020-07-01,20175,19318,857,4.2
16071,2020-07-01,2434,2356,78,3.2
16073,2020-07-01,6175,5862,313,5.1
16075,2020-07-01,11968,11361,607,5.1
16077,2020-07-01,4063,3914,149,3.7
16079,2020-07-01,5541,5136,405,7.3
16081,2020-07-01,7260,6960,300,4.1
16083,2020-07-01,42330,40301,2029,4.8
16085,2020-07-01,6448,6101,347,5.4
16087,2020-07-01,4795,4547,248,5.2
17001,2020-07-01,31801,29541,2260,7.1
17003,2020-07-01,1875,1637,238,12.7
17005,2020-07-01,7647,7036,611,8
17007,2020-07-01,26162,22465,3697,14.1
17009,2020-07-01,2874,2733,141,4.9
17011,2020-07-01,17079,15725,1354,7.9
17013,2020-07-01,2253,2070,183,8.1
17015,2020-07-01,7479,6965,514,6.9
17017,2020-07-01,6064,5618,446,7.4
17019,2020-07-01,103278,94826,8452,8.2
17021,2020-07-01,14032,12696,1336,9.5
17023,2020-07-01,7364,6765,599,8.1
17025,2020-07-01,6056,5483,573,9.5
17027,2020-07-01,19764,18519,1245,6.3
17029,2020-07-01,22243,20066,2177,9.8
17031,2020-07-01,NA,NA,360621,13.8
17033,2020-07-01,8194,7551,643,7.8
17035,2020-07-01,5903,5494,409,6.9
17037,2020-07-01,52780,47418,5362,10.2
17039,2020-07-01,6959,6451,508,7.3
17041,2020-07-01,9931,9275,656,6.6
17043,2020-07-01,490910,443378,47532,9.7
17045,2020-07-01,8575,7973,602,7
17047,2020-07-01,2685,2484,201,7.5
17049,2020-07-01,19185,17709,1476,7.7
17051,2020-07-01,9846,8976,870,8.8
17053,2020-07-01,6167,5696,471,7.6
17055,2020-07-01,16138,14298,1840,11.4
17057,2020-07-01,14642,13177,1465,10
17059,2020-07-01,2190,1976,214,9.8
17061,2020-07-01,5937,5474,463,7.8
17063,2020-07-01,24353,21913,2440,10
17065,2020-07-01,3979,3665,314,7.9
17067,2020-07-01,8212,7626,586,7.1
17069,2020-07-01,1302,1145,157,12.1
17071,2020-07-01,3614,3361,253,7
17073,2020-07-01,24046,21968,2078,8.6
17075,2020-07-01,14185,13295,890,6.3
17077,2020-07-01,27334,24794,2540,9.3
17079,2020-07-01,4719,4413,306,6.5
17081,2020-07-01,17162,15336,1826,10.6
17083,2020-07-01,10678,9777,901,8.4
17085,2020-07-01,10704,9791,913,8.5
17087,2020-07-01,3963,3572,391,9.9
17089,2020-07-01,261229,233630,27599,10.6
17091,2020-07-01,55132,49805,5327,9.7
17093,2020-07-01,66583,59867,6716,10.1
17095,2020-07-01,21179,19087,2092,9.9
17097,2020-07-01,364059,329975,34084,9.4
17099,2020-07-01,52970,47539,5431,10.3
17101,2020-07-01,5630,5145,485,8.6
17103,2020-07-01,17242,15903,1339,7.8
17105,2020-07-01,16182,14979,1203,7.4
17107,2020-07-01,12100,11121,979,8.1
17109,2020-07-01,11794,10662,1132,9.6
17111,2020-07-01,160253,144106,16147,10.1
17113,2020-07-01,82905,76112,6793,8.2
17115,2020-07-01,46869,41153,5716,12.2
17117,2020-07-01,22299,20568,1731,7.8
17119,2020-07-01,132597,120085,12512,9.4
17121,2020-07-01,16882,15267,1615,9.6
17123,2020-07-01,4962,4552,410,8.3
17125,2020-07-01,6174,5621,553,9
17127,2020-07-01,5486,4874,612,11.2
17129,2020-07-01,6224,5814,410,6.6
17131,2020-07-01,7764,7125,639,8.2
17133,2020-07-01,18173,16979,1194,6.6
17135,2020-07-01,11372,10214,1158,10.2
17137,2020-07-01,16213,14849,1364,8.4
17139,2020-07-01,7453,6991,462,6.2
17141,2020-07-01,24200,21807,2393,9.9
17143,2020-07-01,81748,71529,10219,12.5
17145,2020-07-01,8205,7411,794,9.7
17147,2020-07-01,8100,7570,530,6.5
17149,2020-07-01,6947,6507,440,6.3
17151,2020-07-01,1629,1477,152,9.3
17153,2020-07-01,1894,1652,242,12.8
17155,2020-07-01,3074,2813,261,8.5
17157,2020-07-01,13874,12811,1063,7.7
17159,2020-07-01,7073,6538,535,7.6
17161,2020-07-01,69432,62149,7283,10.5
17163,2020-07-01,126799,112574,14225,11.2
17165,2020-07-01,9472,8377,1095,11.6
17167,2020-07-01,99074,89745,9329,9.4
17169,2020-07-01,3184,2967,217,6.8
17171,2020-07-01,2523,2350,173,6.9
17173,2020-07-01,10522,9736,786,7.5
17175,2020-07-01,2360,2167,193,8.2
17177,2020-07-01,21620,19798,1822,8.4
17179,2020-07-01,60100,54249,5851,9.7
17181,2020-07-01,7243,6586,657,9.1
17183,2020-07-01,32400,29139,3261,10.1
17185,2020-07-01,5878,5421,457,7.8
17187,2020-07-01,8272,7673,599,7.2
17189,2020-07-01,8921,8460,461,5.2
17191,2020-07-01,6953,6334,619,8.9
17193,2020-07-01,6357,5859,498,7.8
17195,2020-07-01,27256,24779,2477,9.1
17197,2020-07-01,349022,309733,39289,11.3
17199,2020-07-01,31137,28213,2924,9.4
17201,2020-07-01,138655,119107,19548,14.1
17203,2020-07-01,17367,16099,1268,7.3
18001,2020-07-01,16588,15749,839,5.1
18003,2020-07-01,185967,169948,16019,8.6
18005,2020-07-01,44330,41288,3042,6.9
18007,2020-07-01,4293,4031,262,6.1
18009,2020-07-01,4750,4407,343,7.2
18011,2020-07-01,36148,34378,1770,4.9
18013,2020-07-01,7884,7315,569,7.2
18015,2020-07-01,9668,9062,606,6.3
18017,2020-07-01,17269,16042,1227,7.1
18019,2020-07-01,60869,55732,5137,8.4
18021,2020-07-01,11745,10886,859,7.3
18023,2020-07-01,16978,15996,982,5.8
18025,2020-07-01,4796,4420,376,7.8
18027,2020-07-01,16303,15610,693,4.3
18029,2020-07-01,25446,23602,1844,7.2
18031,2020-07-01,15057,14142,915,6.1
18033,2020-07-01,22238,20725,1513,6.8
18035,2020-07-01,52342,47995,4347,8.3
18037,2020-07-01,23018,21602,1416,6.2
18039,2020-07-01,107653,98894,8759,8.1
18041,2020-07-01,8431,7515,916,10.9
18043,2020-07-01,40787,37695,3092,7.6
18045,2020-07-01,7788,7286,502,6.4
18047,2020-07-01,11113,10509,604,5.4
18049,2020-07-01,9887,9183,704,7.1
18051,2020-07-01,19620,18413,1207,6.2
18053,2020-07-01,30014,27850,2164,7.2
18055,2020-07-01,13013,12131,882,6.8
18057,2020-07-01,183397,173577,9820,5.4
18059,2020-07-01,40490,37951,2539,6.3
18061,2020-07-01,19724,18401,1323,6.7
18063,2020-07-01,90090,84735,5355,5.9
18065,2020-07-01,21742,20255,1487,6.8
18067,2020-07-01,37612,34334,3278,8.7
18069,2020-07-01,17790,16656,1134,6.4
18071,2020-07-01,23131,21604,1527,6.6
18073,2020-07-01,15972,14769,1203,7.5
18075,2020-07-01,8626,8153,473,5.5
18077,2020-07-01,14580,13446,1134,7.8
18079,2020-07-01,13422,12492,930,6.9
18081,2020-07-01,83559,78222,5337,6.4
18083,2020-07-01,17900,16770,1130,6.3
18085,2020-07-01,41378,38587,2791,6.7
18087,2020-07-01,19156,18184,972,5.1
18089,2020-07-01,232486,205919,26567,11.4
18091,2020-07-01,48819,43631,5188,10.6
18093,2020-07-01,20578,19012,1566,7.6
18095,2020-07-01,60163,55238,4925,8.2
18097,2020-07-01,509693,459858,49835,9.8
18099,2020-07-01,22950,21362,1588,6.9
18101,2020-07-01,5437,5163,274,5
18103,2020-07-01,14704,13540,1164,7.9
18105,2020-07-01,66502,61954,4548,6.8
18107,2020-07-01,18324,17273,1051,5.7
18109,2020-07-01,36397,34231,2166,6
18111,2020-07-01,6811,6330,481,7.1
18113,2020-07-01,23190,21390,1800,7.8
18115,2020-07-01,3182,2916,266,8.4
18117,2020-07-01,9332,7995,1337,14.3
18119,2020-07-01,8920,8278,642,7.2
18121,2020-07-01,6966,6549,417,6
18123,2020-07-01,9026,8418,608,6.7
18125,2020-07-01,6015,5590,425,7.1
18127,2020-07-01,86806,78571,8235,9.5
18129,2020-07-01,13676,12992,684,5
18131,2020-07-01,6461,6034,427,6.6
18133,2020-07-01,16837,15732,1105,6.6
18135,2020-07-01,10961,10216,745,6.8
18137,2020-07-01,13829,12981,848,6.1
18139,2020-07-01,8777,8271,506,5.8
18141,2020-07-01,131589,118179,13410,10.2
18143,2020-07-01,10397,9514,883,8.5
18145,2020-07-01,23552,21816,1736,7.4
18147,2020-07-01,11155,10522,633,5.7
18149,2020-07-01,9844,8961,883,9
18151,2020-07-01,20523,19252,1271,6.2
18153,2020-07-01,8085,7510,575,7.1
18155,2020-07-01,4918,4536,382,7.8
18157,2020-07-01,93253,86495,6758,7.2
18159,2020-07-01,9180,8675,505,5.5
18161,2020-07-01,3476,3262,214,6.2
18163,2020-07-01,97453,89662,7791,8
18165,2020-07-01,6724,6222,502,7.5
18167,2020-07-01,47190,43118,4072,8.6
18169,2020-07-01,14148,13255,893,6.3
18171,2020-07-01,4053,3799,254,6.3
18173,2020-07-01,33386,31475,1911,5.7
18175,2020-07-01,13441,12484,957,7.1
18177,2020-07-01,29757,27451,2306,7.7
18179,2020-07-01,14132,13294,838,5.9
18181,2020-07-01,13416,12691,725,5.4
18183,2020-07-01,17356,16291,1065,6.1
19001,2020-07-01,3883,3692,191,4.9
19003,2020-07-01,2018,1911,107,5.3
19005,2020-07-01,6784,6420,364,5.4
19007,2020-07-01,5731,5353,378,6.6
19009,2020-07-01,2840,2712,128,4.5
19011,2020-07-01,12731,11955,776,6.1
19013,2020-07-01,67448,62226,5222,7.7
19015,2020-07-01,14000,13279,721,5.2
19017,2020-07-01,13103,12458,645,4.9
19019,2020-07-01,10518,9919,599,5.7
19021,2020-07-01,11587,10955,632,5.5
19023,2020-07-01,7356,6954,402,5.5
19025,2020-07-01,3932,3723,209,5.3
19027,2020-07-01,10435,9891,544,5.2
19029,2020-07-01,6444,6132,312,4.8
19031,2020-07-01,10204,9656,548,5.4
19033,2020-07-01,22935,21376,1559,6.8
19035,2020-07-01,5820,5541,279,4.8
19037,2020-07-01,6124,5845,279,4.6
19039,2020-07-01,4682,4382,300,6.4
19041,2020-07-01,8090,7640,450,5.6
19043,2020-07-01,9376,8834,542,5.8
19045,2020-07-01,22372,20517,1855,8.3
19047,2020-07-01,7488,7039,449,6
19049,2020-07-01,47271,44961,2310,4.9
19051,2020-07-01,3895,3699,196,5
19053,2020-07-01,4003,3778,225,5.6
19055,2020-07-01,9879,9399,480,4.9
19057,2020-07-01,18877,17266,1611,8.5
19059,2020-07-01,9224,8692,532,5.8
19061,2020-07-01,53723,49779,3944,7.3
19063,2020-07-01,5048,4708,340,6.7
19065,2020-07-01,9742,9076,666,6.8
19067,2020-07-01,8099,7575,524,6.5
19069,2020-07-01,5225,4977,248,4.7
19071,2020-07-01,3449,3289,160,4.6
19073,2020-07-01,5160,4884,276,5.3
19075,2020-07-01,6064,5743,321,5.3
19077,2020-07-01,5228,4926,302,5.8
19079,2020-07-01,6442,6062,380,5.9
19081,2020-07-01,5658,5342,316,5.6
19083,2020-07-01,7504,7044,460,6.1
19085,2020-07-01,6996,6657,339,4.8
19087,2020-07-01,9357,8773,584,6.2
19089,2020-07-01,4879,4642,237,4.9
19091,2020-07-01,4742,4515,227,4.8
19093,2020-07-01,4010,3840,170,4.2
19095,2020-07-01,10067,9585,482,4.8
19097,2020-07-01,10506,9692,814,7.7
19099,2020-07-01,19020,17733,1287,6.8
19101,2020-07-01,10017,9287,730,7.3
19103,2020-07-01,86053,80320,5733,6.7
19105,2020-07-01,10088,9394,694,6.9
19107,2020-07-01,4929,4653,276,5.6
19109,2020-07-01,7786,7437,349,4.5
19111,2020-07-01,15796,14626,1170,7.4
19113,2020-07-01,119313,109596,9717,8.1
19115,2020-07-01,5866,5552,314,5.4
19117,2020-07-01,4492,4271,221,4.9
19119,2020-07-01,6429,6225,204,3.2
19121,2020-07-01,8160,7606,554,6.8
19123,2020-07-01,11451,10688,763,6.7
19125,2020-07-01,17919,16693,1226,6.8
19127,2020-07-01,17081,15832,1249,7.3
19129,2020-07-01,7108,6733,375,5.3
19131,2020-07-01,6872,6631,241,3.5
19133,2020-07-01,4150,3918,232,5.6
19135,2020-07-01,3916,3626,290,7.4
19137,2020-07-01,4754,4467,287,6
19139,2020-07-01,21841,20370,1471,6.7
19141,2020-07-01,7844,7505,339,4.3
19143,2020-07-01,3219,3095,124,3.9
19145,2020-07-01,6153,5792,361,5.9
19147,2020-07-01,4490,4230,260,5.8
19149,2020-07-01,14203,13557,646,4.5
19151,2020-07-01,4267,4076,191,4.5
19153,2020-07-01,263365,242966,20399,7.7
19155,2020-07-01,48033,44638,3395,7.1
19157,2020-07-01,9425,8886,539,5.7
19159,2020-07-01,2302,2183,119,5.2
19161,2020-07-01,4910,4702,208,4.2
19163,2020-07-01,86514,78944,7570,8.8
19165,2020-07-01,6308,6046,262,4.2
19167,2020-07-01,19318,18659,659,3.4
19169,2020-07-01,53950,51152,2798,5.2
19171,2020-07-01,8975,8411,564,6.3
19173,2020-07-01,2994,2827,167,5.6
19175,2020-07-01,6014,5560,454,7.5
19177,2020-07-01,3507,3311,196,5.6
19179,2020-07-01,17374,16055,1319,7.6
19181,2020-07-01,27186,25618,1568,5.8
19183,2020-07-01,11470,10937,533,4.6
19185,2020-07-01,2651,2489,162,6.1
19187,2020-07-01,18832,17565,1267,6.7
19189,2020-07-01,4977,4619,358,7.2
19191,2020-07-01,9606,8965,641,6.7
19193,2020-07-01,55311,51625,3686,6.7
19195,2020-07-01,4029,3808,221,5.5
19197,2020-07-01,6653,6312,341,5.1
20001,2020-07-01,6315,5797,518,8.2
20003,2020-07-01,4371,4157,214,4.9
20005,2020-07-01,6823,6240,583,8.5
20007,2020-07-01,2329,2227,102,4.4
20009,2020-07-01,14265,13449,816,5.7
20011,2020-07-01,7051,6561,490,6.9
20013,2020-07-01,5274,5006,268,5.1
20015,2020-07-01,32876,30155,2721,8.3
20017,2020-07-01,1622,1529,93,5.7
20019,2020-07-01,1529,1398,131,8.6
20021,2020-07-01,10209,9491,718,7
20023,2020-07-01,1273,1240,33,2.6
20025,2020-07-01,1112,1079,33,3
20027,2020-07-01,3649,3422,227,6.2
20029,2020-07-01,3831,3610,221,5.8
20031,2020-07-01,3718,3462,256,6.9
20033,2020-07-01,851,812,39,4.6
20035,2020-07-01,17211,15789,1422,8.3
20037,2020-07-01,19608,18250,1358,6.9
20039,2020-07-01,1265,1206,59,4.7
20041,2020-07-01,9123,8608,515,5.6
20043,2020-07-01,4168,3927,241,5.8
20045,2020-07-01,63071,57895,5176,8.2
20047,2020-07-01,1454,1393,61,4.2
20049,2020-07-01,1097,1015,82,7.5
20051,2020-07-01,17597,16863,734,4.2
20053,2020-07-01,2734,2619,115,4.2
20055,2020-07-01,21065,20167,898,4.3
20057,2020-07-01,17797,17028,769,4.3
20059,2020-07-01,14583,13585,998,6.8
20061,2020-07-01,11599,10502,1097,9.5
20063,2020-07-01,1397,1344,53,3.8
20065,2020-07-01,1247,1169,78,6.3
20067,2020-07-01,3200,3012,188,5.9
20069,2020-07-01,3045,2958,87,2.9
20071,2020-07-01,789,771,18,2.3
20073,2020-07-01,3092,2878,214,6.9
20075,2020-07-01,1594,1561,33,2.1
20077,2020-07-01,2694,2523,171,6.3
20079,2020-07-01,17085,15823,1262,7.4
20081,2020-07-01,2248,2174,74,3.3
20083,2020-07-01,995,962,33,3.3
20085,2020-07-01,7222,6790,432,6
20087,2020-07-01,10141,9552,589,5.8
20089,2020-07-01,1199,1143,56,4.7
20091,2020-07-01,345253,322310,22943,6.6
20093,2020-07-01,2037,1964,73,3.6
20095,2020-07-01,3433,3190,243,7.1
20097,2020-07-01,1189,1132,57,4.8
20099,2020-07-01,9901,9197,704,7.1
20101,2020-07-01,713,682,31,4.3
20103,2020-07-01,37198,34444,2754,7.4
20105,2020-07-01,1707,1640,67,3.9
20107,2020-07-01,4471,4084,387,8.7
20109,2020-07-01,1525,1480,45,3
20111,2020-07-01,17073,16092,981,5.7
20113,2020-07-01,17696,16914,782,4.4
20115,2020-07-01,6077,5727,350,5.8
20117,2020-07-01,5647,5446,201,3.6
20119,2020-07-01,2132,2057,75,3.5
20121,2020-07-01,17638,16528,1110,6.3
20123,2020-07-01,3464,3335,129,3.7
20125,2020-07-01,15732,14313,1419,9
20127,2020-07-01,2991,2844,147,4.9
20129,2020-07-01,1100,1052,48,4.4
20131,2020-07-01,5530,5338,192,3.5
20133,2020-07-01,6428,5843,585,9.1
20135,2020-07-01,1342,1286,56,4.2
20137,2020-07-01,2721,2633,88,3.2
20139,2020-07-01,7999,7509,490,6.1
20141,2020-07-01,1967,1898,69,3.5
20143,2020-07-01,3015,2826,189,6.3
20145,2020-07-01,2884,2743,141,4.9
20147,2020-07-01,2543,2444,99,3.9
20149,2020-07-01,11093,10394,699,6.3
20151,2020-07-01,4952,4717,235,4.7
20153,2020-07-01,1511,1460,51,3.4
20155,2020-07-01,30757,28598,2159,7
20157,2020-07-01,2334,2222,112,4.8
20159,2020-07-01,5157,4845,312,6.1
20161,2020-07-01,31648,29182,2466,7.8
20163,2020-07-01,2510,2374,136,5.4
20165,2020-07-01,1668,1582,86,5.2
20167,2020-07-01,3416,3227,189,5.5
20169,2020-07-01,30844,28703,2141,6.9
20171,2020-07-01,2840,2746,94,3.3
20173,2020-07-01,263046,232572,30474,11.6
20175,2020-07-01,10026,9457,569,5.7
20177,2020-07-01,92041,85321,6720,7.3
20179,2020-07-01,1398,1348,50,3.6
20181,2020-07-01,2917,2794,123,4.2
20183,2020-07-01,1898,1838,60,3.2
20185,2020-07-01,1925,1823,102,5.3
20187,2020-07-01,1044,1017,27,2.6
20189,2020-07-01,2792,2683,109,3.9
20191,2020-07-01,11426,10098,1328,11.6
20193,2020-07-01,4327,4166,161,3.7
20195,2020-07-01,1477,1415,62,4.2
20197,2020-07-01,3620,3435,185,5.1
20199,2020-07-01,812,792,20,2.5
20201,2020-07-01,3010,2918,92,3.1
20203,2020-07-01,1287,1257,30,2.3
20205,2020-07-01,4037,3651,386,9.6
20207,2020-07-01,1542,1411,131,8.5
20209,2020-07-01,80824,72276,8548,10.6
21001,2020-07-01,6139,5816,323,5.3
21003,2020-07-01,7830,7494,336,4.3
21005,2020-07-01,10879,10385,494,4.5
21007,2020-07-01,3003,2854,149,5
21009,2020-07-01,16145,15237,908,5.6
21011,2020-07-01,4184,3941,243,5.8
21013,2020-07-01,7374,6910,464,6.3
21015,2020-07-01,65125,62417,2708,4.2
21017,2020-07-01,9236,8873,363,3.9
21019,2020-07-01,16414,15362,1052,6.4
21021,2020-07-01,10546,9902,644,6.1
21023,2020-07-01,3492,3340,152,4.4
21025,2020-07-01,2903,2653,250,8.6
21027,2020-07-01,7177,6829,348,4.8
21029,2020-07-01,38620,36978,1642,4.3
21031,2020-07-01,4318,4111,207,4.8
21033,2020-07-01,4871,4628,243,5
21035,2020-07-01,16846,16053,793,4.7
21037,2020-07-01,46594,44561,2033,4.4
21039,2020-07-01,2009,1937,72,3.6
21041,2020-07-01,4869,4649,220,4.5
21043,2020-07-01,8619,8002,617,7.2
21045,2020-07-01,5934,5694,240,4
21047,2020-07-01,22958,21604,1354,5.9
21049,2020-07-01,15622,14832,790,5.1
21051,2020-07-01,4493,4170,323,7.2
21053,2020-07-01,3672,3523,149,4.1
21055,2020-07-01,3359,3220,139,4.1
21057,2020-07-01,2971,2862,109,3.7
21059,2020-07-01,44180,42219,1961,4.4
21061,2020-07-01,4083,3859,224,5.5
21063,2020-07-01,1778,1651,127,7.1
21065,2020-07-01,4717,4443,274,5.8
21067,2020-07-01,159239,151976,7263,4.6
21069,2020-07-01,5945,5659,286,4.8
21071,2020-07-01,9533,8795,738,7.7
21073,2020-07-01,22907,21746,1161,5.1
21075,2020-07-01,1972,1866,106,5.4
21077,2020-07-01,3776,3614,162,4.3
21079,2020-07-01,6686,6363,323,4.8
21081,2020-07-01,10802,10271,531,4.9
21083,2020-07-01,13937,13278,659,4.7
21085,2020-07-01,9883,9344,539,5.5
21087,2020-07-01,4438,4264,174,3.9
21089,2020-07-01,12274,11475,799,6.5
21091,2020-07-01,3686,3549,137,3.7
21093,2020-07-01,44449,42245,2204,5
21095,2020-07-01,5612,5016,596,10.6
21097,2020-07-01,7945,7627,318,4
21099,2020-07-01,7133,6842,291,4.1
21101,2020-07-01,20823,20018,805,3.9
21103,2020-07-01,7550,7257,293,3.9
21105,2020-07-01,1650,1585,65,3.9
21107,2020-07-01,15431,14555,876,5.7
21109,2020-07-01,3425,3198,227,6.6
21111,2020-07-01,364639,345449,19190,5.3
21113,2020-07-01,23965,22912,1053,4.4
21115,2020-07-01,5899,5479,420,7.1
21117,2020-07-01,80694,77062,3632,4.5
21119,2020-07-01,3800,3515,285,7.5
21121,2020-07-01,8800,8198,602,6.8
21123,2020-07-01,5427,5162,265,4.9
21125,2020-07-01,21748,20569,1179,5.4
21127,2020-07-01,4729,4427,302,6.4
21129,2020-07-01,1846,1747,99,5.4
21131,2020-07-01,2278,2080,198,8.7
21133,2020-07-01,5404,4922,482,8.9
21135,2020-07-01,4050,3772,278,6.9
21137,2020-07-01,7855,7350,505,6.4
21139,2020-07-01,3117,2943,174,5.6
21141,2020-07-01,11117,10672,445,4
21143,2020-07-01,2753,2643,110,4
21145,2020-07-01,24928,23533,1395,5.6
21147,2020-07-01,4153,3908,245,5.9
21149,2020-07-01,3949,3796,153,3.9
21151,2020-07-01,39807,37901,1906,4.8
21153,2020-07-01,2833,2480,353,12.5
21155,2020-07-01,8879,8480,399,4.5
21157,2020-07-01,13360,12769,591,4.4
21159,2020-07-01,2503,2283,220,8.8
21161,2020-07-01,6293,5931,362,5.8
21163,2020-07-01,11112,10573,539,4.9
21165,2020-07-01,2052,1927,125,6.1
21167,2020-07-01,8736,8210,526,6
21169,2020-07-01,3571,3389,182,5.1
21171,2020-07-01,4152,3994,158,3.8
21173,2020-07-01,10455,9856,599,5.7
21175,2020-07-01,4022,3812,210,5.2
21177,2020-07-01,9167,8538,629,6.9
21179,2020-07-01,21399,20418,981,4.6
21181,2020-07-01,3038,2887,151,5
21183,2020-07-01,9084,8618,466,5.1
21185,2020-07-01,30099,29083,1016,3.4
21187,2020-07-01,4573,4357,216,4.7
21189,2020-07-01,1029,971,58,5.6
21191,2020-07-01,6366,6134,232,3.6
21193,2020-07-01,7044,6487,557,7.9
21195,2020-07-01,16553,15365,1188,7.2
21197,2020-07-01,4551,4284,267,5.9
21199,2020-07-01,23959,22604,1355,5.7
21201,2020-07-01,760,727,33,4.3
21203,2020-07-01,5616,5312,304,5.4
21205,2020-07-01,8948,8454,494,5.5
21207,2020-07-01,5581,5277,304,5.4
21209,2020-07-01,26393,25296,1097,4.2
21211,2020-07-01,23313,22441,872,3.7
21213,2020-07-01,8039,7637,402,5
21215,2020-07-01,9226,8878,348,3.8
21217,2020-07-01,10671,10200,471,4.4
21219,2020-07-01,4932,4750,182,3.7
21221,2020-07-01,5592,5310,282,5
21223,2020-07-01,3538,3382,156,4.4
21225,2020-07-01,5378,5161,217,4
21227,2020-07-01,55090,52344,2746,5
21229,2020-07-01,5883,5667,216,3.7
21231,2020-07-01,6809,6463,346,5.1
21233,2020-07-01,5203,4973,230,4.4
21235,2020-07-01,12111,11409,702,5.8
21237,2020-07-01,1757,1649,108,6.1
21239,2020-07-01,14014,13494,520,3.7
22001,2020-07-01,23307,21294,2013,8.6
22003,2020-07-01,8595,7708,887,10.3
22005,2020-07-01,61640,56609,5031,8.2
22007,2020-07-01,8833,7808,1025,11.6
22009,2020-07-01,14683,13368,1315,9
22011,2020-07-01,14066,12991,1075,7.6
22013,2020-07-01,5257,4774,483,9.2
22015,2020-07-01,56051,51919,4132,7.4
22017,2020-07-01,103357,92249,11108,10.7
22019,2020-07-01,98834,88965,9869,10
22021,2020-07-01,3630,3340,290,8
22023,2020-07-01,3519,3303,216,6.1
22025,2020-07-01,3316,3028,288,8.7
22027,2020-07-01,5466,5091,375,6.9
22029,2020-07-01,6824,6137,687,10.1
22031,2020-07-01,10443,9580,863,8.3
22033,2020-07-01,225242,203483,21759,9.7
22035,2020-07-01,1775,1528,247,13.9
22037,2020-07-01,7646,7022,624,8.2
22039,2020-07-01,11417,10281,1136,10
22041,2020-07-01,7140,6444,696,9.7
22043,2020-07-01,7909,7327,582,7.4
22045,2020-07-01,28389,25176,3213,11.3
22047,2020-07-01,13743,12129,1614,11.7
22049,2020-07-01,6425,6015,410,6.4
22051,2020-07-01,205870,182236,23634,11.5
22053,2020-07-01,12561,11422,1139,9.1
22055,2020-07-01,113275,103486,9789,8.6
22057,2020-07-01,40990,37827,3163,7.7
22059,2020-07-01,6520,6137,383,5.9
22061,2020-07-01,19961,18426,1535,7.7
22063,2020-07-01,66041,60849,5192,7.9
22065,2020-07-01,3347,3015,332,9.9
22067,2020-07-01,9703,8638,1065,11
22069,2020-07-01,15349,14057,1292,8.4
22071,2020-07-01,178498,151598,26900,15.1
22073,2020-07-01,71876,65855,6021,8.4
22075,2020-07-01,9267,8488,779,8.4
22077,2020-07-01,9455,8565,890,9.4
22079,2020-07-01,53713,49740,3973,7.4
22081,2020-07-01,3551,3312,239,6.7
22083,2020-07-01,7935,7231,704,8.9
22085,2020-07-01,8659,8074,585,6.8
22087,2020-07-01,19224,16820,2404,12.5
22089,2020-07-01,23675,21390,2285,9.7
22091,2020-07-01,4324,3696,628,14.5
22093,2020-07-01,8681,7676,1005,11.6
22095,2020-07-01,19051,16477,2574,13.5
22097,2020-07-01,31347,28099,3248,10.4
22099,2020-07-01,22113,19928,2185,9.9
22101,2020-07-01,19269,17166,2103,10.9
22103,2020-07-01,111060,101958,9102,8.2
22105,2020-07-01,54252,47688,6564,12.1
22107,2020-07-01,1265,1142,123,9.7
22109,2020-07-01,45683,41485,4198,9.2
22111,2020-07-01,9146,8415,731,8
22113,2020-07-01,23757,21721,2036,8.6
22115,2020-07-01,15163,13871,1292,8.5
22117,2020-07-01,16299,14701,1598,9.8
22119,2020-07-01,14067,12811,1256,8.9
22121,2020-07-01,13192,12035,1157,8.8
22123,2020-07-01,3352,3004,348,10.4
22125,2020-07-01,5059,4743,316,6.2
22127,2020-07-01,4560,4188,372,8.2
23001,2020-07-01,57275,51360,5915,10.3
23003,2020-07-01,30770,28048,2722,8.8
23005,2020-07-01,169950,153283,16667,9.8
23007,2020-07-01,14710,13123,1587,10.8
23009,2020-07-01,30007,27514,2493,8.3
23011,2020-07-01,64421,59025,5396,8.4
23013,2020-07-01,21446,19573,1873,8.7
23015,2020-07-01,17822,16306,1516,8.5
23017,2020-07-01,28196,24881,3315,11.8
23019,2020-07-01,77668,70628,7040,9.1
23021,2020-07-01,7533,6879,654,8.7
23023,2020-07-01,20414,18701,1713,8.4
23025,2020-07-01,23727,21305,2422,10.2
23027,2020-07-01,21335,19561,1774,8.3
23029,2020-07-01,14373,13057,1316,9.2
23031,2020-07-01,115736,104643,11093,9.6
24001,2020-07-01,30734,28191,2543,8.3
24003,2020-07-01,318817,296884,21933,6.9
24005,2020-07-01,461743,424647,37096,8
24009,2020-07-01,50057,47004,3053,6.1
24011,2020-07-01,17688,16615,1073,6.1
24013,2020-07-01,95963,90251,5712,6
24015,2020-07-01,52075,48513,3562,6.8
24017,2020-07-01,88910,81669,7241,8.1
24019,2020-07-01,15486,14297,1189,7.7
24021,2020-07-01,137756,128205,9551,6.9
24023,2020-07-01,15254,14181,1073,7
24025,2020-07-01,141996,132391,9605,6.8
24027,2020-07-01,189091,177252,11839,6.3
24029,2020-07-01,10023,9253,770,7.7
24031,2020-07-01,579504,535067,44437,7.7
24033,2020-07-01,527465,475673,51792,9.8
24035,2020-07-01,27949,26221,1728,6.2
24037,2020-07-01,55738,52338,3400,6.1
24039,2020-07-01,9383,8578,805,8.6
24041,2020-07-01,18570,17355,1215,6.5
24043,2020-07-01,74327,68694,5633,7.6
24045,2020-07-01,52578,48692,3886,7.4
24047,2020-07-01,25967,23577,2390,9.2
24510,2020-07-01,296599,265962,30637,10.3
25001,2020-07-01,115995,98211,17784,15.3
25003,2020-07-01,64712,54387,10325,16
25005,2020-07-01,301771,248757,53014,17.6
25007,2020-07-01,11963,10656,1307,10.9
25009,2020-07-01,424848,348473,76375,18
25011,2020-07-01,39071,33731,5340,13.7
25013,2020-07-01,221547,179001,42546,19.2
25015,2020-07-01,83108,71698,11410,13.7
25017,2020-07-01,882613,761009,121604,13.8
25019,2020-07-01,9792,8887,905,9.2
25021,2020-07-01,382458,322930,59528,15.6
25023,2020-07-01,280040,233057,46983,16.8
25025,2020-07-01,463958,375820,88138,19
25027,2020-07-01,443276,372739,70537,15.9
26001,2020-07-01,4006,3617,389,9.7
26003,2020-07-01,3118,2803,315,10.1
26005,2020-07-01,63694,58859,4835,7.6
26007,2020-07-01,13430,12268,1162,8.7
26009,2020-07-01,10973,10003,970,8.8
26011,2020-07-01,6316,5684,632,10
26013,2020-07-01,3236,2817,419,12.9
26015,2020-07-01,32040,29507,2533,7.9
26017,2020-07-01,49350,44599,4751,9.6
26019,2020-07-01,9487,8721,766,8.1
26021,2020-07-01,76635,69025,7610,9.9
26023,2020-07-01,20005,18240,1765,8.8
26025,2020-07-01,62005,55237,6768,10.9
26027,2020-07-01,24836,22359,2477,10
26029,2020-07-01,13349,12207,1142,8.6
26031,2020-07-01,10893,9784,1109,10.2
26033,2020-07-01,17118,15589,1529,8.9
26035,2020-07-01,11827,10428,1399,11.8
26037,2020-07-01,40076,37230,2846,7.1
26039,2020-07-01,5494,4878,616,11.2
26041,2020-07-01,18080,16637,1443,8
26043,2020-07-01,13112,12175,937,7.1
26045,2020-07-01,55732,51092,4640,8.3
26047,2020-07-01,19121,17510,1611,8.4
26049,2020-07-01,186165,164172,21993,11.8
26051,2020-07-01,9884,8874,1010,10.2
26053,2020-07-01,6362,5844,518,8.1
26055,2020-07-01,53993,49612,4381,8.1
26057,2020-07-01,18826,17335,1491,7.9
26059,2020-07-01,20876,19054,1822,8.7
26061,2020-07-01,16605,15180,1425,8.6
26063,2020-07-01,16593,15289,1304,7.9
26065,2020-07-01,147938,134787,13151,8.9
26067,2020-07-01,30331,27922,2409,7.9
26069,2020-07-01,10531,9466,1065,10.1
26071,2020-07-01,5468,5039,429,7.8
26073,2020-07-01,36732,33701,3031,8.3
26075,2020-07-01,75451,67821,7630,10.1
26077,2020-07-01,136259,124350,11909,8.7
26079,2020-07-01,8609,7724,885,10.3
26081,2020-07-01,366441,334257,32184,8.8
26083,2020-07-01,910,820,90,9.9
26085,2020-07-01,4000,3531,469,11.7
26087,2020-07-01,38724,35275,3449,8.9
26089,2020-07-01,11352,10544,808,7.1
26091,2020-07-01,47119,42956,4163,8.8
26093,2020-07-01,97073,90165,6908,7.1
26095,2020-07-01,2477,2275,202,8.2
26097,2020-07-01,5358,4989,369,6.9
26099,2020-07-01,427237,385067,42170,9.9
26101,2020-07-01,10202,9054,1148,11.3
26103,2020-07-01,33730,30985,2745,8.1
26105,2020-07-01,13939,12666,1273,9.1
26107,2020-07-01,19249,17529,1720,8.9
26109,2020-07-01,11477,10716,761,6.6
26111,2020-07-01,40118,36914,3204,8
26113,2020-07-01,7572,6904,668,8.8
26115,2020-07-01,73749,66919,6830,9.3
26117,2020-07-01,29108,26336,2772,9.5
26119,2020-07-01,3143,2727,416,13.2
26121,2020-07-01,80114,69835,10279,12.8
26123,2020-07-01,23887,21742,2145,9
26125,2020-07-01,638549,586430,52119,8.2
26127,2020-07-01,12336,11024,1312,10.6
26129,2020-07-01,8458,7598,860,10.2
26131,2020-07-01,2098,1878,220,10.5
26133,2020-07-01,12130,11186,944,7.8
26135,2020-07-01,3101,2741,360,11.6
26137,2020-07-01,11854,10651,1203,10.1
26139,2020-07-01,162722,150511,12211,7.5
26141,2020-07-01,5002,4499,503,10.1
26143,2020-07-01,7851,6923,928,11.8
26145,2020-07-01,86936,77728,9208,10.6
26147,2020-07-01,71295,64936,6359,8.9
26149,2020-07-01,30010,27212,2798,9.3
26151,2020-07-01,20386,18552,1834,9
26153,2020-07-01,3464,3146,318,9.2
26155,2020-07-01,34815,31801,3014,8.7
26157,2020-07-01,24831,22446,2385,9.6
26159,2020-07-01,36010,32853,3157,8.8
26161,2020-07-01,203194,187022,16172,8
26163,2020-07-01,768444,672697,95747,12.5
26165,2020-07-01,16038,14414,1624,10.1
27001,2020-07-01,7315,6781,534,7.3
27003,2020-07-01,198576,182638,15938,8
27005,2020-07-01,19340,18234,1106,5.7
27007,2020-07-01,25042,23400,1642,6.6
27009,2020-07-01,22562,21112,1450,6.4
27011,2020-07-01,2515,2428,87,3.5
27013,2020-07-01,41379,38729,2650,6.4
27015,2020-07-01,14791,14095,696,4.7
27017,2020-07-01,17273,15898,1375,8
27019,2020-07-01,58399,54597,3802,6.5
27021,2020-07-01,14721,13420,1301,8.8
27023,2020-07-01,7059,6720,339,4.8
27025,2020-07-01,29753,27677,2076,7
27027,2020-07-01,36504,34751,1753,4.8
27029,2020-07-01,4366,4068,298,6.8
27031,2020-07-01,3135,2904,231,7.4
27033,2020-07-01,6340,6002,338,5.3
27035,2020-07-01,32928,30666,2262,6.9
27037,2020-07-01,242696,223608,19088,7.9
27039,2020-07-01,12018,11320,698,5.8
27041,2020-07-01,21524,20543,981,4.6
27043,2020-07-01,7221,6771,450,6.2
27045,2020-07-01,11808,11196,612,5.2
27047,2020-07-01,16882,15819,1063,6.3
27049,2020-07-01,27571,25847,1724,6.3
27051,2020-07-01,3474,3302,172,5
27053,2020-07-01,719732,655596,64136,8.9
27055,2020-07-01,10139,9687,452,4.5
27057,2020-07-01,9999,9385,614,6.1
27059,2020-07-01,21074,19560,1514,7.2
27061,2020-07-01,21801,19872,1929,8.8
27063,2020-07-01,6091,5731,360,5.9
27065,2020-07-01,9035,8444,591,6.5
27067,2020-07-01,24803,23642,1161,4.7
27069,2020-07-01,2425,2321,104,4.3
27071,2020-07-01,5879,5443,436,7.4
27073,2020-07-01,3730,3575,155,4.2
27075,2020-07-01,5551,5029,522,9.4
27077,2020-07-01,2454,2298,156,6.4
27079,2020-07-01,15952,14934,1018,6.4
27081,2020-07-01,3378,3263,115,3.4
27083,2020-07-01,14890,14219,671,4.5
27085,2020-07-01,19481,18309,1172,6
27087,2020-07-01,2557,2213,344,13.5
27089,2020-07-01,5418,5168,250,4.6
27091,2020-07-01,10505,9855,650,6.2
27093,2020-07-01,13499,12892,607,4.5
27095,2020-07-01,12776,11760,1016,8
27097,2020-07-01,17922,16958,964,5.4
27099,2020-07-01,21201,20003,1198,5.7
27101,2020-07-01,4847,4636,211,4.4
27103,2020-07-01,21392,20152,1240,5.8
27105,2020-07-01,11835,11284,551,4.7
27107,2020-07-01,3429,3215,214,6.2
27109,2020-07-01,90082,83764,6318,7
27111,2020-07-01,31683,30146,1537,4.9
27113,2020-07-01,8597,8193,404,4.7
27115,2020-07-01,15120,13958,1162,7.7
27117,2020-07-01,4913,4747,166,3.4
27119,2020-07-01,16708,15677,1031,6.2
27121,2020-07-01,6714,6403,311,4.6
27123,2020-07-01,295244,268067,27177,9.2
27125,2020-07-01,2224,2114,110,4.9
27127,2020-07-01,7978,7555,423,5.3
27129,2020-07-01,8790,8328,462,5.3
27131,2020-07-01,38101,35807,2294,6
27133,2020-07-01,5882,5675,207,3.5
27135,2020-07-01,8083,7597,486,6
27137,2020-07-01,99383,90851,8532,8.6
27139,2020-07-01,83492,77483,6009,7.2
27141,2020-07-01,51719,48306,3413,6.6
27143,2020-07-01,8657,8185,472,5.5
27145,2020-07-01,93277,87615,5662,6.1
27147,2020-07-01,21938,20653,1285,5.9
27149,2020-07-01,5515,5341,174,3.2
27151,2020-07-01,5105,4804,301,5.9
27153,2020-07-01,14074,13416,658,4.7
27155,2020-07-01,1889,1812,77,4.1
27157,2020-07-01,12609,11896,713,5.7
27159,2020-07-01,6213,5822,391,6.3
27161,2020-07-01,9357,8735,622,6.6
27163,2020-07-01,142898,132793,10105,7.1
27165,2020-07-01,6776,6435,341,5
27167,2020-07-01,3587,3431,156,4.3
27169,2020-07-01,29637,27930,1707,5.8
27171,2020-07-01,74826,70186,4640,6.2
27173,2020-07-01,5535,5295,240,4.3
28001,2020-07-01,10695,9279,1416,13.2
28003,2020-07-01,15323,14188,1135,7.4
28005,2020-07-01,4286,3853,433,10.1
28007,2020-07-01,6833,6122,711,10.4
28009,2020-07-01,2911,2603,308,10.6
28011,2020-07-01,11795,10532,1263,10.7
28013,2020-07-01,5507,4974,533,9.7
28015,2020-07-01,3292,2979,313,9.5
28017,2020-07-01,6833,5918,915,13.4
28019,2020-07-01,3590,3299,291,8.1
28021,2020-07-01,3061,2484,577,18.9
28023,2020-07-01,5650,5051,599,10.6
28025,2020-07-01,7734,6605,1129,14.6
28027,2020-07-01,8591,7265,1326,15.4
28029,2020-07-01,10789,9667,1122,10.4
28031,2020-07-01,7932,7182,750,9.5
28033,2020-07-01,85929,79184,6745,7.8
28035,2020-07-01,32504,29128,3376,10.4
28037,2020-07-01,2720,2452,268,9.9
28039,2020-07-01,8535,7595,940,11
28041,2020-07-01,4173,3680,493,11.8
28043,2020-07-01,9174,8262,912,9.9
28045,2020-07-01,18345,16577,1768,9.6
28047,2020-07-01,85890,76766,9124,10.6
28049,2020-07-01,105450,92880,12570,11.9
28051,2020-07-01,5520,4454,1066,19.3
28053,2020-07-01,2338,1894,444,19
28055,2020-07-01,341,312,29,8.5
28057,2020-07-01,10060,9265,795,7.9
28059,2020-07-01,57842,51538,6304,10.9
28061,2020-07-01,5973,5332,641,10.7
28063,2020-07-01,1969,1514,455,23.1
28065,2020-07-01,3962,3482,480,12.1
28067,2020-07-01,25264,22881,2383,9.4
28069,2020-07-01,3427,3005,422,12.3
28071,2020-07-01,26600,24448,2152,8.1
28073,2020-07-01,29280,27118,2162,7.4
28075,2020-07-01,28777,26075,2702,9.4
28077,2020-07-01,4511,4037,474,10.5
28079,2020-07-01,7921,7109,812,10.3
28081,2020-07-01,40292,36194,4098,10.2
28083,2020-07-01,9792,8442,1350,13.8
28085,2020-07-01,14048,12792,1256,8.9
28087,2020-07-01,24172,21457,2715,11.2
28089,2020-07-01,50555,46671,3884,7.7
28091,2020-07-01,9404,8545,859,9.1
28093,2020-07-01,13829,12419,1410,10.2
28095,2020-07-01,14965,13288,1677,11.2
28097,2020-07-01,3815,3432,383,10
28099,2020-07-01,10520,9036,1484,14.1
28101,2020-07-01,8383,7567,816,9.7
28103,2020-07-01,3714,3118,596,16
28105,2020-07-01,21691,19522,2169,10
28107,2020-07-01,12370,10676,1694,13.7
28109,2020-07-01,22417,20435,1982,8.8
28111,2020-07-01,4132,3709,423,10.2
28113,2020-07-01,14258,12595,1663,11.7
28115,2020-07-01,14351,13014,1337,9.3
28117,2020-07-01,10771,9871,900,8.4
28119,2020-07-01,2226,1915,311,14
28121,2020-07-01,71484,67002,4482,6.3
28123,2020-07-01,12355,11481,874,7.1
28125,2020-07-01,1562,1378,184,11.8
28127,2020-07-01,10254,9397,857,8.4
28129,2020-07-01,6470,6037,433,6.7
28131,2020-07-01,6624,5997,627,9.5
28133,2020-07-01,7700,6631,1069,13.9
28135,2020-07-01,4912,4431,481,9.8
28137,2020-07-01,11871,10671,1200,10.1
28139,2020-07-01,8961,8199,762,8.5
28141,2020-07-01,8217,7595,622,7.6
28143,2020-07-01,4678,3847,831,17.8
28145,2020-07-01,13868,12699,1169,8.4
28147,2020-07-01,4695,4182,513,10.9
28149,2020-07-01,19640,17468,2172,11.1
28151,2020-07-01,16743,14426,2317,13.8
28153,2020-07-01,7415,6577,838,11.3
28155,2020-07-01,3815,3436,379,9.9
28157,2020-07-01,2695,2277,418,15.5
28159,2020-07-01,7201,6390,811,11.3
28161,2020-07-01,4578,4127,451,9.9
28163,2020-07-01,9343,8191,1152,12.3
29001,2020-07-01,10468,9753,715,6.8
29003,2020-07-01,9761,9273,488,5
29005,2020-07-01,2696,2563,133,4.9
29007,2020-07-01,10674,10003,671,6.3
29009,2020-07-01,16070,14814,1256,7.8
29011,2020-07-01,5216,4933,283,5.4
29013,2020-07-01,7802,7316,486,6.2
29015,2020-07-01,7411,6799,612,8.3
29017,2020-07-01,5016,4679,337,6.7
29019,2020-07-01,96886,91955,4931,5.1
29021,2020-07-01,44873,42332,2541,5.7
29023,2020-07-01,18364,17149,1215,6.6
29025,2020-07-01,4330,4076,254,5.9
29027,2020-07-01,21545,20369,1176,5.5
29029,2020-07-01,18826,17593,1233,6.5
29031,2020-07-01,37255,34942,2313,6.2
29033,2020-07-01,4688,4400,288,6.1
29035,2020-07-01,2619,2431,188,7.2
29037,2020-07-01,54788,51397,3391,6.2
29039,2020-07-01,5844,5538,306,5.2
29041,2020-07-01,3749,3556,193,5.1
29043,2020-07-01,45282,42705,2577,5.7
29045,2020-07-01,3198,3011,187,5.8
29047,2020-07-01,137777,128113,9664,7
29049,2020-07-01,10756,10040,716,6.7
29051,2020-07-01,39636,37357,2279,5.7
29053,2020-07-01,7434,6965,469,6.3
29055,2020-07-01,11204,10360,844,7.5
29057,2020-07-01,3599,3406,193,5.4
29059,2020-07-01,7101,6578,523,7.4
29061,2020-07-01,4127,3956,171,4.1
29063,2020-07-01,4798,4566,232,4.8
29065,2020-07-01,6416,6087,329,5.1
29067,2020-07-01,5106,4790,316,6.2
29069,2020-07-01,11571,10603,968,8.4
29071,2020-07-01,53081,49201,3880,7.3
29073,2020-07-01,7938,7322,616,7.8
29075,2020-07-01,3479,3332,147,4.2
29077,2020-07-01,153809,143811,9998,6.5
29079,2020-07-01,4376,4174,202,4.6
29081,2020-07-01,3861,3656,205,5.3
29083,2020-07-01,9985,9253,732,7.3
29085,2020-07-01,3924,3724,200,5.1
29087,2020-07-01,2556,2446,110,4.3
29089,2020-07-01,4857,4605,252,5.2
29091,2020-07-01,16992,15675,1317,7.8
29093,2020-07-01,3626,3336,290,8
29095,2020-07-01,369780,338036,31744,8.6
29097,2020-07-01,57080,53413,3667,6.4
29099,2020-07-01,117867,109426,8441,7.2
29101,2020-07-01,24059,22525,1534,6.4
29103,2020-07-01,1764,1676,88,5
29105,2020-07-01,17730,15977,1753,9.9
29107,2020-07-01,16736,15736,1000,6
29109,2020-07-01,18540,17173,1367,7.4
29111,2020-07-01,5091,4767,324,6.4
29113,2020-07-01,28165,26253,1912,6.8
29115,2020-07-01,5231,4824,407,7.8
29117,2020-07-01,7449,7124,325,4.4
29119,2020-07-01,10732,10105,627,5.8
29121,2020-07-01,7675,7195,480,6.3
29123,2020-07-01,5741,5295,446,7.8
29125,2020-07-01,3971,3713,258,6.5
29127,2020-07-01,14782,13912,870,5.9
29129,2020-07-01,1877,1800,77,4.1
29131,2020-07-01,12400,11722,678,5.5
29133,2020-07-01,5815,5440,375,6.4
29135,2020-07-01,7311,6938,373,5.1
29137,2020-07-01,3852,3568,284,7.4
29139,2020-07-01,5807,5461,346,6
29141,2020-07-01,8029,7589,440,5.5
29143,2020-07-01,8462,7901,561,6.6
29145,2020-07-01,27288,25446,1842,6.8
29147,2020-07-01,11316,10819,497,4.4
29149,2020-07-01,4110,3807,303,7.4
29151,2020-07-01,7162,6792,370,5.2
29153,2020-07-01,3450,3209,241,7
29155,2020-07-01,6576,5970,606,9.2
29157,2020-07-01,9870,9393,477,4.8
29159,2020-07-01,21720,19993,1727,8
29161,2020-07-01,19996,18907,1089,5.4
29163,2020-07-01,7586,7140,446,5.9
29165,2020-07-01,59221,55252,3969,6.7
29167,2020-07-01,14546,13722,824,5.7
29169,2020-07-01,14966,13966,1000,6.7
29171,2020-07-01,2241,2102,139,6.2
29173,2020-07-01,5715,5400,315,5.5
29175,2020-07-01,10520,9802,718,6.8
29177,2020-07-01,11064,10260,804,7.3
29179,2020-07-01,3016,2841,175,5.8
29181,2020-07-01,5168,4688,480,9.3
29183,2020-07-01,224801,211282,13519,6
29185,2020-07-01,3816,3522,294,7.7
29186,2020-07-01,9201,8707,494,5.4
29187,2020-07-01,27504,25216,2288,8.3
29189,2020-07-01,535736,493657,42079,7.9
29195,2020-07-01,11205,10419,786,7
29197,2020-07-01,2013,1815,198,9.8
29199,2020-07-01,2358,2266,92,3.9
29201,2020-07-01,19589,18386,1203,6.1
29203,2020-07-01,3311,3030,281,8.5
29205,2020-07-01,3129,2964,165,5.3
29207,2020-07-01,13220,12446,774,5.9
29209,2020-07-01,14051,12875,1176,8.4
29211,2020-07-01,2694,2577,117,4.3
29213,2020-07-01,28168,25140,3028,10.7
29215,2020-07-01,8984,8373,611,6.8
29217,2020-07-01,9501,9019,482,5.1
29219,2020-07-01,17859,16661,1198,6.7
29221,2020-07-01,10447,9640,807,7.7
29223,2020-07-01,5149,4805,344,6.7
29225,2020-07-01,17372,16251,1121,6.5
29227,2020-07-01,1164,1110,54,4.6
29229,2020-07-01,7479,6923,556,7.4
29510,2020-07-01,157904,140515,17389,11
30001,2020-07-01,4951,4756,195,3.9
30003,2020-07-01,4568,4220,348,7.6
30005,2020-07-01,2174,2060,114,5.2
30007,2020-07-01,2567,2401,166,6.5
30009,2020-07-01,5530,5205,325,5.9
30011,2020-07-01,572,552,20,3.5
30013,2020-07-01,38677,36271,2406,6.2
30015,2020-07-01,2318,2225,93,4
30017,2020-07-01,6105,5766,339,5.6
30019,2020-07-01,851,826,25,2.9
30021,2020-07-01,4548,4190,358,7.9
30023,2020-07-01,5049,4788,261,5.2
30025,2020-07-01,1632,1546,86,5.3
30027,2020-07-01,5565,5329,236,4.2
30029,2020-07-01,50971,47368,3603,7.1
30031,2020-07-01,72758,69198,3560,4.9
30033,2020-07-01,641,626,15,2.3
30035,2020-07-01,5898,5288,610,10.3
30037,2020-07-01,352,338,14,4
30039,2020-07-01,1599,1496,103,6.4
30041,2020-07-01,7326,6893,433,5.9
30043,2020-07-01,5696,5384,312,5.5
30045,2020-07-01,889,848,41,4.6
30047,2020-07-01,13587,12652,935,6.9
30049,2020-07-01,36138,34216,1922,5.3
30051,2020-07-01,885,858,27,3.1
30053,2020-07-01,8068,7330,738,9.1
30055,2020-07-01,857,821,36,4.2
30057,2020-07-01,4456,4250,206,4.6
30059,2020-07-01,953,911,42,4.4
30061,2020-07-01,1809,1650,159,8.8
30063,2020-07-01,66607,62396,4211,6.3
30065,2020-07-01,2218,2077,141,6.4
30067,2020-07-01,9597,8939,658,6.9
30069,2020-07-01,251,242,9,3.6
30071,2020-07-01,1728,1634,94,5.4
30073,2020-07-01,2464,2318,146,5.9
30075,2020-07-01,877,849,28,3.2
30077,2020-07-01,2847,2721,126,4.4
30079,2020-07-01,438,398,40,9.1
30081,2020-07-01,20247,19095,1152,5.7
30083,2020-07-01,5844,5334,510,8.7
30085,2020-07-01,4276,3960,316,7.4
30087,2020-07-01,3518,3301,217,6.2
30089,2020-07-01,4924,4561,363,7.4
30091,2020-07-01,1684,1587,97,5.8
30093,2020-07-01,17374,16164,1210,7
30095,2020-07-01,5258,4959,299,5.7
30097,2020-07-01,1748,1683,65,3.7
30099,2020-07-01,2584,2469,115,4.5
30101,2020-07-01,2057,1927,130,6.3
30103,2020-07-01,301,288,13,4.3
30105,2020-07-01,3978,3806,172,4.3
30107,2020-07-01,708,652,56,7.9
30109,2020-07-01,450,422,28,6.2
30111,2020-07-01,83792,78840,4952,5.9
31001,2020-07-01,16856,16082,774,4.6
31003,2020-07-01,3754,3668,86,2.3
31005,2020-07-01,226,210,16,7.1
31007,2020-07-01,356,346,10,2.8
31009,2020-07-01,242,235,7,2.9
31011,2020-07-01,2838,2765,73,2.6
31013,2020-07-01,5415,5080,335,6.2
31015,2020-07-01,1019,990,29,2.8
31017,2020-07-01,1353,1325,28,2.1
31019,2020-07-01,27494,26343,1151,4.2
31021,2020-07-01,3479,3340,139,4
31023,2020-07-01,4462,4281,181,4.1
31025,2020-07-01,13955,13255,700,5
31027,2020-07-01,4426,4308,118,2.7
31029,2020-07-01,2209,2171,38,1.7
31031,2020-07-01,3311,3224,87,2.6
31033,2020-07-01,4276,4054,222,5.2
31035,2020-07-01,3209,3103,106,3.3
31037,2020-07-01,5539,5327,212,3.8
31039,2020-07-01,4721,4595,126,2.7
31041,2020-07-01,6395,6074,321,5
31043,2020-07-01,11230,10621,609,5.4
31045,2020-07-01,4800,4621,179,3.7
31047,2020-07-01,13119,12536,583,4.4
31049,2020-07-01,946,916,30,3.2
31051,2020-07-01,3057,2962,95,3.1
31053,2020-07-01,20189,19351,838,4.2
31055,2020-07-01,313997,293763,20234,6.4
31057,2020-07-01,1103,1080,23,2.1
31059,2020-07-01,3162,3057,105,3.3
31061,2020-07-01,1454,1391,63,4.3
31063,2020-07-01,1474,1426,48,3.3
31065,2020-07-01,2524,2442,82,3.2
31067,2020-07-01,10916,10433,483,4.4
31069,2020-07-01,1062,1017,45,4.2
31071,2020-07-01,1126,1106,20,1.8
31073,2020-07-01,1075,1046,29,2.7
31075,2020-07-01,381,374,7,1.8
31077,2020-07-01,1210,1175,35,2.9
31079,2020-07-01,33204,31151,2053,6.2
31081,2020-07-01,4809,4629,180,3.7
31083,2020-07-01,1787,1730,57,3.2
31085,2020-07-01,567,551,16,2.8
31087,2020-07-01,1277,1229,48,3.8
31089,2020-07-01,5582,5424,158,2.8
31091,2020-07-01,427,418,9,2.1
31093,2020-07-01,3357,3253,104,3.1
31095,2020-07-01,4075,3930,145,3.6
31097,2020-07-01,2053,1967,86,4.2
31099,2020-07-01,3754,3609,145,3.9
31101,2020-07-01,4615,4460,155,3.4
31103,2020-07-01,562,554,8,1.4
31105,2020-07-01,1980,1892,88,4.4
31107,2020-07-01,4585,4458,127,2.8
31109,2020-07-01,187749,178228,9521,5.1
31111,2020-07-01,18365,17471,894,4.9
31113,2020-07-01,438,426,12,2.7
31115,2020-07-01,369,356,13,3.5
31117,2020-07-01,425,413,12,2.8
31119,2020-07-01,19463,18621,842,4.3
31121,2020-07-01,4030,3888,142,3.5
31123,2020-07-01,2581,2478,103,4
31125,2020-07-01,1916,1848,68,3.5
31127,2020-07-01,3631,3449,182,5
31129,2020-07-01,2351,2278,73,3.1
31131,2020-07-01,8428,8076,352,4.2
31133,2020-07-01,1428,1379,49,3.4
31135,2020-07-01,1779,1745,34,1.9
31137,2020-07-01,4876,4700,176,3.6
31139,2020-07-01,4010,3890,120,3
31141,2020-07-01,17538,16743,795,4.5
31143,2020-07-01,2826,2736,90,3.2
31145,2020-07-01,5793,5573,220,3.8
31147,2020-07-01,4239,4071,168,4
31149,2020-07-01,835,820,15,1.8
31151,2020-07-01,7345,7023,322,4.4
31153,2020-07-01,99840,95069,4771,4.8
31155,2020-07-01,11412,10954,458,4
31157,2020-07-01,17992,17080,912,5.1
31159,2020-07-01,9284,8878,406,4.4
31161,2020-07-01,2615,2540,75,2.9
31163,2020-07-01,1609,1553,56,3.5
31165,2020-07-01,727,713,14,1.9
31167,2020-07-01,3434,3324,110,3.2
31169,2020-07-01,2701,2596,105,3.9
31171,2020-07-01,407,388,19,4.7
31173,2020-07-01,3159,2947,212,6.7
31175,2020-07-01,2160,2096,64,3
31177,2020-07-01,11472,11051,421,3.7
31179,2020-07-01,5287,5124,163,3.1
31181,2020-07-01,1578,1510,68,4.3
31183,2020-07-01,505,494,11,2.2
31185,2020-07-01,7382,7103,279,3.8
32001,2020-07-01,10489,9883,606,5.8
32003,2020-07-01,NA,921048,183108,16.6
32005,2020-07-01,22567,20733,1834,8.1
32007,2020-07-01,25452,24166,1286,5.1
32009,2020-07-01,398,383,15,3.8
32011,2020-07-01,914,876,38,4.2
32013,2020-07-01,7550,7164,386,5.1
32015,2020-07-01,3001,2862,139,4.6
32017,2020-07-01,1903,1807,96,5
32019,2020-07-01,22180,20319,1861,8.4
32021,2020-07-01,1935,1818,117,6
32023,2020-07-01,17105,15417,1688,9.9
32027,2020-07-01,2275,2171,104,4.6
32029,2020-07-01,1940,1772,168,8.7
32031,2020-07-01,243302,223414,19888,8.2
32033,2020-07-01,4363,4187,176,4
32510,2020-07-01,25409,23352,2057,8.1
33001,2020-07-01,30445,28085,2360,7.8
33003,2020-07-01,23275,21358,1917,8.2
33005,2020-07-01,39423,36508,2915,7.4
33007,2020-07-01,14412,13178,1234,8.6
33009,2020-07-01,48240,44970,3270,6.8
33011,2020-07-01,235906,216351,19555,8.3
33013,2020-07-01,80594,75047,5547,6.9
33015,2020-07-01,181597,166433,15164,8.4
33017,2020-07-01,70778,65208,5570,7.9
33019,2020-07-01,22464,21032,1432,6.4
34001,2020-07-01,128751,97204,31547,24.5
34003,2020-07-01,497668,425789,71879,14.4
34005,2020-07-01,236554,207565,28989,12.3
34007,2020-07-01,264660,226188,38472,14.5
34009,2020-07-01,47744,40454,7290,15.3
34011,2020-07-01,67136,57031,10105,15.1
34013,2020-07-01,391806,324539,67267,17.2
34015,2020-07-01,155087,134286,20801,13.4
34017,2020-07-01,378403,317760,60643,16
34019,2020-07-01,64534,57618,6916,10.7
34021,2020-07-01,208761,185029,23732,11.4
34023,2020-07-01,450234,391004,59230,13.2
34025,2020-07-01,336278,292742,43536,12.9
34027,2020-07-01,259714,229729,29985,11.5
34029,2020-07-01,281878,243810,38068,13.5
34031,2020-07-01,257660,210665,46995,18.2
34033,2020-07-01,30020,25910,4110,13.7
34035,2020-07-01,173137,152982,20155,11.6
34037,2020-07-01,75855,65687,10168,13.4
34039,2020-07-01,286811,245064,41747,14.6
34041,2020-07-01,58038,51043,6995,12.1
35001,2020-07-01,317987,276714,41273,13
35003,2020-07-01,1052,928,124,11.8
35005,2020-07-01,26736,23150,3586,13.4
35006,2020-07-01,8737,7502,1235,14.1
35007,2020-07-01,5066,4503,563,11.1
35009,2020-07-01,20436,18537,1899,9.3
35011,2020-07-01,660,609,51,7.7
35013,2020-07-01,90817,78971,11846,13
35015,2020-07-01,34917,31172,3745,10.7
35017,2020-07-01,12075,10281,1794,14.9
35019,2020-07-01,1418,1272,146,10.3
35021,2020-07-01,266,247,19,7.1
35023,2020-07-01,2015,1830,185,9.2
35025,2020-07-01,32998,27513,5485,16.6
35027,2020-07-01,8491,7372,1119,13.2
35028,2020-07-01,8723,8149,574,6.6
35029,2020-07-01,11999,9739,2260,18.8
35031,2020-07-01,23851,20122,3729,15.6
35033,2020-07-01,2000,1769,231,11.6
35035,2020-07-01,24153,21026,3127,12.9
35037,2020-07-01,2999,2638,361,12
35039,2020-07-01,15888,13802,2086,13.1
35041,2020-07-01,7518,6732,786,10.5
35043,2020-07-01,63508,54710,8798,13.9
35045,2020-07-01,49077,41449,7628,15.5
35047,2020-07-01,10442,9102,1340,12.8
35049,2020-07-01,70222,60754,9468,13.5
35051,2020-07-01,3781,3232,549,14.5
35053,2020-07-01,5982,5302,680,11.4
35055,2020-07-01,15685,13070,2615,16.7
35057,2020-07-01,5193,4431,762,14.7
35059,2020-07-01,1635,1504,131,8
35061,2020-07-01,29022,25215,3807,13.1
36001,2020-07-01,163974,144873,19101,11.6
36003,2020-07-01,19246,16918,2328,12.1
36005,2020-07-01,620458,465154,155304,25
36007,2020-07-01,88209,76994,11215,12.7
36009,2020-07-01,35182,30589,4593,13.1
36011,2020-07-01,37732,33261,4471,11.8
36013,2020-07-01,56297,49334,6963,12.4
36015,2020-07-01,38359,33576,4783,12.5
36017,2020-07-01,22909,20657,2252,9.8
36019,2020-07-01,38787,34509,4278,11
36021,2020-07-01,32023,28909,3114,9.7
36023,2020-07-01,23156,20489,2667,11.5
36025,2020-07-01,20262,18194,2068,10.2
36027,2020-07-01,148333,129798,18535,12.5
36029,2020-07-01,468737,402978,65759,14
36031,2020-07-01,17844,15976,1868,10.5
36033,2020-07-01,20693,18172,2521,12.2
36035,2020-07-01,23002,20009,2993,13
36037,2020-07-01,30309,27141,3168,10.5
36039,2020-07-01,21730,18981,2749,12.7
36041,2020-07-01,2678,2482,196,7.3
36043,2020-07-01,28455,25329,3126,11
36045,2020-07-01,43643,38209,5434,12.5
36047,2020-07-01,NA,946385,243870,20.5
36049,2020-07-01,11532,10413,1119,9.7
36051,2020-07-01,30310,27186,3124,10.3
36053,2020-07-01,33308,29358,3950,11.9
36055,2020-07-01,370641,319924,50717,13.7
36057,2020-07-01,22440,19403,3037,13.5
36059,2020-07-01,743834,639693,104141,14
36061,2020-07-01,862150,724484,137666,16
36063,2020-07-01,104710,89515,15195,14.5
36065,2020-07-01,105452,92383,13069,12.4
36067,2020-07-01,229129,198914,30215,13.2
36069,2020-07-01,55375,49195,6180,11.2
36071,2020-07-01,189692,163733,25959,13.7
36073,2020-07-01,17687,15435,2252,12.7
36075,2020-07-01,54029,47020,7009,13
36077,2020-07-01,27795,24842,2953,10.6
36079,2020-07-01,52527,46138,6389,12.2
36081,2020-07-01,NA,905311,234261,20.6
36083,2020-07-01,83791,74531,9260,11.1
36085,2020-07-01,212233,175502,36731,17.3
36087,2020-07-01,160094,138060,22034,13.8
36089,2020-07-01,45459,39999,5460,12
36091,2020-07-01,122678,109779,12899,10.5
36093,2020-07-01,80420,69826,10594,13.2
36095,2020-07-01,14912,13309,1603,10.7
36097,2020-07-01,8744,7780,964,11
36099,2020-07-01,16676,14751,1925,11.5
36101,2020-07-01,43669,38567,5102,11.7
36103,2020-07-01,810726,700651,110075,13.6
36105,2020-07-01,40968,35398,5570,13.6
36107,2020-07-01,23702,21041,2661,11.2
36109,2020-07-01,51164,46153,5011,9.8
36111,2020-07-01,93650,82069,11581,12.4
36113,2020-07-01,32313,28608,3705,11.5
36115,2020-07-01,28541,25514,3027,10.6
36117,2020-07-01,43757,38820,4937,11.3
36119,2020-07-01,501360,430316,71044,14.2
36121,2020-07-01,18537,16687,1850,10
36123,2020-07-01,11657,10552,1105,9.5
37001,2020-07-01,80809,73763,7046,8.7
37003,2020-07-01,17090,15654,1436,8.4
37005,2020-07-01,4503,4191,312,6.9
37007,2020-07-01,10676,9619,1057,9.9
37009,2020-07-01,13077,12184,893,6.8
37011,2020-07-01,8156,7618,538,6.6
37013,2020-07-01,19187,17719,1468,7.7
37015,2020-07-01,7692,7151,541,7
37017,2020-07-01,15390,14148,1242,8.1
37019,2020-07-01,53135,48128,5007,9.4
37021,2020-07-01,137070,123254,13816,10.1
37023,2020-07-01,38719,35533,3186,8.2
37025,2020-07-01,107118,97926,9192,8.6
37027,2020-07-01,34957,31598,3359,9.6
37029,2020-07-01,4553,4279,274,6
37031,2020-07-01,32639,30571,2068,6.3
37033,2020-07-01,9573,8744,829,8.7
37035,2020-07-01,75394,68445,6949,9.2
37037,2020-07-01,33873,31616,2257,6.7
37039,2020-07-01,11615,10591,1024,8.8
37041,2020-07-01,5644,5241,403,7.1
37043,2020-07-01,4289,3942,347,8.1
37045,2020-07-01,49341,44887,4454,9
37047,2020-07-01,23673,21487,2186,9.2
37049,2020-07-01,40852,37741,3111,7.6
37051,2020-07-01,123273,108767,14506,11.8
37053,2020-07-01,13933,13035,898,6.4
37055,2020-07-01,20811,19121,1690,8.1
37057,2020-07-01,77930,71351,6579,8.4
37059,2020-07-01,19852,18252,1600,8.1
37061,2020-07-01,25035,23425,1610,6.4
37063,2020-07-01,165776,151488,14288,8.6
37065,2020-07-01,21256,18438,2818,13.3
37067,2020-07-01,182419,165531,16888,9.3
37069,2020-07-01,30280,27792,2488,8.2
37071,2020-07-01,110011,99460,10551,9.6
37073,2020-07-01,5267,4911,356,6.8
37075,2020-07-01,3546,3220,326,9.2
37077,2020-07-01,29628,27518,2110,7.1
37079,2020-07-01,9234,8616,618,6.7
37081,2020-07-01,257811,230224,27587,10.7
37083,2020-07-01,20344,18120,2224,10.9
37085,2020-07-01,52548,47907,4641,8.8
37087,2020-07-01,28672,26162,2510,8.8
37089,2020-07-01,52273,48165,4108,7.9
37091,2020-07-01,9383,8607,776,8.3
37093,2020-07-01,19239,17170,2069,10.8
37095,2020-07-01,1868,1701,167,8.9
37097,2020-07-01,87892,80334,7558,8.6
37099,2020-07-01,20489,18793,1696,8.3
37101,2020-07-01,95776,88294,7482,7.8
37103,2020-07-01,4226,3947,279,6.6
37105,2020-07-01,25888,23440,2448,9.5
37107,2020-07-01,28703,26582,2121,7.4
37109,2020-07-01,42283,39077,3206,7.6
37111,2020-07-01,21200,19571,1629,7.7
37113,2020-07-01,16026,14847,1179,7.4
37115,2020-07-01,9624,8859,765,7.9
37117,2020-07-01,8751,8025,726,8.3
37119,2020-07-01,618591,558328,60263,9.7
37121,2020-07-01,6135,5609,526,8.6
37123,2020-07-01,11376,10360,1016,8.9
37125,2020-07-01,41935,38571,3364,8
37127,2020-07-01,42342,37979,4363,10.3
37129,2020-07-01,121037,110880,10157,8.4
37131,2020-07-01,7553,6909,644,8.5
37133,2020-07-01,62334,57079,5255,8.4
37135,2020-07-01,74956,69956,5000,6.7
37137,2020-07-01,5171,4828,343,6.6
37139,2020-07-01,16726,15357,1369,8.2
37141,2020-07-01,27763,25677,2086,7.5
37143,2020-07-01,4875,4514,361,7.4
37145,2020-07-01,17716,16168,1548,8.7
37147,2020-07-01,86078,78663,7415,8.6
37149,2020-07-01,9006,8389,617,6.9
37151,2020-07-01,63734,58257,5477,8.6
37153,2020-07-01,17265,15375,1890,10.9
37155,2020-07-01,51479,45727,5752,11.2
37157,2020-07-01,38923,35082,3841,9.9
37159,2020-07-01,65275,59201,6074,9.3
37161,2020-07-01,25605,22890,2715,10.6
37163,2020-07-01,29230,27185,2045,7
37165,2020-07-01,12280,10564,1716,14
37167,2020-07-01,30744,28550,2194,7.1
37169,2020-07-01,20759,19175,1584,7.6
37171,2020-07-01,33891,31345,2546,7.5
37173,2020-07-01,8012,7400,612,7.6
37175,2020-07-01,15112,14126,986,6.5
37177,2020-07-01,1490,1369,121,8.1
37179,2020-07-01,119886,111353,8533,7.1
37181,2020-07-01,18267,16138,2129,11.7
37183,2020-07-01,578632,532839,45793,7.9
37185,2020-07-01,6940,6145,795,11.5
37187,2020-07-01,4332,3936,396,9.1
37189,2020-07-01,30819,28823,1996,6.5
37191,2020-07-01,48200,44281,3919,8.1
37193,2020-07-01,29681,27488,2193,7.4
37195,2020-07-01,35198,31530,3668,10.4
37197,2020-07-01,17013,15649,1364,8
37199,2020-07-01,8115,7498,617,7.6
38001,2020-07-01,1023,976,47,4.6
38003,2020-07-01,5036,4738,298,5.9
38005,2020-07-01,2291,2124,167,7.3
38007,2020-07-01,355,337,18,5.1
38009,2020-07-01,2824,2639,185,6.6
38011,2020-07-01,1574,1516,58,3.7
38013,2020-07-01,1026,966,60,5.8
38015,2020-07-01,50737,48337,2400,4.7
38017,2020-07-01,107045,101512,5533,5.2
38019,2020-07-01,1804,1731,73,4
38021,2020-07-01,2222,2142,80,3.6
38023,2020-07-01,1359,1294,65,4.8
38025,2020-07-01,3333,3140,193,5.8
38027,2020-07-01,1160,1111,49,4.2
38029,2020-07-01,1360,1295,65,4.8
38031,2020-07-01,1430,1375,55,3.8
38033,2020-07-01,817,780,37,4.5
38035,2020-07-01,37764,35653,2111,5.6
38037,2020-07-01,1154,1121,33,2.9
38039,2020-07-01,990,956,34,3.4
38041,2020-07-01,1353,1285,68,5
38043,2020-07-01,1210,1148,62,5.1
38045,2020-07-01,1958,1900,58,3
38047,2020-07-01,843,818,25,3
38049,2020-07-01,2981,2817,164,5.5
38051,2020-07-01,1053,1020,33,3.1
38053,2020-07-01,10213,9189,1024,10
38055,2020-07-01,4537,4316,221,4.9
38057,2020-07-01,3429,3202,227,6.6
38059,2020-07-01,16676,15748,928,5.6
38061,2020-07-01,7426,6923,503,6.8
38063,2020-07-01,1319,1253,66,5
38065,2020-07-01,876,824,52,5.9
38067,2020-07-01,3194,3011,183,5.7
38069,2020-07-01,1601,1528,73,4.6
38071,2020-07-01,5391,5102,289,5.4
38073,2020-07-01,2746,2634,112,4.1
38075,2020-07-01,1195,1117,78,6.5
38077,2020-07-01,8305,7960,345,4.2
38079,2020-07-01,4913,3960,953,19.4
38081,2020-07-01,2652,2549,103,3.9
38083,2020-07-01,636,602,34,5.3
38085,2020-07-01,1249,1187,62,5
38087,2020-07-01,373,361,12,3.2
38089,2020-07-01,19148,17199,1949,10.2
38091,2020-07-01,962,921,41,4.3
38093,2020-07-01,10014,9613,401,4
38095,2020-07-01,1046,1010,36,3.4
38097,2020-07-01,4291,4094,197,4.6
38099,2020-07-01,4961,4665,296,6
38101,2020-07-01,31460,29093,2367,7.5
38103,2020-07-01,1830,1752,78,4.3
38105,2020-07-01,25226,21785,3441,13.6
39001,2020-07-01,10732,9743,989,9.2
39003,2020-07-01,47493,43339,4154,8.7
39005,2020-07-01,26190,24376,1814,6.9
39007,2020-07-01,43530,39586,3944,9.1
39009,2020-07-01,27136,24836,2300,8.5
39011,2020-07-01,24946,23117,1829,7.3
39013,2020-07-01,28258,25188,3070,10.9
39015,2020-07-01,19530,17870,1660,8.5
39017,2020-07-01,195441,179331,16110,8.2
39019,2020-07-01,12774,11550,1224,9.6
39021,2020-07-01,19617,18244,1373,7
39023,2020-07-01,63054,57691,5363,8.5
39025,2020-07-01,106536,98427,8109,7.6
39027,2020-07-01,17702,16141,1561,8.8
39029,2020-07-01,46720,41928,4792,10.3
39031,2020-07-01,14032,12706,1326,9.4
39033,2020-07-01,18146,16391,1755,9.7
39035,2020-07-01,611294,531199,80095,13.1
39037,2020-07-01,25447,23755,1692,6.6
39039,2020-07-01,17833,16485,1348,7.6
39041,2020-07-01,106915,100236,6679,6.2
39043,2020-07-01,36433,32863,3570,9.8
39045,2020-07-01,76055,70327,5728,7.5
39047,2020-07-01,13714,12610,1104,8.1
39049,2020-07-01,693274,630133,63141,9.1
39051,2020-07-01,21766,20193,1573,7.2
39053,2020-07-01,12478,11488,990,7.9
39055,2020-07-01,46920,43309,3611,7.7
39057,2020-07-01,82358,76406,5952,7.2
39059,2020-07-01,18490,16907,1583,8.6
39061,2020-07-01,421552,382974,38578,9.2
39063,2020-07-01,41811,38872,2939,7
39065,2020-07-01,13973,12840,1133,8.1
39067,2020-07-01,6668,5993,675,10.1
39069,2020-07-01,12667,11721,946,7.5
39071,2020-07-01,16861,15340,1521,9
39073,2020-07-01,12652,11719,933,7.4
39075,2020-07-01,20742,19878,864,4.2
39077,2020-07-01,27569,25207,2362,8.6
39079,2020-07-01,12807,11668,1139,8.9
39081,2020-07-01,27526,24516,3010,10.9
39083,2020-07-01,31065,29051,2014,6.5
39085,2020-07-01,122219,110053,12166,10
39087,2020-07-01,24027,21756,2271,9.5
39089,2020-07-01,88329,81763,6566,7.4
39091,2020-07-01,22282,20648,1634,7.3
39093,2020-07-01,150681,133029,17652,11.7
39095,2020-07-01,210809,187954,22855,10.8
39097,2020-07-01,20058,18790,1268,6.3
39099,2020-07-01,98509,87561,10948,11.1
39101,2020-07-01,27939,25739,2200,7.9
39103,2020-07-01,93591,85316,8275,8.8
39105,2020-07-01,8793,7878,915,10.4
39107,2020-07-01,23239,21905,1334,5.7
39109,2020-07-01,53585,49626,3959,7.4
39111,2020-07-01,5227,4609,618,11.8
39113,2020-07-01,255425,230687,24738,9.7
39115,2020-07-01,6560,5998,562,8.6
39117,2020-07-01,16288,15141,1147,7
39119,2020-07-01,39498,36459,3039,7.7
39121,2020-07-01,4662,4244,418,9
39123,2020-07-01,20295,18589,1706,8.4
39125,2020-07-01,8478,7867,611,7.2
39127,2020-07-01,15426,14117,1309,8.5
39129,2020-07-01,25670,23798,1872,7.3
39131,2020-07-01,10730,9737,993,9.3
39133,2020-07-01,83558,76780,6778,8.1
39135,2020-07-01,20772,19274,1498,7.2
39137,2020-07-01,18430,17467,963,5.2
39139,2020-07-01,52157,47278,4879,9.4
39141,2020-07-01,35109,32238,2871,8.2
39143,2020-07-01,30076,27794,2282,7.6
39145,2020-07-01,29091,26508,2583,8.9
39147,2020-07-01,27376,25143,2233,8.2
39149,2020-07-01,24035,22170,1865,7.8
39151,2020-07-01,182057,165970,16087,8.8
39153,2020-07-01,264247,239087,25160,9.5
39155,2020-07-01,82820,73483,9337,11.3
39157,2020-07-01,44941,41296,3645,8.1
39159,2020-07-01,27980,26330,1650,5.9
39161,2020-07-01,14949,13947,1002,6.7
39163,2020-07-01,5559,5047,512,9.2
39165,2020-07-01,118303,109973,8330,7
39167,2020-07-01,27773,25249,2524,9.1
39169,2020-07-01,61406,57501,3905,6.4
39171,2020-07-01,18930,17512,1418,7.5
39173,2020-07-01,69368,64272,5096,7.3
39175,2020-07-01,12941,12181,760,5.9
40001,2020-07-01,7897,7426,471,6
40003,2020-07-01,2676,2570,106,4
40005,2020-07-01,4933,4511,422,8.6
40007,2020-07-01,2738,2667,71,2.6
40009,2020-07-01,9615,8712,903,9.4
40011,2020-07-01,4600,4266,334,7.3
40013,2020-07-01,21257,20018,1239,5.8
40015,2020-07-01,11641,10863,778,6.7
40017,2020-07-01,73531,68311,5220,7.1
40019,2020-07-01,20945,19331,1614,7.7
40021,2020-07-01,18489,17351,1138,6.2
40023,2020-07-01,5398,4907,491,9.1
40025,2020-07-01,1321,1294,27,2
40027,2020-07-01,140382,131200,9182,6.5
40029,2020-07-01,2373,2204,169,7.1
40031,2020-07-01,47454,43998,3456,7.3
40033,2020-07-01,2737,2528,209,7.6
40035,2020-07-01,5693,5351,342,6
40037,2020-07-01,30809,28554,2255,7.3
40039,2020-07-01,15429,14475,954,6.2
40041,2020-07-01,17904,16896,1008,5.6
40043,2020-07-01,2892,2741,151,5.2
40045,2020-07-01,2051,1939,112,5.5
40047,2020-07-01,25667,23992,1675,6.5
40049,2020-07-01,12305,11398,907,7.4
40051,2020-07-01,26286,24399,1887,7.2
40053,2020-07-01,2557,2461,96,3.8
40055,2020-07-01,1850,1697,153,8.3
40057,2020-07-01,1176,1133,43,3.7
40059,2020-07-01,1723,1656,67,3.9
40061,2020-07-01,4199,3819,380,9
40063,2020-07-01,5341,4886,455,8.5
40065,2020-07-01,10494,10019,475,4.5
40067,2020-07-01,2502,2305,197,7.9
40069,2020-07-01,3261,2946,315,9.7
40071,2020-07-01,17748,16383,1365,7.7
40073,2020-07-01,8730,8292,438,5
40075,2020-07-01,3332,3138,194,5.8
40077,2020-07-01,3107,2750,357,11.5
40079,2020-07-01,18730,17220,1510,8.1
40081,2020-07-01,15434,14479,955,6.2
40083,2020-07-01,21579,20354,1225,5.7
40085,2020-07-01,5961,5687,274,4.6
40087,2020-07-01,19432,18188,1244,6.4
40089,2020-07-01,14740,13593,1147,7.8
40091,2020-07-01,7179,6534,645,9
40093,2020-07-01,3742,3534,208,5.6
40095,2020-07-01,6814,6377,437,6.4
40097,2020-07-01,19049,17913,1136,6
40099,2020-07-01,6288,5849,439,7
40101,2020-07-01,29238,27294,1944,6.6
40103,2020-07-01,5428,5178,250,4.6
40105,2020-07-01,4560,4277,283,6.2
40107,2020-07-01,4432,4115,317,7.2
40109,2020-07-01,380889,352503,28386,7.5
40111,2020-07-01,15244,14038,1206,7.9
40113,2020-07-01,20182,18695,1487,7.4
40115,2020-07-01,14158,13314,844,6
40117,2020-07-01,7192,6662,530,7.4
40119,2020-07-01,37485,35274,2211,5.9
40121,2020-07-01,16838,15399,1439,8.5
40123,2020-07-01,18789,17718,1071,5.7
40125,2020-07-01,31900,29700,2200,6.9
40127,2020-07-01,4242,3911,331,7.8
40129,2020-07-01,1794,1696,98,5.5
40131,2020-07-01,43864,40924,2940,6.7
40133,2020-07-01,9362,8611,751,8
40135,2020-07-01,15900,14722,1178,7.4
40137,2020-07-01,18555,16896,1659,8.9
40139,2020-07-01,11464,11204,260,2.3
40141,2020-07-01,2951,2793,158,5.4
40143,2020-07-01,318248,293318,24930,7.8
40145,2020-07-01,36940,34459,2481,6.7
40147,2020-07-01,21701,20194,1507,6.9
40149,2020-07-01,5060,4645,415,8.2
40151,2020-07-01,4532,4354,178,3.9
40153,2020-07-01,8786,8034,752,8.6
41001,2020-07-01,6965,6294,671,9.6
41003,2020-07-01,44767,40972,3795,8.5
41005,2020-07-01,215477,193398,22079,10.2
41007,2020-07-01,19601,17284,2317,11.8
41009,2020-07-01,23695,21195,2500,10.6
41011,2020-07-01,25600,22630,2970,11.6
41013,2020-07-01,9835,8714,1121,11.4
41015,2020-07-01,8535,7548,987,11.6
41017,2020-07-01,93969,83914,10055,10.7
41019,2020-07-01,45059,40552,4507,10
41021,2020-07-01,1031,948,83,8.1
41023,2020-07-01,3155,2877,278,8.8
41025,2020-07-01,3492,3253,239,6.8
41027,2020-07-01,15415,14175,1240,8
41029,2020-07-01,102504,91281,11223,10.9
41031,2020-07-01,9588,8568,1020,10.6
41033,2020-07-01,34384,30693,3691,10.7
41035,2020-07-01,28157,25155,3002,10.7
41037,2020-07-01,3678,3422,256,7
41039,2020-07-01,182271,162784,19487,10.7
41041,2020-07-01,20824,17750,3074,14.8
41043,2020-07-01,58100,52030,6070,10.4
41045,2020-07-01,12252,11344,908,7.4
41047,2020-07-01,158809,143767,15042,9.5
41049,2020-07-01,5725,5345,380,6.6
41051,2020-07-01,459058,400089,58969,12.8
41053,2020-07-01,38599,35044,3555,9.2
41055,2020-07-01,952,880,72,7.6
41057,2020-07-01,11823,10569,1254,10.6
41059,2020-07-01,37151,34203,2948,7.9
41061,2020-07-01,11632,10485,1147,9.9
41063,2020-07-01,3445,3192,253,7.3
41065,2020-07-01,17873,16638,1235,6.9
41067,2020-07-01,316917,286972,29945,9.4
41069,2020-07-01,645,613,32,5
41071,2020-07-01,53964,48911,5053,9.4
42001,2020-07-01,55391,50277,5114,9.2
42003,2020-07-01,645267,559512,85755,13.3
42005,2020-07-01,31815,27667,4148,13
42007,2020-07-01,84481,72215,12266,14.5
42009,2020-07-01,23417,20505,2912,12.4
42011,2020-07-01,226387,198722,27665,12.2
42013,2020-07-01,59292,52255,7037,11.9
42015,2020-07-01,28328,25419,2909,10.3
42017,2020-07-01,338851,298433,40418,11.9
42019,2020-07-01,96953,86504,10449,10.8
42021,2020-07-01,56378,49010,7368,13.1
42023,2020-07-01,2098,1756,342,16.3
42025,2020-07-01,31812,27710,4102,12.9
42027,2020-07-01,74620,68293,6327,8.5
42029,2020-07-01,277273,250947,26326,9.5
42031,2020-07-01,16445,14669,1776,10.8
42033,2020-07-01,35934,31688,4246,11.8
42035,2020-07-01,17707,15771,1936,10.9
42037,2020-07-01,33816,30301,3515,10.4
42039,2020-07-01,37155,32569,4586,12.3
42041,2020-07-01,132912,120547,12365,9.3
42043,2020-07-01,148687,130487,18200,12.2
42045,2020-07-01,301413,261487,39926,13.2
42047,2020-07-01,15749,13199,2550,16.2
42049,2020-07-01,126265,109216,17049,13.5
42051,2020-07-01,57359,48496,8863,15.5
42053,2020-07-01,1796,1551,245,13.6
42055,2020-07-01,77842,69341,8501,10.9
42057,2020-07-01,8485,7063,1422,16.8
42059,2020-07-01,16566,14307,2259,13.6
42061,2020-07-01,19891,16978,2913,14.6
42063,2020-07-01,38214,33325,4889,12.8
42065,2020-07-01,20216,17862,2354,11.6
42067,2020-07-01,12211,11171,1040,8.5
42069,2020-07-01,100954,87310,13644,13.5
42071,2020-07-01,295190,265092,30098,10.2
42073,2020-07-01,39697,34290,5407,13.6
42075,2020-07-01,72552,64606,7946,11
42077,2020-07-01,193216,167592,25624,13.3
42079,2020-07-01,152423,129823,22600,14.8
42081,2020-07-01,52644,46282,6362,12.1
42083,2020-07-01,17113,14917,2196,12.8
42085,2020-07-01,47345,41073,6272,13.2
42087,2020-07-01,20876,18585,2291,11
42089,2020-07-01,81323,68672,12651,15.6
42091,2020-07-01,444775,395327,49448,11.1
42093,2020-07-01,9058,8337,721,8
42095,2020-07-01,160611,140337,20274,12.6
42097,2020-07-01,41918,36839,5079,12.1
42099,2020-07-01,24541,22385,2156,8.8
42101,2020-07-01,748497,613202,135295,18.1
42103,2020-07-01,24908,21315,3593,14.4
42105,2020-07-01,7053,6225,828,11.7
42107,2020-07-01,66163,57902,8261,12.5
42109,2020-07-01,19250,17481,1769,9.2
42111,2020-07-01,32846,28904,3942,12
42113,2020-07-01,2553,2259,294,11.5
42115,2020-07-01,19519,17693,1826,9.4
42117,2020-07-01,18946,16597,2349,12.4
42119,2020-07-01,18923,17130,1793,9.5
42121,2020-07-01,21931,19281,2650,12.1
42123,2020-07-01,18574,16484,2090,11.3
42125,2020-07-01,105964,92191,13773,13
42127,2020-07-01,22126,19563,2563,11.6
42129,2020-07-01,178111,156000,22111,12.4
42131,2020-07-01,12831,11405,1426,11.1
42133,2020-07-01,235137,209476,25661,10.9
44001,2020-07-01,25840,23487,2353,9.1
44003,2020-07-01,91439,81761,9678,10.6
44005,2020-07-01,44113,39948,4165,9.4
44007,2020-07-01,334081,291358,42723,12.8
44009,2020-07-01,68943,62680,6263,9.1
45001,2020-07-01,10486,9580,906,8.6
45003,2020-07-01,76902,71669,5233,6.8
45005,2020-07-01,2821,2428,393,13.9
45007,2020-07-01,96435,88703,7732,8
45009,2020-07-01,5285,4620,665,12.6
45011,2020-07-01,8596,7591,1005,11.7
45013,2020-07-01,81873,76004,5869,7.2
45015,2020-07-01,108340,98976,9364,8.6
45017,2020-07-01,6876,6263,613,8.9
45019,2020-07-01,222996,201733,21263,9.5
45021,2020-07-01,27361,24226,3135,11.5
45023,2020-07-01,14253,12310,1943,13.6
45025,2020-07-01,23092,21106,1986,8.6
45027,2020-07-01,13384,12086,1298,9.7
45029,2020-07-01,17786,16165,1621,9.1
45031,2020-07-01,32896,29750,3146,9.6
45033,2020-07-01,13835,12651,1184,8.6
45035,2020-07-01,81584,74369,7215,8.8
45037,2020-07-01,11006,10238,768,7
45039,2020-07-01,10205,9053,1152,11.3
45041,2020-07-01,71623,65894,5729,8
45043,2020-07-01,27655,24811,2844,10.3
45045,2020-07-01,270025,248616,21409,7.9
45047,2020-07-01,33037,29948,3089,9.4
45049,2020-07-01,8789,8110,679,7.7
45051,2020-07-01,155342,138191,17151,11
45053,2020-07-01,13404,12372,1032,7.7
45055,2020-07-01,30313,27998,2315,7.6
45057,2020-07-01,42663,38188,4475,10.5
45059,2020-07-01,32286,29247,3039,9.4
45061,2020-07-01,7070,6284,786,11.1
45063,2020-07-01,154302,144595,9707,6.3
45065,2020-07-01,3508,3194,314,9
45067,2020-07-01,13904,12295,1609,11.6
45069,2020-07-01,10045,8641,1404,14
45071,2020-07-01,19598,18220,1378,7
45073,2020-07-01,36814,34045,2769,7.5
45075,2020-07-01,38149,33219,4930,12.9
45077,2020-07-01,60133,55823,4310,7.2
45079,2020-07-01,209184,190911,18273,8.7
45081,2020-07-01,9020,8473,547,6.1
45083,2020-07-01,159016,143676,15340,9.6
45085,2020-07-01,46091,41527,4564,9.9
45087,2020-07-01,12527,10831,1696,13.5
45089,2020-07-01,12951,11436,1515,11.7
45091,2020-07-01,144173,130649,13524,9.4
46003,2020-07-01,1520,1454,66,4.3
46005,2020-07-01,9842,9353,489,5
46007,2020-07-01,1104,1030,74,6.7
46009,2020-07-01,2907,2768,139,4.8
46011,2020-07-01,18997,17823,1174,6.2
46013,2020-07-01,20997,19780,1217,5.8
46015,2020-07-01,2487,2358,129,5.2
46017,2020-07-01,729,628,101,13.9
46019,2020-07-01,5269,4869,400,7.6
46021,2020-07-01,765,736,29,3.8
46023,2020-07-01,4023,3611,412,10.2
46025,2020-07-01,1926,1814,112,5.8
46027,2020-07-01,7050,6590,460,6.5
46029,2020-07-01,15897,14862,1035,6.5
46031,2020-07-01,1315,1209,106,8.1
46033,2020-07-01,4055,3756,299,7.4
46035,2020-07-01,11433,10789,644,5.6
46037,2020-07-01,2852,2671,181,6.3
46039,2020-07-01,2277,2151,126,5.5
46041,2020-07-01,2272,1906,366,16.1
46043,2020-07-01,1579,1533,46,2.9
46045,2020-07-01,1977,1923,54,2.7
46047,2020-07-01,3192,2953,239,7.5
46049,2020-07-01,1033,993,40,3.9
46051,2020-07-01,4400,4218,182,4.1
46053,2020-07-01,2024,1927,97,4.8
46055,2020-07-01,1010,995,15,1.5
46057,2020-07-01,3338,3205,133,4
46059,2020-07-01,1704,1650,54,3.2
46061,2020-07-01,1766,1646,120,6.8
46063,2020-07-01,714,677,37,5.2
46065,2020-07-01,10173,9773,400,3.9
46067,2020-07-01,3650,3495,155,4.2
46069,2020-07-01,651,628,23,3.5
46071,2020-07-01,1284,1236,48,3.7
46073,2020-07-01,1103,1072,31,2.8
46075,2020-07-01,578,560,18,3.1
46077,2020-07-01,2686,2551,135,5
46079,2020-07-01,6584,6268,316,4.8
46081,2020-07-01,14082,13017,1065,7.6
46083,2020-07-01,35378,33713,1665,4.7
46085,2020-07-01,1793,1649,144,8
46087,2020-07-01,3103,2960,143,4.6
46089,2020-07-01,969,915,54,5.6
46091,2020-07-01,2486,2282,204,8.2
46093,2020-07-01,14363,13482,881,6.1
46095,2020-07-01,728,656,72,9.9
46097,2020-07-01,1212,1114,98,8.1
46099,2020-07-01,116780,109940,6840,5.9
46101,2020-07-01,4085,3801,284,7
46102,2020-07-01,3819,3151,668,17.5
46103,2020-07-01,58319,54280,4039,6.9
46105,2020-07-01,1401,1329,72,5.1
46107,2020-07-01,1069,1029,40,3.7
46109,2020-07-01,4811,4442,369,7.7
46111,2020-07-01,1144,1089,55,4.8
46115,2020-07-01,3188,3041,147,4.6
46117,2020-07-01,1851,1777,74,4
46119,2020-07-01,792,755,37,4.7
46121,2020-07-01,3167,2864,303,9.6
46123,2020-07-01,3083,2965,118,3.8
46125,2020-07-01,4753,4517,236,5
46127,2020-07-01,8692,8157,535,6.2
46129,2020-07-01,2196,2029,167,7.6
46135,2020-07-01,12477,11685,792,6.3
46137,2020-07-01,896,815,81,9
47001,2020-07-01,33152,30400,2752,8.3
47003,2020-07-01,20052,18176,1876,9.4
47005,2020-07-01,6419,5841,578,9
47007,2020-07-01,4080,3701,379,9.3
47009,2020-07-01,60933,55968,4965,8.1
47011,2020-07-01,50886,46413,4473,8.8
47013,2020-07-01,14106,12893,1213,8.6
47015,2020-07-01,6091,5643,448,7.4
47017,2020-07-01,11202,10205,997,8.9
47019,2020-07-01,22436,20403,2033,9.1
47021,2020-07-01,20531,18930,1601,7.8
47023,2020-07-01,7950,7376,574,7.2
47025,2020-07-01,12165,11200,965,7.9
47027,2020-07-01,2452,2228,224,9.1
47029,2020-07-01,14481,12832,1649,11.4
47031,2020-07-01,24415,22252,2163,8.9
47033,2020-07-01,6478,6029,449,6.9
47035,2020-07-01,22172,20246,1926,8.7
47037,2020-07-01,397508,348437,49071,12.3
47039,2020-07-01,4346,3904,442,10.2
47041,2020-07-01,7170,6422,748,10.4
47043,2020-07-01,25057,23171,1886,7.5
47045,2020-07-01,15832,14307,1525,9.6
47047,2020-07-01,17971,16355,1616,9
47049,2020-07-01,7024,6482,542,7.7
47051,2020-07-01,18955,17410,1545,8.2
47053,2020-07-01,20890,19057,1833,8.8
47055,2020-07-01,13902,12535,1367,9.8
47057,2020-07-01,9147,8321,826,9
47059,2020-07-01,27889,25046,2843,10.2
47061,2020-07-01,4646,4147,499,10.7
47063,2020-07-01,27193,24764,2429,8.9
47065,2020-07-01,182195,165482,16713,9.2
47067,2020-07-01,2010,1756,254,12.6
47069,2020-07-01,9161,8160,1001,10.9
47071,2020-07-01,9957,9073,884,8.9
47073,2020-07-01,22272,20043,2229,10
47075,2020-07-01,7429,6460,969,13
47077,2020-07-01,11653,10519,1134,9.7
47079,2020-07-01,13344,12248,1096,8.2
47081,2020-07-01,10584,9837,747,7.1
47083,2020-07-01,2997,2708,289,9.6
47085,2020-07-01,8217,7596,621,7.6
47087,2020-07-01,4419,3990,429,9.7
47089,2020-07-01,23820,21675,2145,9
47091,2020-07-01,7152,6653,499,7
47093,2020-07-01,233776,215508,18268,7.8
47095,2020-07-01,1641,1472,169,10.3
47097,2020-07-01,9344,8223,1121,12
47099,2020-07-01,18162,16431,1731,9.5
47101,2020-07-01,4811,4388,423,8.8
47103,2020-07-01,14790,13389,1401,9.5
47105,2020-07-01,22340,20595,1745,7.8
47107,2020-07-01,22797,20645,2152,9.4
47109,2020-07-01,8084,7140,944,11.7
47111,2020-07-01,10529,9639,890,8.5
47113,2020-07-01,47201,42300,4901,10.4
47115,2020-07-01,12251,11130,1121,9.2
47117,2020-07-01,14807,13314,1493,10.1
47119,2020-07-01,47106,42332,4774,10.1
47121,2020-07-01,4987,4464,523,10.5
47123,2020-07-01,19367,17635,1732,8.9
47125,2020-07-01,81067,72882,8185,10.1
47127,2020-07-01,3326,3112,214,6.4
47129,2020-07-01,7426,6855,571,7.7
47131,2020-07-01,11890,10885,1005,8.5
47133,2020-07-01,9423,8788,635,6.7
47135,2020-07-01,2840,2545,295,10.4
47137,2020-07-01,2162,2026,136,6.3
47139,2020-07-01,7250,6664,586,8.1
47141,2020-07-01,33483,30763,2720,8.1
47143,2020-07-01,12718,11345,1373,10.8
47145,2020-07-01,22098,20398,1700,7.7
47147,2020-07-01,35530,32574,2956,8.3
47149,2020-07-01,174541,158327,16214,9.3
47151,2020-07-01,7911,7126,785,9.9
47153,2020-07-01,6090,5534,556,9.1
47155,2020-07-01,53210,47576,5634,10.6
47157,2020-07-01,444166,378587,65579,14.8
47159,2020-07-01,8747,8113,634,7.2
47161,2020-07-01,5126,4717,409,8
47163,2020-07-01,65918,59661,6257,9.5
47165,2020-07-01,96942,88200,8742,9
47167,2020-07-01,26385,23955,2430,9.2
47169,2020-07-01,5061,4648,413,8.2
47171,2020-07-01,6593,5944,649,9.8
47173,2020-07-01,7341,6685,656,8.9
47175,2020-07-01,1938,1750,188,9.7
47177,2020-07-01,15705,14125,1580,10.1
47179,2020-07-01,56063,51421,4642,8.3
47181,2020-07-01,5812,5290,522,9
47183,2020-07-01,14167,13031,1136,8
47185,2020-07-01,11509,10544,965,8.4
47187,2020-07-01,118793,111059,7734,6.5
47189,2020-07-01,72462,65877,6585,9.1
48001,2020-07-01,23023,21616,1407,6.1
48003,2020-07-01,9836,8946,890,9
48005,2020-07-01,34891,32004,2887,8.3
48007,2020-07-01,9100,8291,809,8.9
48009,2020-07-01,3935,3715,220,5.6
48011,2020-07-01,872,836,36,4.1
48013,2020-07-01,21735,19684,2051,9.4
48015,2020-07-01,13633,12680,953,7
48017,2020-07-01,2275,2155,120,5.3
48019,2020-07-01,9756,9169,587,6
48021,2020-07-01,42153,39438,2715,6.4
48023,2020-07-01,1729,1665,64,3.7
48025,2020-07-01,9848,8747,1101,11.2
48027,2020-07-01,141753,131331,10422,7.4
48029,2020-07-01,943487,864780,78707,8.3
48031,2020-07-01,6285,6033,252,4
48033,2020-07-01,395,381,14,3.5
48035,2020-07-01,8038,7568,470,5.8
48037,2020-07-01,39260,36389,2871,7.3
48039,2020-07-01,176145,160046,16099,9.1
48041,2020-07-01,117007,110282,6725,5.7
48043,2020-07-01,4121,3817,304,7.4
48045,2020-07-01,540,516,24,4.4
48047,2020-07-01,2629,2317,312,11.9
48049,2020-07-01,14853,13834,1019,6.9
48051,2020-07-01,8246,7714,532,6.5
48053,2020-07-01,22615,21492,1123,5
48055,2020-07-01,19344,18019,1325,6.8
48057,2020-07-01,11829,11087,742,6.3
48059,2020-07-01,5955,5618,337,5.7
48061,2020-07-01,164826,146494,18332,11.1
48063,2020-07-01,4858,4461,397,8.2
48065,2020-07-01,2835,2713,122,4.3
48067,2020-07-01,12142,11164,978,8.1
48069,2020-07-01,3212,3092,120,3.7
48071,2020-07-01,19320,17313,2007,10.4
48073,2020-07-01,20403,18680,1723,8.4
48075,2020-07-01,2743,2636,107,3.9
48077,2020-07-01,4687,4413,274,5.8
48079,2020-07-01,1072,985,87,8.1
48081,2020-07-01,1395,1311,84,6
48083,2020-07-01,2782,2556,226,8.1
48085,2020-07-01,558352,520953,37399,6.7
48087,2020-07-01,1040,997,43,4.1
48089,2020-07-01,9393,8813,580,6.2
48091,2020-07-01,71745,66944,4801,6.7
48093,2020-07-01,5396,5079,317,5.9
48095,2020-07-01,1274,1209,65,5.1
48097,2020-07-01,19666,18266,1400,7.1
48099,2020-07-01,23625,21994,1631,6.9
48101,2020-07-01,496,469,27,5.4
48103,2020-07-01,1592,1332,260,16.3
48105,2020-07-01,1602,1450,152,9.5
48107,2020-07-01,2376,2251,125,5.3
48109,2020-07-01,991,895,96,9.7
48111,2020-07-01,3563,3462,101,2.8
48113,2020-07-01,NA,NA,112240,8.2
48115,2020-07-01,4637,4204,433,9.3
48117,2020-07-01,7989,7683,306,3.8
48119,2020-07-01,2328,2192,136,5.8
48121,2020-07-01,491938,457691,34247,7
48123,2020-07-01,9595,8944,651,6.8
48125,2020-07-01,637,593,44,6.9
48127,2020-07-01,7027,6558,469,6.7
48129,2020-07-01,1282,1212,70,5.5
48131,2020-07-01,4972,4294,678,13.6
48133,2020-07-01,7423,6912,511,6.9
48135,2020-07-01,85618,74781,10837,12.7
48137,2020-07-01,1066,1021,45,4.2
48139,2020-07-01,91466,85652,5814,6.4
48141,2020-07-01,355906,324578,31328,8.8
48143,2020-07-01,20021,18799,1222,6.1
48145,2020-07-01,6547,6140,407,6.2
48147,2020-07-01,17058,16241,817,4.8
48149,2020-07-01,11437,10873,564,4.9
48151,2020-07-01,1527,1446,81,5.3
48153,2020-07-01,2414,2262,152,6.3
48155,2020-07-01,551,532,19,3.4
48157,2020-07-01,385393,352476,32917,8.5
48159,2020-07-01,4445,4189,256,5.8
48161,2020-07-01,6156,5580,576,9.4
48163,2020-07-01,9982,9372,610,6.1
48165,2020-07-01,9448,8866,582,6.2
48167,2020-07-01,163021,147826,15195,9.3
48169,2020-07-01,2104,1944,160,7.6
48171,2020-07-01,12896,12277,619,4.8
48173,2020-07-01,735,707,28,3.8
48175,2020-07-01,3193,2916,277,8.7
48177,2020-07-01,9216,8661,555,6
48179,2020-07-01,7925,7227,698,8.8
48181,2020-07-01,63938,60152,3786,5.9
48183,2020-07-01,56102,51085,5017,8.9
48185,2020-07-01,10986,10054,932,8.5
48187,2020-07-01,79527,74338,5189,6.5
48189,2020-07-01,11502,10619,883,7.7
48191,2020-07-01,991,930,61,6.2
48193,2020-07-01,3471,3301,170,4.9
48195,2020-07-01,2498,2406,92,3.7
48197,2020-07-01,1646,1576,70,4.3
48199,2020-07-01,24138,21767,2371,9.8
48201,2020-07-01,NA,NA,227324,9.9
48203,2020-07-01,28165,25741,2424,8.6
48205,2020-07-01,2564,2506,58,2.3
48207,2020-07-01,2145,2023,122,5.7
48209,2020-07-01,118851,110500,8351,7
48211,2020-07-01,1716,1636,80,4.7
48213,2020-07-01,35813,33322,2491,7
48215,2020-07-01,352024,307733,44291,12.6
48217,2020-07-01,16038,14957,1081,6.7
48219,2020-07-01,10958,9998,960,8.8
48221,2020-07-01,27073,25117,1956,7.2
48223,2020-07-01,16752,15846,906,5.4
48225,2020-07-01,9717,9182,535,5.5
48227,2020-07-01,14061,12797,1264,9
48229,2020-07-01,1794,1627,167,9.3
48231,2020-07-01,42883,39926,2957,6.9
48233,2020-07-01,8214,7602,612,7.5
48235,2020-07-01,729,678,51,7
48237,2020-07-01,3241,2987,254,7.8
48239,2020-07-01,7313,6830,483,6.6
48241,2020-07-01,12494,11012,1482,11.9
48243,2020-07-01,938,890,48,5.1
48245,2020-07-01,104175,90810,13365,12.8
48247,2020-07-01,1785,1580,205,11.5
48249,2020-07-01,17145,14739,2406,14
48251,2020-07-01,80620,74970,5650,7
48253,2020-07-01,5633,5201,432,7.7
48255,2020-07-01,7146,6629,517,7.2
48257,2020-07-01,64170,59578,4592,7.2
48259,2020-07-01,21393,20266,1127,5.3
48261,2020-07-01,183,172,11,6
48263,2020-07-01,449,432,17,3.8
48265,2020-07-01,21509,20222,1287,6
48267,2020-07-01,1741,1642,99,5.7
48269,2020-07-01,218,215,3,1.4
48271,2020-07-01,1305,1232,73,5.6
48273,2020-07-01,13233,11964,1269,9.6
48275,2020-07-01,1353,1275,78,5.8
48277,2020-07-01,23719,22011,1708,7.2
48279,2020-07-01,5021,4759,262,5.2
48281,2020-07-01,8940,8456,484,5.4
48283,2020-07-01,4142,3850,292,7
48285,2020-07-01,7978,7505,473,5.9
48287,2020-07-01,9610,9128,482,5
48289,2020-07-01,6100,5627,473,7.8
48291,2020-07-01,33047,29265,3782,11.4
48293,2020-07-01,8421,7781,640,7.6
48295,2020-07-01,1500,1433,67,4.5
48297,2020-07-01,5466,5040,426,7.8
48299,2020-07-01,8379,7896,483,5.8
48301,2020-07-01,675,671,4,0.6
48303,2020-07-01,154149,144206,9943,6.5
48305,2020-07-01,2685,2525,160,6
48307,2020-07-01,3186,2922,264,8.3
48309,2020-07-01,119834,111920,7914,6.6
48311,2020-07-01,835,811,24,2.9
48313,2020-07-01,4362,4022,340,7.8
48315,2020-07-01,4074,3704,370,9.1
48317,2020-07-01,2622,2440,182,6.9
48319,2020-07-01,1683,1589,94,5.6
48321,2020-07-01,16676,14784,1892,11.3
48323,2020-07-01,24025,20253,3772,15.7
48325,2020-07-01,21282,19878,1404,6.6
48327,2020-07-01,827,776,51,6.2
48329,2020-07-01,100118,90583,9535,9.5
48331,2020-07-01,9347,8628,719,7.7
48333,2020-07-01,1780,1705,75,4.2
48335,2020-07-01,2306,2085,221,9.6
48337,2020-07-01,9052,8411,641,7.1
48339,2020-07-01,278282,255588,22694,8.2
48341,2020-07-01,10215,9797,418,4.1
48343,2020-07-01,4823,4220,603,12.5
48345,2020-07-01,440,421,19,4.3
48347,2020-07-01,26817,24854,1963,7.3
48349,2020-07-01,23273,21797,1476,6.3
48351,2020-07-01,4961,4378,583,11.8
48353,2020-07-01,6977,6574,403,5.8
48355,2020-07-01,163466,147158,16308,10
48357,2020-07-01,3987,3731,256,6.4
48359,2020-07-01,851,822,29,3.4
48361,2020-07-01,35091,31123,3968,11.3
48363,2020-07-01,13284,12271,1013,7.6
48365,2020-07-01,9738,8904,834,8.6
48367,2020-07-01,65830,61637,4193,6.4
48369,2020-07-01,4491,4369,122,2.7
48371,2020-07-01,6172,5565,607,9.8
48373,2020-07-01,17725,16068,1657,9.3
48375,2020-07-01,52686,49602,3084,5.9
48377,2020-07-01,3169,2668,501,15.8
48379,2020-07-01,5901,5615,286,4.8
48381,2020-07-01,68128,64909,3219,4.7
48383,2020-07-01,1920,1719,201,10.5
48385,2020-07-01,959,876,83,8.7
48387,2020-07-01,4856,4526,330,6.8
48389,2020-07-01,12005,11288,717,6
48391,2020-07-01,3078,2794,284,9.2
48393,2020-07-01,393,374,19,4.8
48395,2020-07-01,7515,7025,490,6.5
48397,2020-07-01,51434,48142,3292,6.4
48399,2020-07-01,4367,4137,230,5.3
48401,2020-07-01,21935,20261,1674,7.6
48403,2020-07-01,3592,3155,437,12.2
48405,2020-07-01,3393,3105,288,8.5
48407,2020-07-01,11441,10434,1007,8.8
48409,2020-07-01,29061,25902,3159,10.9
48411,2020-07-01,2394,2282,112,4.7
48413,2020-07-01,1209,1119,90,7.4
48415,2020-07-01,6445,5869,576,8.9
48417,2020-07-01,1791,1685,106,5.9
48419,2020-07-01,10758,9921,837,7.8
48421,2020-07-01,1289,1250,39,3
48423,2020-07-01,105836,98181,7655,7.2
48425,2020-07-01,4260,3969,291,6.8
48427,2020-07-01,25287,20826,4461,17.6
48429,2020-07-01,3877,3597,280,7.2
48431,2020-07-01,556,515,41,7.4
48433,2020-07-01,538,507,31,5.8
48435,2020-07-01,1278,1155,123,9.6
48437,2020-07-01,2456,2326,130,5.3
48439,2020-07-01,NA,986934,84832,7.9
48441,2020-07-01,65460,61590,3870,5.9
48443,2020-07-01,352,331,21,6
48445,2020-07-01,4730,4351,379,8
48447,2020-07-01,599,563,36,6
48449,2020-07-01,12650,11697,953,7.5
48451,2020-07-01,51509,47712,3797,7.4
48453,2020-07-01,735599,684560,51039,6.9
48455,2020-07-01,5131,4691,440,8.6
48457,2020-07-01,6957,6209,748,10.8
48459,2020-07-01,17121,15709,1412,8.2
48461,2020-07-01,1623,1509,114,7
48463,2020-07-01,10858,10099,759,7
48465,2020-07-01,21762,19922,1840,8.5
48467,2020-07-01,25371,23708,1663,6.6
48469,2020-07-01,42089,38111,3978,9.5
48471,2020-07-01,23375,21567,1808,7.7
48473,2020-07-01,23018,21036,1982,8.6
48475,2020-07-01,7808,7122,686,8.8
48477,2020-07-01,14749,13857,892,6
48479,2020-07-01,115746,105095,10651,9.2
48481,2020-07-01,21054,19480,1574,7.5
48483,2020-07-01,2148,2020,128,6
48485,2020-07-01,54334,50326,4008,7.4
48487,2020-07-01,4757,4478,279,5.9
48489,2020-07-01,6581,5776,805,12.2
48491,2020-07-01,308547,289180,19367,6.3
48493,2020-07-01,24240,22732,1508,6.2
48495,2020-07-01,3923,3476,447,11.4
48497,2020-07-01,31293,29099,2194,7
48499,2020-07-01,17175,15970,1205,7
48501,2020-07-01,3874,3360,514,13.3
48503,2020-07-01,7682,7251,431,5.6
48505,2020-07-01,4811,4182,629,13.1
48507,2020-07-01,3214,2694,520,16.2
49001,2020-07-01,2739,2636,103,3.8
49003,2020-07-01,26476,25595,881,3.3
49005,2020-07-01,62616,60923,1693,2.7
49007,2020-07-01,8653,8226,427,4.9
49009,2020-07-01,418,406,12,2.9
49011,2020-07-01,180216,173245,6971,3.9
49013,2020-07-01,8048,7380,668,8.3
49015,2020-07-01,4316,4153,163,3.8
49017,2020-07-01,3062,2903,159,5.2
49019,2020-07-01,6736,6285,451,6.7
49021,2020-07-01,23778,22772,1006,4.2
49023,2020-07-01,5705,5563,142,2.5
49025,2020-07-01,4079,3916,163,4
49027,2020-07-01,6016,5844,172,2.9
49029,2020-07-01,5674,5534,140,2.5
49031,2020-07-01,477,454,23,4.8
49033,2020-07-01,1499,1474,25,1.7
49035,2020-07-01,643576,609309,34267,5.3
49037,2020-07-01,5982,5428,554,9.3
49039,2020-07-01,12195,11777,418,3.4
49041,2020-07-01,9862,9488,374,3.8
49043,2020-07-01,24866,23100,1766,7.1
49045,2020-07-01,34041,32481,1560,4.6
49047,2020-07-01,14275,13007,1268,8.9
49049,2020-07-01,311177,299896,11281,3.6
49051,2020-07-01,16679,15704,975,5.8
49053,2020-07-01,78122,74077,4045,5.2
49055,2020-07-01,1482,1410,72,4.9
49057,2020-07-01,132017,126320,5697,4.3
50001,2020-07-01,21088,19731,1357,6.4
50003,2020-07-01,18227,16517,1710,9.4
50005,2020-07-01,14980,13767,1213,8.1
50007,2020-07-01,95310,88042,7268,7.6
50009,2020-07-01,2726,2490,236,8.7
50011,2020-07-01,26834,24701,2133,7.9
50013,2020-07-01,3994,3647,347,8.7
50015,2020-07-01,14062,12625,1437,10.2
50017,2020-07-01,16185,15161,1024,6.3
50019,2020-07-01,13131,11793,1338,10.2
50021,2020-07-01,31316,28263,3053,9.7
50023,2020-07-01,34414,31928,2486,7.2
50025,2020-07-01,22548,20331,2217,9.8
50027,2020-07-01,28950,26576,2374,8.2
51001,2020-07-01,16838,15641,1197,7.1
51003,2020-07-01,56957,52976,3981,7
51005,2020-07-01,6608,6060,548,8.3
51007,2020-07-01,6215,5766,449,7.2
51009,2020-07-01,14775,13765,1010,6.8
51011,2020-07-01,7035,6545,490,7
51013,2020-07-01,151579,143024,8555,5.6
51015,2020-07-01,38812,36772,2040,5.3
51017,2020-07-01,2667,2405,262,9.8
51019,2020-07-01,37594,35364,2230,5.9
51021,2020-07-01,2745,2565,180,6.6
51023,2020-07-01,16828,15929,899,5.3
51025,2020-07-01,5925,5315,610,10.3
51027,2020-07-01,6559,5818,741,11.3
51029,2020-07-01,6437,5851,586,9.1
51031,2020-07-01,25694,23812,1882,7.3
51033,2020-07-01,15217,13960,1257,8.3
51035,2020-07-01,13185,11999,1186,9
51036,2020-07-01,3644,3350,294,8.1
51037,2020-07-01,5199,4849,350,6.7
51041,2020-07-01,186213,172286,13927,7.5
51043,2020-07-01,7453,7036,417,5.6
51045,2020-07-01,2225,2096,129,5.8
51047,2020-07-01,24189,22734,1455,6
51049,2020-07-01,4614,4238,376,8.1
51051,2020-07-01,4652,4213,439,9.4
51053,2020-07-01,13613,12529,1084,8
51057,2020-07-01,5472,5015,457,8.4
51059,2020-07-01,634188,586873,47315,7.5
51061,2020-07-01,36513,34444,2069,5.7
51063,2020-07-01,7717,7255,462,6
51065,2020-07-01,13796,12888,908,6.6
51067,2020-07-01,25825,24105,1720,6.7
51069,2020-07-01,46323,43666,2657,5.7
51071,2020-07-01,7412,6876,536,7.2
51073,2020-07-01,19573,18269,1304,6.7
51075,2020-07-01,10991,10341,650,5.9
51077,2020-07-01,7938,7434,504,6.3
51079,2020-07-01,10423,9734,689,6.6
51081,2020-07-01,4307,3940,367,8.5
51083,2020-07-01,15102,13862,1240,8.2
51085,2020-07-01,58082,54639,3443,5.9
51087,2020-07-01,182733,167102,15631,8.6
51089,2020-07-01,24052,21756,2296,9.5
51091,2020-07-01,1214,1163,51,4.2
51093,2020-07-01,19313,18107,1206,6.2
51095,2020-07-01,37348,34102,3246,8.7
51097,2020-07-01,3846,3602,244,6.3
51099,2020-07-01,13173,12420,753,5.7
51101,2020-07-01,9042,8445,597,6.6
51103,2020-07-01,5580,5158,422,7.6
51105,2020-07-01,7959,7361,598,7.5
51107,2020-07-01,220621,205382,15239,6.9
51109,2020-07-01,19897,18609,1288,6.5
51111,2020-07-01,5113,4783,330,6.5
51113,2020-07-01,7270,6946,324,4.5
51115,2020-07-01,4076,3851,225,5.5
51117,2020-07-01,12203,11197,1006,8.2
51119,2020-07-01,5350,5040,310,5.8
51121,2020-07-01,46468,43648,2820,6.1
51125,2020-07-01,7427,6918,509,6.9
51127,2020-07-01,12230,11525,705,5.8
51131,2020-07-01,5571,5058,513,9.2
51133,2020-07-01,5723,5327,396,6.9
51135,2020-07-01,7035,6573,462,6.6
51137,2020-07-01,17437,16293,1144,6.6
51139,2020-07-01,12045,11139,906,7.5
51141,2020-07-01,7116,6609,507,7.1
51143,2020-07-01,28680,26454,2226,7.8
51145,2020-07-01,13854,13045,809,5.8
51147,2020-07-01,10330,9481,849,8.2
51149,2020-07-01,15005,13770,1235,8.2
51153,2020-07-01,247120,226053,21067,8.5
51155,2020-07-01,15303,13932,1371,9
51157,2020-07-01,3631,3437,194,5.3
51159,2020-07-01,4022,3781,241,6
51161,2020-07-01,48141,45133,3008,6.2
51163,2020-07-01,10802,10109,693,6.4
51165,2020-07-01,40083,37778,2305,5.8
51167,2020-07-01,10909,10033,876,8
51169,2020-07-01,8783,8249,534,6.1
51171,2020-07-01,22357,20967,1390,6.2
51173,2020-07-01,13478,12407,1071,7.9
51175,2020-07-01,8949,8391,558,6.2
51177,2020-07-01,66614,61524,5090,7.6
51179,2020-07-01,71299,66117,5182,7.3
51181,2020-07-01,3601,3342,259,7.2
51183,2020-07-01,3881,3460,421,10.8
51185,2020-07-01,15097,13639,1458,9.7
51187,2020-07-01,20206,18796,1410,7
51191,2020-07-01,25919,24105,1814,7
51193,2020-07-01,9521,8878,643,6.8
51195,2020-07-01,12666,11471,1195,9.4
51197,2020-07-01,13498,12330,1168,8.7
51199,2020-07-01,32770,30495,2275,6.9
51510,2020-07-01,101506,93705,7801,7.7
51520,2020-07-01,7162,6470,692,9.7
51530,2020-07-01,3527,3296,231,6.5
51540,2020-07-01,26759,24428,2331,8.7
51550,2020-07-01,123874,113898,9976,8.1
51570,2020-07-01,8857,8054,803,9.1
51580,2020-07-01,2390,2094,296,12.4
51590,2020-07-01,18975,16710,2265,11.9
51595,2020-07-01,2452,2085,367,15
51600,2020-07-01,13431,12448,983,7.3
51610,2020-07-01,8343,7964,379,4.5
51620,2020-07-01,3735,3291,444,11.9
51630,2020-07-01,14239,12908,1331,9.3
51640,2020-07-01,2917,2654,263,9
51650,2020-07-01,66681,59196,7485,11.2
51660,2020-07-01,24211,22233,1978,8.2
51670,2020-07-01,10244,8742,1502,14.7
51678,2020-07-01,2053,1874,179,8.7
51680,2020-07-01,36435,33054,3381,9.3
51683,2020-07-01,22192,20315,1877,8.5
51685,2020-07-01,9510,8653,857,9
51690,2020-07-01,5877,5016,861,14.7
51700,2020-07-01,92691,81919,10772,11.6
51710,2020-07-01,116654,102966,13688,11.7
51720,2020-07-01,1646,1485,161,9.8
51730,2020-07-01,14327,11612,2715,19
51735,2020-07-01,6289,5969,320,5.1
51740,2020-07-01,46669,40663,6006,12.9
51750,2020-07-01,8137,7449,688,8.5
51760,2020-07-01,123037,108145,14892,12.1
51770,2020-07-01,49835,44711,5124,10.3
51775,2020-07-01,12735,11819,916,7.2
51790,2020-07-01,12965,11971,994,7.7
51800,2020-07-01,45262,41356,3906,8.6
51810,2020-07-01,235021,216853,18168,7.7
51820,2020-07-01,11370,10438,932,8.2
51830,2020-07-01,6831,6152,679,9.9
51840,2020-07-01,14472,13390,1082,7.5
53001,2020-07-01,10004,9119,885,8.8
53003,2020-07-01,10286,9532,754,7.3
53005,2020-07-01,110303,98740,11563,10.5
53007,2020-07-01,44953,40479,4474,10
53009,2020-07-01,30867,27185,3682,11.9
53011,2020-07-01,248712,219708,29004,11.7
53013,2020-07-01,1739,1585,154,8.9
53015,2020-07-01,50526,44767,5759,11.4
53017,2020-07-01,22093,19930,2163,9.8
53019,2020-07-01,2671,2337,334,12.5
53021,2020-07-01,46037,40816,5221,11.3
53023,2020-07-01,857,761,96,11.2
53025,2020-07-01,48686,43245,5441,11.2
53027,2020-07-01,31256,27000,4256,13.6
53029,2020-07-01,36694,32910,3784,10.3
53031,2020-07-01,14619,13030,1589,10.9
53033,2020-07-01,NA,NA,106490,8.3
53035,2020-07-01,134663,122046,12617,9.4
53037,2020-07-01,21306,18807,2499,11.7
53039,2020-07-01,10324,9251,1073,10.4
53041,2020-07-01,35896,31840,4056,11.3
53043,2020-07-01,4757,4367,390,8.2
53045,2020-07-01,26212,23070,3142,12
53047,2020-07-01,18178,16080,2098,11.5
53049,2020-07-01,8685,7571,1114,12.8
53051,2020-07-01,5117,4386,731,14.3
53053,2020-07-01,468649,411836,56813,12.1
53055,2020-07-01,7827,7060,767,9.8
53057,2020-07-01,65589,57708,7881,12
53059,2020-07-01,5651,4971,680,12
53061,2020-07-01,438922,400521,38401,8.7
53063,2020-07-01,260314,230962,29352,11.3
53065,2020-07-01,18691,16607,2084,11.1
53067,2020-07-01,149391,134021,15370,10.3
53069,2020-07-01,1426,1260,166,11.6
53071,2020-07-01,30201,27679,2522,8.4
53073,2020-07-01,120916,106879,14037,11.6
53075,2020-07-01,21175,19486,1689,8
53077,2020-07-01,138148,121054,17094,12.4
54001,2020-07-01,6741,6057,684,10.1
54003,2020-07-01,56778,52377,4401,7.8
54005,2020-07-01,7486,6533,953,12.7
54007,2020-07-01,4725,4174,551,11.7
54009,2020-07-01,9768,8765,1003,10.3
54011,2020-07-01,41878,37908,3970,9.5
54013,2020-07-01,2096,1763,333,15.9
54015,2020-07-01,3078,2675,403,13.1
54017,2020-07-01,3743,3506,237,6.3
54019,2020-07-01,16426,14674,1752,10.7
54021,2020-07-01,2235,1972,263,11.8
54023,2020-07-01,5594,5187,407,7.3
54025,2020-07-01,15263,13964,1299,8.5
54027,2020-07-01,10278,9621,657,6.4
54029,2020-07-01,12974,11468,1506,11.6
54031,2020-07-01,5625,5191,434,7.7
54033,2020-07-01,33780,30696,3084,9.1
54035,2020-07-01,12365,11127,1238,10
54037,2020-07-01,29537,27320,2217,7.5
54039,2020-07-01,81797,73034,8763,10.7
54041,2020-07-01,6169,5407,762,12.4
54043,2020-07-01,7261,6426,835,11.5
54045,2020-07-01,10246,8652,1594,15.6
54047,2020-07-01,4197,3517,680,16.2
54049,2020-07-01,24544,21935,2609,10.6
54051,2020-07-01,13102,11660,1442,11
54053,2020-07-01,9345,8430,915,9.8
54055,2020-07-01,19379,17047,2332,12
54057,2020-07-01,11666,10676,990,8.5
54059,2020-07-01,6254,5113,1141,18.2
54061,2020-07-01,53275,48590,4685,8.8
54063,2020-07-01,5579,5128,451,8.1
54065,2020-07-01,7790,7211,579,7.4
54067,2020-07-01,8713,7646,1067,12.2
54069,2020-07-01,19779,17796,1983,10
54071,2020-07-01,3513,3327,186,5.3
54073,2020-07-01,2875,2512,363,12.6
54075,2020-07-01,3950,3560,390,9.9
54077,2020-07-01,15050,13770,1280,8.5
54079,2020-07-01,26559,24335,2224,8.4
54081,2020-07-01,30896,27769,3127,10.1
54083,2020-07-01,11810,10529,1281,10.8
54085,2020-07-01,4111,3745,366,8.9
54087,2020-07-01,4726,4064,662,14
54089,2020-07-01,4027,3679,348,8.6
54091,2020-07-01,7350,6696,654,8.9
54093,2020-07-01,3177,2895,282,8.9
54095,2020-07-01,2985,2587,398,13.3
54097,2020-07-01,8581,7482,1099,12.8
54099,2020-07-01,15701,14233,1468,9.3
54101,2020-07-01,2917,2581,336,11.5
54103,2020-07-01,6160,5435,725,11.8
54105,2020-07-01,2250,2017,233,10.4
54107,2020-07-01,37001,33313,3688,10
54109,2020-07-01,6115,5305,810,13.2
55001,2020-07-01,8083,7355,728,9
55003,2020-07-01,7834,7139,695,8.9
55005,2020-07-01,23641,22338,1303,5.5
55007,2020-07-01,7410,6780,630,8.5
55009,2020-07-01,141605,131827,9778,6.9
55011,2020-07-01,6341,5869,472,7.4
55013,2020-07-01,7101,6464,637,9
55015,2020-07-01,26517,25136,1381,5.2
55017,2020-07-01,31853,29656,2197,6.9
55019,2020-07-01,17261,16509,752,4.4
55021,2020-07-01,30012,28091,1921,6.4
55023,2020-07-01,7466,6989,477,6.4
55025,2020-07-01,307770,289368,18402,6
55027,2020-07-01,47512,44172,3340,7
55029,2020-07-01,13991,13080,911,6.5
55031,2020-07-01,22614,20303,2311,10.2
55033,2020-07-01,23306,21903,1403,6
55035,2020-07-01,57097,53280,3817,6.7
55037,2020-07-01,2232,2056,176,7.9
55039,2020-07-01,57556,54123,3433,6
55041,2020-07-01,4387,3718,669,15.2
55043,2020-07-01,27079,25675,1404,5.2
55045,2020-07-01,19714,18681,1033,5.2
55047,2020-07-01,9441,8898,543,5.8
55049,2020-07-01,12890,12138,752,5.8
55051,2020-07-01,2613,2292,321,12.3
55053,2020-07-01,10330,9338,992,9.6
55055,2020-07-01,46935,44245,2690,5.7
55057,2020-07-01,13696,12738,958,7
55059,2020-07-01,88059,81082,6977,7.9
55061,2020-07-01,10564,10071,493,4.7
55063,2020-07-01,63848,59907,3941,6.2
55065,2020-07-01,9709,9304,405,4.2
55067,2020-07-01,9449,8777,672,7.1
55069,2020-07-01,15076,14147,929,6.2
55071,2020-07-01,41937,39254,2683,6.4
55073,2020-07-01,72344,68319,4025,5.6
55075,2020-07-01,19550,18003,1547,7.9
55077,2020-07-01,7582,7134,448,5.9
55078,2020-07-01,1770,1441,329,18.6
55079,2020-07-01,473965,425895,48070,10.1
55081,2020-07-01,23491,22039,1452,6.2
55083,2020-07-01,20167,18881,1286,6.4
55085,2020-07-01,17251,16028,1223,7.1
55087,2020-07-01,100718,94392,6326,6.3
55089,2020-07-01,48289,45186,3103,6.4
55091,2020-07-01,4006,3762,244,6.1
55093,2020-07-01,24780,22942,1838,7.4
55095,2020-07-01,24230,22596,1634,6.7
55097,2020-07-01,39213,37112,2101,5.4
55099,2020-07-01,6413,5982,431,6.7
55101,2020-07-01,100408,92467,7941,7.9
55103,2020-07-01,9158,8697,461,5
55105,2020-07-01,83710,76650,7060,8.4
55107,2020-07-01,6610,6205,405,6.1
55109,2020-07-01,49687,45820,3867,7.8
55111,2020-07-01,35261,32778,2483,7
55113,2020-07-01,7688,7068,620,8.1
55115,2020-07-01,20966,19631,1335,6.4
55117,2020-07-01,61880,58002,3878,6.3
55119,2020-07-01,10716,10256,460,4.3
55121,2020-07-01,15842,14748,1094,6.9
55123,2020-07-01,15085,14302,783,5.2
55125,2020-07-01,9665,8982,683,7.1
55127,2020-07-01,57447,53683,3764,6.6
55129,2020-07-01,7957,7449,508,6.4
55131,2020-07-01,76044,71053,4991,6.6
55133,2020-07-01,221756,207308,14448,6.5
55135,2020-07-01,25670,24200,1470,5.7
55137,2020-07-01,11694,11008,686,5.9
55139,2020-07-01,90598,85013,5585,6.2
55141,2020-07-01,35784,33436,2348,6.6
56001,2020-07-01,21939,21071,868,4
56003,2020-07-01,5474,5188,286,5.2
56005,2020-07-01,24363,22213,2150,8.8
56007,2020-07-01,7940,7563,377,4.7
56009,2020-07-01,9347,8693,654,7
56011,2020-07-01,3982,3804,178,4.5
56013,2020-07-01,19573,18186,1387,7.1
56015,2020-07-01,6914,6587,327,4.7
56017,2020-07-01,2265,2126,139,6.1
56019,2020-07-01,4314,4044,270,6.3
56021,2020-07-01,49156,46270,2886,5.9
56023,2020-07-01,8977,8491,486,5.4
56025,2020-07-01,40113,36006,4107,10.2
56027,2020-07-01,1327,1269,58,4.4
56029,2020-07-01,15378,14521,857,5.6
56031,2020-07-01,4992,4719,273,5.5
56033,2020-07-01,16289,15439,850,5.2
56035,2020-07-01,4276,3952,324,7.6
56037,2020-07-01,21672,19762,1910,8.8
56039,2020-07-01,14307,13485,822,5.7
56041,2020-07-01,9218,8481,737,8
56043,2020-07-01,4007,3756,251,6.3
56045,2020-07-01,3911,3731,180,4.6
72001,2020-07-01,3709,3361,348,9.4
72003,2020-07-01,11201,10347,854,7.6
72005,2020-07-01,13696,12581,1115,8.1
72007,2020-07-01,6203,5687,516,8.3
72009,2020-07-01,5990,5539,451,7.5
72011,2020-07-01,8339,7792,547,6.6
72013,2020-07-01,23595,21828,1767,7.5
72015,2020-07-01,4273,3964,309,7.2
72017,2020-07-01,5537,5007,530,9.6
72019,2020-07-01,6911,6287,624,9
72021,2020-07-01,63697,58861,4836,7.6
72023,2020-07-01,12888,11969,919,7.1
72025,2020-07-01,45777,42705,3072,6.7
72027,2020-07-01,9374,8745,629,6.7
72029,2020-07-01,15506,14356,1150,7.4
72031,2020-07-01,59886,55481,4405,7.4
72033,2020-07-01,7697,7015,682,8.9
72035,2020-07-01,15330,14429,901,5.9
72037,2020-07-01,3513,3230,283,8.1
72039,2020-07-01,3537,3167,370,10.5
72041,2020-07-01,14627,13857,770,5.3
72043,2020-07-01,9175,8388,787,8.6
72045,2020-07-01,4641,4252,389,8.4
72047,2020-07-01,8560,7679,881,10.3
72049,2020-07-01,911,847,64,7
72051,2020-07-01,12725,11943,782,6.1
72053,2020-07-01,10356,9452,904,8.7
72054,2020-07-01,3122,2814,308,9.9
72055,2020-07-01,3683,3343,340,9.2
72057,2020-07-01,10226,9525,701,6.9
72059,2020-07-01,4745,4378,367,7.7
72061,2020-07-01,36713,34938,1775,4.8
72063,2020-07-01,17154,16289,865,5
72065,2020-07-01,12800,11967,833,6.5
72067,2020-07-01,5084,4725,359,7.1
72069,2020-07-01,16063,14995,1068,6.6
72071,2020-07-01,11045,10233,812,7.4
72073,2020-07-01,3731,3478,253,6.8
72075,2020-07-01,14502,13597,905,6.2
72077,2020-07-01,11589,10711,878,7.6
72079,2020-07-01,4762,4325,437,9.2
72081,2020-07-01,6326,5708,618,9.8
72083,2020-07-01,2442,2224,218,8.9
72085,2020-07-01,10586,9840,746,7
72087,2020-07-01,8070,7424,646,8
72089,2020-07-01,5922,5400,522,8.8
72091,2020-07-01,10880,10084,796,7.3
72093,2020-07-01,1677,1565,112,6.7
72095,2020-07-01,2596,2394,202,7.8
72097,2020-07-01,20280,18827,1453,7.2
72099,2020-07-01,9799,9000,799,8.2
72101,2020-07-01,7615,6882,733,9.6
72103,2020-07-01,7655,7144,511,6.7
72105,2020-07-01,6894,6116,778,11.3
72107,2020-07-01,4660,4179,481,10.3
72109,2020-07-01,3857,3547,310,8
72111,2020-07-01,5374,4911,463,8.6
72113,2020-07-01,43205,40154,3051,7.1
72115,2020-07-01,5931,5432,499,8.4
72117,2020-07-01,4309,3963,346,8
72119,2020-07-01,16316,14973,1343,8.2
72121,2020-07-01,5484,5067,417,7.6
72123,2020-07-01,6503,5943,560,8.6
72125,2020-07-01,8994,8349,645,7.2
72127,2020-07-01,132055,123100,8955,6.8
72129,2020-07-01,10904,10168,736,6.7
72131,2020-07-01,9388,8527,861,9.2
72133,2020-07-01,6978,6504,474,6.8
72135,2020-07-01,26108,24447,1661,6.4
72137,2020-07-01,28186,26298,1888,6.7
72139,2020-07-01,26130,24720,1410,5.4
72141,2020-07-01,6141,5683,458,7.5
72143,2020-07-01,9326,8496,830,8.9
72145,2020-07-01,12649,11375,1274,10.1
72147,2020-07-01,2451,2246,205,8.4
72149,2020-07-01,6646,6128,518,7.8
72151,2020-07-01,8006,7346,660,8.2
72153,2020-07-01,8919,8126,793,8.9
01001,2020-08-01,25446,24272,1174,4.6
01003,2020-08-01,98267,93297,4970,5.1
01005,2020-08-01,9476,8806,670,7.1
01007,2020-08-01,8676,8141,535,6.2
01009,2020-08-01,24792,23889,903,3.6
01011,2020-08-01,4983,4701,282,5.7
01013,2020-08-01,9839,9049,790,8
01015,2020-08-01,44829,41797,3032,6.8
01017,2020-08-01,16674,15689,985,5.9
01019,2020-08-01,11939,11517,422,3.5
01021,2020-08-01,19571,18666,905,4.6
01023,2020-08-01,4635,4351,284,6.1
01025,2020-08-01,8300,7517,783,9.4
01027,2020-08-01,6543,6324,219,3.3
01029,2020-08-01,5763,5555,208,3.6
01031,2020-08-01,22758,21860,898,3.9
01033,2020-08-01,23667,22246,1421,6
01035,2020-08-01,4916,4570,346,7
01037,2020-08-01,4803,4581,222,4.6
01039,2020-08-01,16118,15451,667,4.1
01041,2020-08-01,6729,6413,316,4.7
01043,2020-08-01,40280,38873,1407,3.5
01045,2020-08-01,21621,20597,1024,4.7
01047,2020-08-01,15583,13953,1630,10.5
01049,2020-08-01,32700,31500,1200,3.7
01051,2020-08-01,36548,34862,1686,4.6
01053,2020-08-01,15665,14747,918,5.9
01055,2020-08-01,41299,38399,2900,7
01057,2020-08-01,6832,6544,288,4.2
01059,2020-08-01,15296,14750,546,3.6
01061,2020-08-01,10902,10483,419,3.8
01063,2020-08-01,3196,2854,342,10.7
01065,2020-08-01,6292,5724,568,9
01067,2020-08-01,6843,6536,307,4.5
01069,2020-08-01,46192,43630,2562,5.5
01071,2020-08-01,24047,23006,1041,4.3
01073,2020-08-01,319908,299222,20686,6.5
01075,2020-08-01,6077,5829,248,4.1
01077,2020-08-01,42339,40270,2069,4.9
01079,2020-08-01,14060,13403,657,4.7
01081,2020-08-01,75453,71755,3698,4.9
01083,2020-08-01,43330,41670,1660,3.8
01085,2020-08-01,3731,3225,506,13.6
01087,2020-08-01,8410,7604,806,9.6
01089,2020-08-01,184585,176052,8533,4.6
01091,2020-08-01,8175,7681,494,6
01093,2020-08-01,13823,13251,572,4.1
01095,2020-08-01,46757,45102,1655,3.5
01097,2020-08-01,188231,172556,15675,8.3
01099,2020-08-01,8068,7455,613,7.6
01101,2020-08-01,106537,97552,8985,8.4
01103,2020-08-01,57302,54792,2510,4.4
01105,2020-08-01,3713,3320,393,10.6
01107,2020-08-01,7898,7428,470,6
01109,2020-08-01,16562,15767,795,4.8
01111,2020-08-01,9981,9622,359,3.6
01113,2020-08-01,23262,22155,1107,4.8
01115,2020-08-01,39963,38146,1817,4.5
01117,2020-08-01,113796,109618,4178,3.7
01119,2020-08-01,5034,4712,322,6.4
01121,2020-08-01,37518,35266,2252,6
01123,2020-08-01,20119,18911,1208,6
01125,2020-08-01,105482,98939,6543,6.2
01127,2020-08-01,25086,23736,1350,5.4
01129,2020-08-01,7126,6544,582,8.2
01131,2020-08-01,3095,2645,450,14.5
01133,2020-08-01,10457,10032,425,4.1
02013,2020-08-01,3411,3354,57,1.7
02016,2020-08-01,3715,3635,80,2.2
02020,2020-08-01,140546,131361,9185,6.5
02050,2020-08-01,6441,5803,638,9.9
02060,2020-08-01,545,524,21,3.9
02068,2020-08-01,1275,1199,76,6
02070,2020-08-01,2032,1918,114,5.6
02090,2020-08-01,43184,41025,2159,5
02100,2020-08-01,1240,1121,119,9.6
02105,2020-08-01,1191,1086,105,8.8
02110,2020-08-01,15785,14886,899,5.7
02122,2020-08-01,26297,24520,1777,6.8
02130,2020-08-01,6603,6098,505,7.6
02150,2020-08-01,5624,5372,252,4.5
02158,2020-08-01,2511,2166,345,13.7
02164,2020-08-01,862,813,49,5.7
02170,2020-08-01,44110,41134,2976,6.7
02180,2020-08-01,3688,3368,320,8.7
02185,2020-08-01,2860,2720,140,4.9
02188,2020-08-01,2687,2410,277,10.3
02195,2020-08-01,1402,1328,74,5.3
02198,2020-08-01,2532,2338,194,7.7
02220,2020-08-01,4449,4239,210,4.7
02230,2020-08-01,905,795,110,12.2
02240,2020-08-01,2705,2562,143,5.3
02261,2020-08-01,5345,5098,247,4.6
02275,2020-08-01,928,869,59,6.4
02282,2020-08-01,236,220,16,6.8
02290,2020-08-01,2258,2052,206,9.1
04001,2020-08-01,19202,17220,1982,10.3
04003,2020-08-01,50003,47374,2629,5.3
04005,2020-08-01,66826,61553,5273,7.9
04007,2020-08-01,20120,18928,1192,5.9
04009,2020-08-01,14529,13762,767,5.3
04011,2020-08-01,4471,4264,207,4.6
04012,2020-08-01,8748,8244,504,5.8
04013,2020-08-01,NA,NA,130933,5.9
04015,2020-08-01,83356,77148,6208,7.4
04017,2020-08-01,39254,36114,3140,8
04019,2020-08-01,476987,448777,28210,5.9
04021,2020-08-01,178529,167939,10590,5.9
04023,2020-08-01,18104,16226,1878,10.4
04025,2020-08-01,105732,100062,5670,5.4
04027,2020-08-01,90264,75416,14848,16.4
05001,2020-08-01,9234,8787,447,4.8
05003,2020-08-01,7417,6627,790,10.7
05005,2020-08-01,15962,14914,1048,6.6
05007,2020-08-01,135783,128240,7543,5.6
05009,2020-08-01,15845,14932,913,5.8
05011,2020-08-01,4373,4104,269,6.2
05013,2020-08-01,2375,2243,132,5.6
05015,2020-08-01,12709,11865,844,6.6
05017,2020-08-01,3182,2792,390,12.3
05019,2020-08-01,9490,8865,625,6.6
05021,2020-08-01,5489,5138,351,6.4
05023,2020-08-01,9033,8300,733,8.1
05025,2020-08-01,3123,2898,225,7.2
05027,2020-08-01,9263,8499,764,8.2
05029,2020-08-01,8078,7545,533,6.6
05031,2020-08-01,56531,52766,3765,6.7
05033,2020-08-01,26304,24647,1657,6.3
05035,2020-08-01,21440,19091,2349,11
05037,2020-08-01,7336,6812,524,7.1
05039,2020-08-01,2696,2530,166,6.2
05041,2020-08-01,5339,4850,489,9.2
05043,2020-08-01,7642,7054,588,7.7
05045,2020-08-01,59963,56226,3737,6.2
05047,2020-08-01,7402,6929,473,6.4
05049,2020-08-01,4977,4707,270,5.4
05051,2020-08-01,42482,38179,4303,10.1
05053,2020-08-01,8040,7550,490,6.1
05055,2020-08-01,19849,18547,1302,6.6
05057,2020-08-01,9605,9031,574,6
05059,2020-08-01,13852,12853,999,7.2
05061,2020-08-01,5480,5144,336,6.1
05063,2020-08-01,16463,15448,1015,6.2
05065,2020-08-01,4840,4399,441,9.1
05067,2020-08-01,5547,5081,466,8.4
05069,2020-08-01,27157,24401,2756,10.1
05071,2020-08-01,10009,9312,697,7
05073,2020-08-01,2468,2242,226,9.2
05075,2020-08-01,6933,6422,511,7.4
05077,2020-08-01,2761,2506,255,9.2
05079,2020-08-01,3819,3548,271,7.1
05081,2020-08-01,5456,5053,403,7.4
05083,2020-08-01,8239,7611,628,7.6
05085,2020-08-01,33262,31009,2253,6.8
05087,2020-08-01,7330,6983,347,4.7
05089,2020-08-01,6544,6104,440,6.7
05091,2020-08-01,19672,18170,1502,7.6
05093,2020-08-01,17402,15517,1885,10.8
05095,2020-08-01,2732,2510,222,8.1
05097,2020-08-01,2918,2682,236,8.1
05099,2020-08-01,3576,3315,261,7.3
05101,2020-08-01,3266,3107,159,4.9
05103,2020-08-01,9538,8900,638,6.7
05105,2020-08-01,4079,3825,254,6.2
05107,2020-08-01,6255,5592,663,10.6
05109,2020-08-01,4215,3932,283,6.7
05111,2020-08-01,10360,9699,661,6.4
05113,2020-08-01,7989,7387,602,7.5
05115,2020-08-01,28497,26638,1859,6.5
05117,2020-08-01,3530,3315,215,6.1
05119,2020-08-01,189647,170423,19224,10.1
05121,2020-08-01,7365,6846,519,7
05123,2020-08-01,8137,7371,766,9.4
05125,2020-08-01,56792,53291,3501,6.2
05127,2020-08-01,4277,4058,219,5.1
05129,2020-08-01,2842,2646,196,6.9
05131,2020-08-01,55762,51900,3862,6.9
05133,2020-08-01,5425,5063,362,6.7
05135,2020-08-01,5715,5274,441,7.7
05137,2020-08-01,4669,4313,356,7.6
05139,2020-08-01,15623,14067,1556,10
05141,2020-08-01,5671,5237,434,7.7
05143,2020-08-01,124399,117068,7331,5.9
05145,2020-08-01,33144,30788,2356,7.1
05147,2020-08-01,2667,2487,180,6.7
05149,2020-08-01,8280,7813,467,5.6
06001,2020-08-01,802810,726777,76033,9.5
06003,2020-08-01,454,407,47,10.4
06005,2020-08-01,14139,12882,1257,8.9
06007,2020-08-01,93038,85055,7983,8.6
06009,2020-08-01,20488,19014,1474,7.2
06011,2020-08-01,9959,8926,1033,10.4
06013,2020-08-01,533354,483039,50315,9.4
06015,2020-08-01,9329,8490,839,9
06017,2020-08-01,88302,81549,6753,7.6
06019,2020-08-01,442393,396702,45691,10.3
06021,2020-08-01,12357,11402,955,7.7
06023,2020-08-01,59033,54198,4835,8.2
06025,2020-08-01,68236,53223,15013,22
06027,2020-08-01,8158,7574,584,7.2
06029,2020-08-01,368318,322645,45673,12.4
06031,2020-08-01,55010,49449,5561,10.1
06033,2020-08-01,28517,26096,2421,8.5
06035,2020-08-01,8937,8367,570,6.4
06037,2020-08-01,NA,NA,862109,17.5
06039,2020-08-01,61477,55649,5828,9.5
06041,2020-08-01,132825,123848,8977,6.8
06043,2020-08-01,7769,7127,642,8.3
06045,2020-08-01,36730,33605,3125,8.5
06047,2020-08-01,112487,100397,12090,10.7
06049,2020-08-01,3047,2854,193,6.3
06051,2020-08-01,6857,6085,772,11.3
06053,2020-08-01,194764,177381,17383,8.9
06055,2020-08-01,71566,65874,5692,8
06057,2020-08-01,45387,41862,3525,7.8
06059,2020-08-01,NA,NA,147078,9.5
06061,2020-08-01,180647,167254,13393,7.4
06063,2020-08-01,7849,7236,613,7.8
06065,2020-08-01,NA,962744,114918,10.7
06067,2020-08-01,699501,630568,68933,9.9
06069,2020-08-01,30292,27613,2679,8.8
06071,2020-08-01,945607,848134,97473,10.3
06073,2020-08-01,NA,NA,147537,9.5
06075,2020-08-01,563620,515798,47822,8.5
06077,2020-08-01,319738,283367,36371,11.4
06079,2020-08-01,128900,119111,9789,7.6
06081,2020-08-01,439118,407484,31634,7.2
06083,2020-08-01,209910,193862,16048,7.6
06085,2020-08-01,NA,946873,73651,7.2
06087,2020-08-01,128379,117485,10894,8.5
06089,2020-08-01,72260,66563,5697,7.9
06091,2020-08-01,1210,1122,88,7.3
06093,2020-08-01,15712,14343,1369,8.7
06095,2020-08-01,200812,181053,19759,9.8
06097,2020-08-01,250791,231930,18861,7.5
06099,2020-08-01,235516,211175,24341,10.3
06101,2020-08-01,41526,37332,4194,10.1
06103,2020-08-01,24190,22158,2032,8.4
06105,2020-08-01,4493,4200,293,6.5
06107,2020-08-01,190069,166669,23400,12.3
06109,2020-08-01,19462,17551,1911,9.8
06111,2020-08-01,404632,369299,35333,8.7
06113,2020-08-01,103606,96164,7442,7.2
06115,2020-08-01,27897,25016,2881,10.3
08001,2020-08-01,275817,255189,20628,7.5
08003,2020-08-01,8061,7610,451,5.6
08005,2020-08-01,370801,342953,27848,7.5
08007,2020-08-01,6986,6532,454,6.5
08009,2020-08-01,1975,1939,36,1.8
08011,2020-08-01,1742,1672,70,4
08013,2020-08-01,189804,178821,10983,5.8
08014,2020-08-01,40148,37763,2385,5.9
08015,2020-08-01,9562,9059,503,5.3
08017,2020-08-01,1041,1016,25,2.4
08019,2020-08-01,6171,5699,472,7.6
08021,2020-08-01,3763,3593,170,4.5
08023,2020-08-01,1752,1618,134,7.6
08025,2020-08-01,1379,1319,60,4.4
08027,2020-08-01,2013,1930,83,4.1
08029,2020-08-01,13406,12626,780,5.8
08031,2020-08-01,425612,392049,33563,7.9
08033,2020-08-01,1086,1025,61,5.6
08035,2020-08-01,193007,183141,9866,5.1
08037,2020-08-01,34782,32105,2677,7.7
08039,2020-08-01,14800,14218,582,3.9
08041,2020-08-01,344180,322766,21414,6.2
08043,2020-08-01,14628,13643,985,6.7
08045,2020-08-01,30526,28770,1756,5.8
08047,2020-08-01,4000,3571,429,10.7
08049,2020-08-01,8825,8245,580,6.6
08051,2020-08-01,11118,10581,537,4.8
08053,2020-08-01,494,480,14,2.8
08055,2020-08-01,2287,2069,218,9.5
08057,2020-08-01,937,905,32,3.4
08059,2020-08-01,337371,315744,21627,6.4
08061,2020-08-01,931,912,19,2
08063,2020-08-01,3774,3679,95,2.5
08065,2020-08-01,4493,4187,306,6.8
08067,2020-08-01,30334,28658,1676,5.5
08069,2020-08-01,198555,187523,11032,5.6
08071,2020-08-01,6242,5804,438,7
08073,2020-08-01,2111,2028,83,3.9
08075,2020-08-01,10130,9693,437,4.3
08077,2020-08-01,77363,72544,4819,6.2
08079,2020-08-01,391,371,20,5.1
08081,2020-08-01,6687,6335,352,5.3
08083,2020-08-01,12247,11537,710,5.8
08085,2020-08-01,20480,19344,1136,5.5
08087,2020-08-01,15286,14427,859,5.6
08089,2020-08-01,7766,7335,431,5.5
08091,2020-08-01,2502,2350,152,6.1
08093,2020-08-01,11077,10538,539,4.9
08095,2020-08-01,2300,2247,53,2.3
08097,2020-08-01,10828,9977,851,7.9
08099,2020-08-01,6003,5762,241,4
08101,2020-08-01,75309,69830,5479,7.3
08103,2020-08-01,2901,2761,140,4.8
08105,2020-08-01,4943,4608,335,6.8
08107,2020-08-01,15342,14329,1013,6.6
08109,2020-08-01,3242,2999,243,7.5
08111,2020-08-01,560,533,27,4.8
08113,2020-08-01,5062,4642,420,8.3
08115,2020-08-01,979,947,32,3.3
08117,2020-08-01,19065,17316,1749,9.2
08119,2020-08-01,12899,12137,762,5.9
08121,2020-08-01,2666,2579,87,3.3
08123,2020-08-01,165695,154682,11013,6.6
08125,2020-08-01,4821,4680,141,2.9
09001,2020-08-01,465883,427229,38654,8.3
09003,2020-08-01,478540,437632,40908,8.5
09005,2020-08-01,102662,95830,6832,6.7
09007,2020-08-01,92178,86243,5935,6.4
09009,2020-08-01,455061,416834,38227,8.4
09011,2020-08-01,134824,122017,12807,9.5
09013,2020-08-01,84637,79512,5125,6.1
09015,2020-08-01,63076,58349,4727,7.5
10001,2020-08-01,85298,76909,8389,9.8
10003,2020-08-01,305306,276435,28871,9.5
10005,2020-08-01,113273,104656,8617,7.6
11001,2020-08-01,406441,370306,36135,8.9
12001,2020-08-01,133012,126595,6417,4.8
12003,2020-08-01,11534,11046,488,4.2
12005,2020-08-01,81921,77798,4123,5
12007,2020-08-01,10862,10321,541,5
12009,2020-08-01,286196,268895,17301,6
12011,2020-08-01,NA,924649,93669,9.2
12013,2020-08-01,4527,4318,209,4.6
12015,2020-08-01,72048,67378,4670,6.5
12017,2020-08-01,46049,42718,3331,7.2
12019,2020-08-01,105211,100462,4749,4.5
12021,2020-08-01,173868,161971,11897,6.8
12023,2020-08-01,29265,27762,1503,5.1
12027,2020-08-01,14475,13860,615,4.2
12029,2020-08-01,5609,5344,265,4.7
12031,2020-08-01,488680,457743,30937,6.3
12033,2020-08-01,143303,134832,8471,5.9
12035,2020-08-01,46242,43227,3015,6.5
12037,2020-08-01,4414,4203,211,4.8
12039,2020-08-01,18209,17002,1207,6.6
12041,2020-08-01,6743,6463,280,4.2
12043,2020-08-01,5070,4823,247,4.9
12045,2020-08-01,5565,5274,291,5.2
12047,2020-08-01,4257,3956,301,7.1
12049,2020-08-01,8289,7805,484,5.8
12051,2020-08-01,14859,13593,1266,8.5
12053,2020-08-01,70860,65717,5143,7.3
12055,2020-08-01,35488,33112,2376,6.7
12057,2020-08-01,742169,691013,51156,6.9
12059,2020-08-01,6630,6333,297,4.5
12061,2020-08-01,63672,59329,4343,6.8
12063,2020-08-01,16495,15734,761,4.6
12065,2020-08-01,5315,5037,278,5.2
12067,2020-08-01,2751,2652,99,3.6
12069,2020-08-01,152866,139704,13162,8.6
12071,2020-08-01,338229,314361,23868,7.1
12073,2020-08-01,147449,139372,8077,5.5
12075,2020-08-01,16218,15403,815,5
12077,2020-08-01,2491,2385,106,4.3
12079,2020-08-01,7453,7005,448,6
12081,2020-08-01,172913,162302,10611,6.1
12083,2020-08-01,140990,132363,8627,6.1
12085,2020-08-01,72708,68819,3889,5.3
12086,2020-08-01,NA,NA,118303,9.1
12087,2020-08-01,48910,45683,3227,6.6
12089,2020-08-01,40361,38423,1938,4.8
12091,2020-08-01,94704,90579,4125,4.4
12093,2020-08-01,17294,16442,852,4.9
12095,2020-08-01,757170,671012,86158,11.4
12097,2020-08-01,189472,161472,28000,14.8
12099,2020-08-01,694307,639337,54970,7.9
12101,2020-08-01,234327,218901,15426,6.6
12103,2020-08-01,488898,457013,31885,6.5
12105,2020-08-01,310303,281858,28445,9.2
12107,2020-08-01,26022,24145,1877,7.2
12109,2020-08-01,129741,123812,5929,4.6
12111,2020-08-01,144204,133655,10549,7.3
12113,2020-08-01,80376,76845,3531,4.4
12115,2020-08-01,181891,170708,11183,6.1
12117,2020-08-01,241767,224838,16929,7
12119,2020-08-01,32440,30377,2063,6.4
12121,2020-08-01,17774,16880,894,5
12123,2020-08-01,8171,7672,499,6.1
12125,2020-08-01,4380,4195,185,4.2
12127,2020-08-01,251850,234479,17371,6.9
12129,2020-08-01,14010,13437,573,4.1
12131,2020-08-01,30892,29458,1434,4.6
12133,2020-08-01,9300,8862,438,4.7
13001,2020-08-01,9220,8853,367,4
13003,2020-08-01,4130,4001,129,3.1
13005,2020-08-01,4576,4387,189,4.1
13007,2020-08-01,1073,1014,59,5.5
13009,2020-08-01,17564,16515,1049,6
13011,2020-08-01,9399,9089,310,3.3
13013,2020-08-01,38153,36506,1647,4.3
13015,2020-08-01,47956,45471,2485,5.2
13017,2020-08-01,5255,4931,324,6.2
13019,2020-08-01,7130,6816,314,4.4
13021,2020-08-01,64836,60113,4723,7.3
13023,2020-08-01,4212,3978,234,5.6
13025,2020-08-01,6353,6055,298,4.7
13027,2020-08-01,6692,6376,316,4.7
13029,2020-08-01,17232,16420,812,4.7
13031,2020-08-01,36390,34344,2046,5.6
13033,2020-08-01,8537,7978,559,6.5
13035,2020-08-01,10221,9647,574,5.6
13037,2020-08-01,2182,2080,102,4.7
13039,2020-08-01,19857,19017,840,4.2
13043,2020-08-01,5497,5267,230,4.2
13045,2020-08-01,52625,49711,2914,5.5
13047,2020-08-01,32196,31043,1153,3.6
13049,2020-08-01,4569,4419,150,3.3
13051,2020-08-01,134587,124885,9702,7.2
13053,2020-08-01,1844,1739,105,5.7
13055,2020-08-01,9537,8922,615,6.4
13057,2020-08-01,128496,123222,5274,4.1
13059,2020-08-01,56195,52949,3246,5.8
13061,2020-08-01,916,804,112,12.2
13063,2020-08-01,137152,122703,14449,10.5
13065,2020-08-01,2368,2276,92,3.9
13067,2020-08-01,406343,384568,21775,5.4
13069,2020-08-01,18470,17509,961,5.2
13071,2020-08-01,20438,19611,827,4
13073,2020-08-01,69765,67285,2480,3.6
13075,2020-08-01,7864,7527,337,4.3
13077,2020-08-01,71202,67380,3822,5.4
13079,2020-08-01,5192,4972,220,4.2
13081,2020-08-01,9378,8702,676,7.2
13083,2020-08-01,7907,7653,254,3.2
13085,2020-08-01,11639,11199,440,3.8
13087,2020-08-01,10961,10474,487,4.4
13089,2020-08-01,389595,359171,30424,7.8
13091,2020-08-01,6617,6282,335,5.1
13093,2020-08-01,4907,4597,310,6.3
13095,2020-08-01,36962,33829,3133,8.5
13097,2020-08-01,70758,65803,4955,7
13099,2020-08-01,4352,4080,272,6.3
13101,2020-08-01,1815,1753,62,3.4
13103,2020-08-01,28982,27692,1290,4.5
13105,2020-08-01,7632,7149,483,6.3
13107,2020-08-01,7966,7395,571,7.2
13109,2020-08-01,4763,4525,238,5
13111,2020-08-01,12121,11723,398,3.3
13113,2020-08-01,54929,52343,2586,4.7
13115,2020-08-01,42930,40825,2105,4.9
13117,2020-08-01,114963,110593,4370,3.8
13119,2020-08-01,9644,9194,450,4.7
13121,2020-08-01,543424,500634,42790,7.9
13123,2020-08-01,11073,10668,405,3.7
13125,2020-08-01,1185,1146,39,3.3
13127,2020-08-01,34555,32416,2139,6.2
13129,2020-08-01,27960,26770,1190,4.3
13131,2020-08-01,9872,9503,369,3.7
13133,2020-08-01,6882,6527,355,5.2
13135,2020-08-01,470491,442947,27544,5.9
13137,2020-08-01,18138,17328,810,4.5
13139,2020-08-01,96500,92700,3800,3.9
13141,2020-08-01,2462,2258,204,8.3
13143,2020-08-01,11933,11335,598,5
13145,2020-08-01,15388,14808,580,3.8
13147,2020-08-01,10635,10142,493,4.6
13149,2020-08-01,4970,4724,246,4.9
13151,2020-08-01,111282,103424,7858,7.1
13153,2020-08-01,65342,62282,3060,4.7
13155,2020-08-01,3288,3128,160,4.9
13157,2020-08-01,36232,34896,1336,3.7
13159,2020-08-01,6556,6269,287,4.4
13161,2020-08-01,5641,5390,251,4.4
13163,2020-08-01,6405,5988,417,6.5
13165,2020-08-01,3050,2869,181,5.9
13167,2020-08-01,3839,3670,169,4.4
13169,2020-08-01,12713,12225,488,3.8
13171,2020-08-01,7801,7394,407,5.2
13173,2020-08-01,3624,3466,158,4.4
13175,2020-08-01,18355,17295,1060,5.8
13177,2020-08-01,13799,13225,574,4.2
13179,2020-08-01,25670,24214,1456,5.7
13181,2020-08-01,3309,3145,164,5
13183,2020-08-01,7834,7545,289,3.7
13185,2020-08-01,50150,47449,2701,5.4
13187,2020-08-01,15895,15268,627,3.9
13189,2020-08-01,8327,7736,591,7.1
13191,2020-08-01,5375,5080,295,5.5
13193,2020-08-01,4396,4130,266,6.1
13195,2020-08-01,12547,12010,537,4.3
13197,2020-08-01,3044,2912,132,4.3
13199,2020-08-01,8614,7940,674,7.8
13201,2020-08-01,2574,2477,97,3.8
13205,2020-08-01,8039,7546,493,6.1
13207,2020-08-01,12157,11619,538,4.4
13209,2020-08-01,3682,3511,171,4.6
13211,2020-08-01,8779,8370,409,4.7
13213,2020-08-01,14349,13566,783,5.5
13215,2020-08-01,73338,67829,5509,7.5
13217,2020-08-01,50100,46695,3405,6.8
13219,2020-08-01,18250,17730,520,2.8
13221,2020-08-01,6492,6221,271,4.2
13223,2020-08-01,81455,77553,3902,4.8
13225,2020-08-01,11045,10417,628,5.7
13227,2020-08-01,14354,13795,559,3.9
13229,2020-08-01,8254,7940,314,3.8
13231,2020-08-01,8382,8054,328,3.9
13233,2020-08-01,17606,16779,827,4.7
13235,2020-08-01,3721,3580,141,3.8
13237,2020-08-01,7822,7371,451,5.8
13239,2020-08-01,819,760,59,7.2
13241,2020-08-01,7101,6802,299,4.2
13243,2020-08-01,2467,2325,142,5.8
13245,2020-08-01,80840,74752,6088,7.5
13247,2020-08-01,43183,40106,3077,7.1
13249,2020-08-01,2156,2085,71,3.3
13251,2020-08-01,4989,4623,366,7.3
13253,2020-08-01,2954,2811,143,4.8
13255,2020-08-01,27597,25629,1968,7.1
13257,2020-08-01,10428,9868,560,5.4
13259,2020-08-01,2502,2373,129,5.2
13261,2020-08-01,12710,11866,844,6.6
13263,2020-08-01,2662,2508,154,5.8
13265,2020-08-01,548,520,28,5.1
13267,2020-08-01,9098,8758,340,3.7
13269,2020-08-01,2844,2682,162,5.7
13271,2020-08-01,3492,3186,306,8.8
13273,2020-08-01,3342,3088,254,7.6
13275,2020-08-01,16353,15370,983,6
13277,2020-08-01,19490,18606,884,4.5
13279,2020-08-01,11460,10802,658,5.7
13281,2020-08-01,3594,3410,184,5.1
13283,2020-08-01,2491,2361,130,5.2
13285,2020-08-01,37238,35008,2230,6
13287,2020-08-01,3072,2861,211,6.9
13289,2020-08-01,2668,2490,178,6.7
13291,2020-08-01,9882,9531,351,3.6
13293,2020-08-01,10919,10296,623,5.7
13295,2020-08-01,30057,28847,1210,4
13297,2020-08-01,43481,41488,1993,4.6
13299,2020-08-01,14872,14140,732,4.9
13301,2020-08-01,2712,2560,152,5.6
13303,2020-08-01,6483,6083,400,6.2
13305,2020-08-01,10706,10177,529,4.9
13307,2020-08-01,985,930,55,5.6
13309,2020-08-01,1521,1430,91,6
13311,2020-08-01,15909,15437,472,3
13313,2020-08-01,40537,38366,2171,5.4
13315,2020-08-01,2576,2422,154,6
13317,2020-08-01,3728,3516,212,5.7
13319,2020-08-01,3932,3756,176,4.5
13321,2020-08-01,8297,7907,390,4.7
15001,2020-08-01,88337,77488,10849,12.3
15003,2020-08-01,433505,385945,47560,11
15007,2020-08-01,35042,28618,6424,18.3
15009,2020-08-01,82266,64884,17382,21.1
16001,2020-08-01,259224,248812,10412,4
16003,2020-08-01,1903,1803,100,5.3
16005,2020-08-01,40726,39253,1473,3.6
16007,2020-08-01,3200,3100,100,3.1
16009,2020-08-01,4228,4051,177,4.2
16011,2020-08-01,24215,23585,630,2.6
16013,2020-08-01,13685,13052,633,4.6
16015,2020-08-01,3608,3396,212,5.9
16017,2020-08-01,22050,20991,1059,4.8
16019,2020-08-01,59910,58243,1667,2.8
16021,2020-08-01,5737,5522,215,3.7
16023,2020-08-01,1464,1428,36,2.5
16025,2020-08-01,742,721,21,2.8
16027,2020-08-01,106809,102264,4545,4.3
16029,2020-08-01,4253,4163,90,2.1
16031,2020-08-01,12733,12404,329,2.6
16033,2020-08-01,399,387,12,3
16035,2020-08-01,3087,2936,151,4.9
16037,2020-08-01,2631,2556,75,2.9
16039,2020-08-01,12280,11853,427,3.5
16041,2020-08-01,6973,6789,184,2.6
16043,2020-08-01,7600,7417,183,2.4
16045,2020-08-01,8470,8107,363,4.3
16047,2020-08-01,8470,8244,226,2.7
16049,2020-08-01,6965,6645,320,4.6
16051,2020-08-01,14690,14362,328,2.2
16053,2020-08-01,12439,12098,341,2.7
16055,2020-08-01,79134,75306,3828,4.8
16057,2020-08-01,19772,19107,665,3.4
16059,2020-08-01,4011,3854,157,3.9
16061,2020-08-01,1752,1663,89,5.1
16063,2020-08-01,2868,2777,91,3.2
16065,2020-08-01,21083,20635,448,2.1
16067,2020-08-01,11880,11553,327,2.8
16069,2020-08-01,19973,19297,676,3.4
16071,2020-08-01,2436,2366,70,2.9
16073,2020-08-01,6047,5808,239,4
16075,2020-08-01,11921,11467,454,3.8
16077,2020-08-01,4123,4007,116,2.8
16079,2020-08-01,5502,5174,328,6
16081,2020-08-01,7176,6951,225,3.1
16083,2020-08-01,42134,40607,1527,3.6
16085,2020-08-01,6324,6054,270,4.3
16087,2020-08-01,4802,4616,186,3.9
17001,2020-08-01,32551,30414,2137,6.6
17003,2020-08-01,1950,1737,213,10.9
17005,2020-08-01,7888,7301,587,7.4
17007,2020-08-01,25988,23401,2587,10
17009,2020-08-01,3003,2879,124,4.1
17011,2020-08-01,17599,16321,1278,7.3
17013,2020-08-01,2317,2152,165,7.1
17015,2020-08-01,7647,7166,481,6.3
17017,2020-08-01,6234,5800,434,7
17019,2020-08-01,105493,97385,8108,7.7
17021,2020-08-01,14556,13291,1265,8.7
17023,2020-08-01,7625,7066,559,7.3
17025,2020-08-01,6266,5740,526,8.4
17027,2020-08-01,20371,19212,1159,5.7
17029,2020-08-01,23227,21175,2052,8.8
17031,2020-08-01,NA,NA,355079,13.9
17033,2020-08-01,8489,7854,635,7.5
17035,2020-08-01,6079,5719,360,5.9
17037,2020-08-01,54221,49372,4849,8.9
17039,2020-08-01,7308,6778,530,7.3
17041,2020-08-01,10176,9545,631,6.2
17043,2020-08-01,479653,434716,44937,9.4
17045,2020-08-01,8835,8243,592,6.7
17047,2020-08-01,2687,2513,174,6.5
17049,2020-08-01,19637,18271,1366,7
17051,2020-08-01,10185,9354,831,8.2
17053,2020-08-01,6309,5886,423,6.7
17055,2020-08-01,16365,14687,1678,10.3
17057,2020-08-01,15061,13750,1311,8.7
17059,2020-08-01,2245,2042,203,9
17061,2020-08-01,6185,5742,443,7.2
17063,2020-08-01,23722,21488,2234,9.4
17065,2020-08-01,4235,3983,252,6
17067,2020-08-01,8556,7982,574,6.7
17069,2020-08-01,1357,1221,136,10
17071,2020-08-01,3698,3472,226,6.1
17073,2020-08-01,24720,22817,1903,7.7
17075,2020-08-01,14595,13715,880,6
17077,2020-08-01,28065,25624,2441,8.7
17079,2020-08-01,4905,4623,282,5.7
17081,2020-08-01,17559,15907,1652,9.4
17083,2020-08-01,10960,10146,814,7.4
17085,2020-08-01,10925,10085,840,7.7
17087,2020-08-01,4074,3697,377,9.3
17089,2020-08-01,269873,243052,26821,9.9
17091,2020-08-01,56983,51777,5206,9.1
17093,2020-08-01,64901,58613,6288,9.7
17095,2020-08-01,21956,19912,2044,9.3
17097,2020-08-01,374524,341440,33084,8.8
17099,2020-08-01,54371,49216,5155,9.5
17101,2020-08-01,5787,5327,460,7.9
17103,2020-08-01,17618,16344,1274,7.2
17105,2020-08-01,16825,15666,1159,6.9
17107,2020-08-01,12588,11676,912,7.2
17109,2020-08-01,12739,11693,1046,8.2
17111,2020-08-01,155999,141337,14662,9.4
17113,2020-08-01,86156,79794,6362,7.4
17115,2020-08-01,49234,43654,5580,11.3
17117,2020-08-01,22966,21350,1616,7
17119,2020-08-01,136038,124406,11632,8.6
17121,2020-08-01,17340,15811,1529,8.8
17123,2020-08-01,5117,4731,386,7.5
17125,2020-08-01,6431,5894,537,8.4
17127,2020-08-01,5608,5068,540,9.6
17129,2020-08-01,6470,6072,398,6.2
17131,2020-08-01,7996,7409,587,7.3
17133,2020-08-01,18643,17591,1052,5.6
17135,2020-08-01,11725,10651,1074,9.2
17137,2020-08-01,16750,15477,1273,7.6
17139,2020-08-01,7716,7290,426,5.5
17141,2020-08-01,24627,22611,2016,8.2
17143,2020-08-01,83797,73979,9818,11.7
17145,2020-08-01,8421,7685,736,8.7
17147,2020-08-01,8289,7798,491,5.9
17149,2020-08-01,7187,6769,418,5.8
17151,2020-08-01,1686,1550,136,8.1
17153,2020-08-01,2013,1781,232,11.5
17155,2020-08-01,3121,2891,230,7.4
17157,2020-08-01,14589,13597,992,6.8
17159,2020-08-01,7201,6692,509,7.1
17161,2020-08-01,71191,64466,6725,9.4
17163,2020-08-01,130224,116637,13587,10.4
17165,2020-08-01,9834,8779,1055,10.7
17167,2020-08-01,102715,93639,9076,8.8
17169,2020-08-01,3277,3083,194,5.9
17171,2020-08-01,2611,2461,150,5.7
17173,2020-08-01,10907,10171,736,6.7
17175,2020-08-01,2421,2253,168,6.9
17177,2020-08-01,22359,20615,1744,7.8
17179,2020-08-01,61372,56129,5243,8.5
17181,2020-08-01,7445,6857,588,7.9
17183,2020-08-01,33451,30286,3165,9.5
17185,2020-08-01,6000,5613,387,6.5
17187,2020-08-01,8439,7909,530,6.3
17189,2020-08-01,9215,8790,425,4.6
17191,2020-08-01,7070,6541,529,7.5
17193,2020-08-01,6550,6096,454,6.9
17195,2020-08-01,28162,25824,2338,8.3
17197,2020-08-01,340426,303302,37124,10.9
17199,2020-08-01,31895,29139,2756,8.6
17201,2020-08-01,140680,124033,16647,11.8
17203,2020-08-01,17841,16673,1168,6.5
18001,2020-08-01,16795,16131,664,4
18003,2020-08-01,186432,173731,12701,6.8
18005,2020-08-01,44513,42111,2402,5.4
18007,2020-08-01,4176,3972,204,4.9
18009,2020-08-01,4704,4404,300,6.4
18011,2020-08-01,36334,34868,1466,4
18013,2020-08-01,7874,7427,447,5.7
18015,2020-08-01,9477,9017,460,4.9
18017,2020-08-01,17371,16423,948,5.5
18019,2020-08-01,61054,56933,4121,6.7
18021,2020-08-01,11743,11010,733,6.2
18023,2020-08-01,17091,16289,802,4.7
18025,2020-08-01,4877,4591,286,5.9
18027,2020-08-01,16516,15938,578,3.5
18029,2020-08-01,25269,23771,1498,5.9
18031,2020-08-01,15116,14398,718,4.7
18033,2020-08-01,22262,21101,1161,5.2
18035,2020-08-01,51346,47654,3692,7.2
18037,2020-08-01,22859,21832,1027,4.5
18039,2020-08-01,107096,100554,6542,6.1
18041,2020-08-01,8585,7861,724,8.4
18043,2020-08-01,40973,38485,2488,6.1
18045,2020-08-01,7765,7396,369,4.8
18047,2020-08-01,11266,10765,501,4.4
18049,2020-08-01,9808,9246,562,5.7
18051,2020-08-01,19719,18790,929,4.7
18053,2020-08-01,30600,28778,1822,6
18055,2020-08-01,13376,12613,763,5.7
18057,2020-08-01,184843,176614,8229,4.5
18059,2020-08-01,40656,38541,2115,5.2
18061,2020-08-01,19871,18770,1101,5.5
18063,2020-08-01,90691,86245,4446,4.9
18065,2020-08-01,22160,20911,1249,5.6
18067,2020-08-01,37462,34780,2682,7.2
18069,2020-08-01,18058,17151,907,5
18071,2020-08-01,23389,22098,1291,5.5
18073,2020-08-01,15766,14823,943,6
18075,2020-08-01,8786,8365,421,4.8
18077,2020-08-01,14761,13861,900,6.1
18079,2020-08-01,13568,12810,758,5.6
18081,2020-08-01,83878,79505,4373,5.2
18083,2020-08-01,17969,17058,911,5.1
18085,2020-08-01,41684,39439,2245,5.4
18087,2020-08-01,19278,18519,759,3.9
18089,2020-08-01,230777,208873,21904,9.5
18091,2020-08-01,47829,43745,4084,8.5
18093,2020-08-01,21088,19834,1254,5.9
18095,2020-08-01,60250,56099,4151,6.9
18097,2020-08-01,510678,468310,42368,8.3
18099,2020-08-01,22646,21436,1210,5.3
18101,2020-08-01,5402,5194,208,3.9
18103,2020-08-01,14863,13856,1007,6.8
18105,2020-08-01,68593,64835,3758,5.5
18107,2020-08-01,18465,17589,876,4.7
18109,2020-08-01,36601,34770,1831,5
18111,2020-08-01,6743,6342,401,5.9
18113,2020-08-01,23096,21781,1315,5.7
18115,2020-08-01,3147,2943,204,6.5
18117,2020-08-01,8981,8247,734,8.2
18119,2020-08-01,9151,8606,545,6
18121,2020-08-01,6965,6624,341,4.9
18123,2020-08-01,9175,8668,507,5.5
18125,2020-08-01,6019,5696,323,5.4
18127,2020-08-01,85838,79666,6172,7.2
18129,2020-08-01,13585,13025,560,4.1
18131,2020-08-01,6448,6104,344,5.3
18133,2020-08-01,16837,15941,896,5.3
18135,2020-08-01,11052,10407,645,5.8
18137,2020-08-01,13989,13285,704,5
18139,2020-08-01,8775,8350,425,4.8
18141,2020-08-01,130290,119488,10802,8.3
18143,2020-08-01,10430,9709,721,6.9
18145,2020-08-01,23526,22140,1386,5.9
18147,2020-08-01,10973,10465,508,4.6
18149,2020-08-01,9825,9170,655,6.7
18151,2020-08-01,20514,19562,952,4.6
18153,2020-08-01,8046,7557,489,6.1
18155,2020-08-01,4908,4598,310,6.3
18157,2020-08-01,93104,87331,5773,6.2
18159,2020-08-01,9223,8806,417,4.5
18161,2020-08-01,3423,3266,157,4.6
18163,2020-08-01,96727,90453,6274,6.5
18165,2020-08-01,6689,6268,421,6.3
18167,2020-08-01,47241,43781,3460,7.3
18169,2020-08-01,14159,13406,753,5.3
18171,2020-08-01,4023,3842,181,4.5
18173,2020-08-01,33308,31741,1567,4.7
18175,2020-08-01,13384,12591,793,5.9
18177,2020-08-01,30395,28385,2010,6.6
18179,2020-08-01,14144,13481,663,4.7
18181,2020-08-01,13460,12846,614,4.6
18183,2020-08-01,17409,16598,811,4.7
19001,2020-08-01,3851,3688,163,4.2
19003,2020-08-01,1989,1901,88,4.4
19005,2020-08-01,6721,6415,306,4.6
19007,2020-08-01,5614,5272,342,6.1
19009,2020-08-01,2807,2702,105,3.7
19011,2020-08-01,12566,11790,776,6.2
19013,2020-08-01,66447,61732,4715,7.1
19015,2020-08-01,13979,13326,653,4.7
19017,2020-08-01,12940,12409,531,4.1
19019,2020-08-01,10365,9832,533,5.1
19021,2020-08-01,11360,10841,519,4.6
19023,2020-08-01,7293,6958,335,4.6
19025,2020-08-01,3896,3716,180,4.6
19027,2020-08-01,10228,9771,457,4.5
19029,2020-08-01,6392,6120,272,4.3
19031,2020-08-01,10107,9616,491,4.9
19033,2020-08-01,22364,21013,1351,6
19035,2020-08-01,5793,5550,243,4.2
19037,2020-08-01,6120,5817,303,5
19039,2020-08-01,4552,4291,261,5.7
19041,2020-08-01,7965,7570,395,5
19043,2020-08-01,9172,8707,465,5.1
19045,2020-08-01,22166,20420,1746,7.9
19047,2020-08-01,7466,7055,411,5.5
19049,2020-08-01,46382,44341,2041,4.4
19051,2020-08-01,3882,3699,183,4.7
19053,2020-08-01,3948,3777,171,4.3
19055,2020-08-01,9765,9358,407,4.2
19057,2020-08-01,18384,16910,1474,8
19059,2020-08-01,8966,8547,419,4.7
19061,2020-08-01,52679,49268,3411,6.5
19063,2020-08-01,4881,4637,244,5
19065,2020-08-01,9543,8996,547,5.7
19067,2020-08-01,8085,7511,574,7.1
19069,2020-08-01,5163,4951,212,4.1
19071,2020-08-01,3408,3275,133,3.9
19073,2020-08-01,4980,4748,232,4.7
19075,2020-08-01,6036,5744,292,4.8
19077,2020-08-01,5182,4894,288,5.6
19079,2020-08-01,6456,6123,333,5.2
19081,2020-08-01,5595,5322,273,4.9
19083,2020-08-01,7394,7010,384,5.2
19085,2020-08-01,6950,6655,295,4.2
19087,2020-08-01,9209,8685,524,5.7
19089,2020-08-01,4816,4612,204,4.2
19091,2020-08-01,4644,4448,196,4.2
19093,2020-08-01,3963,3800,163,4.1
19095,2020-08-01,9960,9516,444,4.5
19097,2020-08-01,10361,9637,724,7
19099,2020-08-01,18505,17401,1104,6
19101,2020-08-01,9903,9235,668,6.7
19103,2020-08-01,84893,79516,5377,6.3
19105,2020-08-01,9889,9278,611,6.2
19107,2020-08-01,4892,4639,253,5.2
19109,2020-08-01,7750,7434,316,4.1
19111,2020-08-01,15642,14508,1134,7.2
19113,2020-08-01,117696,107480,10216,8.7
19115,2020-08-01,5804,5520,284,4.9
19117,2020-08-01,4412,4218,194,4.4
19119,2020-08-01,6339,6168,171,2.7
19121,2020-08-01,8014,7515,499,6.2
19123,2020-08-01,11193,10610,583,5.2
19125,2020-08-01,17231,16481,750,4.4
19127,2020-08-01,16900,15703,1197,7.1
19129,2020-08-01,7034,6721,313,4.4
19131,2020-08-01,6786,6592,194,2.9
19133,2020-08-01,3982,3777,205,5.1
19135,2020-08-01,3805,3573,232,6.1
19137,2020-08-01,4671,4400,271,5.8
19139,2020-08-01,21302,19962,1340,6.3
19141,2020-08-01,7739,7425,314,4.1
19143,2020-08-01,3228,3121,107,3.3
19145,2020-08-01,6114,5785,329,5.4
19147,2020-08-01,4387,4166,221,5
19149,2020-08-01,13999,13427,572,4.1
19151,2020-08-01,4348,4182,166,3.8
19153,2020-08-01,258215,239313,18902,7.3
19155,2020-08-01,47268,44405,2863,6.1
19157,2020-08-01,9372,8877,495,5.3
19159,2020-08-01,2257,2159,98,4.3
19161,2020-08-01,4855,4683,172,3.5
19163,2020-08-01,85115,78239,6876,8.1
19165,2020-08-01,6246,6004,242,3.9
19167,2020-08-01,19172,18632,540,2.8
19169,2020-08-01,55718,53243,2475,4.4
19171,2020-08-01,8850,8323,527,6
19173,2020-08-01,2941,2830,111,3.8
19175,2020-08-01,5967,5556,411,6.9
19177,2020-08-01,3415,3229,186,5.4
19179,2020-08-01,17012,15757,1255,7.4
19181,2020-08-01,26583,25229,1354,5.1
19183,2020-08-01,11342,10875,467,4.1
19185,2020-08-01,2627,2491,136,5.2
19187,2020-08-01,18534,17404,1130,6.1
19189,2020-08-01,4858,4560,298,6.1
19191,2020-08-01,9467,8988,479,5.1
19193,2020-08-01,54174,50882,3292,6.1
19195,2020-08-01,3955,3775,180,4.6
19197,2020-08-01,6666,6351,315,4.7
20001,2020-08-01,6211,5760,451,7.3
20003,2020-08-01,4340,4113,227,5.2
20005,2020-08-01,6836,6280,556,8.1
20007,2020-08-01,2331,2234,97,4.2
20009,2020-08-01,14117,13384,733,5.2
20011,2020-08-01,6919,6416,503,7.3
20013,2020-08-01,5210,4966,244,4.7
20015,2020-08-01,32313,29814,2499,7.7
20017,2020-08-01,1569,1446,123,7.8
20019,2020-08-01,1500,1371,129,8.6
20021,2020-08-01,9969,9364,605,6.1
20023,2020-08-01,1294,1263,31,2.4
20025,2020-08-01,1129,1098,31,2.7
20027,2020-08-01,3752,3550,202,5.4
20029,2020-08-01,3755,3558,197,5.2
20031,2020-08-01,3629,3390,239,6.6
20033,2020-08-01,860,821,39,4.5
20035,2020-08-01,17074,15712,1362,8
20037,2020-08-01,19179,17904,1275,6.6
20039,2020-08-01,1278,1222,56,4.4
20041,2020-08-01,9001,8527,474,5.3
20043,2020-08-01,4102,3888,214,5.2
20045,2020-08-01,64784,60118,4666,7.2
20047,2020-08-01,1483,1424,59,4
20049,2020-08-01,1123,1047,76,6.8
20051,2020-08-01,17204,16548,656,3.8
20053,2020-08-01,2756,2647,109,4
20055,2020-08-01,20841,19973,868,4.2
20057,2020-08-01,17880,17133,747,4.2
20059,2020-08-01,14371,13355,1016,7.1
20061,2020-08-01,11662,10599,1063,9.1
20063,2020-08-01,1431,1389,42,2.9
20065,2020-08-01,1252,1173,79,6.3
20067,2020-08-01,3293,3098,195,5.9
20069,2020-08-01,3197,3114,83,2.6
20071,2020-08-01,814,796,18,2.2
20073,2020-08-01,3057,2862,195,6.4
20075,2020-08-01,1678,1642,36,2.1
20077,2020-08-01,2691,2517,174,6.5
20079,2020-08-01,16711,15667,1044,6.2
20081,2020-08-01,2289,2227,62,2.7
20083,2020-08-01,1037,1006,31,3
20085,2020-08-01,7085,6709,376,5.3
20087,2020-08-01,9979,9442,537,5.4
20089,2020-08-01,1221,1174,47,3.8
20091,2020-08-01,337577,317017,20560,6.1
20093,2020-08-01,2069,1999,70,3.4
20095,2020-08-01,3428,3218,210,6.1
20097,2020-08-01,1236,1183,53,4.3
20099,2020-08-01,9821,9123,698,7.1
20101,2020-08-01,744,716,28,3.8
20103,2020-08-01,36368,33947,2421,6.7
20105,2020-08-01,1697,1631,66,3.9
20107,2020-08-01,4420,4048,372,8.4
20109,2020-08-01,1535,1493,42,2.7
20111,2020-08-01,16834,15919,915,5.4
20113,2020-08-01,17629,16945,684,3.9
20115,2020-08-01,6018,5725,293,4.9
20117,2020-08-01,5636,5444,192,3.4
20119,2020-08-01,2193,2117,76,3.5
20121,2020-08-01,17280,16282,998,5.8
20123,2020-08-01,3415,3299,116,3.4
20125,2020-08-01,15307,13958,1349,8.8
20127,2020-08-01,3030,2872,158,5.2
20129,2020-08-01,1131,1081,50,4.4
20131,2020-08-01,5545,5378,167,3
20133,2020-08-01,6320,5785,535,8.5
20135,2020-08-01,1353,1296,57,4.2
20137,2020-08-01,2713,2626,87,3.2
20139,2020-08-01,7887,7415,472,6
20141,2020-08-01,1971,1906,65,3.3
20143,2020-08-01,2972,2818,154,5.2
20145,2020-08-01,2864,2741,123,4.3
20147,2020-08-01,2564,2466,98,3.8
20149,2020-08-01,11704,11124,580,5
20151,2020-08-01,4930,4706,224,4.5
20153,2020-08-01,1558,1506,52,3.3
20155,2020-08-01,29814,27849,1965,6.6
20157,2020-08-01,2378,2281,97,4.1
20159,2020-08-01,5004,4753,251,5
20161,2020-08-01,33336,31243,2093,6.3
20163,2020-08-01,2526,2397,129,5.1
20165,2020-08-01,1654,1570,84,5.1
20167,2020-08-01,3345,3171,174,5.2
20169,2020-08-01,30594,28636,1958,6.4
20171,2020-08-01,2836,2753,83,2.9
20173,2020-08-01,257302,229274,28028,10.9
20175,2020-08-01,10072,9528,544,5.4
20177,2020-08-01,90126,83835,6291,7
20179,2020-08-01,1461,1416,45,3.1
20181,2020-08-01,2926,2808,118,4
20183,2020-08-01,1954,1892,62,3.2
20185,2020-08-01,1997,1898,99,5
20187,2020-08-01,1065,1037,28,2.6
20189,2020-08-01,2856,2745,111,3.9
20191,2020-08-01,11184,10063,1121,10
20193,2020-08-01,4366,4222,144,3.3
20195,2020-08-01,1473,1416,57,3.9
20197,2020-08-01,3601,3450,151,4.2
20199,2020-08-01,846,829,17,2
20201,2020-08-01,3070,2987,83,2.7
20203,2020-08-01,1352,1324,28,2.1
20205,2020-08-01,4017,3655,362,9
20207,2020-08-01,1531,1409,122,8
20209,2020-08-01,78596,71207,7389,9.4
21001,2020-08-01,6573,6049,524,8
21003,2020-08-01,8408,7888,520,6.2
21005,2020-08-01,11643,10850,793,6.8
21007,2020-08-01,3193,2962,231,7.2
21009,2020-08-01,17286,15851,1435,8.3
21011,2020-08-01,4481,4112,369,8.2
21013,2020-08-01,7920,7188,732,9.2
21015,2020-08-01,69734,65432,4302,6.2
21017,2020-08-01,9765,9205,560,5.7
21019,2020-08-01,17818,16123,1695,9.5
21021,2020-08-01,11454,10405,1049,9.2
21023,2020-08-01,3714,3478,236,6.4
21025,2020-08-01,3180,2794,386,12.1
21027,2020-08-01,7649,7074,575,7.5
21029,2020-08-01,41793,39210,2583,6.2
21031,2020-08-01,4693,4360,333,7.1
21033,2020-08-01,5235,4854,381,7.3
21035,2020-08-01,18046,16818,1228,6.8
21037,2020-08-01,49967,46722,3245,6.5
21039,2020-08-01,2163,2056,107,4.9
21041,2020-08-01,5204,4837,367,7.1
21043,2020-08-01,9310,8341,969,10.4
21045,2020-08-01,6347,5929,418,6.6
21047,2020-08-01,24877,22771,2106,8.5
21049,2020-08-01,17012,15747,1265,7.4
21051,2020-08-01,5052,4524,528,10.5
21053,2020-08-01,3857,3621,236,6.1
21055,2020-08-01,3600,3389,211,5.9
21057,2020-08-01,3074,2918,156,5.1
21059,2020-08-01,46637,43579,3058,6.6
21061,2020-08-01,4445,4112,333,7.5
21063,2020-08-01,1925,1725,200,10.4
21065,2020-08-01,5098,4681,417,8.2
21067,2020-08-01,173244,161606,11638,6.7
21069,2020-08-01,6283,5866,417,6.6
21071,2020-08-01,10394,9211,1183,11.4
21073,2020-08-01,24654,22718,1936,7.9
21075,2020-08-01,2113,1938,175,8.3
21077,2020-08-01,4033,3765,268,6.6
21079,2020-08-01,7207,6694,513,7.1
21081,2020-08-01,11622,10739,883,7.6
21083,2020-08-01,14853,13825,1028,6.9
21085,2020-08-01,10907,10018,889,8.2
21087,2020-08-01,4744,4476,268,5.6
21089,2020-08-01,13293,12026,1267,9.5
21091,2020-08-01,3891,3664,227,5.8
21093,2020-08-01,47013,43523,3490,7.4
21095,2020-08-01,6257,5267,990,15.8
21097,2020-08-01,8578,8074,504,5.9
21099,2020-08-01,7478,7027,451,6
21101,2020-08-01,22143,20902,1241,5.6
21103,2020-08-01,8068,7623,445,5.5
21105,2020-08-01,1698,1602,96,5.7
21107,2020-08-01,16517,15129,1388,8.4
21109,2020-08-01,3824,3446,378,9.9
21111,2020-08-01,396960,366374,30586,7.7
21113,2020-08-01,26034,24360,1674,6.4
21115,2020-08-01,6396,5717,679,10.6
21117,2020-08-01,86578,80808,5770,6.7
21119,2020-08-01,4169,3713,456,10.9
21121,2020-08-01,9732,8788,944,9.7
21123,2020-08-01,5674,5291,383,6.8
21125,2020-08-01,23906,22060,1846,7.7
21127,2020-08-01,5170,4686,484,9.4
21129,2020-08-01,1977,1826,151,7.6
21131,2020-08-01,2508,2196,312,12.4
21133,2020-08-01,6026,5238,788,13.1
21135,2020-08-01,4340,3928,412,9.5
21137,2020-08-01,8519,7716,803,9.4
21139,2020-08-01,3342,3070,272,8.1
21141,2020-08-01,11969,11282,687,5.7
21143,2020-08-01,2935,2750,185,6.3
21145,2020-08-01,26755,24567,2188,8.2
21147,2020-08-01,4463,4095,368,8.2
21149,2020-08-01,4154,3892,262,6.3
21151,2020-08-01,42928,39938,2990,7
21153,2020-08-01,3243,2658,585,18
21155,2020-08-01,9454,8834,620,6.6
21157,2020-08-01,14446,13519,927,6.4
21159,2020-08-01,2780,2408,372,13.4
21161,2020-08-01,6746,6175,571,8.5
21163,2020-08-01,11727,10875,852,7.3
21165,2020-08-01,2240,2035,205,9.2
21167,2020-08-01,9485,8682,803,8.5
21169,2020-08-01,3795,3493,302,8
21171,2020-08-01,4386,4127,259,5.9
21173,2020-08-01,11331,10401,930,8.2
21175,2020-08-01,4453,4145,308,6.9
21177,2020-08-01,9892,8877,1015,10.3
21179,2020-08-01,22946,21555,1391,6.1
21181,2020-08-01,3275,3045,230,7
21183,2020-08-01,9822,9080,742,7.6
21185,2020-08-01,32369,30778,1591,4.9
21187,2020-08-01,4930,4589,341,6.9
21189,2020-08-01,1098,1005,93,8.5
21191,2020-08-01,6779,6406,373,5.5
21193,2020-08-01,7755,6869,886,11.4
21195,2020-08-01,17921,16051,1870,10.4
21197,2020-08-01,4879,4481,398,8.2
21199,2020-08-01,25457,23482,1975,7.8
21201,2020-08-01,809,760,49,6.1
21203,2020-08-01,6046,5592,454,7.5
21205,2020-08-01,9706,8954,752,7.7
21207,2020-08-01,5975,5508,467,7.8
21209,2020-08-01,28521,26881,1640,5.8
21211,2020-08-01,25035,23646,1389,5.5
21213,2020-08-01,8656,8053,603,7
21215,2020-08-01,9951,9397,554,5.6
21217,2020-08-01,11429,10691,738,6.5
21219,2020-08-01,5270,4986,284,5.4
21221,2020-08-01,5986,5562,424,7.1
21223,2020-08-01,3803,3563,240,6.3
21225,2020-08-01,5730,5386,344,6
21227,2020-08-01,60274,55974,4300,7.1
21229,2020-08-01,6141,5806,335,5.5
21231,2020-08-01,7196,6670,526,7.3
21233,2020-08-01,5516,5164,352,6.4
21235,2020-08-01,13401,12256,1145,8.5
21237,2020-08-01,1905,1744,161,8.5
21239,2020-08-01,14889,14042,847,5.7
22001,2020-08-01,24141,22417,1724,7.1
22003,2020-08-01,8866,8134,732,8.3
22005,2020-08-01,64400,60390,4010,6.2
22007,2020-08-01,9222,8339,883,9.6
22009,2020-08-01,15359,14195,1164,7.6
22011,2020-08-01,14574,13685,889,6.1
22013,2020-08-01,5506,5071,435,7.9
22015,2020-08-01,57910,54495,3415,5.9
22017,2020-08-01,106261,96751,9510,8.9
22019,2020-08-01,99729,91504,8225,8.2
22021,2020-08-01,3787,3541,246,6.5
22023,2020-08-01,3582,3404,178,5
22025,2020-08-01,3506,3249,257,7.3
22027,2020-08-01,5746,5386,360,6.3
22029,2020-08-01,7141,6570,571,8
22031,2020-08-01,10841,10081,760,7
22033,2020-08-01,234871,217015,17856,7.6
22035,2020-08-01,1863,1645,218,11.7
22037,2020-08-01,8020,7501,519,6.5
22039,2020-08-01,11865,10901,964,8.1
22041,2020-08-01,7474,6883,591,7.9
22043,2020-08-01,8216,7720,496,6
22045,2020-08-01,29228,26431,2797,9.6
22047,2020-08-01,14427,13002,1425,9.9
22049,2020-08-01,6736,6401,335,5
22051,2020-08-01,211132,191872,19260,9.1
22053,2020-08-01,12959,12050,909,7
22055,2020-08-01,115894,107999,7895,6.8
22057,2020-08-01,42679,40127,2552,6
22059,2020-08-01,6794,6478,316,4.7
22061,2020-08-01,20781,19488,1293,6.2
22063,2020-08-01,68998,64962,4036,5.8
22065,2020-08-01,3526,3239,287,8.1
22067,2020-08-01,10130,9154,976,9.6
22069,2020-08-01,16039,14889,1150,7.2
22071,2020-08-01,182619,159570,23049,12.6
22073,2020-08-01,74290,69192,5098,6.9
22075,2020-08-01,9661,9030,631,6.5
22077,2020-08-01,9967,9215,752,7.5
22079,2020-08-01,55748,52373,3375,6.1
22081,2020-08-01,3772,3542,230,6.1
22083,2020-08-01,8308,7689,619,7.5
22085,2020-08-01,9142,8630,512,5.6
22087,2020-08-01,19796,17752,2044,10.3
22089,2020-08-01,24340,22527,1813,7.4
22091,2020-08-01,4507,3954,553,12.3
22093,2020-08-01,9004,8108,896,10
22095,2020-08-01,19596,17346,2250,11.5
22097,2020-08-01,32514,29638,2876,8.8
22099,2020-08-01,22716,20886,1830,8.1
22101,2020-08-01,19987,18155,1832,9.2
22103,2020-08-01,114400,107344,7056,6.2
22105,2020-08-01,55942,50534,5408,9.7
22107,2020-08-01,1369,1266,103,7.5
22109,2020-08-01,47671,44118,3553,7.5
22111,2020-08-01,9571,8928,643,6.7
22113,2020-08-01,24514,22763,1751,7.1
22115,2020-08-01,15716,14662,1054,6.7
22117,2020-08-01,16938,15545,1393,8.2
22119,2020-08-01,14554,13451,1103,7.6
22121,2020-08-01,13802,12830,972,7
22123,2020-08-01,3544,3243,301,8.5
22125,2020-08-01,5340,5083,257,4.8
22127,2020-08-01,4827,4481,346,7.2
23001,2020-08-01,55427,51671,3756,6.8
23003,2020-08-01,30125,28339,1786,5.9
23005,2020-08-01,164662,154418,10244,6.2
23007,2020-08-01,13821,12834,987,7.1
23009,2020-08-01,30255,28660,1595,5.3
23011,2020-08-01,62461,58902,3559,5.7
23013,2020-08-01,20578,19421,1157,5.6
23015,2020-08-01,17239,16243,996,5.8
23017,2020-08-01,26558,24394,2164,8.1
23019,2020-08-01,76053,71523,4530,6
23021,2020-08-01,7373,6952,421,5.7
23023,2020-08-01,19412,18306,1106,5.7
23025,2020-08-01,22399,20822,1577,7
23027,2020-08-01,20722,19521,1201,5.8
23029,2020-08-01,14129,13270,859,6.1
23031,2020-08-01,112903,105851,7052,6.2
24001,2020-08-01,30862,28625,2237,7.2
24003,2020-08-01,315423,296412,19011,6
24005,2020-08-01,457003,424067,32936,7.2
24009,2020-08-01,49463,46819,2644,5.3
24011,2020-08-01,17435,16455,980,5.6
24013,2020-08-01,94535,89708,4827,5.1
24015,2020-08-01,51445,48265,3180,6.2
24017,2020-08-01,87798,81299,6499,7.4
24019,2020-08-01,15160,14094,1066,7
24021,2020-08-01,135631,127351,8280,6.1
24023,2020-08-01,14958,14096,862,5.8
24025,2020-08-01,140314,132003,8311,5.9
24027,2020-08-01,187348,177070,10278,5.5
24029,2020-08-01,9571,8971,600,6.3
24031,2020-08-01,573695,534159,39536,6.9
24033,2020-08-01,521458,473713,47745,9.2
24035,2020-08-01,27365,25902,1463,5.3
24037,2020-08-01,55434,52462,2972,5.4
24039,2020-08-01,9084,8362,722,7.9
24041,2020-08-01,18199,17214,985,5.4
24043,2020-08-01,73507,68510,4997,6.8
24045,2020-08-01,51909,48479,3430,6.6
24047,2020-08-01,25451,23426,2025,8
24510,2020-08-01,293613,265614,27999,9.5
25001,2020-08-01,110351,98863,11488,10.4
25003,2020-08-01,61685,54926,6759,11
25005,2020-08-01,288905,254030,34875,12.1
25007,2020-08-01,11411,10623,788,6.9
25009,2020-08-01,407589,356758,50831,12.5
25011,2020-08-01,37554,34058,3496,9.3
25013,2020-08-01,211245,182517,28728,13.6
25015,2020-08-01,80389,73100,7289,9.1
25017,2020-08-01,857060,776705,80355,9.4
25019,2020-08-01,9486,8913,573,6
25021,2020-08-01,369315,329915,39400,10.7
25023,2020-08-01,269062,238060,31002,11.5
25025,2020-08-01,443608,383940,59668,13.5
25027,2020-08-01,426778,380102,46676,10.9
26001,2020-08-01,4046,3700,346,8.6
26003,2020-08-01,3147,2874,273,8.7
26005,2020-08-01,64096,59992,4104,6.4
26007,2020-08-01,13615,12632,983,7.2
26009,2020-08-01,11124,10275,849,7.6
26011,2020-08-01,6355,5806,549,8.6
26013,2020-08-01,3231,2874,357,11
26015,2020-08-01,32322,30126,2196,6.8
26017,2020-08-01,49397,45189,4208,8.5
26019,2020-08-01,9592,8923,669,7
26021,2020-08-01,76525,69853,6672,8.7
26023,2020-08-01,20067,18538,1529,7.6
26025,2020-08-01,62342,56279,6063,9.7
26027,2020-08-01,24776,22727,2049,8.3
26029,2020-08-01,13467,12500,967,7.2
26031,2020-08-01,11221,10352,869,7.7
26033,2020-08-01,17153,15847,1306,7.6
26035,2020-08-01,11975,10734,1241,10.4
26037,2020-08-01,40323,37879,2444,6.1
26039,2020-08-01,5488,4941,547,10
26041,2020-08-01,18232,16946,1286,7.1
26043,2020-08-01,13062,12242,820,6.3
26045,2020-08-01,55999,51955,4044,7.2
26047,2020-08-01,19412,18068,1344,6.9
26049,2020-08-01,186605,166832,19773,10.6
26051,2020-08-01,9981,9105,876,8.8
26053,2020-08-01,6340,5873,467,7.4
26055,2020-08-01,54407,50750,3657,6.7
26057,2020-08-01,18972,17662,1310,6.9
26059,2020-08-01,20954,19332,1622,7.7
26061,2020-08-01,16991,15809,1182,7
26063,2020-08-01,16652,15575,1077,6.5
26065,2020-08-01,148935,137014,11921,8
26067,2020-08-01,30535,28458,2077,6.8
26069,2020-08-01,10547,9617,930,8.8
26071,2020-08-01,5457,5095,362,6.6
26073,2020-08-01,36841,34235,2606,7.1
26075,2020-08-01,75302,68713,6589,8.8
26077,2020-08-01,137684,127130,10554,7.7
26079,2020-08-01,8671,7896,775,8.9
26081,2020-08-01,368973,340892,28081,7.6
26083,2020-08-01,930,854,76,8.2
26085,2020-08-01,4026,3585,441,11
26087,2020-08-01,39538,36269,3269,8.3
26089,2020-08-01,11500,10798,702,6.1
26091,2020-08-01,47435,43815,3620,7.6
26093,2020-08-01,99401,92736,6665,6.7
26095,2020-08-01,2478,2300,178,7.2
26097,2020-08-01,6394,6099,295,4.6
26099,2020-08-01,437993,395627,42366,9.7
26101,2020-08-01,10445,9459,986,9.4
26103,2020-08-01,34324,32070,2254,6.6
26105,2020-08-01,14131,13002,1129,8
26107,2020-08-01,19440,17940,1500,7.7
26109,2020-08-01,11340,10673,667,5.9
26111,2020-08-01,40480,37655,2825,7
26113,2020-08-01,7595,7069,526,6.9
26115,2020-08-01,73885,67944,5941,8
26117,2020-08-01,29176,26853,2323,8
26119,2020-08-01,3145,2799,346,11
26121,2020-08-01,79897,70832,9065,11.3
26123,2020-08-01,24070,22188,1882,7.8
26125,2020-08-01,655212,603027,52185,8
26127,2020-08-01,12360,11210,1150,9.3
26129,2020-08-01,8547,7765,782,9.1
26131,2020-08-01,2111,1904,207,9.8
26133,2020-08-01,12209,11358,851,7
26135,2020-08-01,3128,2809,319,10.2
26137,2020-08-01,11823,10807,1016,8.6
26139,2020-08-01,163727,153474,10253,6.3
26141,2020-08-01,5120,4664,456,8.9
26143,2020-08-01,7882,7058,824,10.5
26145,2020-08-01,87135,78694,8441,9.7
26147,2020-08-01,73100,66782,6318,8.6
26149,2020-08-01,30168,27695,2473,8.2
26151,2020-08-01,20391,18863,1528,7.5
26153,2020-08-01,3485,3226,259,7.4
26155,2020-08-01,35146,32520,2626,7.5
26157,2020-08-01,24939,22920,2019,8.1
26159,2020-08-01,36371,33565,2806,7.7
26161,2020-08-01,204743,190593,14150,6.9
26163,2020-08-01,790830,689709,101121,12.8
26165,2020-08-01,16119,14770,1349,8.4
27001,2020-08-01,7349,6811,538,7.3
27003,2020-08-01,198948,183845,15103,7.6
27005,2020-08-01,19244,18184,1060,5.5
27007,2020-08-01,24974,23440,1534,6.1
27009,2020-08-01,22359,21008,1351,6
27011,2020-08-01,2441,2353,88,3.6
27013,2020-08-01,41108,38579,2529,6.2
27015,2020-08-01,14575,13902,673,4.6
27017,2020-08-01,17334,15986,1348,7.8
27019,2020-08-01,58419,54801,3618,6.2
27021,2020-08-01,14795,13494,1301,8.8
27023,2020-08-01,6941,6618,323,4.7
27025,2020-08-01,29830,27832,1998,6.7
27027,2020-08-01,36065,34521,1544,4.3
27029,2020-08-01,4331,4045,286,6.6
27031,2020-08-01,3114,2920,194,6.2
27033,2020-08-01,6149,5868,281,4.6
27035,2020-08-01,33120,30947,2173,6.6
27037,2020-08-01,243612,225079,18533,7.6
27039,2020-08-01,11850,11256,594,5
27041,2020-08-01,21574,20622,952,4.4
27043,2020-08-01,7044,6625,419,5.9
27045,2020-08-01,11563,11014,549,4.7
27047,2020-08-01,16642,15651,991,6
27049,2020-08-01,27300,25705,1595,5.8
27051,2020-08-01,3392,3240,152,4.5
27053,2020-08-01,723392,661047,62345,8.6
27055,2020-08-01,9947,9531,416,4.2
27057,2020-08-01,10015,9418,597,6
27059,2020-08-01,21098,19651,1447,6.9
27061,2020-08-01,21808,19946,1862,8.5
27063,2020-08-01,5865,5612,253,4.3
27065,2020-08-01,9015,8455,560,6.2
27067,2020-08-01,24587,23441,1146,4.7
27069,2020-08-01,2348,2242,106,4.5
27071,2020-08-01,5847,5441,406,6.9
27073,2020-08-01,3602,3453,149,4.1
27075,2020-08-01,5416,5056,360,6.6
27077,2020-08-01,2429,2276,153,6.3
27079,2020-08-01,15881,14908,973,6.1
27081,2020-08-01,3246,3144,102,3.1
27083,2020-08-01,14637,13984,653,4.5
27085,2020-08-01,19409,18250,1159,6
27087,2020-08-01,2536,2195,341,13.4
27089,2020-08-01,5223,4999,224,4.3
27091,2020-08-01,10228,9696,532,5.2
27093,2020-08-01,13380,12770,610,4.6
27095,2020-08-01,12773,11797,976,7.6
27097,2020-08-01,17580,16718,862,4.9
27099,2020-08-01,21005,19895,1110,5.3
27101,2020-08-01,4689,4492,197,4.2
27103,2020-08-01,21245,20047,1198,5.6
27105,2020-08-01,11608,11071,537,4.6
27107,2020-08-01,3283,3092,191,5.8
27109,2020-08-01,90000,84423,5577,6.2
27111,2020-08-01,31422,29970,1452,4.6
27113,2020-08-01,8543,8177,366,4.3
27115,2020-08-01,15058,13935,1123,7.5
27117,2020-08-01,4810,4646,164,3.4
27119,2020-08-01,16171,15264,907,5.6
27121,2020-08-01,6615,6310,305,4.6
27123,2020-08-01,296775,270084,26691,9
27125,2020-08-01,2178,2087,91,4.2
27127,2020-08-01,7777,7363,414,5.3
27129,2020-08-01,8455,8033,422,5
27131,2020-08-01,38115,35895,2220,5.8
27133,2020-08-01,5737,5543,194,3.4
27135,2020-08-01,7943,7554,389,4.9
27137,2020-08-01,99255,91453,7802,7.9
27139,2020-08-01,83826,77990,5836,7
27141,2020-08-01,51789,48543,3246,6.3
27143,2020-08-01,8429,7983,446,5.3
27145,2020-08-01,92410,86947,5463,5.9
27147,2020-08-01,21840,20620,1220,5.6
27149,2020-08-01,5396,5218,178,3.3
27151,2020-08-01,5049,4697,352,7
27153,2020-08-01,13846,13204,642,4.6
27155,2020-08-01,1790,1732,58,3.2
27157,2020-08-01,12366,11748,618,5
27159,2020-08-01,6180,5811,369,6
27161,2020-08-01,9242,8640,602,6.5
27163,2020-08-01,143025,133541,9484,6.6
27165,2020-08-01,6567,6267,300,4.6
27167,2020-08-01,3440,3317,123,3.6
27169,2020-08-01,29387,27841,1546,5.3
27171,2020-08-01,74842,70533,4309,5.8
27173,2020-08-01,5402,5176,226,4.2
28001,2020-08-01,10873,9654,1219,11.2
28003,2020-08-01,15466,14595,871,5.6
28005,2020-08-01,4359,3950,409,9.4
28007,2020-08-01,6928,6330,598,8.6
28009,2020-08-01,2939,2686,253,8.6
28011,2020-08-01,11645,10623,1022,8.8
28013,2020-08-01,5250,4861,389,7.4
28015,2020-08-01,3287,3026,261,7.9
28017,2020-08-01,6688,6050,638,9.5
28019,2020-08-01,3540,3320,220,6.2
28021,2020-08-01,3016,2547,469,15.6
28023,2020-08-01,5682,5172,510,9
28025,2020-08-01,7590,6721,869,11.4
28027,2020-08-01,8417,7371,1046,12.4
28029,2020-08-01,10755,9872,883,8.2
28031,2020-08-01,8009,7400,609,7.6
28033,2020-08-01,87572,81797,5775,6.6
28035,2020-08-01,32881,30192,2689,8.2
28037,2020-08-01,2716,2475,241,8.9
28039,2020-08-01,8578,7680,898,10.5
28041,2020-08-01,4154,3693,461,11.1
28043,2020-08-01,9222,8567,655,7.1
28045,2020-08-01,18543,17085,1458,7.9
28047,2020-08-01,86108,79164,6944,8.1
28049,2020-08-01,104974,95534,9440,9
28051,2020-08-01,5402,4549,853,15.8
28053,2020-08-01,2232,1890,342,15.3
28055,2020-08-01,331,303,28,8.5
28057,2020-08-01,10096,9507,589,5.8
28059,2020-08-01,58184,53161,5023,8.6
28061,2020-08-01,5991,5447,544,9.1
28063,2020-08-01,1942,1540,402,20.7
28065,2020-08-01,3886,3483,403,10.4
28067,2020-08-01,25347,23481,1866,7.4
28069,2020-08-01,3373,3046,327,9.7
28071,2020-08-01,26705,25146,1559,5.8
28073,2020-08-01,29901,28148,1753,5.9
28075,2020-08-01,28908,26853,2055,7.1
28077,2020-08-01,4530,4090,440,9.7
28079,2020-08-01,7760,7179,581,7.5
28081,2020-08-01,40163,37338,2825,7
28083,2020-08-01,9678,8605,1073,11.1
28085,2020-08-01,14180,13117,1063,7.5
28087,2020-08-01,24296,22267,2029,8.4
28089,2020-08-01,50876,47994,2882,5.7
28091,2020-08-01,9564,8810,754,7.9
28093,2020-08-01,13979,12802,1177,8.4
28095,2020-08-01,14974,13728,1246,8.3
28097,2020-08-01,3820,3510,310,8.1
28099,2020-08-01,9796,8973,823,8.4
28101,2020-08-01,8360,7733,627,7.5
28103,2020-08-01,3609,3147,462,12.8
28105,2020-08-01,21870,20249,1621,7.4
28107,2020-08-01,12225,10954,1271,10.4
28109,2020-08-01,22746,20970,1776,7.8
28111,2020-08-01,4213,3828,385,9.1
28113,2020-08-01,14440,13058,1382,9.6
28115,2020-08-01,14312,13389,923,6.4
28117,2020-08-01,10616,9938,678,6.4
28119,2020-08-01,2185,1906,279,12.8
28121,2020-08-01,72295,68905,3390,4.7
28123,2020-08-01,12400,11711,689,5.6
28125,2020-08-01,1502,1355,147,9.8
28127,2020-08-01,10330,9608,722,7
28129,2020-08-01,6490,6109,381,5.9
28131,2020-08-01,6647,6118,529,8
28133,2020-08-01,7616,6734,882,11.6
28135,2020-08-01,4818,4426,392,8.1
28137,2020-08-01,11955,10952,1003,8.4
28139,2020-08-01,8924,8353,571,6.4
28141,2020-08-01,8359,7836,523,6.3
28143,2020-08-01,4590,3916,674,14.7
28145,2020-08-01,13873,13042,831,6
28147,2020-08-01,4833,4387,446,9.2
28149,2020-08-01,19735,17999,1736,8.8
28151,2020-08-01,16479,14594,1885,11.4
28153,2020-08-01,7408,6666,742,10
28155,2020-08-01,3792,3532,260,6.9
28157,2020-08-01,2743,2314,429,15.6
28159,2020-08-01,7132,6498,634,8.9
28161,2020-08-01,4593,4247,346,7.5
28163,2020-08-01,9195,8307,888,9.7
29001,2020-08-01,10256,9677,579,5.6
29003,2020-08-01,9643,9156,487,5.1
29005,2020-08-01,2728,2593,135,4.9
29007,2020-08-01,10528,9954,574,5.5
29009,2020-08-01,15885,14774,1111,7
29011,2020-08-01,5233,4946,287,5.5
29013,2020-08-01,7826,7306,520,6.6
29015,2020-08-01,7348,6769,579,7.9
29017,2020-08-01,5080,4759,321,6.3
29019,2020-08-01,96085,91141,4944,5.1
29021,2020-08-01,44098,41604,2494,5.7
29023,2020-08-01,18217,16987,1230,6.8
29025,2020-08-01,4321,4077,244,5.6
29027,2020-08-01,21217,20022,1195,5.6
29029,2020-08-01,18610,17435,1175,6.3
29031,2020-08-01,37563,35323,2240,6
29033,2020-08-01,4665,4415,250,5.4
29035,2020-08-01,2604,2415,189,7.3
29037,2020-08-01,54295,50889,3406,6.3
29039,2020-08-01,5854,5528,326,5.6
29041,2020-08-01,3738,3566,172,4.6
29043,2020-08-01,44384,41938,2446,5.5
29045,2020-08-01,3215,3015,200,6.2
29047,2020-08-01,135458,126621,8837,6.5
29049,2020-08-01,10645,9970,675,6.3
29051,2020-08-01,39033,36657,2376,6.1
29053,2020-08-01,7362,6924,438,5.9
29055,2020-08-01,11070,10262,808,7.3
29057,2020-08-01,3596,3407,189,5.3
29059,2020-08-01,6959,6508,451,6.5
29061,2020-08-01,4228,3990,238,5.6
29063,2020-08-01,4776,4530,246,5.2
29065,2020-08-01,6381,6036,345,5.4
29067,2020-08-01,5058,4753,305,6
29069,2020-08-01,11624,10614,1010,8.7
29071,2020-08-01,52209,48675,3534,6.8
29073,2020-08-01,7693,7282,411,5.3
29075,2020-08-01,3493,3351,142,4.1
29077,2020-08-01,149994,141079,8915,5.9
29079,2020-08-01,4439,4187,252,5.7
29081,2020-08-01,3889,3681,208,5.3
29083,2020-08-01,9771,9169,602,6.2
29085,2020-08-01,3904,3702,202,5.2
29087,2020-08-01,2569,2463,106,4.1
29089,2020-08-01,4823,4582,241,5
29091,2020-08-01,16825,15535,1290,7.7
29093,2020-08-01,3600,3305,295,8.2
29095,2020-08-01,366112,334043,32069,8.8
29097,2020-08-01,56763,53208,3555,6.3
29099,2020-08-01,116165,108110,8055,6.9
29101,2020-08-01,23726,22313,1413,6
29103,2020-08-01,1789,1698,91,5.1
29105,2020-08-01,17195,15861,1334,7.8
29107,2020-08-01,16605,15640,965,5.8
29109,2020-08-01,18364,17072,1292,7
29111,2020-08-01,5035,4752,283,5.6
29113,2020-08-01,27770,25996,1774,6.4
29115,2020-08-01,5204,4802,402,7.7
29117,2020-08-01,7472,7105,367,4.9
29119,2020-08-01,10794,10116,678,6.3
29121,2020-08-01,7648,7168,480,6.3
29123,2020-08-01,5675,5246,429,7.6
29125,2020-08-01,3945,3692,253,6.4
29127,2020-08-01,14751,13800,951,6.4
29129,2020-08-01,1927,1842,85,4.4
29131,2020-08-01,12305,11615,690,5.6
29133,2020-08-01,5854,5447,407,7
29135,2020-08-01,7262,6874,388,5.3
29137,2020-08-01,3840,3559,281,7.3
29139,2020-08-01,5752,5446,306,5.3
29141,2020-08-01,8018,7561,457,5.7
29143,2020-08-01,8517,7905,612,7.2
29145,2020-08-01,27188,25408,1780,6.5
29147,2020-08-01,11285,10776,509,4.5
29149,2020-08-01,4118,3803,315,7.6
29151,2020-08-01,7109,6719,390,5.5
29153,2020-08-01,3471,3214,257,7.4
29155,2020-08-01,6615,5948,667,10.1
29157,2020-08-01,9791,9344,447,4.6
29159,2020-08-01,21379,19856,1523,7.1
29161,2020-08-01,19807,18713,1094,5.5
29163,2020-08-01,7600,7097,503,6.6
29165,2020-08-01,58248,54620,3628,6.2
29167,2020-08-01,14373,13575,798,5.6
29169,2020-08-01,14731,13808,923,6.3
29171,2020-08-01,2254,2136,118,5.2
29173,2020-08-01,5690,5375,315,5.5
29175,2020-08-01,10430,9719,711,6.8
29177,2020-08-01,10866,10164,702,6.5
29179,2020-08-01,3024,2820,204,6.7
29181,2020-08-01,5141,4661,480,9.3
29183,2020-08-01,221336,208740,12596,5.7
29185,2020-08-01,3795,3530,265,7
29186,2020-08-01,9131,8630,501,5.5
29187,2020-08-01,27195,24894,2301,8.5
29189,2020-08-01,529269,487704,41565,7.9
29195,2020-08-01,10962,10385,577,5.3
29197,2020-08-01,1962,1827,135,6.9
29199,2020-08-01,2386,2290,96,4
29201,2020-08-01,19618,18362,1256,6.4
29203,2020-08-01,3328,3047,281,8.4
29205,2020-08-01,3150,2979,171,5.4
29207,2020-08-01,13202,12424,778,5.9
29209,2020-08-01,13886,12769,1117,8
29211,2020-08-01,2721,2590,131,4.8
29213,2020-08-01,27758,24874,2884,10.4
29215,2020-08-01,8996,8367,629,7
29217,2020-08-01,9560,9025,535,5.6
29219,2020-08-01,17668,16496,1172,6.6
29221,2020-08-01,10313,9540,773,7.5
29223,2020-08-01,5135,4766,369,7.2
29225,2020-08-01,17044,16048,996,5.8
29227,2020-08-01,1190,1126,64,5.4
29229,2020-08-01,7483,6947,536,7.2
29510,2020-08-01,156382,138780,17602,11.3
30001,2020-08-01,4989,4815,174,3.5
30003,2020-08-01,4605,4278,327,7.1
30005,2020-08-01,2171,2065,106,4.9
30007,2020-08-01,2597,2449,148,5.7
30009,2020-08-01,5525,5230,295,5.3
30011,2020-08-01,655,636,19,2.9
30013,2020-08-01,38402,36279,2123,5.5
30015,2020-08-01,2444,2357,87,3.6
30017,2020-08-01,6035,5759,276,4.6
30019,2020-08-01,862,843,19,2.2
30021,2020-08-01,4541,4231,310,6.8
30023,2020-08-01,4974,4756,218,4.4
30025,2020-08-01,1708,1631,77,4.5
30027,2020-08-01,5585,5388,197,3.5
30029,2020-08-01,50019,46882,3137,6.3
30031,2020-08-01,71295,68266,3029,4.2
30033,2020-08-01,672,660,12,1.8
30035,2020-08-01,6132,5512,620,10.1
30037,2020-08-01,357,343,14,3.9
30039,2020-08-01,1640,1539,101,6.2
30041,2020-08-01,7321,6934,387,5.3
30043,2020-08-01,5647,5383,264,4.7
30045,2020-08-01,930,883,47,5.1
30047,2020-08-01,13461,12650,811,6
30049,2020-08-01,35776,34062,1714,4.8
30051,2020-08-01,909,887,22,2.4
30053,2020-08-01,8145,7498,647,7.9
30055,2020-08-01,885,849,36,4.1
30057,2020-08-01,4441,4269,172,3.9
30059,2020-08-01,897,860,37,4.1
30061,2020-08-01,1777,1644,133,7.5
30063,2020-08-01,65898,62219,3679,5.6
30065,2020-08-01,2212,2082,130,5.9
30067,2020-08-01,9538,8990,548,5.7
30069,2020-08-01,259,252,7,2.7
30071,2020-08-01,1804,1720,84,4.7
30073,2020-08-01,2549,2400,149,5.8
30075,2020-08-01,916,899,17,1.9
30077,2020-08-01,2846,2740,106,3.7
30079,2020-08-01,453,416,37,8.2
30081,2020-08-01,20172,19148,1024,5.1
30083,2020-08-01,5919,5459,460,7.8
30085,2020-08-01,4251,3975,276,6.5
30087,2020-08-01,3558,3372,186,5.2
30089,2020-08-01,4974,4648,326,6.6
30091,2020-08-01,1748,1664,84,4.8
30093,2020-08-01,17160,16026,1134,6.6
30095,2020-08-01,5291,5019,272,5.1
30097,2020-08-01,1757,1704,53,3
30099,2020-08-01,2650,2550,100,3.8
30101,2020-08-01,2065,1948,117,5.7
30103,2020-08-01,320,306,14,4.4
30105,2020-08-01,3978,3817,161,4
30107,2020-08-01,751,703,48,6.4
30109,2020-08-01,443,421,22,5
30111,2020-08-01,82749,78494,4255,5.1
31001,2020-08-01,16528,16004,524,3.2
31003,2020-08-01,3682,3607,75,2
31005,2020-08-01,216,204,12,5.6
31007,2020-08-01,347,340,7,2
31009,2020-08-01,232,227,5,2.2
31011,2020-08-01,2786,2725,61,2.2
31013,2020-08-01,5290,5027,263,5
31015,2020-08-01,994,970,24,2.4
31017,2020-08-01,1342,1314,28,2.1
31019,2020-08-01,27145,26327,818,3
31021,2020-08-01,3416,3295,121,3.5
31023,2020-08-01,4394,4247,147,3.3
31025,2020-08-01,13663,13159,504,3.7
31027,2020-08-01,4323,4224,99,2.3
31029,2020-08-01,2164,2128,36,1.7
31031,2020-08-01,3245,3182,63,1.9
31033,2020-08-01,4182,4004,178,4.3
31035,2020-08-01,3149,3065,84,2.7
31037,2020-08-01,5483,5331,152,2.8
31039,2020-08-01,4663,4554,109,2.3
31041,2020-08-01,6166,5987,179,2.9
31043,2020-08-01,10915,10445,470,4.3
31045,2020-08-01,4683,4557,126,2.7
31047,2020-08-01,12899,12478,421,3.3
31049,2020-08-01,925,903,22,2.4
31051,2020-08-01,2975,2899,76,2.6
31053,2020-08-01,20005,19351,654,3.3
31055,2020-08-01,307033,292016,15017,4.9
31057,2020-08-01,1085,1061,24,2.2
31059,2020-08-01,3091,3015,76,2.5
31061,2020-08-01,1410,1363,47,3.3
31063,2020-08-01,1433,1399,34,2.4
31065,2020-08-01,2458,2394,64,2.6
31067,2020-08-01,10662,10314,348,3.3
31069,2020-08-01,1031,998,33,3.2
31071,2020-08-01,1118,1099,19,1.7
31073,2020-08-01,1065,1042,23,2.2
31075,2020-08-01,373,366,7,1.9
31077,2020-08-01,1173,1138,35,3
31079,2020-08-01,32003,30266,1737,5.4
31081,2020-08-01,4638,4490,148,3.2
31083,2020-08-01,1754,1711,43,2.5
31085,2020-08-01,558,546,12,2.2
31087,2020-08-01,1262,1220,42,3.3
31089,2020-08-01,5450,5336,114,2.1
31091,2020-08-01,425,417,8,1.9
31093,2020-08-01,3274,3154,120,3.7
31095,2020-08-01,4019,3906,113,2.8
31097,2020-08-01,2014,1940,74,3.7
31099,2020-08-01,3682,3575,107,2.9
31101,2020-08-01,4520,4393,127,2.8
31103,2020-08-01,556,547,9,1.6
31105,2020-08-01,1947,1879,68,3.5
31107,2020-08-01,4451,4346,105,2.4
31109,2020-08-01,183710,176653,7057,3.8
31111,2020-08-01,18105,17452,653,3.6
31113,2020-08-01,433,422,11,2.5
31115,2020-08-01,357,347,10,2.8
31117,2020-08-01,414,407,7,1.7
31119,2020-08-01,19396,18625,771,4
31121,2020-08-01,3922,3769,153,3.9
31123,2020-08-01,2511,2432,79,3.1
31125,2020-08-01,1881,1824,57,3
31127,2020-08-01,3425,3318,107,3.1
31129,2020-08-01,2288,2234,54,2.4
31131,2020-08-01,8232,7979,253,3.1
31133,2020-08-01,1406,1370,36,2.6
31135,2020-08-01,1734,1706,28,1.6
31137,2020-08-01,4792,4660,132,2.8
31139,2020-08-01,3999,3851,148,3.7
31141,2020-08-01,17361,16811,550,3.2
31143,2020-08-01,2776,2704,72,2.6
31145,2020-08-01,5719,5547,172,3
31147,2020-08-01,4149,4031,118,2.8
31149,2020-08-01,813,799,14,1.7
31151,2020-08-01,7155,6939,216,3
31153,2020-08-01,98072,94507,3565,3.6
31155,2020-08-01,11222,10862,360,3.2
31157,2020-08-01,17678,16984,694,3.9
31159,2020-08-01,9061,8768,293,3.2
31161,2020-08-01,2572,2513,59,2.3
31163,2020-08-01,1575,1529,46,2.9
31165,2020-08-01,711,696,15,2.1
31167,2020-08-01,3431,3314,117,3.4
31169,2020-08-01,2612,2552,60,2.3
31171,2020-08-01,401,382,19,4.7
31173,2020-08-01,3037,2904,133,4.4
31175,2020-08-01,2108,2058,50,2.4
31177,2020-08-01,11321,10968,353,3.1
31179,2020-08-01,5295,5161,134,2.5
31181,2020-08-01,1546,1496,50,3.2
31183,2020-08-01,503,493,10,2
31185,2020-08-01,7190,6995,195,2.7
32001,2020-08-01,10505,9946,559,5.3
32003,2020-08-01,NA,931501,171841,15.6
32005,2020-08-01,22709,21014,1695,7.5
32007,2020-08-01,25554,24356,1198,4.7
32009,2020-08-01,399,382,17,4.3
32011,2020-08-01,898,863,35,3.9
32013,2020-08-01,7557,7190,367,4.9
32015,2020-08-01,3012,2881,131,4.3
32017,2020-08-01,1907,1811,96,5
32019,2020-08-01,22338,20553,1785,8
32021,2020-08-01,1954,1838,116,5.9
32023,2020-08-01,17262,15583,1679,9.7
32027,2020-08-01,2281,2169,112,4.9
32029,2020-08-01,1953,1800,153,7.8
32031,2020-08-01,244475,226625,17850,7.3
32033,2020-08-01,4406,4221,185,4.2
32510,2020-08-01,25603,23732,1871,7.3
33001,2020-08-01,30356,28378,1978,6.5
33003,2020-08-01,23330,21719,1611,6.9
33005,2020-08-01,39062,36751,2311,5.9
33007,2020-08-01,14356,13383,973,6.8
33009,2020-08-01,47829,45365,2464,5.2
33011,2020-08-01,235864,219759,16105,6.8
33013,2020-08-01,80520,76045,4475,5.6
33015,2020-08-01,181573,169136,12437,6.8
33017,2020-08-01,70230,65946,4284,6.1
33019,2020-08-01,22246,21055,1191,5.4
34001,2020-08-01,123426,101307,22119,17.9
34003,2020-08-01,492806,437684,55122,11.2
34005,2020-08-01,235923,214027,21896,9.3
34007,2020-08-01,262315,232788,29527,11.3
34009,2020-08-01,47778,42404,5374,11.2
34011,2020-08-01,67481,59691,7790,11.5
34013,2020-08-01,383542,330451,53091,13.8
34015,2020-08-01,154008,138295,15713,10.2
34017,2020-08-01,373585,326406,47179,12.6
34019,2020-08-01,64209,59039,5170,8.1
34021,2020-08-01,207745,189698,18047,8.7
34023,2020-08-01,445786,400485,45301,10.2
34025,2020-08-01,333523,300466,33057,9.9
34027,2020-08-01,256962,234050,22912,8.9
34029,2020-08-01,278844,250059,28785,10.3
34031,2020-08-01,253055,216539,36516,14.4
34033,2020-08-01,29866,26682,3184,10.7
34035,2020-08-01,171123,155869,15254,8.9
34037,2020-08-01,74848,67150,7698,10.3
34039,2020-08-01,281642,249419,32223,11.4
34041,2020-08-01,57772,52457,5315,9.2
35001,2020-08-01,317050,282326,34724,11
35003,2020-08-01,996,899,97,9.7
35005,2020-08-01,25559,22529,3030,11.9
35006,2020-08-01,8383,7346,1037,12.4
35007,2020-08-01,4835,4381,454,9.4
35009,2020-08-01,19625,18070,1555,7.9
35011,2020-08-01,635,598,37,5.8
35013,2020-08-01,87716,78133,9583,10.9
35015,2020-08-01,33426,30093,3333,10
35017,2020-08-01,11472,9967,1505,13.1
35019,2020-08-01,1381,1242,139,10.1
35021,2020-08-01,256,240,16,6.3
35023,2020-08-01,1935,1781,154,8
35025,2020-08-01,31458,26544,4914,15.6
35027,2020-08-01,8227,7163,1064,12.9
35028,2020-08-01,8372,7932,440,5.3
35029,2020-08-01,10835,8959,1876,17.3
35031,2020-08-01,22960,19604,3356,14.6
35033,2020-08-01,1932,1731,201,10.4
35035,2020-08-01,23430,20466,2964,12.7
35037,2020-08-01,2855,2553,302,10.6
35039,2020-08-01,15305,13504,1801,11.8
35041,2020-08-01,7209,6565,644,8.9
35043,2020-08-01,63289,55810,7479,11.8
35045,2020-08-01,48047,41460,6587,13.7
35047,2020-08-01,9986,8908,1078,10.8
35049,2020-08-01,68344,60486,7858,11.5
35051,2020-08-01,3577,3094,483,13.5
35053,2020-08-01,5737,5190,547,9.5
35055,2020-08-01,14953,12744,2209,14.8
35057,2020-08-01,5169,4524,645,12.5
35059,2020-08-01,1595,1495,100,6.3
35061,2020-08-01,28863,25664,3199,11.1
36001,2020-08-01,160457,146102,14355,8.9
36003,2020-08-01,18775,17114,1661,8.8
36005,2020-08-01,612749,483152,129597,21.2
36007,2020-08-01,86079,77858,8221,9.6
36009,2020-08-01,34132,30799,3333,9.8
36011,2020-08-01,36853,33522,3331,9
36013,2020-08-01,54651,49493,5158,9.4
36015,2020-08-01,37334,33768,3566,9.6
36017,2020-08-01,22505,20847,1658,7.4
36019,2020-08-01,37712,34745,2967,7.9
36021,2020-08-01,31522,29252,2270,7.2
36023,2020-08-01,22657,20808,1849,8.2
36025,2020-08-01,19756,18249,1507,7.6
36027,2020-08-01,144717,131288,13429,9.3
36029,2020-08-01,457966,409163,48803,10.7
36031,2020-08-01,17667,16342,1325,7.5
36033,2020-08-01,20521,18786,1735,8.5
36035,2020-08-01,22523,20244,2279,10.1
36037,2020-08-01,29719,27345,2374,8
36039,2020-08-01,21305,19272,2033,9.5
36041,2020-08-01,2580,2436,144,5.6
36043,2020-08-01,28097,25608,2489,8.9
36045,2020-08-01,42602,38728,3874,9.1
36047,2020-08-01,NA,982850,194460,16.5
36049,2020-08-01,11249,10441,808,7.2
36051,2020-08-01,29754,27507,2247,7.6
36053,2020-08-01,32228,29568,2660,8.3
36055,2020-08-01,361686,323801,37885,10.5
36057,2020-08-01,21926,19671,2255,10.3
36059,2020-08-01,725032,648316,76716,10.6
36061,2020-08-01,863573,752365,111208,12.9
36063,2020-08-01,101859,90882,10977,10.8
36065,2020-08-01,102932,93407,9525,9.3
36067,2020-08-01,222336,200344,21992,9.9
36069,2020-08-01,54247,49783,4464,8.2
36071,2020-08-01,185416,166172,19244,10.4
36073,2020-08-01,17296,15618,1678,9.7
36075,2020-08-01,52481,47359,5122,9.8
36077,2020-08-01,27081,24931,2150,7.9
36079,2020-08-01,51383,46670,4713,9.2
36081,2020-08-01,NA,940238,183190,16.3
36083,2020-08-01,81997,75162,6835,8.3
36085,2020-08-01,211445,182342,29103,13.8
36087,2020-08-01,156286,140103,16183,10.4
36089,2020-08-01,44223,40380,3843,8.7
36091,2020-08-01,119994,110707,9287,7.7
36093,2020-08-01,78445,70418,8027,10.2
36095,2020-08-01,14535,13421,1114,7.7
36097,2020-08-01,8427,7751,676,8
36099,2020-08-01,16276,14847,1429,8.8
36101,2020-08-01,42939,39124,3815,8.9
36103,2020-08-01,791349,710115,81234,10.3
36105,2020-08-01,40205,35867,4338,10.8
36107,2020-08-01,23222,21277,1945,8.4
36109,2020-08-01,50467,46889,3578,7.1
36111,2020-08-01,91654,83222,8432,9.2
36113,2020-08-01,31601,28957,2644,8.4
36115,2020-08-01,27991,25820,2171,7.8
36117,2020-08-01,42934,39283,3651,8.5
36119,2020-08-01,490759,436648,54111,11
36121,2020-08-01,18152,16812,1340,7.4
36123,2020-08-01,11455,10672,783,6.8
37001,2020-08-01,79162,73932,5230,6.6
37003,2020-08-01,16594,15547,1047,6.3
37005,2020-08-01,4520,4251,269,6
37007,2020-08-01,10396,9563,833,8
37009,2020-08-01,12996,12341,655,5
37011,2020-08-01,7916,7521,395,5
37013,2020-08-01,18610,17511,1099,5.9
37015,2020-08-01,7467,7030,437,5.9
37017,2020-08-01,14893,13927,966,6.5
37019,2020-08-01,50801,47015,3786,7.5
37021,2020-08-01,132695,122778,9917,7.5
37023,2020-08-01,37717,35336,2381,6.3
37025,2020-08-01,104271,97425,6846,6.6
37027,2020-08-01,33864,31430,2434,7.2
37029,2020-08-01,4457,4252,205,4.6
37031,2020-08-01,31483,29938,1545,4.9
37033,2020-08-01,9371,8730,641,6.8
37035,2020-08-01,73154,68073,5081,6.9
37037,2020-08-01,33350,31668,1682,5
37039,2020-08-01,11256,10522,734,6.5
37041,2020-08-01,5453,5142,311,5.7
37043,2020-08-01,4179,3910,269,6.4
37045,2020-08-01,47961,44617,3344,7
37047,2020-08-01,22837,21142,1695,7.4
37049,2020-08-01,39502,37125,2377,6
37051,2020-08-01,120143,109087,11056,9.2
37053,2020-08-01,13545,12889,656,4.8
37055,2020-08-01,19941,18713,1228,6.2
37057,2020-08-01,76377,71596,4781,6.3
37059,2020-08-01,19479,18300,1179,6.1
37061,2020-08-01,24392,23196,1196,4.9
37063,2020-08-01,162334,151776,10558,6.5
37065,2020-08-01,20374,18192,2182,10.7
37067,2020-08-01,178704,166132,12572,7
37069,2020-08-01,29541,27625,1916,6.5
37071,2020-08-01,106954,98979,7975,7.5
37073,2020-08-01,5103,4844,259,5.1
37075,2020-08-01,3395,3152,243,7.2
37077,2020-08-01,28993,27417,1576,5.4
37079,2020-08-01,9094,8608,486,5.3
37081,2020-08-01,249802,229268,20534,8.2
37083,2020-08-01,19833,18080,1753,8.8
37085,2020-08-01,51290,47809,3481,6.8
37087,2020-08-01,27921,26050,1871,6.7
37089,2020-08-01,50975,47938,3037,6
37091,2020-08-01,9057,8481,576,6.4
37093,2020-08-01,18758,17208,1550,8.3
37095,2020-08-01,1804,1673,131,7.3
37097,2020-08-01,85516,79926,5590,6.5
37099,2020-08-01,19965,18753,1212,6.1
37101,2020-08-01,93316,87717,5599,6
37103,2020-08-01,4080,3864,216,5.3
37105,2020-08-01,25296,23488,1808,7.1
37107,2020-08-01,28058,26411,1647,5.9
37109,2020-08-01,41290,38891,2399,5.8
37111,2020-08-01,20534,19344,1190,5.8
37113,2020-08-01,15514,14621,893,5.8
37115,2020-08-01,9395,8819,576,6.1
37117,2020-08-01,8575,8012,563,6.6
37119,2020-08-01,601230,555791,45439,7.6
37121,2020-08-01,5949,5567,382,6.4
37123,2020-08-01,11097,10406,691,6.2
37125,2020-08-01,41413,38915,2498,6
37127,2020-08-01,40841,37508,3333,8.2
37129,2020-08-01,117479,109951,7528,6.4
37131,2020-08-01,7376,6886,490,6.6
37133,2020-08-01,63114,59133,3981,6.3
37135,2020-08-01,73750,70116,3634,4.9
37137,2020-08-01,5001,4740,261,5.2
37139,2020-08-01,16327,15288,1039,6.4
37141,2020-08-01,26999,25422,1577,5.8
37143,2020-08-01,4756,4483,273,5.7
37145,2020-08-01,17314,16178,1136,6.6
37147,2020-08-01,82958,77504,5454,6.6
37149,2020-08-01,8786,8327,459,5.2
37151,2020-08-01,61963,57967,3996,6.4
37153,2020-08-01,16684,15210,1474,8.8
37155,2020-08-01,49819,45365,4454,8.9
37157,2020-08-01,37736,34919,2817,7.5
37159,2020-08-01,63367,58907,4460,7
37161,2020-08-01,24775,22791,1984,8
37163,2020-08-01,28439,26936,1503,5.3
37165,2020-08-01,11919,10548,1371,11.5
37167,2020-08-01,29884,28260,1624,5.4
37169,2020-08-01,20393,19243,1150,5.6
37171,2020-08-01,33014,31117,1897,5.7
37173,2020-08-01,7716,7275,441,5.7
37175,2020-08-01,14634,13899,735,5
37177,2020-08-01,1419,1327,92,6.5
37179,2020-08-01,117184,110795,6389,5.5
37181,2020-08-01,17763,16083,1680,9.5
37183,2020-08-01,563657,529900,33757,6
37185,2020-08-01,6682,6080,602,9
37187,2020-08-01,4255,3928,327,7.7
37189,2020-08-01,30019,28649,1370,4.6
37191,2020-08-01,47463,44500,2963,6.2
37193,2020-08-01,28994,27362,1632,5.6
37195,2020-08-01,33907,31077,2830,8.3
37197,2020-08-01,16643,15671,972,5.8
37199,2020-08-01,8144,7689,455,5.6
38001,2020-08-01,1034,997,37,3.6
38003,2020-08-01,4936,4780,156,3.2
38005,2020-08-01,2297,2162,135,5.9
38007,2020-08-01,362,347,15,4.1
38009,2020-08-01,2795,2657,138,4.9
38011,2020-08-01,1576,1526,50,3.2
38013,2020-08-01,1030,977,53,5.1
38015,2020-08-01,49886,48042,1844,3.7
38017,2020-08-01,104917,100914,4003,3.8
38019,2020-08-01,1834,1778,56,3.1
38021,2020-08-01,2221,2171,50,2.3
38023,2020-08-01,1373,1325,48,3.5
38025,2020-08-01,3344,3188,156,4.7
38027,2020-08-01,1181,1137,44,3.7
38029,2020-08-01,1391,1331,60,4.3
38031,2020-08-01,1440,1395,45,3.1
38033,2020-08-01,827,799,28,3.4
38035,2020-08-01,36701,35189,1512,4.1
38037,2020-08-01,1188,1163,25,2.1
38039,2020-08-01,1008,981,27,2.7
38041,2020-08-01,1369,1317,52,3.8
38043,2020-08-01,1245,1197,48,3.9
38045,2020-08-01,2005,1964,41,2
38047,2020-08-01,861,839,22,2.6
38049,2020-08-01,2997,2871,126,4.2
38051,2020-08-01,1084,1048,36,3.3
38053,2020-08-01,9972,9215,757,7.6
38055,2020-08-01,4565,4379,186,4.1
38057,2020-08-01,3379,3190,189,5.6
38059,2020-08-01,16452,15728,724,4.4
38061,2020-08-01,7322,6937,385,5.3
38063,2020-08-01,1332,1283,49,3.7
38065,2020-08-01,876,837,39,4.5
38067,2020-08-01,3199,3059,140,4.4
38069,2020-08-01,1609,1554,55,3.4
38071,2020-08-01,5332,5128,204,3.8
38073,2020-08-01,2730,2655,75,2.7
38075,2020-08-01,1190,1137,53,4.5
38077,2020-08-01,8304,8042,262,3.2
38079,2020-08-01,4845,3960,885,18.3
38081,2020-08-01,2629,2571,58,2.2
38083,2020-08-01,652,623,29,4.4
38085,2020-08-01,1252,1194,58,4.6
38087,2020-08-01,391,381,10,2.6
38089,2020-08-01,18576,17154,1422,7.7
38091,2020-08-01,974,945,29,3
38093,2020-08-01,9972,9648,324,3.2
38095,2020-08-01,1081,1056,25,2.3
38097,2020-08-01,4238,4110,128,3
38099,2020-08-01,4972,4760,212,4.3
38101,2020-08-01,30806,29006,1800,5.8
38103,2020-08-01,1854,1789,65,3.5
38105,2020-08-01,24250,21700,2550,10.5
39001,2020-08-01,10921,9925,996,9.1
39003,2020-08-01,47607,43581,4026,8.5
39005,2020-08-01,26429,24686,1743,6.6
39007,2020-08-01,44203,40355,3848,8.7
39009,2020-08-01,27479,25205,2274,8.3
39011,2020-08-01,25093,23494,1599,6.4
39013,2020-08-01,28396,25338,3058,10.8
39015,2020-08-01,19862,18179,1683,8.5
39017,2020-08-01,198391,182329,16062,8.1
39019,2020-08-01,12862,11694,1168,9.1
39021,2020-08-01,19903,18498,1405,7.1
39023,2020-08-01,64215,58844,5371,8.4
39025,2020-08-01,108260,100121,8139,7.5
39027,2020-08-01,17910,16362,1548,8.6
39029,2020-08-01,47357,42627,4730,10
39031,2020-08-01,14251,12960,1291,9.1
39033,2020-08-01,18412,16750,1662,9
39035,2020-08-01,610540,538820,71720,11.7
39037,2020-08-01,25686,24106,1580,6.2
39039,2020-08-01,18029,16722,1307,7.2
39041,2020-08-01,108336,101734,6602,6.1
39043,2020-08-01,36870,33482,3388,9.2
39045,2020-08-01,76969,71306,5663,7.4
39047,2020-08-01,13871,12726,1145,8.3
39049,2020-08-01,703467,639399,64068,9.1
39051,2020-08-01,21897,20432,1465,6.7
39053,2020-08-01,12601,11612,989,7.8
39055,2020-08-01,47078,43986,3092,6.6
39057,2020-08-01,83373,77531,5842,7
39059,2020-08-01,18758,17172,1586,8.5
39061,2020-08-01,428909,389602,39307,9.2
39063,2020-08-01,42139,39405,2734,6.5
39065,2020-08-01,14147,13084,1063,7.5
39067,2020-08-01,6758,6096,662,9.8
39069,2020-08-01,12761,11890,871,6.8
39071,2020-08-01,17117,15619,1498,8.8
39073,2020-08-01,12817,11900,917,7.2
39075,2020-08-01,20844,19998,846,4.1
39077,2020-08-01,27848,25646,2202,7.9
39079,2020-08-01,12985,11837,1148,8.8
39081,2020-08-01,27972,24807,3165,11.3
39083,2020-08-01,31454,29448,2006,6.4
39085,2020-08-01,122025,111590,10435,8.6
39087,2020-08-01,24465,22163,2302,9.4
39089,2020-08-01,89503,82950,6553,7.3
39091,2020-08-01,22487,20909,1578,7
39093,2020-08-01,149615,134837,14778,9.9
39095,2020-08-01,212971,190569,22402,10.5
39097,2020-08-01,20317,19015,1302,6.4
39099,2020-08-01,99643,88401,11242,11.3
39101,2020-08-01,28318,26011,2307,8.1
39103,2020-08-01,93594,86499,7095,7.6
39105,2020-08-01,8984,8061,923,10.3
39107,2020-08-01,23409,22202,1207,5.2
39109,2020-08-01,54239,50329,3910,7.2
39111,2020-08-01,5296,4665,631,11.9
39113,2020-08-01,258959,234197,24762,9.6
39115,2020-08-01,6684,6126,558,8.3
39117,2020-08-01,16535,15362,1173,7.1
39119,2020-08-01,40038,36914,3124,7.8
39121,2020-08-01,4750,4326,424,8.9
39123,2020-08-01,20568,18914,1654,8
39125,2020-08-01,8560,7994,566,6.6
39127,2020-08-01,15661,14308,1353,8.6
39129,2020-08-01,26003,24119,1884,7.2
39131,2020-08-01,10888,9842,1046,9.6
39133,2020-08-01,84470,77722,6748,8
39135,2020-08-01,21056,19680,1376,6.5
39137,2020-08-01,18535,17656,879,4.7
39139,2020-08-01,52715,48163,4552,8.6
39141,2020-08-01,35535,32728,2807,7.9
39143,2020-08-01,30404,28227,2177,7.2
39145,2020-08-01,29517,26861,2656,9
39147,2020-08-01,27734,25669,2065,7.4
39149,2020-08-01,24258,22482,1776,7.3
39151,2020-08-01,183956,168145,15811,8.6
39153,2020-08-01,267137,242012,25125,9.4
39155,2020-08-01,83681,74221,9460,11.3
39157,2020-08-01,45477,42082,3395,7.5
39159,2020-08-01,28385,26686,1699,6
39161,2020-08-01,15066,14173,893,5.9
39163,2020-08-01,5667,5148,519,9.2
39165,2020-08-01,120194,111842,8352,6.9
39167,2020-08-01,28024,25672,2352,8.4
39169,2020-08-01,61911,58158,3753,6.1
39171,2020-08-01,19119,17778,1341,7
39173,2020-08-01,70009,65137,4872,7
39175,2020-08-01,13044,12299,745,5.7
40001,2020-08-01,8099,7661,438,5.4
40003,2020-08-01,2766,2672,94,3.4
40005,2020-08-01,4971,4626,345,6.9
40007,2020-08-01,2826,2770,56,2
40009,2020-08-01,9696,8928,768,7.9
40011,2020-08-01,4659,4385,274,5.9
40013,2020-08-01,21421,20450,971,4.5
40015,2020-08-01,11861,11199,662,5.6
40017,2020-08-01,74277,70172,4105,5.5
40019,2020-08-01,21061,19791,1270,6
40021,2020-08-01,18716,17803,913,4.9
40023,2020-08-01,5444,5034,410,7.5
40025,2020-08-01,1391,1365,26,1.9
40027,2020-08-01,141749,134582,7167,5.1
40029,2020-08-01,2406,2261,145,6
40031,2020-08-01,47275,44617,2658,5.6
40033,2020-08-01,2756,2586,170,6.2
40035,2020-08-01,5777,5505,272,4.7
40037,2020-08-01,30940,29042,1898,6.1
40039,2020-08-01,15657,14830,827,5.3
40041,2020-08-01,18137,17344,793,4.4
40043,2020-08-01,2973,2832,141,4.7
40045,2020-08-01,2113,2010,103,4.9
40047,2020-08-01,25943,24554,1389,5.4
40049,2020-08-01,12480,11698,782,6.3
40051,2020-08-01,26657,25102,1555,5.8
40053,2020-08-01,2646,2565,81,3.1
40055,2020-08-01,1902,1767,135,7.1
40057,2020-08-01,1220,1178,42,3.4
40059,2020-08-01,1786,1732,54,3
40061,2020-08-01,4231,3918,313,7.4
40063,2020-08-01,5427,5037,390,7.2
40065,2020-08-01,10667,10286,381,3.6
40067,2020-08-01,2546,2377,169,6.6
40069,2020-08-01,3282,3028,254,7.7
40071,2020-08-01,17887,16791,1096,6.1
40073,2020-08-01,8921,8550,371,4.2
40075,2020-08-01,3410,3239,171,5
40077,2020-08-01,3124,2821,303,9.7
40079,2020-08-01,19035,17797,1238,6.5
40081,2020-08-01,15664,14886,778,5
40083,2020-08-01,21949,20925,1024,4.7
40085,2020-08-01,6078,5842,236,3.9
40087,2020-08-01,19751,18725,1026,5.2
40089,2020-08-01,14933,13989,944,6.3
40091,2020-08-01,7225,6688,537,7.4
40093,2020-08-01,3832,3656,176,4.6
40095,2020-08-01,6899,6536,363,5.3
40097,2020-08-01,19234,18307,927,4.8
40099,2020-08-01,6352,5988,364,5.7
40101,2020-08-01,29428,27866,1562,5.3
40103,2020-08-01,5496,5308,188,3.4
40105,2020-08-01,4597,4371,226,4.9
40107,2020-08-01,4492,4223,269,6
40109,2020-08-01,384154,361613,22541,5.9
40111,2020-08-01,15336,14304,1032,6.7
40113,2020-08-01,20262,19047,1215,6
40115,2020-08-01,14270,13660,610,4.3
40117,2020-08-01,7229,6793,436,6
40119,2020-08-01,37757,36100,1657,4.4
40121,2020-08-01,16956,15767,1189,7
40123,2020-08-01,18964,18125,839,4.4
40125,2020-08-01,32173,30400,1773,5.5
40127,2020-08-01,4321,4045,276,6.4
40129,2020-08-01,1857,1760,97,5.2
40131,2020-08-01,44029,41620,2409,5.5
40133,2020-08-01,9441,8808,633,6.7
40135,2020-08-01,16181,15208,973,6
40137,2020-08-01,18697,17267,1430,7.6
40139,2020-08-01,11817,11598,219,1.9
40141,2020-08-01,3011,2889,122,4.1
40143,2020-08-01,317869,298090,19779,6.2
40145,2020-08-01,37045,35042,2003,5.4
40147,2020-08-01,21809,20618,1191,5.5
40149,2020-08-01,5164,4797,367,7.1
40151,2020-08-01,4637,4484,153,3.3
40153,2020-08-01,8886,8250,636,7.2
41001,2020-08-01,7067,6554,513,7.3
41003,2020-08-01,44669,41713,2956,6.6
41005,2020-08-01,216341,198464,17877,8.3
41007,2020-08-01,19635,17912,1723,8.8
41009,2020-08-01,23768,21735,2033,8.6
41011,2020-08-01,25875,23531,2344,9.1
41013,2020-08-01,9946,9063,883,8.9
41015,2020-08-01,8763,7989,774,8.8
41017,2020-08-01,94530,86863,7667,8.1
41019,2020-08-01,45293,41735,3558,7.9
41021,2020-08-01,1038,972,66,6.4
41023,2020-08-01,3206,2987,219,6.8
41025,2020-08-01,3565,3364,201,5.6
41027,2020-08-01,15389,14456,933,6.1
41029,2020-08-01,104335,95368,8967,8.6
41031,2020-08-01,9725,8842,883,9.1
41033,2020-08-01,34806,31739,3067,8.8
41035,2020-08-01,28412,25986,2426,8.5
41037,2020-08-01,3739,3540,199,5.3
41039,2020-08-01,183346,167825,15521,8.5
41041,2020-08-01,20667,18440,2227,10.8
41043,2020-08-01,58604,53747,4857,8.3
41045,2020-08-01,12454,11773,681,5.5
41047,2020-08-01,159159,147099,12060,7.6
41049,2020-08-01,5799,5490,309,5.3
41051,2020-08-01,458598,410644,47954,10.5
41053,2020-08-01,38726,35888,2838,7.3
41055,2020-08-01,963,896,67,7
41057,2020-08-01,11883,10947,936,7.9
41059,2020-08-01,37360,34744,2616,7
41061,2020-08-01,11735,10899,836,7.1
41063,2020-08-01,3514,3321,193,5.5
41065,2020-08-01,13315,12340,975,7.3
41067,2020-08-01,318034,293803,24231,7.6
41069,2020-08-01,661,633,28,4.2
41071,2020-08-01,53915,49980,3935,7.3
42001,2020-08-01,54582,50639,3943,7.2
42003,2020-08-01,632167,562421,69746,11
42005,2020-08-01,31260,27836,3424,11
42007,2020-08-01,82672,72606,10066,12.2
42009,2020-08-01,22881,20724,2157,9.4
42011,2020-08-01,221761,198778,22983,10.4
42013,2020-08-01,57915,52506,5409,9.3
42015,2020-08-01,28009,25697,2312,8.3
42017,2020-08-01,333362,300683,32679,9.8
42019,2020-08-01,95327,86998,8329,8.7
42021,2020-08-01,55116,49261,5855,10.6
42023,2020-08-01,2021,1764,257,12.7
42025,2020-08-01,31264,27893,3371,10.8
42027,2020-08-01,74769,70123,4646,6.2
42029,2020-08-01,274202,253322,20880,7.6
42031,2020-08-01,16321,14974,1347,8.3
42033,2020-08-01,35489,32056,3433,9.7
42035,2020-08-01,17594,16032,1562,8.9
42037,2020-08-01,33164,30415,2749,8.3
42039,2020-08-01,36507,32821,3686,10.1
42041,2020-08-01,130786,121091,9695,7.4
42043,2020-08-01,145973,131010,14963,10.3
42045,2020-08-01,294889,261903,32986,11.2
42047,2020-08-01,15255,13238,2017,13.2
42049,2020-08-01,123744,109915,13829,11.2
42051,2020-08-01,56205,48774,7431,13.2
42053,2020-08-01,1775,1571,204,11.5
42055,2020-08-01,77057,70283,6774,8.8
42057,2020-08-01,8249,7120,1129,13.7
42059,2020-08-01,16213,14426,1787,11
42061,2020-08-01,19513,17349,2164,11.1
42063,2020-08-01,37472,33622,3850,10.3
42065,2020-08-01,19975,18027,1948,9.8
42067,2020-08-01,12134,11288,846,7
42069,2020-08-01,99513,88362,11151,11.2
42071,2020-08-01,290361,266757,23604,8.1
42073,2020-08-01,38944,34466,4478,11.5
42075,2020-08-01,71360,64888,6472,9.1
42077,2020-08-01,190196,168648,21548,11.3
42079,2020-08-01,150317,131390,18927,12.6
42081,2020-08-01,52241,46930,5311,10.2
42083,2020-08-01,16791,15076,1715,10.2
42085,2020-08-01,46379,41243,5136,11.1
42087,2020-08-01,20659,18772,1887,9.1
42089,2020-08-01,79408,69079,10329,13
42091,2020-08-01,438453,398249,40204,9.2
42093,2020-08-01,8953,8370,583,6.5
42095,2020-08-01,157466,141223,16243,10.3
42097,2020-08-01,41488,37197,4291,10.3
42099,2020-08-01,24273,22524,1749,7.2
42101,2020-08-01,733112,617212,115900,15.8
42103,2020-08-01,24376,21449,2927,12
42105,2020-08-01,7000,6328,672,9.6
42107,2020-08-01,65161,58341,6820,10.5
42109,2020-08-01,19043,17696,1347,7.1
42111,2020-08-01,32449,29162,3287,10.1
42113,2020-08-01,2528,2296,232,9.2
42115,2020-08-01,19464,17942,1522,7.8
42117,2020-08-01,18665,16798,1867,10
42119,2020-08-01,18828,17494,1334,7.1
42121,2020-08-01,21589,19398,2191,10.1
42123,2020-08-01,18286,16613,1673,9.1
42125,2020-08-01,103960,92702,11258,10.8
42127,2020-08-01,21882,19838,2044,9.3
42129,2020-08-01,174757,156861,17896,10.2
42131,2020-08-01,12709,11558,1151,9.1
42133,2020-08-01,232162,211240,20922,9
44001,2020-08-01,24879,22358,2521,10.1
44003,2020-08-01,88202,77831,10371,11.8
44005,2020-08-01,42540,38026,4514,10.6
44007,2020-08-01,324003,277349,46654,14.4
44009,2020-08-01,66339,59554,6785,10.2
45001,2020-08-01,10226,9590,636,6.2
45003,2020-08-01,75546,71880,3666,4.9
45005,2020-08-01,2752,2452,300,10.9
45007,2020-08-01,94650,89018,5632,6
45009,2020-08-01,5161,4651,510,9.9
45011,2020-08-01,8260,7616,644,7.8
45013,2020-08-01,82267,78076,4191,5.1
45015,2020-08-01,105425,98817,6608,6.3
45017,2020-08-01,6744,6278,466,6.9
45019,2020-08-01,217452,201545,15907,7.3
45021,2020-08-01,26499,24269,2230,8.4
45023,2020-08-01,13855,12424,1431,10.3
45025,2020-08-01,22661,21189,1472,6.5
45027,2020-08-01,13029,12088,941,7.2
45029,2020-08-01,17452,16205,1247,7.1
45031,2020-08-01,31951,29538,2413,7.6
45033,2020-08-01,13615,12707,908,6.7
45035,2020-08-01,79410,74267,5143,6.5
45037,2020-08-01,10835,10301,534,4.9
45039,2020-08-01,9934,9061,873,8.8
45041,2020-08-01,69798,65316,4482,6.4
45043,2020-08-01,27012,24835,2177,8.1
45045,2020-08-01,264710,249437,15273,5.8
45047,2020-08-01,32276,30003,2273,7
45049,2020-08-01,8754,8244,510,5.8
45051,2020-08-01,149080,136632,12448,8.3
45053,2020-08-01,13447,12712,735,5.5
45055,2020-08-01,29707,28021,1686,5.7
45057,2020-08-01,41842,38529,3313,7.9
45059,2020-08-01,31571,29377,2194,6.9
45061,2020-08-01,6872,6277,595,8.7
45063,2020-08-01,151722,144591,7131,4.7
45065,2020-08-01,3429,3201,228,6.6
45067,2020-08-01,13523,12276,1247,9.2
45069,2020-08-01,9720,8662,1058,10.9
45071,2020-08-01,19347,18330,1017,5.3
45073,2020-08-01,35973,34150,1823,5.1
45075,2020-08-01,37115,33324,3791,10.2
45077,2020-08-01,58922,56012,2910,4.9
45079,2020-08-01,204656,190637,14019,6.9
45081,2020-08-01,8926,8560,366,4.1
45083,2020-08-01,155732,144603,11129,7.1
45085,2020-08-01,44065,40592,3473,7.9
45087,2020-08-01,12100,10903,1197,9.9
45089,2020-08-01,12665,11456,1209,9.5
45091,2020-08-01,141617,131713,9904,7
46003,2020-08-01,1559,1507,52,3.3
46005,2020-08-01,9743,9338,405,4.2
46007,2020-08-01,1125,1065,60,5.3
46009,2020-08-01,2937,2816,121,4.1
46011,2020-08-01,18767,17949,818,4.4
46013,2020-08-01,20764,19867,897,4.3
46015,2020-08-01,2496,2394,102,4.1
46017,2020-08-01,713,635,78,10.9
46019,2020-08-01,5191,4898,293,5.6
46021,2020-08-01,791,758,33,4.2
46023,2020-08-01,4024,3654,370,9.2
46025,2020-08-01,1906,1826,80,4.2
46027,2020-08-01,6897,6569,328,4.8
46029,2020-08-01,15673,14926,747,4.8
46031,2020-08-01,1340,1237,103,7.7
46033,2020-08-01,3986,3738,248,6.2
46035,2020-08-01,11239,10798,441,3.9
46037,2020-08-01,2806,2667,139,5
46039,2020-08-01,2229,2115,114,5.1
46041,2020-08-01,2247,1986,261,11.6
46043,2020-08-01,1596,1546,50,3.1
46045,2020-08-01,2016,1960,56,2.8
46047,2020-08-01,3096,2895,201,6.5
46049,2020-08-01,1053,1012,41,3.9
46051,2020-08-01,4433,4283,150,3.4
46053,2020-08-01,2011,1931,80,4
46055,2020-08-01,1048,1018,30,2.9
46057,2020-08-01,3350,3240,110,3.3
46059,2020-08-01,1760,1704,56,3.2
46061,2020-08-01,1752,1668,84,4.8
46063,2020-08-01,744,713,31,4.2
46065,2020-08-01,10009,9688,321,3.2
46067,2020-08-01,3610,3483,127,3.5
46069,2020-08-01,687,663,24,3.5
46071,2020-08-01,1345,1289,56,4.2
46073,2020-08-01,1131,1094,37,3.3
46075,2020-08-01,600,574,26,4.3
46077,2020-08-01,2649,2554,95,3.6
46079,2020-08-01,6525,6238,287,4.4
46081,2020-08-01,13631,12932,699,5.1
46083,2020-08-01,34416,33129,1287,3.7
46085,2020-08-01,1802,1685,117,6.5
46087,2020-08-01,3068,2947,121,3.9
46089,2020-08-01,1003,939,64,6.4
46091,2020-08-01,2446,2341,105,4.3
46093,2020-08-01,13905,13234,671,4.8
46095,2020-08-01,757,709,48,6.3
46097,2020-08-01,1208,1135,73,6
46099,2020-08-01,112960,107938,5022,4.4
46101,2020-08-01,4126,3896,230,5.6
46102,2020-08-01,3983,3406,577,14.5
46103,2020-08-01,56175,53170,3005,5.3
46105,2020-08-01,1453,1382,71,4.9
46107,2020-08-01,1083,1044,39,3.6
46109,2020-08-01,4911,4609,302,6.1
46111,2020-08-01,1179,1130,49,4.2
46115,2020-08-01,3223,3088,135,4.2
46117,2020-08-01,1857,1785,72,3.9
46119,2020-08-01,810,775,35,4.3
46121,2020-08-01,3163,2921,242,7.7
46123,2020-08-01,3091,2994,97,3.1
46125,2020-08-01,4675,4494,181,3.9
46127,2020-08-01,8450,8005,445,5.3
46129,2020-08-01,2204,2064,140,6.4
46135,2020-08-01,12051,11503,548,4.5
46137,2020-08-01,924,856,68,7.4
47001,2020-08-01,35149,32678,2471,7
47003,2020-08-01,21423,19764,1659,7.7
47005,2020-08-01,7071,6422,649,9.2
47007,2020-08-01,4411,4062,349,7.9
47009,2020-08-01,64454,60193,4261,6.6
47011,2020-08-01,54210,50296,3914,7.2
47013,2020-08-01,14933,13871,1062,7.1
47015,2020-08-01,6514,6119,395,6.1
47017,2020-08-01,12135,11225,910,7.5
47019,2020-08-01,23835,21994,1841,7.7
47021,2020-08-01,21958,20530,1428,6.5
47023,2020-08-01,8448,7963,485,5.7
47025,2020-08-01,12948,12117,831,6.4
47027,2020-08-01,2759,2568,191,6.9
47029,2020-08-01,15422,13947,1475,9.6
47031,2020-08-01,25932,24068,1864,7.2
47033,2020-08-01,6955,6527,428,6.2
47035,2020-08-01,23973,22261,1712,7.1
47037,2020-08-01,422032,377419,44613,10.6
47039,2020-08-01,4609,4222,387,8.4
47041,2020-08-01,7732,7076,656,8.5
47043,2020-08-01,26782,25104,1678,6.3
47045,2020-08-01,16912,15536,1376,8.1
47047,2020-08-01,19145,17681,1464,7.6
47049,2020-08-01,7579,7072,507,6.7
47051,2020-08-01,20212,18869,1343,6.6
47053,2020-08-01,22364,20696,1668,7.5
47055,2020-08-01,14912,13726,1186,8
47057,2020-08-01,9685,8964,721,7.4
47059,2020-08-01,29812,27266,2546,8.5
47061,2020-08-01,5138,4674,464,9
47063,2020-08-01,28483,26380,2103,7.4
47065,2020-08-01,191334,176319,15015,7.8
47067,2020-08-01,2161,1969,192,8.9
47069,2020-08-01,9800,8850,950,9.7
47071,2020-08-01,10834,10032,802,7.4
47073,2020-08-01,23471,21631,1840,7.8
47075,2020-08-01,8095,7163,932,11.5
47077,2020-08-01,12495,11513,982,7.9
47079,2020-08-01,14412,13381,1031,7.2
47081,2020-08-01,11351,10670,681,6
47083,2020-08-01,3304,3027,277,8.4
47085,2020-08-01,8972,8395,577,6.4
47087,2020-08-01,4764,4386,378,7.9
47089,2020-08-01,24903,23094,1809,7.3
47091,2020-08-01,7782,7310,472,6.1
47093,2020-08-01,247882,231650,16232,6.5
47095,2020-08-01,1782,1617,165,9.3
47097,2020-08-01,10086,9061,1025,10.2
47099,2020-08-01,19592,18088,1504,7.7
47101,2020-08-01,5242,4852,390,7.4
47103,2020-08-01,16106,14808,1298,8.1
47105,2020-08-01,23700,22172,1528,6.4
47107,2020-08-01,24239,22363,1876,7.7
47109,2020-08-01,8883,8067,816,9.2
47111,2020-08-01,11265,10476,789,7
47113,2020-08-01,50230,45612,4618,9.2
47115,2020-08-01,12880,11864,1016,7.9
47117,2020-08-01,15874,14596,1278,8.1
47119,2020-08-01,49892,45867,4025,8.1
47121,2020-08-01,5417,4936,481,8.9
47123,2020-08-01,20694,19190,1504,7.3
47125,2020-08-01,87004,79458,7546,8.7
47127,2020-08-01,3607,3424,183,5.1
47129,2020-08-01,7927,7372,555,7
47131,2020-08-01,12819,11877,942,7.3
47133,2020-08-01,10234,9664,570,5.6
47135,2020-08-01,3059,2811,248,8.1
47137,2020-08-01,2344,2223,121,5.2
47139,2020-08-01,7739,7226,513,6.6
47141,2020-08-01,36012,33604,2408,6.7
47143,2020-08-01,13456,12264,1192,8.9
47145,2020-08-01,23531,21930,1601,6.8
47147,2020-08-01,37954,35321,2633,6.9
47149,2020-08-01,185571,171456,14115,7.6
47151,2020-08-01,8414,7682,732,8.7
47153,2020-08-01,6413,5908,505,7.9
47155,2020-08-01,55787,51119,4668,8.4
47157,2020-08-01,472390,408329,64061,13.6
47159,2020-08-01,9346,8800,546,5.8
47161,2020-08-01,5526,5166,360,6.5
47163,2020-08-01,69976,64387,5589,8
47165,2020-08-01,103376,95568,7808,7.6
47167,2020-08-01,28091,25855,2236,8
47169,2020-08-01,5417,5040,377,7
47171,2020-08-01,7020,6419,601,8.6
47173,2020-08-01,7758,7198,560,7.2
47175,2020-08-01,2098,1938,160,7.6
47177,2020-08-01,16752,15433,1319,7.9
47179,2020-08-01,59571,55380,4191,7
47181,2020-08-01,6237,5779,458,7.3
47183,2020-08-01,15629,14636,993,6.4
47185,2020-08-01,12419,11542,877,7.1
47187,2020-08-01,127059,120377,6682,5.3
47189,2020-08-01,77147,71375,5772,7.5
48001,2020-08-01,23896,22637,1259,5.3
48003,2020-08-01,10132,9340,792,7.8
48005,2020-08-01,36035,33525,2510,7
48007,2020-08-01,9410,8714,696,7.4
48009,2020-08-01,4146,3955,191,4.6
48011,2020-08-01,910,879,31,3.4
48013,2020-08-01,22526,20738,1788,7.9
48015,2020-08-01,14113,13275,838,5.9
48017,2020-08-01,2400,2302,98,4.1
48019,2020-08-01,10186,9666,520,5.1
48021,2020-08-01,44068,41716,2352,5.3
48023,2020-08-01,1810,1759,51,2.8
48025,2020-08-01,10128,9158,970,9.6
48027,2020-08-01,146410,137271,9139,6.2
48029,2020-08-01,975757,908506,67251,6.9
48031,2020-08-01,6605,6384,221,3.3
48033,2020-08-01,417,404,13,3.1
48035,2020-08-01,8399,8001,398,4.7
48037,2020-08-01,40803,38269,2534,6.2
48039,2020-08-01,181332,166976,14356,7.9
48041,2020-08-01,121503,115930,5573,4.6
48043,2020-08-01,4287,4033,254,5.9
48045,2020-08-01,573,551,22,3.8
48047,2020-08-01,2700,2433,267,9.9
48049,2020-08-01,15499,14603,896,5.8
48051,2020-08-01,8610,8131,479,5.6
48053,2020-08-01,23669,22702,967,4.1
48055,2020-08-01,20210,19057,1153,5.7
48057,2020-08-01,12268,11609,659,5.4
48059,2020-08-01,6207,5914,293,4.7
48061,2020-08-01,170009,154146,15863,9.3
48063,2020-08-01,5054,4689,365,7.2
48065,2020-08-01,2957,2852,105,3.6
48067,2020-08-01,12641,11723,918,7.3
48069,2020-08-01,3405,3297,108,3.2
48071,2020-08-01,19868,18061,1807,9.1
48073,2020-08-01,21284,19670,1614,7.6
48075,2020-08-01,2867,2769,98,3.4
48077,2020-08-01,4940,4703,237,4.8
48079,2020-08-01,1136,1057,79,7
48081,2020-08-01,1460,1388,72,4.9
48083,2020-08-01,2913,2717,196,6.7
48085,2020-08-01,579516,547741,31775,5.5
48087,2020-08-01,1099,1060,39,3.5
48089,2020-08-01,9740,9233,507,5.2
48091,2020-08-01,74456,70407,4049,5.4
48093,2020-08-01,5658,5385,273,4.8
48095,2020-08-01,1354,1304,50,3.7
48097,2020-08-01,20436,19213,1223,6
48099,2020-08-01,24371,22996,1375,5.6
48101,2020-08-01,521,499,22,4.2
48103,2020-08-01,1612,1393,219,13.6
48105,2020-08-01,1655,1518,137,8.3
48107,2020-08-01,2501,2397,104,4.2
48109,2020-08-01,1024,944,80,7.8
48111,2020-08-01,3750,3659,91,2.4
48113,2020-08-01,NA,NA,97733,6.9
48115,2020-08-01,4846,4463,383,7.9
48117,2020-08-01,8413,8140,273,3.2
48119,2020-08-01,2418,2303,115,4.8
48121,2020-08-01,510046,481140,28906,5.7
48123,2020-08-01,9932,9358,574,5.8
48125,2020-08-01,667,632,35,5.2
48127,2020-08-01,7249,6840,409,5.6
48129,2020-08-01,1341,1280,61,4.5
48131,2020-08-01,5091,4488,603,11.8
48133,2020-08-01,7682,7234,448,5.8
48135,2020-08-01,87776,78028,9748,11.1
48137,2020-08-01,1121,1082,39,3.5
48139,2020-08-01,95148,90105,5043,5.3
48141,2020-08-01,370138,343183,26955,7.3
48143,2020-08-01,20882,19888,994,4.8
48145,2020-08-01,6882,6514,368,5.3
48147,2020-08-01,17740,17043,697,3.9
48149,2020-08-01,12002,11497,505,4.2
48151,2020-08-01,1608,1538,70,4.4
48153,2020-08-01,2535,2403,132,5.2
48155,2020-08-01,580,562,18,3.1
48157,2020-08-01,396583,367832,28751,7.2
48159,2020-08-01,4640,4408,232,5
48161,2020-08-01,6370,5873,497,7.8
48163,2020-08-01,10349,9834,515,5
48165,2020-08-01,9867,9346,521,5.3
48167,2020-08-01,167573,154313,13260,7.9
48169,2020-08-01,2188,2041,147,6.7
48171,2020-08-01,13528,12984,544,4
48173,2020-08-01,790,762,28,3.5
48175,2020-08-01,3295,3040,255,7.7
48177,2020-08-01,9694,9210,484,5
48179,2020-08-01,8219,7581,638,7.8
48181,2020-08-01,66052,62735,3317,5
48183,2020-08-01,58104,53659,4445,7.7
48185,2020-08-01,11435,10598,837,7.3
48187,2020-08-01,82442,78101,4341,5.3
48189,2020-08-01,11894,11194,700,5.9
48191,2020-08-01,1046,988,58,5.5
48193,2020-08-01,3633,3484,149,4.1
48195,2020-08-01,2628,2545,83,3.2
48197,2020-08-01,1727,1666,61,3.5
48199,2020-08-01,24719,22686,2033,8.2
48201,2020-08-01,NA,NA,200249,8.5
48203,2020-08-01,29106,26992,2114,7.3
48205,2020-08-01,2691,2648,43,1.6
48207,2020-08-01,2267,2159,108,4.8
48209,2020-08-01,123724,116770,6954,5.6
48211,2020-08-01,1789,1720,69,3.9
48213,2020-08-01,37254,35039,2215,5.9
48215,2020-08-01,362084,322758,39326,10.9
48217,2020-08-01,16711,15769,942,5.6
48219,2020-08-01,11334,10481,853,7.5
48221,2020-08-01,27935,26274,1661,5.9
48223,2020-08-01,17451,16656,795,4.6
48225,2020-08-01,10117,9650,467,4.6
48227,2020-08-01,14617,13495,1122,7.7
48229,2020-08-01,1876,1738,138,7.4
48231,2020-08-01,44573,42020,2553,5.7
48233,2020-08-01,8464,7932,532,6.3
48235,2020-08-01,763,719,44,5.8
48237,2020-08-01,3342,3120,222,6.6
48239,2020-08-01,7564,7151,413,5.5
48241,2020-08-01,12902,11553,1349,10.5
48243,2020-08-01,997,954,43,4.3
48245,2020-08-01,106465,94683,11782,11.1
48247,2020-08-01,1855,1667,188,10.1
48249,2020-08-01,17553,15404,2149,12.2
48251,2020-08-01,83078,78244,4834,5.8
48253,2020-08-01,5855,5484,371,6.3
48255,2020-08-01,7387,6928,459,6.2
48257,2020-08-01,66620,62635,3985,6
48259,2020-08-01,22330,21376,954,4.3
48261,2020-08-01,195,186,9,4.6
48263,2020-08-01,480,462,18,3.8
48265,2020-08-01,22414,21374,1040,4.6
48267,2020-08-01,1843,1751,92,5
48269,2020-08-01,236,233,3,1.3
48271,2020-08-01,1367,1308,59,4.3
48273,2020-08-01,13644,12534,1110,8.1
48275,2020-08-01,1442,1368,74,5.1
48277,2020-08-01,24448,23064,1384,5.7
48279,2020-08-01,5283,5046,237,4.5
48281,2020-08-01,9269,8863,406,4.4
48283,2020-08-01,4314,4059,255,5.9
48285,2020-08-01,8301,7871,430,5.2
48287,2020-08-01,10049,9638,411,4.1
48289,2020-08-01,6390,5965,425,6.7
48291,2020-08-01,34003,30578,3425,10.1
48293,2020-08-01,8795,8216,579,6.6
48295,2020-08-01,1573,1513,60,3.8
48297,2020-08-01,5658,5271,387,6.8
48299,2020-08-01,8767,8345,422,4.8
48301,2020-08-01,708,705,3,0.4
48303,2020-08-01,159567,151262,8305,5.2
48305,2020-08-01,2805,2681,124,4.4
48307,2020-08-01,3331,3108,223,6.7
48309,2020-08-01,125044,118346,6698,5.4
48311,2020-08-01,875,852,23,2.6
48313,2020-08-01,4578,4265,313,6.8
48315,2020-08-01,4211,3882,329,7.8
48317,2020-08-01,2744,2585,159,5.8
48319,2020-08-01,1788,1699,89,5
48321,2020-08-01,17156,15484,1672,9.7
48323,2020-08-01,24660,21282,3378,13.7
48325,2020-08-01,22138,20941,1197,5.4
48327,2020-08-01,863,824,39,4.5
48329,2020-08-01,103607,95184,8423,8.1
48331,2020-08-01,9780,9141,639,6.5
48333,2020-08-01,1880,1814,66,3.5
48335,2020-08-01,2401,2198,203,8.5
48337,2020-08-01,9360,8796,564,6
48339,2020-08-01,286689,266928,19761,6.9
48341,2020-08-01,10674,10306,368,3.4
48343,2020-08-01,4980,4424,556,11.2
48345,2020-08-01,468,450,18,3.8
48347,2020-08-01,27796,26088,1708,6.1
48349,2020-08-01,24169,22897,1272,5.3
48351,2020-08-01,5076,4569,507,10
48353,2020-08-01,7298,6940,358,4.9
48355,2020-08-01,168150,154205,13945,8.3
48357,2020-08-01,4141,3918,223,5.4
48359,2020-08-01,891,866,25,2.8
48361,2020-08-01,35902,32442,3460,9.6
48363,2020-08-01,13781,12877,904,6.6
48365,2020-08-01,10109,9343,766,7.6
48367,2020-08-01,67974,64391,3583,5.3
48369,2020-08-01,4733,4630,103,2.2
48371,2020-08-01,6350,5813,537,8.5
48373,2020-08-01,18333,16855,1478,8.1
48375,2020-08-01,54417,51747,2670,4.9
48377,2020-08-01,3291,2821,470,14.3
48379,2020-08-01,6147,5897,250,4.1
48381,2020-08-01,70375,67691,2684,3.8
48383,2020-08-01,1986,1800,186,9.4
48385,2020-08-01,999,931,68,6.8
48387,2020-08-01,5023,4752,271,5.4
48389,2020-08-01,12435,11773,662,5.3
48391,2020-08-01,3186,2935,251,7.9
48393,2020-08-01,414,395,19,4.6
48395,2020-08-01,7825,7414,411,5.3
48397,2020-08-01,53401,50633,2768,5.2
48399,2020-08-01,4581,4388,193,4.2
48401,2020-08-01,22873,21317,1556,6.8
48403,2020-08-01,3700,3308,392,10.6
48405,2020-08-01,3530,3258,272,7.7
48407,2020-08-01,11830,10939,891,7.5
48409,2020-08-01,29927,27157,2770,9.3
48411,2020-08-01,2517,2418,99,3.9
48413,2020-08-01,1272,1185,87,6.8
48415,2020-08-01,6649,6141,508,7.6
48417,2020-08-01,1868,1774,94,5
48419,2020-08-01,11185,10444,741,6.6
48421,2020-08-01,1363,1332,31,2.3
48423,2020-08-01,110422,103795,6627,6
48425,2020-08-01,4392,4144,248,5.6
48427,2020-08-01,26027,21956,4071,15.6
48429,2020-08-01,4019,3765,254,6.3
48431,2020-08-01,591,558,33,5.6
48433,2020-08-01,566,538,28,4.9
48435,2020-08-01,1324,1213,111,8.4
48437,2020-08-01,2581,2464,117,4.5
48439,2020-08-01,NA,NA,73225,6.6
48441,2020-08-01,67954,64667,3287,4.8
48443,2020-08-01,369,351,18,4.9
48445,2020-08-01,4953,4613,340,6.9
48447,2020-08-01,632,603,29,4.6
48449,2020-08-01,13108,12280,828,6.3
48451,2020-08-01,53245,50087,3158,5.9
48453,2020-08-01,766984,723437,43547,5.7
48455,2020-08-01,5339,4934,405,7.6
48457,2020-08-01,7211,6536,675,9.4
48459,2020-08-01,17755,16527,1228,6.9
48461,2020-08-01,1681,1582,99,5.9
48463,2020-08-01,11335,10664,671,5.9
48465,2020-08-01,22519,20930,1589,7.1
48467,2020-08-01,26397,24956,1441,5.5
48469,2020-08-01,42794,39604,3190,7.5
48471,2020-08-01,24115,22507,1608,6.7
48473,2020-08-01,23752,21999,1753,7.4
48475,2020-08-01,8044,7422,622,7.7
48477,2020-08-01,15453,14642,811,5.2
48479,2020-08-01,119165,109785,9380,7.9
48481,2020-08-01,21810,20439,1371,6.3
48483,2020-08-01,2258,2132,126,5.6
48485,2020-08-01,56835,53409,3426,6
48487,2020-08-01,4965,4714,251,5.1
48489,2020-08-01,6814,6094,720,10.6
48491,2020-08-01,321892,305449,16443,5.1
48493,2020-08-01,25212,23916,1296,5.1
48495,2020-08-01,4031,3631,400,9.9
48497,2020-08-01,32288,30422,1866,5.8
48499,2020-08-01,17847,16804,1043,5.8
48501,2020-08-01,3968,3535,433,10.9
48503,2020-08-01,8009,7633,376,4.7
48505,2020-08-01,4933,4379,554,11.2
48507,2020-08-01,3303,2847,456,13.8
49001,2020-08-01,2734,2626,108,4
49003,2020-08-01,26340,25537,803,3
49005,2020-08-01,64169,62473,1696,2.6
49007,2020-08-01,8559,8164,395,4.6
49009,2020-08-01,422,411,11,2.6
49011,2020-08-01,179518,173126,6392,3.6
49013,2020-08-01,7607,7007,600,7.9
49015,2020-08-01,4383,4217,166,3.8
49017,2020-08-01,2927,2784,143,4.9
49019,2020-08-01,6811,6446,365,5.4
49021,2020-08-01,24171,23203,968,4
49023,2020-08-01,5747,5602,145,2.5
49025,2020-08-01,4155,4004,151,3.6
49027,2020-08-01,5962,5783,179,3
49029,2020-08-01,5679,5530,149,2.6
49031,2020-08-01,473,448,25,5.3
49033,2020-08-01,1556,1515,41,2.6
49035,2020-08-01,638384,608122,30262,4.7
49037,2020-08-01,5708,5193,515,9
49039,2020-08-01,12142,11713,429,3.5
49041,2020-08-01,9811,9456,355,3.6
49043,2020-08-01,23352,21920,1432,6.1
49045,2020-08-01,33805,32380,1425,4.2
49047,2020-08-01,13458,12296,1162,8.6
49049,2020-08-01,312869,302234,10635,3.4
49051,2020-08-01,16064,15232,832,5.2
49053,2020-08-01,78128,74386,3742,4.8
49055,2020-08-01,1457,1398,59,4
49057,2020-08-01,131425,126111,5314,4
50001,2020-08-01,20072,19329,743,3.7
50003,2020-08-01,17153,16238,915,5.3
50005,2020-08-01,14208,13569,639,4.5
50007,2020-08-01,91245,87335,3910,4.3
50009,2020-08-01,2586,2471,115,4.4
50011,2020-08-01,25624,24458,1166,4.6
50013,2020-08-01,3813,3620,193,5.1
50015,2020-08-01,13265,12498,767,5.8
50017,2020-08-01,15649,15097,552,3.5
50019,2020-08-01,12288,11559,729,5.9
50021,2020-08-01,29309,27638,1671,5.7
50023,2020-08-01,33104,31816,1288,3.9
50025,2020-08-01,21209,20012,1197,5.6
50027,2020-08-01,27757,26525,1232,4.4
51001,2020-08-01,16645,15670,975,5.9
51003,2020-08-01,56622,53635,2987,5.3
51005,2020-08-01,6582,6198,384,5.8
51007,2020-08-01,6202,5844,358,5.8
51009,2020-08-01,14543,13740,803,5.5
51011,2020-08-01,6919,6531,388,5.6
51013,2020-08-01,151658,144670,6988,4.6
51015,2020-08-01,38436,36854,1582,4.1
51017,2020-08-01,2574,2392,182,7.1
51019,2020-08-01,37106,35348,1758,4.7
51021,2020-08-01,2749,2596,153,5.6
51023,2020-08-01,16782,16102,680,4.1
51025,2020-08-01,5884,5389,495,8.4
51027,2020-08-01,6411,5841,570,8.9
51029,2020-08-01,6359,5922,437,6.9
51031,2020-08-01,25226,23777,1449,5.7
51033,2020-08-01,15151,14147,1004,6.6
51035,2020-08-01,13256,12310,946,7.1
51036,2020-08-01,3618,3389,229,6.3
51037,2020-08-01,5189,4916,273,5.3
51041,2020-08-01,185435,174601,10834,5.8
51043,2020-08-01,7432,7121,311,4.2
51045,2020-08-01,2231,2121,110,4.9
51047,2020-08-01,24171,23041,1130,4.7
51049,2020-08-01,4579,4292,287,6.3
51051,2020-08-01,4635,4278,357,7.7
51053,2020-08-01,13590,12715,875,6.4
51057,2020-08-01,5428,5055,373,6.9
51059,2020-08-01,631666,594050,37616,6
51061,2020-08-01,36432,34845,1587,4.4
51063,2020-08-01,7931,7549,382,4.8
51065,2020-08-01,13752,13050,702,5.1
51067,2020-08-01,25757,24389,1368,5.3
51069,2020-08-01,45847,43825,2022,4.4
51071,2020-08-01,7620,7170,450,5.9
51073,2020-08-01,19448,18426,1022,5.3
51075,2020-08-01,10996,10500,496,4.5
51077,2020-08-01,7874,7476,398,5.1
51079,2020-08-01,10354,9859,495,4.8
51081,2020-08-01,4302,3982,320,7.4
51083,2020-08-01,15447,14441,1006,6.5
51085,2020-08-01,58007,55367,2640,4.6
51087,2020-08-01,181552,169315,12237,6.7
51089,2020-08-01,24110,22310,1800,7.5
51091,2020-08-01,1211,1172,39,3.2
51093,2020-08-01,19256,18267,989,5.1
51095,2020-08-01,36886,34408,2478,6.7
51097,2020-08-01,3836,3635,201,5.2
51099,2020-08-01,13280,12703,577,4.3
51101,2020-08-01,9048,8574,474,5.2
51103,2020-08-01,5546,5214,332,6
51105,2020-08-01,8014,7557,457,5.7
51107,2020-08-01,219507,207670,11837,5.4
51109,2020-08-01,19954,18970,984,4.9
51111,2020-08-01,5137,4849,288,5.6
51113,2020-08-01,7286,7031,255,3.5
51115,2020-08-01,4075,3888,187,4.6
51117,2020-08-01,12151,11355,796,6.6
51119,2020-08-01,5358,5104,254,4.7
51121,2020-08-01,47653,45532,2121,4.5
51125,2020-08-01,7427,7026,401,5.4
51127,2020-08-01,12236,11684,552,4.5
51131,2020-08-01,5548,5122,426,7.7
51133,2020-08-01,5708,5409,299,5.2
51135,2020-08-01,7082,6700,382,5.4
51137,2020-08-01,17398,16505,893,5.1
51139,2020-08-01,11944,11256,688,5.8
51141,2020-08-01,7215,6754,461,6.4
51143,2020-08-01,29243,27483,1760,6
51145,2020-08-01,13839,13234,605,4.4
51147,2020-08-01,10344,9673,671,6.5
51149,2020-08-01,14927,13946,981,6.6
51153,2020-08-01,245090,228598,16492,6.7
51155,2020-08-01,15928,14540,1388,8.7
51157,2020-08-01,3653,3494,159,4.4
51159,2020-08-01,4031,3842,189,4.7
51161,2020-08-01,47923,45643,2280,4.8
51163,2020-08-01,10910,10422,488,4.5
51165,2020-08-01,39831,38180,1651,4.1
51167,2020-08-01,10721,10055,666,6.2
51169,2020-08-01,8694,8353,341,3.9
51171,2020-08-01,22050,20976,1074,4.9
51173,2020-08-01,13378,12578,800,6
51175,2020-08-01,9005,8514,491,5.5
51177,2020-08-01,66135,62228,3907,5.9
51179,2020-08-01,70849,66814,4035,5.7
51181,2020-08-01,3586,3384,202,5.6
51183,2020-08-01,3848,3496,352,9.1
51185,2020-08-01,14881,13744,1137,7.6
51187,2020-08-01,20154,19033,1121,5.6
51191,2020-08-01,25704,24403,1301,5.1
51193,2020-08-01,9455,8931,524,5.5
51195,2020-08-01,13065,12107,958,7.3
51197,2020-08-01,13514,12508,1006,7.4
51199,2020-08-01,32509,30737,1772,5.5
51510,2020-08-01,101048,94792,6256,6.2
51520,2020-08-01,7040,6565,475,6.7
51530,2020-08-01,3478,3319,159,4.6
51540,2020-08-01,26437,24706,1731,6.5
51550,2020-08-01,122610,114758,7852,6.4
51570,2020-08-01,8806,8162,644,7.3
51580,2020-08-01,2324,2133,191,8.2
51590,2020-08-01,18880,17056,1824,9.7
51595,2020-08-01,2417,2100,317,13.1
51600,2020-08-01,13351,12603,748,5.6
51610,2020-08-01,8359,8064,295,3.5
51620,2020-08-01,3731,3349,382,10.2
51630,2020-08-01,14072,13048,1024,7.3
51640,2020-08-01,2913,2709,204,7
51650,2020-08-01,65643,59643,6000,9.1
51660,2020-08-01,23963,22464,1499,6.3
51670,2020-08-01,10034,8852,1182,11.8
51678,2020-08-01,2041,1903,138,6.8
51680,2020-08-01,35657,32972,2685,7.5
51683,2020-08-01,22016,20555,1461,6.6
51685,2020-08-01,9434,8763,671,7.1
51690,2020-08-01,5787,5120,667,11.5
51700,2020-08-01,90993,82526,8467,9.3
51710,2020-08-01,114540,103732,10808,9.4
51720,2020-08-01,1672,1550,122,7.3
51730,2020-08-01,13954,11764,2190,15.7
51735,2020-08-01,6260,6018,242,3.9
51740,2020-08-01,45938,40977,4961,10.8
51750,2020-08-01,8291,7769,522,6.3
51760,2020-08-01,121162,109627,11535,9.5
51770,2020-08-01,49299,45218,4081,8.3
51775,2020-08-01,12633,11944,689,5.5
51790,2020-08-01,12756,11996,760,6
51800,2020-08-01,44800,41655,3145,7
51810,2020-08-01,232567,218640,13927,6
51820,2020-08-01,11157,10455,702,6.3
51830,2020-08-01,6751,6203,548,8.1
51840,2020-08-01,14274,13439,835,5.8
53001,2020-08-01,10150,9529,621,6.1
53003,2020-08-01,10155,9601,554,5.5
53005,2020-08-01,108895,99935,8960,8.2
53007,2020-08-01,44387,40804,3583,8.1
53009,2020-08-01,30430,27539,2891,9.5
53011,2020-08-01,243800,220680,23120,9.5
53013,2020-08-01,1710,1594,116,6.8
53015,2020-08-01,50033,45331,4702,9.4
53017,2020-08-01,21856,20017,1839,8.4
53019,2020-08-01,2616,2357,259,9.9
53021,2020-08-01,45993,41992,4001,8.7
53023,2020-08-01,833,766,67,8
53025,2020-08-01,48151,44015,4136,8.6
53027,2020-08-01,30631,27227,3404,11.1
53029,2020-08-01,36377,33327,3050,8.4
53031,2020-08-01,14185,12947,1238,8.7
53033,2020-08-01,NA,NA,92737,7.2
53035,2020-08-01,134607,124370,10237,7.6
53037,2020-08-01,20690,18696,1994,9.6
53039,2020-08-01,10210,9372,838,8.2
53041,2020-08-01,35394,32179,3215,9.1
53043,2020-08-01,4712,4414,298,6.3
53045,2020-08-01,25824,23288,2536,9.8
53047,2020-08-01,18053,16376,1677,9.3
53049,2020-08-01,8583,7660,923,10.8
53051,2020-08-01,4924,4370,554,11.3
53053,2020-08-01,459328,413523,45805,10
53055,2020-08-01,7699,7096,603,7.8
53057,2020-08-01,64363,58202,6161,9.6
53059,2020-08-01,5549,4985,564,10.2
53061,2020-08-01,440815,406835,33980,7.7
53063,2020-08-01,253444,230328,23116,9.1
53065,2020-08-01,18197,16550,1647,9.1
53067,2020-08-01,146499,134516,11983,8.2
53069,2020-08-01,1391,1270,121,8.7
53071,2020-08-01,30207,28110,2097,6.9
53073,2020-08-01,119000,107902,11098,9.3
53075,2020-08-01,23922,22512,1410,5.9
53077,2020-08-01,136871,123220,13651,10
54001,2020-08-01,6967,6348,619,8.9
54003,2020-08-01,56704,52812,3892,6.9
54005,2020-08-01,7500,6605,895,11.9
54007,2020-08-01,4763,4251,512,10.7
54009,2020-08-01,9813,8875,938,9.6
54011,2020-08-01,42128,38562,3566,8.5
54013,2020-08-01,2150,1787,363,16.9
54015,2020-08-01,3100,2713,387,12.5
54017,2020-08-01,3843,3587,256,6.7
54019,2020-08-01,16470,14856,1614,9.8
54021,2020-08-01,2248,2028,220,9.8
54023,2020-08-01,5713,5338,375,6.6
54025,2020-08-01,15412,14271,1141,7.4
54027,2020-08-01,10434,9827,607,5.8
54029,2020-08-01,12944,11588,1356,10.5
54031,2020-08-01,5726,5340,386,6.7
54033,2020-08-01,33825,31040,2785,8.2
54035,2020-08-01,12312,11147,1165,9.5
54037,2020-08-01,29681,27732,1949,6.6
54039,2020-08-01,81806,73801,8005,9.8
54041,2020-08-01,6183,5481,702,11.4
54043,2020-08-01,7286,6527,759,10.4
54045,2020-08-01,10246,8721,1525,14.9
54047,2020-08-01,4190,3553,637,15.2
54049,2020-08-01,24779,22531,2248,9.1
54051,2020-08-01,12981,11711,1270,9.8
54053,2020-08-01,9530,8678,852,8.9
54055,2020-08-01,19419,17257,2162,11.1
54057,2020-08-01,11877,11010,867,7.3
54059,2020-08-01,6274,5198,1076,17.2
54061,2020-08-01,53989,50368,3621,6.7
54063,2020-08-01,5773,5357,416,7.2
54065,2020-08-01,8029,7521,508,6.3
54067,2020-08-01,8725,7740,985,11.3
54069,2020-08-01,19627,17870,1757,9
54071,2020-08-01,3587,3426,161,4.5
54073,2020-08-01,2897,2583,314,10.8
54075,2020-08-01,3991,3675,316,7.9
54077,2020-08-01,15390,14323,1067,6.9
54079,2020-08-01,26776,24812,1964,7.3
54081,2020-08-01,30976,28131,2845,9.2
54083,2020-08-01,11851,10784,1067,9
54085,2020-08-01,4189,3793,396,9.5
54087,2020-08-01,4725,4120,605,12.8
54089,2020-08-01,4067,3755,312,7.7
54091,2020-08-01,7427,6863,564,7.6
54093,2020-08-01,3206,2950,256,8
54095,2020-08-01,2971,2639,332,11.2
54097,2020-08-01,8682,7697,985,11.3
54099,2020-08-01,15852,14489,1363,8.6
54101,2020-08-01,3078,2770,308,10
54103,2020-08-01,6173,5520,653,10.6
54105,2020-08-01,2290,2070,220,9.6
54107,2020-08-01,37041,33889,3152,8.5
54109,2020-08-01,6041,5319,722,12
55001,2020-08-01,7883,7234,649,8.2
55003,2020-08-01,7649,7059,590,7.7
55005,2020-08-01,23235,22102,1133,4.9
55007,2020-08-01,7249,6737,512,7.1
55009,2020-08-01,142835,134510,8325,5.8
55011,2020-08-01,6155,5759,396,6.4
55013,2020-08-01,6895,6356,539,7.8
55015,2020-08-01,26864,25701,1163,4.3
55017,2020-08-01,32467,30597,1870,5.8
55019,2020-08-01,16680,16040,640,3.8
55021,2020-08-01,30096,28448,1648,5.5
55023,2020-08-01,7144,6757,387,5.4
55025,2020-08-01,309877,294002,15875,5.1
55027,2020-08-01,46250,43936,2314,5
55029,2020-08-01,13698,12917,781,5.7
55031,2020-08-01,22854,20912,1942,8.5
55033,2020-08-01,22621,21505,1116,4.9
55035,2020-08-01,58393,55110,3283,5.6
55037,2020-08-01,2194,2048,146,6.7
55039,2020-08-01,57907,55206,2701,4.7
55041,2020-08-01,4274,3639,635,14.9
55043,2020-08-01,25951,24737,1214,4.7
55045,2020-08-01,19746,18888,858,4.3
55047,2020-08-01,8889,8442,447,5
55049,2020-08-01,12911,12254,657,5.1
55051,2020-08-01,2581,2295,286,11.1
55053,2020-08-01,10189,9258,931,9.1
55055,2020-08-01,44968,42669,2299,5.1
55057,2020-08-01,13291,12454,837,6.3
55059,2020-08-01,88821,82595,6226,7
55061,2020-08-01,10604,10202,402,3.8
55063,2020-08-01,64443,61040,3403,5.3
55065,2020-08-01,9433,9090,343,3.6
55067,2020-08-01,9089,8456,633,7
55069,2020-08-01,14811,14024,787,5.3
55071,2020-08-01,40304,38011,2293,5.7
55073,2020-08-01,72943,69626,3317,4.5
55075,2020-08-01,19136,17745,1391,7.3
55077,2020-08-01,7414,7000,414,5.6
55078,2020-08-01,1732,1397,335,19.3
55079,2020-08-01,477930,435446,42484,8.9
55081,2020-08-01,23002,21745,1257,5.5
55083,2020-08-01,20292,19244,1048,5.2
55085,2020-08-01,16939,15835,1104,6.5
55087,2020-08-01,102229,96771,5458,5.3
55089,2020-08-01,48948,46281,2667,5.4
55091,2020-08-01,3867,3696,171,4.4
55093,2020-08-01,24972,23507,1465,5.9
55095,2020-08-01,23986,22611,1375,5.7
55097,2020-08-01,36922,35002,1920,5.2
55099,2020-08-01,6233,5887,346,5.6
55101,2020-08-01,101378,94363,7015,6.9
55103,2020-08-01,8771,8394,377,4.3
55105,2020-08-01,84778,79064,5714,6.7
55107,2020-08-01,6372,6043,329,5.2
55109,2020-08-01,50201,47061,3140,6.3
55111,2020-08-01,34748,32575,2173,6.3
55113,2020-08-01,7606,7044,562,7.4
55115,2020-08-01,20343,19163,1180,5.8
55117,2020-08-01,62232,59126,3106,5
55119,2020-08-01,10358,9971,387,3.7
55121,2020-08-01,15455,14494,961,6.2
55123,2020-08-01,14550,13895,655,4.5
55125,2020-08-01,9584,9010,574,6
55127,2020-08-01,55603,52443,3160,5.7
55129,2020-08-01,7607,7172,435,5.7
55131,2020-08-01,76766,72572,4194,5.5
55133,2020-08-01,224493,212126,12367,5.5
55135,2020-08-01,25182,23846,1336,5.3
55137,2020-08-01,11007,10430,577,5.2
55139,2020-08-01,91513,86845,4668,5.1
55141,2020-08-01,34771,32516,2255,6.5
56001,2020-08-01,21656,20955,701,3.2
56003,2020-08-01,5367,5116,251,4.7
56005,2020-08-01,24108,22132,1976,8.2
56007,2020-08-01,7826,7497,329,4.2
56009,2020-08-01,9233,8645,588,6.4
56011,2020-08-01,3871,3720,151,3.9
56013,2020-08-01,19216,18011,1205,6.3
56015,2020-08-01,6760,6473,287,4.2
56017,2020-08-01,2223,2108,115,5.2
56019,2020-08-01,4211,3977,234,5.6
56021,2020-08-01,48701,46194,2507,5.1
56023,2020-08-01,8934,8426,508,5.7
56025,2020-08-01,39532,35795,3737,9.5
56027,2020-08-01,1279,1231,48,3.8
56029,2020-08-01,15040,14325,715,4.8
56031,2020-08-01,4881,4647,234,4.8
56033,2020-08-01,15956,15287,669,4.2
56035,2020-08-01,4173,3887,286,6.9
56037,2020-08-01,21410,19745,1665,7.8
56039,2020-08-01,13974,13327,647,4.6
56041,2020-08-01,9123,8456,667,7.3
56043,2020-08-01,3907,3704,203,5.2
56045,2020-08-01,3853,3705,148,3.8
72001,2020-08-01,3883,3468,415,10.7
72003,2020-08-01,11277,10304,973,8.6
72005,2020-08-01,13833,12567,1266,9.2
72007,2020-08-01,6231,5638,593,9.5
72009,2020-08-01,6111,5591,520,8.5
72011,2020-08-01,8402,7763,639,7.6
72013,2020-08-01,23776,21807,1969,8.3
72015,2020-08-01,4299,3940,359,8.4
72017,2020-08-01,5559,4973,586,10.5
72019,2020-08-01,6976,6283,693,9.9
72021,2020-08-01,63919,58220,5699,8.9
72023,2020-08-01,13094,11992,1102,8.4
72025,2020-08-01,45862,42274,3588,7.8
72027,2020-08-01,9440,8726,714,7.6
72029,2020-08-01,15580,14222,1358,8.7
72031,2020-08-01,60138,54912,5226,8.7
72033,2020-08-01,7700,6928,772,10
72035,2020-08-01,15328,14267,1061,6.9
72037,2020-08-01,3519,3189,330,9.4
72039,2020-08-01,3609,3164,445,12.3
72041,2020-08-01,14605,13740,865,5.9
72043,2020-08-01,9292,8405,887,9.5
72045,2020-08-01,4693,4234,459,9.8
72047,2020-08-01,8680,7653,1027,11.8
72049,2020-08-01,933,858,75,8
72051,2020-08-01,12744,11835,909,7.1
72053,2020-08-01,10441,9347,1094,10.5
72054,2020-08-01,3170,2798,372,11.7
72055,2020-08-01,3822,3404,418,10.9
72057,2020-08-01,10252,9466,786,7.7
72059,2020-08-01,4945,4491,454,9.2
72061,2020-08-01,36515,34474,2041,5.6
72063,2020-08-01,17135,16137,998,5.8
72065,2020-08-01,12927,11989,938,7.3
72067,2020-08-01,5115,4692,423,8.3
72069,2020-08-01,16127,14875,1252,7.8
72071,2020-08-01,11127,10224,903,8.1
72073,2020-08-01,3848,3547,301,7.8
72075,2020-08-01,14746,13696,1050,7.1
72077,2020-08-01,11686,10653,1033,8.8
72079,2020-08-01,4919,4380,539,11
72081,2020-08-01,6640,5924,716,10.8
72083,2020-08-01,2498,2248,250,10
72085,2020-08-01,10629,9762,867,8.2
72087,2020-08-01,8139,7364,775,9.5
72089,2020-08-01,5960,5340,620,10.4
72091,2020-08-01,10975,10050,925,8.4
72093,2020-08-01,1733,1605,128,7.4
72095,2020-08-01,2611,2373,238,9.1
72097,2020-08-01,20390,18719,1671,8.2
72099,2020-08-01,9898,8988,910,9.2
72101,2020-08-01,7692,6851,841,10.9
72103,2020-08-01,7681,7088,593,7.7
72105,2020-08-01,6988,6082,906,13
72107,2020-08-01,4736,4156,580,12.2
72109,2020-08-01,3898,3533,365,9.4
72111,2020-08-01,5443,4892,551,10.1
72113,2020-08-01,43450,39895,3555,8.2
72115,2020-08-01,5958,5398,560,9.4
72117,2020-08-01,4360,3946,414,9.5
72119,2020-08-01,16454,14854,1600,9.7
72121,2020-08-01,5628,5122,506,9
72123,2020-08-01,6636,5963,673,10.1
72125,2020-08-01,9113,8354,759,8.3
72127,2020-08-01,131841,121293,10548,8
72129,2020-08-01,10979,10092,887,8.1
72131,2020-08-01,9599,8614,985,10.3
72133,2020-08-01,7437,6846,591,7.9
72135,2020-08-01,26108,24217,1891,7.2
72137,2020-08-01,28282,26059,2223,7.9
72139,2020-08-01,26075,24458,1617,6.2
72141,2020-08-01,6198,5675,523,8.4
72143,2020-08-01,9411,8437,974,10.3
72145,2020-08-01,12806,11317,1489,11.6
72147,2020-08-01,2487,2230,257,10.3
72149,2020-08-01,6722,6096,626,9.3
72151,2020-08-01,8064,7286,778,9.6
72153,2020-08-01,9159,8203,956,10.4
01001,2020-09-01,25403,24049,1354,5.3
01003,2020-09-01,97719,92203,5516,5.6
01005,2020-09-01,9595,8750,845,8.8
01007,2020-09-01,8655,8073,582,6.7
01009,2020-09-01,24703,23688,1015,4.1
01011,2020-09-01,5126,4791,335,6.5
01013,2020-09-01,9789,8866,923,9.4
01015,2020-09-01,45314,41864,3450,7.6
01017,2020-09-01,16640,15496,1144,6.9
01019,2020-09-01,11846,11353,493,4.2
01021,2020-09-01,19556,18547,1009,5.2
01023,2020-09-01,5012,4671,341,6.8
01025,2020-09-01,8575,7659,916,10.7
01027,2020-09-01,6594,6324,270,4.1
01029,2020-09-01,5975,5733,242,4.1
01031,2020-09-01,22901,21855,1046,4.6
01033,2020-09-01,23621,22039,1582,6.7
01035,2020-09-01,4947,4541,406,8.2
01037,2020-09-01,4775,4519,256,5.4
01039,2020-09-01,16291,15515,776,4.8
01041,2020-09-01,6612,6253,359,5.4
01043,2020-09-01,40509,38940,1569,3.9
01045,2020-09-01,22131,20926,1205,5.4
01047,2020-09-01,15873,13974,1899,12
01049,2020-09-01,33081,31714,1367,4.1
01051,2020-09-01,36446,34513,1933,5.3
01053,2020-09-01,16121,15061,1060,6.6
01055,2020-09-01,41385,38141,3244,7.8
01057,2020-09-01,6904,6583,321,4.6
01059,2020-09-01,15274,14661,613,4
01061,2020-09-01,10927,10444,483,4.4
01063,2020-09-01,3256,2863,393,12.1
01065,2020-09-01,6439,5764,675,10.5
01067,2020-09-01,6845,6481,364,5.3
01069,2020-09-01,46215,43249,2966,6.4
01071,2020-09-01,23685,22517,1168,4.9
01073,2020-09-01,320027,296322,23705,7.4
01075,2020-09-01,6189,5892,297,4.8
01077,2020-09-01,42106,39831,2275,5.4
01079,2020-09-01,14125,13389,736,5.2
01081,2020-09-01,75874,71659,4215,5.6
01083,2020-09-01,43311,41398,1913,4.4
01085,2020-09-01,3830,3210,620,16.2
01087,2020-09-01,8638,7705,933,10.8
01089,2020-09-01,184458,174710,9748,5.3
01091,2020-09-01,8458,7876,582,6.9
01093,2020-09-01,14497,13800,697,4.8
01095,2020-09-01,46938,45059,1879,4
01097,2020-09-01,190136,172068,18068,9.5
01099,2020-09-01,8110,7398,712,8.8
01101,2020-09-01,107308,96688,10620,9.9
01103,2020-09-01,57518,54712,2806,4.9
01105,2020-09-01,3824,3368,456,11.9
01107,2020-09-01,7985,7438,547,6.9
01109,2020-09-01,17227,16320,907,5.3
01111,2020-09-01,10195,9792,403,4
01113,2020-09-01,23147,21883,1264,5.5
01115,2020-09-01,39827,37773,2054,5.2
01117,2020-09-01,113203,108532,4671,4.1
01119,2020-09-01,5127,4750,377,7.4
01121,2020-09-01,38269,35654,2615,6.8
01123,2020-09-01,19244,17880,1364,7.1
01125,2020-09-01,106040,98650,7390,7
01127,2020-09-01,24992,23482,1510,6
01129,2020-09-01,7307,6659,648,8.9
01131,2020-09-01,3230,2676,554,17.2
01133,2020-09-01,10464,9966,498,4.8
02013,2020-09-01,2883,2823,60,2.1
02016,2020-09-01,3517,3432,85,2.4
02020,2020-09-01,142870,133676,9194,6.4
02050,2020-09-01,6437,5772,665,10.3
02060,2020-09-01,405,379,26,6.4
02068,2020-09-01,1106,1035,71,6.4
02070,2020-09-01,1745,1627,118,6.8
02090,2020-09-01,43877,41664,2213,5
02100,2020-09-01,1097,983,114,10.4
02105,2020-09-01,1112,1006,106,9.5
02110,2020-09-01,15600,14708,892,5.7
02122,2020-09-01,24639,22780,1859,7.5
02130,2020-09-01,6397,5912,485,7.6
02150,2020-09-01,5494,5246,248,4.5
02158,2020-09-01,2593,2256,337,13
02164,2020-09-01,711,667,44,6.2
02170,2020-09-01,44944,41904,3040,6.8
02180,2020-09-01,3825,3487,338,8.8
02185,2020-09-01,2803,2651,152,5.4
02188,2020-09-01,2740,2461,279,10.2
02195,2020-09-01,1361,1288,73,5.4
02198,2020-09-01,2640,2437,203,7.7
02220,2020-09-01,3962,3759,203,5.1
02230,2020-09-01,833,728,105,12.6
02240,2020-09-01,2629,2488,141,5.4
02261,2020-09-01,4862,4609,253,5.2
02275,2020-09-01,930,869,61,6.6
02282,2020-09-01,226,211,15,6.6
02290,2020-09-01,2273,2076,197,8.7
04001,2020-09-01,20199,17983,2216,11
04003,2020-09-01,52305,49408,2897,5.5
04005,2020-09-01,69962,64251,5711,8.2
04007,2020-09-01,21150,19817,1333,6.3
04009,2020-09-01,15848,14998,850,5.4
04011,2020-09-01,4631,4407,224,4.8
04012,2020-09-01,9601,9016,585,6.1
04013,2020-09-01,NA,NA,144814,6.2
04015,2020-09-01,87378,80500,6878,7.9
04017,2020-09-01,41229,37795,3434,8.3
04019,2020-09-01,499135,467605,31530,6.3
04021,2020-09-01,189584,177638,11946,6.3
04023,2020-09-01,19099,16964,2135,11.2
04025,2020-09-01,109981,103834,6147,5.6
04027,2020-09-01,97429,81170,16259,16.7
05001,2020-09-01,9259,8811,448,4.8
05003,2020-09-01,7422,6653,769,10.4
05005,2020-09-01,15987,14995,992,6.2
05007,2020-09-01,136733,129563,7170,5.2
05009,2020-09-01,15860,15008,852,5.4
05011,2020-09-01,4377,4114,263,6
05013,2020-09-01,2375,2249,126,5.3
05015,2020-09-01,12672,11911,761,6
05017,2020-09-01,3180,2792,388,12.2
05019,2020-09-01,9506,8908,598,6.3
05021,2020-09-01,5460,5143,317,5.8
05023,2020-09-01,9022,8331,691,7.7
05025,2020-09-01,3135,2906,229,7.3
05027,2020-09-01,9292,8541,751,8.1
05029,2020-09-01,8086,7569,517,6.4
05031,2020-09-01,57336,53881,3455,6
05033,2020-09-01,26083,24483,1600,6.1
05035,2020-09-01,21314,19144,2170,10.2
05037,2020-09-01,7316,6832,484,6.6
05039,2020-09-01,2699,2541,158,5.9
05041,2020-09-01,5301,4858,443,8.4
05043,2020-09-01,7643,7074,569,7.4
05045,2020-09-01,59711,56236,3475,5.8
05047,2020-09-01,7396,6935,461,6.2
05049,2020-09-01,4983,4724,259,5.2
05051,2020-09-01,41883,37893,3990,9.5
05053,2020-09-01,8014,7545,469,5.9
05055,2020-09-01,19868,18670,1198,6
05057,2020-09-01,9620,9068,552,5.7
05059,2020-09-01,13815,12868,947,6.9
05061,2020-09-01,5480,5158,322,5.9
05063,2020-09-01,16466,15522,944,5.7
05065,2020-09-01,4809,4416,393,8.2
05067,2020-09-01,5518,5089,429,7.8
05069,2020-09-01,27277,24526,2751,10.1
05071,2020-09-01,10002,9351,651,6.5
05073,2020-09-01,2481,2245,236,9.5
05075,2020-09-01,6949,6467,482,6.9
05077,2020-09-01,2753,2506,247,9
05079,2020-09-01,3806,3554,252,6.6
05081,2020-09-01,5491,5104,387,7
05083,2020-09-01,8210,7619,591,7.2
05085,2020-09-01,33045,30989,2056,6.2
05087,2020-09-01,7368,7026,342,4.6
05089,2020-09-01,6566,6135,431,6.6
05091,2020-09-01,19736,18348,1388,7
05093,2020-09-01,17367,15571,1796,10.3
05095,2020-09-01,2727,2512,215,7.9
05097,2020-09-01,2891,2671,220,7.6
05099,2020-09-01,3577,3331,246,6.9
05101,2020-09-01,3265,3118,147,4.5
05103,2020-09-01,9555,8946,609,6.4
05105,2020-09-01,4065,3822,243,6
05107,2020-09-01,6236,5604,632,10.1
05109,2020-09-01,4222,3939,283,6.7
05111,2020-09-01,10505,9874,631,6
05113,2020-09-01,7968,7407,561,7
05115,2020-09-01,28515,26772,1743,6.1
05117,2020-09-01,3516,3313,203,5.8
05119,2020-09-01,188412,170495,17917,9.5
05121,2020-09-01,7360,6874,486,6.6
05123,2020-09-01,8144,7398,746,9.2
05125,2020-09-01,56573,53314,3259,5.8
05127,2020-09-01,4275,4060,215,5
05129,2020-09-01,2839,2658,181,6.4
05131,2020-09-01,55260,51577,3683,6.7
05133,2020-09-01,5432,5077,355,6.5
05135,2020-09-01,5714,5299,415,7.3
05137,2020-09-01,4657,4318,339,7.3
05139,2020-09-01,15616,14137,1479,9.5
05141,2020-09-01,5687,5255,432,7.6
05143,2020-09-01,125134,118275,6859,5.5
05145,2020-09-01,33087,30917,2170,6.6
05147,2020-09-01,2654,2486,168,6.3
05149,2020-09-01,8290,7831,459,5.5
06001,2020-09-01,804726,730818,73908,9.2
06003,2020-09-01,453,406,47,10.4
06005,2020-09-01,14122,12914,1208,8.6
06007,2020-09-01,93147,85302,7845,8.4
06009,2020-09-01,20225,18752,1473,7.3
06011,2020-09-01,9819,8816,1003,10.2
06013,2020-09-01,534860,485865,48995,9.2
06015,2020-09-01,9085,8295,790,8.7
06017,2020-09-01,88544,82057,6487,7.3
06019,2020-09-01,440589,395896,44693,10.1
06021,2020-09-01,12591,11692,899,7.1
06023,2020-09-01,59540,55033,4507,7.6
06025,2020-09-01,67454,53194,14260,21.1
06027,2020-09-01,8107,7518,589,7.3
06029,2020-09-01,365929,321752,44177,12.1
06031,2020-09-01,54897,49408,5489,10
06033,2020-09-01,28555,26130,2425,8.5
06035,2020-09-01,9108,8552,556,6.1
06037,2020-09-01,NA,NA,631853,13.2
06039,2020-09-01,61378,55731,5647,9.2
06041,2020-09-01,132642,124073,8569,6.5
06043,2020-09-01,7621,6990,631,8.3
06045,2020-09-01,36553,33527,3026,8.3
06047,2020-09-01,113891,102199,11692,10.3
06049,2020-09-01,3010,2822,188,6.2
06051,2020-09-01,6588,5851,737,11.2
06053,2020-09-01,193289,176603,16686,8.6
06055,2020-09-01,71465,66097,5368,7.5
06057,2020-09-01,45637,42276,3361,7.4
06059,2020-09-01,NA,NA,139395,8.9
06061,2020-09-01,180825,168249,12576,7
06063,2020-09-01,7508,6928,580,7.7
06065,2020-09-01,NA,969247,111793,10.3
06067,2020-09-01,701497,634133,67364,9.6
06069,2020-09-01,30333,27733,2600,8.6
06071,2020-09-01,949328,853244,96084,10.1
06073,2020-09-01,NA,NA,138465,8.9
06075,2020-09-01,562347,515708,46639,8.3
06077,2020-09-01,320692,284795,35897,11.2
06079,2020-09-01,129170,119932,9238,7.2
06081,2020-09-01,438273,407496,30777,7
06083,2020-09-01,211126,195749,15377,7.3
06085,2020-09-01,NA,951805,70883,6.9
06087,2020-09-01,127830,117478,10352,8.1
06089,2020-09-01,72041,66499,5542,7.7
06091,2020-09-01,1248,1167,81,6.5
06093,2020-09-01,15836,14527,1309,8.3
06095,2020-09-01,201404,182041,19363,9.6
06097,2020-09-01,250710,232729,17981,7.2
06099,2020-09-01,235018,211343,23675,10.1
06101,2020-09-01,40963,36869,4094,10
06103,2020-09-01,24500,22541,1959,8
06105,2020-09-01,4342,4054,288,6.6
06107,2020-09-01,191117,168356,22761,11.9
06109,2020-09-01,19307,17494,1813,9.4
06111,2020-09-01,405955,372325,33630,8.3
06113,2020-09-01,103691,96480,7211,7
06115,2020-09-01,27960,25065,2895,10.4
08001,2020-09-01,278632,259199,19433,7
08003,2020-09-01,8402,7941,461,5.5
08005,2020-09-01,374518,348466,26052,7
08007,2020-09-01,7055,6657,398,5.6
08009,2020-09-01,2046,2009,37,1.8
08011,2020-09-01,1820,1747,73,4
08013,2020-09-01,192840,182651,10189,5.3
08014,2020-09-01,40535,38319,2216,5.5
08015,2020-09-01,9135,8666,469,5.1
08017,2020-09-01,1094,1068,26,2.4
08019,2020-09-01,6219,5798,421,6.8
08021,2020-09-01,3931,3763,168,4.3
08023,2020-09-01,1788,1667,121,6.8
08025,2020-09-01,1449,1383,66,4.6
08027,2020-09-01,2071,1993,78,3.8
08029,2020-09-01,13821,13045,776,5.6
08031,2020-09-01,429795,398313,31482,7.3
08033,2020-09-01,1137,1084,53,4.7
08035,2020-09-01,195189,186021,9168,4.7
08037,2020-09-01,33835,31491,2344,6.9
08039,2020-09-01,15068,14521,547,3.6
08041,2020-09-01,346851,326301,20550,5.9
08043,2020-09-01,14680,13728,952,6.5
08045,2020-09-01,30038,28425,1613,5.4
08047,2020-09-01,3944,3636,308,7.8
08049,2020-09-01,8289,7787,502,6.1
08051,2020-09-01,11134,10700,434,3.9
08053,2020-09-01,457,444,13,2.8
08055,2020-09-01,2452,2248,204,8.3
08057,2020-09-01,973,946,27,2.8
08059,2020-09-01,341117,320986,20131,5.9
08061,2020-09-01,922,905,17,1.8
08063,2020-09-01,3877,3782,95,2.5
08065,2020-09-01,4506,4226,280,6.2
08067,2020-09-01,30807,29240,1567,5.1
08069,2020-09-01,202474,191965,10509,5.2
08071,2020-09-01,6420,5997,423,6.6
08073,2020-09-01,2113,2022,91,4.3
08075,2020-09-01,10844,10408,436,4
08077,2020-09-01,78699,74217,4482,5.7
08079,2020-09-01,350,331,19,5.4
08081,2020-09-01,6933,6598,335,4.8
08083,2020-09-01,12709,12049,660,5.2
08085,2020-09-01,21505,20369,1136,5.3
08087,2020-09-01,15524,14719,805,5.2
08089,2020-09-01,8158,7722,436,5.3
08091,2020-09-01,2429,2292,137,5.6
08093,2020-09-01,11285,10773,512,4.5
08095,2020-09-01,2356,2306,50,2.1
08097,2020-09-01,10625,9882,743,7
08099,2020-09-01,6217,5969,248,4
08101,2020-09-01,76749,71022,5727,7.5
08103,2020-09-01,3000,2865,135,4.5
08105,2020-09-01,5073,4764,309,6.1
08107,2020-09-01,14976,14106,870,5.8
08109,2020-09-01,3365,3127,238,7.1
08111,2020-09-01,537,519,18,3.4
08113,2020-09-01,4954,4610,344,6.9
08115,2020-09-01,1037,1004,33,3.2
08117,2020-09-01,18514,17018,1496,8.1
08119,2020-09-01,13014,12310,704,5.4
08121,2020-09-01,2731,2646,85,3.1
08123,2020-09-01,167930,157402,10528,6.3
08125,2020-09-01,4970,4829,141,2.8
09001,2020-09-01,468675,432332,36343,7.8
09003,2020-09-01,485111,447284,37827,7.8
09005,2020-09-01,103158,96900,6258,6.1
09007,2020-09-01,93219,87749,5470,5.9
09009,2020-09-01,458046,422369,35677,7.8
09011,2020-09-01,135021,123245,11776,8.7
09013,2020-09-01,85869,81259,4610,5.4
09015,2020-09-01,63349,58987,4362,6.9
10001,2020-09-01,81803,74587,7216,8.8
10003,2020-09-01,295713,270064,25649,8.7
10005,2020-09-01,107220,99698,7522,7
11001,2020-09-01,404522,368874,35648,8.8
12001,2020-09-01,136170,130668,5502,4
12003,2020-09-01,11573,11130,443,3.8
12005,2020-09-01,82058,78544,3514,4.3
12007,2020-09-01,10906,10427,479,4.4
12009,2020-09-01,285065,270257,14808,5.2
12011,2020-09-01,NA,935856,79331,7.8
12013,2020-09-01,4624,4445,179,3.9
12015,2020-09-01,72222,68225,3997,5.5
12017,2020-09-01,45600,42726,2874,6.3
12019,2020-09-01,105233,101212,4021,3.8
12021,2020-09-01,174136,164270,9866,5.7
12023,2020-09-01,29417,28045,1372,4.7
12027,2020-09-01,14319,13786,533,3.7
12029,2020-09-01,5820,5580,240,4.1
12031,2020-09-01,487277,461155,26122,5.4
12033,2020-09-01,143541,136275,7266,5.1
12035,2020-09-01,45941,43275,2666,5.8
12037,2020-09-01,4418,4235,183,4.1
12039,2020-09-01,18469,17399,1070,5.8
12041,2020-09-01,6941,6690,251,3.6
12043,2020-09-01,5094,4879,215,4.2
12045,2020-09-01,5562,5322,240,4.3
12047,2020-09-01,4253,3992,261,6.1
12049,2020-09-01,8364,7938,426,5.1
12051,2020-09-01,15101,14040,1061,7
12053,2020-09-01,70640,66283,4357,6.2
12055,2020-09-01,35941,33827,2114,5.9
12057,2020-09-01,741575,698113,43462,5.9
12059,2020-09-01,6793,6531,262,3.9
12061,2020-09-01,63484,59759,3725,5.9
12063,2020-09-01,16871,16174,697,4.1
12065,2020-09-01,5375,5141,234,4.4
12067,2020-09-01,2768,2680,88,3.2
12069,2020-09-01,151655,140508,11147,7.4
12071,2020-09-01,340268,320110,20158,5.9
12073,2020-09-01,148624,141723,6901,4.6
12075,2020-09-01,16434,15697,737,4.5
12077,2020-09-01,2541,2441,100,3.9
12079,2020-09-01,7474,7076,398,5.3
12081,2020-09-01,173501,164422,9079,5.2
12083,2020-09-01,141685,134203,7482,5.3
12085,2020-09-01,73318,69965,3353,4.6
12086,2020-09-01,NA,NA,170076,12.6
12087,2020-09-01,47674,45024,2650,5.6
12089,2020-09-01,40354,38699,1655,4.1
12091,2020-09-01,94116,90611,3505,3.7
12093,2020-09-01,17319,16583,736,4.2
12095,2020-09-01,748262,675176,73086,9.8
12097,2020-09-01,185686,162459,23227,12.5
12099,2020-09-01,698544,652356,46188,6.6
12101,2020-09-01,234049,220943,13106,5.6
12103,2020-09-01,488151,461207,26944,5.5
12105,2020-09-01,308450,283989,24461,7.9
12107,2020-09-01,26005,24333,1672,6.4
12109,2020-09-01,129643,124703,4940,3.8
12111,2020-09-01,144957,135891,9066,6.3
12113,2020-09-01,80570,77686,2884,3.6
12115,2020-09-01,182291,172807,9484,5.2
12117,2020-09-01,240574,226165,14409,6
12119,2020-09-01,32414,30570,1844,5.7
12121,2020-09-01,17802,17013,789,4.4
12123,2020-09-01,8231,7784,447,5.4
12125,2020-09-01,4503,4345,158,3.5
12127,2020-09-01,249657,234869,14788,5.9
12129,2020-09-01,14142,13668,474,3.4
12131,2020-09-01,30672,29424,1248,4.1
12133,2020-09-01,9311,8932,379,4.1
13001,2020-09-01,9066,8690,376,4.1
13003,2020-09-01,4106,3963,143,3.5
13005,2020-09-01,4535,4347,188,4.1
13007,2020-09-01,1056,995,61,5.8
13009,2020-09-01,17786,16656,1130,6.4
13011,2020-09-01,9444,9097,347,3.7
13013,2020-09-01,38493,36788,1705,4.4
13015,2020-09-01,48273,45804,2469,5.1
13017,2020-09-01,5227,4889,338,6.5
13019,2020-09-01,7152,6806,346,4.8
13021,2020-09-01,65928,60893,5035,7.6
13023,2020-09-01,4278,4018,260,6.1
13025,2020-09-01,6334,6011,323,5.1
13027,2020-09-01,6709,6360,349,5.2
13029,2020-09-01,17275,16422,853,4.9
13031,2020-09-01,36494,34357,2137,5.9
13033,2020-09-01,8528,7942,586,6.9
13035,2020-09-01,10328,9718,610,5.9
13037,2020-09-01,2172,2068,104,4.8
13039,2020-09-01,19711,18854,857,4.3
13043,2020-09-01,5492,5257,235,4.3
13045,2020-09-01,52999,50030,2969,5.6
13047,2020-09-01,32374,31238,1136,3.5
13049,2020-09-01,4550,4392,158,3.5
13051,2020-09-01,134973,124995,9978,7.4
13053,2020-09-01,1840,1733,107,5.8
13055,2020-09-01,9558,8941,617,6.5
13057,2020-09-01,129367,124088,5279,4.1
13059,2020-09-01,56456,53137,3319,5.9
13061,2020-09-01,904,793,111,12.3
13063,2020-09-01,139094,123705,15389,11.1
13065,2020-09-01,2362,2258,104,4.4
13067,2020-09-01,409766,387394,22372,5.5
13069,2020-09-01,18505,17499,1006,5.4
13071,2020-09-01,20199,19293,906,4.5
13073,2020-09-01,69561,67074,2487,3.6
13075,2020-09-01,7903,7528,375,4.7
13077,2020-09-01,71871,67896,3975,5.5
13079,2020-09-01,5251,5022,229,4.4
13081,2020-09-01,9419,8683,736,7.8
13083,2020-09-01,7905,7659,246,3.1
13085,2020-09-01,11692,11249,443,3.8
13087,2020-09-01,10879,10373,506,4.7
13089,2020-09-01,393790,361993,31797,8.1
13091,2020-09-01,6628,6286,342,5.2
13093,2020-09-01,4932,4573,359,7.3
13095,2020-09-01,37054,33648,3406,9.2
13097,2020-09-01,71542,66307,5235,7.3
13099,2020-09-01,4319,4048,271,6.3
13101,2020-09-01,1811,1745,66,3.6
13103,2020-09-01,29052,27726,1326,4.6
13105,2020-09-01,7634,7137,497,6.5
13107,2020-09-01,7990,7380,610,7.6
13109,2020-09-01,4778,4532,246,5.1
13111,2020-09-01,12035,11642,393,3.3
13113,2020-09-01,55355,52762,2593,4.7
13115,2020-09-01,43002,40883,2119,4.9
13117,2020-09-01,115732,111397,4335,3.7
13119,2020-09-01,9624,9150,474,4.9
13121,2020-09-01,549462,504433,45029,8.2
13123,2020-09-01,11038,10640,398,3.6
13125,2020-09-01,1175,1139,36,3.1
13127,2020-09-01,34624,32434,2190,6.3
13129,2020-09-01,28036,26860,1176,4.2
13131,2020-09-01,9840,9442,398,4
13133,2020-09-01,6891,6540,351,5.1
13135,2020-09-01,474337,446058,28279,6
13137,2020-09-01,18118,17328,790,4.4
13139,2020-09-01,96652,92839,3813,3.9
13141,2020-09-01,2481,2260,221,8.9
13143,2020-09-01,12017,11407,610,5.1
13145,2020-09-01,15330,14753,577,3.8
13147,2020-09-01,10563,10065,498,4.7
13149,2020-09-01,5017,4752,265,5.3
13151,2020-09-01,112535,104349,8186,7.3
13153,2020-09-01,65692,62555,3137,4.8
13155,2020-09-01,3264,3102,162,5
13157,2020-09-01,36500,35101,1399,3.8
13159,2020-09-01,6598,6300,298,4.5
13161,2020-09-01,5593,5335,258,4.6
13163,2020-09-01,6359,5933,426,6.7
13165,2020-09-01,3023,2840,183,6.1
13167,2020-09-01,3829,3652,177,4.6
13169,2020-09-01,12876,12359,517,4
13171,2020-09-01,7876,7440,436,5.5
13173,2020-09-01,3653,3487,166,4.5
13175,2020-09-01,18346,17231,1115,6.1
13177,2020-09-01,13733,13150,583,4.2
13179,2020-09-01,25655,24137,1518,5.9
13181,2020-09-01,3297,3123,174,5.3
13183,2020-09-01,7799,7492,307,3.9
13185,2020-09-01,50817,47909,2908,5.7
13187,2020-09-01,15913,15341,572,3.6
13189,2020-09-01,8317,7715,602,7.2
13191,2020-09-01,5376,5061,315,5.9
13193,2020-09-01,4383,4095,288,6.6
13195,2020-09-01,12569,12028,541,4.3
13197,2020-09-01,3037,2896,141,4.6
13199,2020-09-01,8683,7976,707,8.1
13201,2020-09-01,2568,2469,99,3.9
13205,2020-09-01,8027,7484,543,6.8
13207,2020-09-01,12294,11734,560,4.6
13209,2020-09-01,3657,3475,182,5
13211,2020-09-01,8802,8384,418,4.7
13213,2020-09-01,14458,13666,792,5.5
13215,2020-09-01,73411,67690,5721,7.8
13217,2020-09-01,50560,47043,3517,7
13219,2020-09-01,18261,17758,503,2.8
13221,2020-09-01,6491,6222,269,4.1
13223,2020-09-01,82194,78168,4026,4.9
13225,2020-09-01,11070,10416,654,5.9
13227,2020-09-01,14472,13901,571,3.9
13229,2020-09-01,8187,7846,341,4.2
13231,2020-09-01,8450,8098,352,4.2
13233,2020-09-01,17701,16829,872,4.9
13235,2020-09-01,3724,3576,148,4
13237,2020-09-01,7838,7381,457,5.8
13239,2020-09-01,803,758,45,5.6
13241,2020-09-01,6971,6677,294,4.2
13243,2020-09-01,2441,2298,143,5.9
13245,2020-09-01,80919,74620,6299,7.8
13247,2020-09-01,43674,40412,3262,7.5
13249,2020-09-01,2170,2097,73,3.4
13251,2020-09-01,4961,4581,380,7.7
13253,2020-09-01,2930,2787,143,4.9
13255,2020-09-01,27893,25814,2079,7.5
13257,2020-09-01,10425,9862,563,5.4
13259,2020-09-01,2500,2368,132,5.3
13261,2020-09-01,12837,11932,905,7
13263,2020-09-01,2676,2504,172,6.4
13265,2020-09-01,555,521,34,6.1
13267,2020-09-01,9020,8666,354,3.9
13269,2020-09-01,2786,2616,170,6.1
13271,2020-09-01,3481,3153,328,9.4
13273,2020-09-01,3342,3067,275,8.2
13275,2020-09-01,16353,15272,1081,6.6
13277,2020-09-01,19608,18623,985,5
13279,2020-09-01,11403,10686,717,6.3
13281,2020-09-01,3594,3411,183,5.1
13283,2020-09-01,2476,2343,133,5.4
13285,2020-09-01,37074,34810,2264,6.1
13287,2020-09-01,3075,2826,249,8.1
13289,2020-09-01,2705,2526,179,6.6
13291,2020-09-01,9879,9535,344,3.5
13293,2020-09-01,11043,10333,710,6.4
13295,2020-09-01,30181,29012,1169,3.9
13297,2020-09-01,43918,41808,2110,4.8
13299,2020-09-01,14746,13987,759,5.1
13301,2020-09-01,2702,2553,149,5.5
13303,2020-09-01,6473,6034,439,6.8
13305,2020-09-01,10610,10044,566,5.3
13307,2020-09-01,986,932,54,5.5
13309,2020-09-01,1499,1408,91,6.1
13311,2020-09-01,16073,15563,510,3.2
13313,2020-09-01,40697,38694,2003,4.9
13315,2020-09-01,2591,2432,159,6.1
13317,2020-09-01,3736,3511,225,6
13319,2020-09-01,3896,3723,173,4.4
13321,2020-09-01,8256,7843,413,5
15001,2020-09-01,84128,72799,11329,13.5
15003,2020-09-01,414306,358138,56168,13.6
15007,2020-09-01,33230,26528,6702,20.2
15009,2020-09-01,78553,60302,18251,23.2
16001,2020-09-01,264272,248746,15526,5.9
16003,2020-09-01,1895,1740,155,8.2
16005,2020-09-01,42199,39785,2414,5.7
16007,2020-09-01,3225,3086,139,4.3
16009,2020-09-01,4305,4020,285,6.6
16011,2020-09-01,25848,24838,1010,3.9
16013,2020-09-01,12683,11768,915,7.2
16015,2020-09-01,3714,3390,324,8.7
16017,2020-09-01,21878,20282,1596,7.3
16019,2020-09-01,60854,58219,2635,4.3
16021,2020-09-01,5722,5403,319,5.6
16023,2020-09-01,1478,1426,52,3.5
16025,2020-09-01,731,701,30,4.1
16027,2020-09-01,109571,102715,6856,6.3
16029,2020-09-01,4151,3996,155,3.7
16031,2020-09-01,13222,12720,502,3.8
16033,2020-09-01,401,385,16,4
16035,2020-09-01,3147,2911,236,7.5
16037,2020-09-01,2512,2397,115,4.6
16039,2020-09-01,12568,11926,642,5.1
16041,2020-09-01,7253,6976,277,3.8
16043,2020-09-01,8012,7737,275,3.4
16045,2020-09-01,8716,8152,564,6.5
16047,2020-09-01,8630,8298,332,3.8
16049,2020-09-01,7044,6573,471,6.7
16051,2020-09-01,14901,14342,559,3.8
16053,2020-09-01,12803,12276,527,4.1
16055,2020-09-01,80392,74634,5758,7.2
16057,2020-09-01,20593,19528,1065,5.2
16059,2020-09-01,3906,3665,241,6.2
16061,2020-09-01,1766,1642,124,7
16063,2020-09-01,2792,2648,144,5.2
16065,2020-09-01,22383,21631,752,3.4
16067,2020-09-01,12519,12044,475,3.8
16069,2020-09-01,20527,19514,1013,4.9
16071,2020-09-01,2476,2363,113,4.6
16073,2020-09-01,5786,5436,350,6
16075,2020-09-01,12535,11865,670,5.3
16077,2020-09-01,4654,4483,171,3.7
16079,2020-09-01,5710,5208,502,8.8
16081,2020-09-01,6935,6604,331,4.8
16083,2020-09-01,43490,41172,2318,5.3
16085,2020-09-01,5938,5541,397,6.7
16087,2020-09-01,4977,4694,283,5.7
17001,2020-09-01,32110,30377,1733,5.4
17003,2020-09-01,1964,1770,194,9.9
17005,2020-09-01,7707,7226,481,6.2
17007,2020-09-01,25382,23240,2142,8.4
17009,2020-09-01,2930,2832,98,3.3
17011,2020-09-01,17304,16194,1110,6.4
17013,2020-09-01,2264,2131,133,5.9
17015,2020-09-01,7462,7038,424,5.7
17017,2020-09-01,6105,5758,347,5.7
17019,2020-09-01,111704,104697,7007,6.3
17021,2020-09-01,14146,13092,1054,7.5
17023,2020-09-01,7448,6988,460,6.2
17025,2020-09-01,6160,5709,451,7.3
17027,2020-09-01,20065,19099,966,4.8
17029,2020-09-01,24481,22693,1788,7.3
17031,2020-09-01,NA,NA,331985,12.9
17033,2020-09-01,8498,7956,542,6.4
17035,2020-09-01,6057,5760,297,4.9
17037,2020-09-01,53758,49558,4200,7.8
17039,2020-09-01,7264,6816,448,6.2
17041,2020-09-01,10238,9698,540,5.3
17043,2020-09-01,484037,442853,41184,8.5
17045,2020-09-01,8544,8052,492,5.8
17047,2020-09-01,2640,2470,170,6.4
17049,2020-09-01,19218,18145,1073,5.6
17051,2020-09-01,9956,9277,679,6.8
17053,2020-09-01,6507,6148,359,5.5
17055,2020-09-01,16357,14949,1408,8.6
17057,2020-09-01,14870,13762,1108,7.5
17059,2020-09-01,2227,2041,186,8.4
17061,2020-09-01,6053,5675,378,6.2
17063,2020-09-01,23849,21838,2011,8.4
17065,2020-09-01,4310,4086,224,5.2
17067,2020-09-01,8339,7869,470,5.6
17069,2020-09-01,1351,1233,118,8.7
17071,2020-09-01,3590,3404,186,5.2
17073,2020-09-01,24465,22782,1683,6.9
17075,2020-09-01,14335,13559,776,5.4
17077,2020-09-01,28291,26185,2106,7.4
17079,2020-09-01,4796,4546,250,5.2
17081,2020-09-01,17388,15981,1407,8.1
17083,2020-09-01,10845,10121,724,6.7
17085,2020-09-01,10655,9947,708,6.6
17087,2020-09-01,4140,3820,320,7.7
17089,2020-09-01,267354,244622,22732,8.5
17091,2020-09-01,56482,51894,4588,8.1
17093,2020-09-01,65207,59667,5540,8.5
17095,2020-09-01,21736,19878,1858,8.5
17097,2020-09-01,370891,342239,28652,7.7
17099,2020-09-01,54219,49732,4487,8.3
17101,2020-09-01,5683,5272,411,7.2
17103,2020-09-01,17497,16431,1066,6.1
17105,2020-09-01,16578,15605,973,5.9
17107,2020-09-01,12553,11756,797,6.3
17109,2020-09-01,13685,12845,840,6.1
17111,2020-09-01,156713,143793,12920,8.2
17113,2020-09-01,86611,81103,5508,6.4
17115,2020-09-01,48339,43413,4926,10.2
17117,2020-09-01,22607,21228,1379,6.1
17119,2020-09-01,134516,124548,9968,7.4
17121,2020-09-01,17194,15860,1334,7.8
17123,2020-09-01,5010,4669,341,6.8
17125,2020-09-01,6275,5826,449,7.2
17127,2020-09-01,5514,5069,445,8.1
17129,2020-09-01,6337,5991,346,5.5
17131,2020-09-01,7895,7358,537,6.8
17133,2020-09-01,18506,17585,921,5
17135,2020-09-01,11403,10519,884,7.8
17137,2020-09-01,16572,15527,1045,6.3
17139,2020-09-01,7591,7226,365,4.8
17141,2020-09-01,24376,22671,1705,7
17143,2020-09-01,82557,74041,8516,10.3
17145,2020-09-01,8298,7667,631,7.6
17147,2020-09-01,8672,8266,406,4.7
17149,2020-09-01,7025,6678,347,4.9
17151,2020-09-01,1665,1552,113,6.8
17153,2020-09-01,1980,1781,199,10.1
17155,2020-09-01,3128,2910,218,7
17157,2020-09-01,14057,13214,843,6
17159,2020-09-01,7106,6642,464,6.5
17161,2020-09-01,71050,64889,6161,8.7
17163,2020-09-01,128825,116834,11991,9.3
17165,2020-09-01,9709,8816,893,9.2
17167,2020-09-01,100901,92903,7998,7.9
17169,2020-09-01,3223,3065,158,4.9
17171,2020-09-01,2545,2428,117,4.6
17173,2020-09-01,10552,9954,598,5.7
17175,2020-09-01,2359,2205,154,6.5
17177,2020-09-01,21968,20455,1513,6.9
17179,2020-09-01,60502,56035,4467,7.4
17181,2020-09-01,7457,6972,485,6.5
17183,2020-09-01,33413,30599,2814,8.4
17185,2020-09-01,5897,5552,345,5.9
17187,2020-09-01,8410,7933,477,5.7
17189,2020-09-01,9053,8689,364,4
17191,2020-09-01,7067,6616,451,6.4
17193,2020-09-01,6505,6118,387,5.9
17195,2020-09-01,28033,26039,1994,7.1
17197,2020-09-01,343247,308906,34341,10
17199,2020-09-01,32199,29837,2362,7.3
17201,2020-09-01,137912,123510,14402,10.4
17203,2020-09-01,17583,16597,986,5.6
18001,2020-09-01,16183,15591,592,3.7
18003,2020-09-01,187460,176186,11274,6
18005,2020-09-01,44674,42549,2125,4.8
18007,2020-09-01,4380,4208,172,3.9
18009,2020-09-01,4502,4247,255,5.7
18011,2020-09-01,36337,35047,1290,3.6
18013,2020-09-01,7847,7455,392,5
18015,2020-09-01,9953,9531,422,4.2
18017,2020-09-01,16630,15762,868,5.2
18019,2020-09-01,61196,57535,3661,6
18021,2020-09-01,11791,11151,640,5.4
18023,2020-09-01,16516,15799,717,4.3
18025,2020-09-01,4757,4503,254,5.3
18027,2020-09-01,16266,15752,514,3.2
18029,2020-09-01,25436,24118,1318,5.2
18031,2020-09-01,13844,13204,640,4.6
18033,2020-09-01,21266,20252,1014,4.8
18035,2020-09-01,53020,49809,3211,6.1
18037,2020-09-01,21773,20935,838,3.8
18039,2020-09-01,107586,101947,5639,5.2
18041,2020-09-01,8048,7392,656,8.2
18043,2020-09-01,41084,38899,2185,5.3
18045,2020-09-01,7620,7294,326,4.3
18047,2020-09-01,11066,10609,457,4.1
18049,2020-09-01,9452,8953,499,5.3
18051,2020-09-01,18872,18083,789,4.2
18053,2020-09-01,30271,28651,1620,5.4
18055,2020-09-01,13202,12526,676,5.1
18057,2020-09-01,184778,177440,7338,4
18059,2020-09-01,40618,38737,1881,4.6
18061,2020-09-01,19916,18971,945,4.7
18063,2020-09-01,90581,86656,3925,4.3
18065,2020-09-01,21443,20366,1077,5
18067,2020-09-01,37667,34948,2719,7.2
18069,2020-09-01,17362,16563,799,4.6
18071,2020-09-01,21605,20519,1086,5
18073,2020-09-01,15905,15079,826,5.2
18075,2020-09-01,8619,8255,364,4.2
18077,2020-09-01,14409,13653,756,5.2
18079,2020-09-01,13173,12485,688,5.2
18081,2020-09-01,83679,79905,3774,4.5
18083,2020-09-01,17429,16647,782,4.5
18085,2020-09-01,40322,38291,2031,5
18087,2020-09-01,17272,16637,635,3.7
18089,2020-09-01,232030,211885,20145,8.7
18091,2020-09-01,48025,44383,3642,7.6
18093,2020-09-01,20569,19420,1149,5.6
18095,2020-09-01,60210,56389,3821,6.3
18097,2020-09-01,509279,470375,38904,7.6
18099,2020-09-01,21273,20219,1054,5
18101,2020-09-01,5301,5108,193,3.6
18103,2020-09-01,14773,13830,943,6.4
18105,2020-09-01,70321,67131,3190,4.5
18107,2020-09-01,18535,17766,769,4.1
18109,2020-09-01,36554,34934,1620,4.4
18111,2020-09-01,6776,6446,330,4.9
18113,2020-09-01,20977,19851,1126,5.4
18115,2020-09-01,3162,2984,178,5.6
18117,2020-09-01,7421,6798,623,8.4
18119,2020-09-01,9380,8908,472,5
18121,2020-09-01,6854,6557,297,4.3
18123,2020-09-01,8618,8166,452,5.2
18125,2020-09-01,5742,5453,289,5
18127,2020-09-01,86220,80814,5406,6.3
18129,2020-09-01,13739,13249,490,3.6
18131,2020-09-01,6119,5817,302,4.9
18133,2020-09-01,16859,16029,830,4.9
18135,2020-09-01,10916,10348,568,5.2
18137,2020-09-01,13832,13221,611,4.4
18139,2020-09-01,8611,8229,382,4.4
18141,2020-09-01,130605,121084,9521,7.3
18143,2020-09-01,10468,9815,653,6.2
18145,2020-09-01,23410,22258,1152,4.9
18147,2020-09-01,9948,9502,446,4.5
18149,2020-09-01,9324,8728,596,6.4
18151,2020-09-01,19110,18260,850,4.4
18153,2020-09-01,8113,7670,443,5.5
18155,2020-09-01,4539,4251,288,6.3
18157,2020-09-01,97437,92416,5021,5.2
18159,2020-09-01,8773,8392,381,4.3
18161,2020-09-01,3456,3319,137,4
18163,2020-09-01,97536,91923,5613,5.8
18165,2020-09-01,6726,6354,372,5.5
18167,2020-09-01,47318,44310,3008,6.4
18169,2020-09-01,13979,13300,679,4.9
18171,2020-09-01,3966,3803,163,4.1
18173,2020-09-01,33591,32242,1349,4
18175,2020-09-01,13436,12757,679,5.1
18177,2020-09-01,28975,27084,1891,6.5
18179,2020-09-01,14254,13696,558,3.9
18181,2020-09-01,12918,12381,537,4.2
18183,2020-09-01,17568,16850,718,4.1
19001,2020-09-01,3909,3790,119,3
19003,2020-09-01,2017,1947,70,3.5
19005,2020-09-01,6888,6667,221,3.2
19007,2020-09-01,5571,5322,249,4.5
19009,2020-09-01,2842,2758,84,3
19011,2020-09-01,12585,12063,522,4.1
19013,2020-09-01,67128,63631,3497,5.2
19015,2020-09-01,14379,13940,439,3.1
19017,2020-09-01,13186,12798,388,2.9
19019,2020-09-01,10413,10019,394,3.8
19021,2020-09-01,11670,11313,357,3.1
19023,2020-09-01,7453,7211,242,3.2
19025,2020-09-01,3973,3844,129,3.2
19027,2020-09-01,10312,9995,317,3.1
19029,2020-09-01,6470,6269,201,3.1
19031,2020-09-01,10258,9922,336,3.3
19033,2020-09-01,22258,21289,969,4.4
19035,2020-09-01,5907,5743,164,2.8
19037,2020-09-01,6217,6024,193,3.1
19039,2020-09-01,4508,4313,195,4.3
19041,2020-09-01,8095,7814,281,3.5
19043,2020-09-01,9191,8825,366,4
19045,2020-09-01,22116,20835,1281,5.8
19047,2020-09-01,7559,7260,299,4
19049,2020-09-01,46461,45010,1451,3.1
19051,2020-09-01,3947,3804,143,3.6
19053,2020-09-01,4120,4005,115,2.8
19055,2020-09-01,9847,9547,300,3
19057,2020-09-01,18094,16996,1098,6.1
19059,2020-09-01,8712,8404,308,3.5
19061,2020-09-01,53260,50740,2520,4.7
19063,2020-09-01,4968,4794,174,3.5
19065,2020-09-01,9986,9579,407,4.1
19067,2020-09-01,7944,7566,378,4.8
19069,2020-09-01,5235,5075,160,3.1
19071,2020-09-01,3443,3345,98,2.8
19073,2020-09-01,5144,4980,164,3.2
19075,2020-09-01,6144,5935,209,3.4
19077,2020-09-01,5200,4994,206,4
19079,2020-09-01,6567,6327,240,3.7
19081,2020-09-01,5597,5392,205,3.7
19083,2020-09-01,7519,7244,275,3.7
19085,2020-09-01,7010,6794,216,3.1
19087,2020-09-01,9455,9084,371,3.9
19089,2020-09-01,4850,4703,147,3
19091,2020-09-01,4753,4603,150,3.2
19093,2020-09-01,3993,3874,119,3
19095,2020-09-01,10007,9716,291,2.9
19097,2020-09-01,10344,9861,483,4.7
19099,2020-09-01,18797,18007,790,4.2
19101,2020-09-01,10137,9632,505,5
19103,2020-09-01,84030,80385,3645,4.3
19105,2020-09-01,9957,9508,449,4.5
19107,2020-09-01,4908,4714,194,4
19109,2020-09-01,7869,7652,217,2.8
19111,2020-09-01,15652,14837,815,5.2
19113,2020-09-01,116720,109885,6835,5.9
19115,2020-09-01,5846,5627,219,3.7
19117,2020-09-01,4409,4263,146,3.3
19119,2020-09-01,6433,6314,119,1.8
19121,2020-09-01,8005,7641,364,4.5
19123,2020-09-01,11356,10939,417,3.7
19125,2020-09-01,17827,17264,563,3.2
19127,2020-09-01,16707,15847,860,5.1
19129,2020-09-01,7071,6852,219,3.1
19131,2020-09-01,6679,6530,149,2.2
19133,2020-09-01,4022,3883,139,3.5
19135,2020-09-01,3871,3702,169,4.4
19137,2020-09-01,4666,4479,187,4
19139,2020-09-01,21225,20259,966,4.6
19141,2020-09-01,7800,7581,219,2.8
19143,2020-09-01,3252,3183,69,2.1
19145,2020-09-01,6008,5785,223,3.7
19147,2020-09-01,4394,4242,152,3.5
19149,2020-09-01,14187,13783,404,2.8
19151,2020-09-01,4541,4421,120,2.6
19153,2020-09-01,256284,242781,13503,5.3
19155,2020-09-01,47190,45227,1963,4.2
19157,2020-09-01,9934,9592,342,3.4
19159,2020-09-01,2273,2201,72,3.2
19161,2020-09-01,4956,4823,133,2.7
19163,2020-09-01,85038,79970,5068,6
19165,2020-09-01,6247,6071,176,2.8
19167,2020-09-01,19642,19290,352,1.8
19169,2020-09-01,59467,57806,1661,2.8
19171,2020-09-01,8917,8530,387,4.3
19173,2020-09-01,2981,2904,77,2.6
19175,2020-09-01,6006,5700,306,5.1
19177,2020-09-01,3447,3321,126,3.7
19179,2020-09-01,17101,16183,918,5.4
19181,2020-09-01,26591,25621,970,3.6
19183,2020-09-01,11385,11041,344,3
19185,2020-09-01,2692,2591,101,3.8
19187,2020-09-01,18535,17740,795,4.3
19189,2020-09-01,4876,4642,234,4.8
19191,2020-09-01,10572,10232,340,3.2
19193,2020-09-01,54368,52078,2290,4.2
19195,2020-09-01,3942,3802,140,3.6
19197,2020-09-01,6632,6413,219,3.3
20001,2020-09-01,6388,6070,318,5
20003,2020-09-01,4196,4024,172,4.1
20005,2020-09-01,6805,6386,419,6.2
20007,2020-09-01,2293,2224,69,3
20009,2020-09-01,13719,13114,605,4.4
20011,2020-09-01,6516,6140,376,5.8
20013,2020-09-01,5164,4967,197,3.8
20015,2020-09-01,31817,29901,1916,6
20017,2020-09-01,1422,1325,97,6.8
20019,2020-09-01,1423,1328,95,6.7
20021,2020-09-01,9988,9511,477,4.8
20023,2020-09-01,1316,1290,26,2
20025,2020-09-01,1119,1100,19,1.7
20027,2020-09-01,3861,3703,158,4.1
20029,2020-09-01,3752,3591,161,4.3
20031,2020-09-01,3913,3733,180,4.6
20033,2020-09-01,859,824,35,4.1
20035,2020-09-01,16741,15729,1012,6
20037,2020-09-01,18747,17727,1020,5.4
20039,2020-09-01,1245,1207,38,3.1
20041,2020-09-01,8801,8443,358,4.1
20043,2020-09-01,4024,3865,159,4
20045,2020-09-01,64175,60582,3593,5.6
20047,2020-09-01,1503,1460,43,2.9
20049,2020-09-01,1156,1104,52,4.5
20051,2020-09-01,16984,16478,506,3
20053,2020-09-01,2719,2635,84,3.1
20055,2020-09-01,20774,20126,648,3.1
20057,2020-09-01,17155,16558,597,3.5
20059,2020-09-01,14191,13447,744,5.2
20061,2020-09-01,11627,10822,805,6.9
20063,2020-09-01,1451,1418,33,2.3
20065,2020-09-01,1152,1093,59,5.1
20067,2020-09-01,3188,3047,141,4.4
20069,2020-09-01,3308,3241,67,2
20071,2020-09-01,866,853,13,1.5
20073,2020-09-01,3048,2899,149,4.9
20075,2020-09-01,1677,1652,25,1.5
20077,2020-09-01,2717,2585,132,4.9
20079,2020-09-01,16456,15701,755,4.6
20081,2020-09-01,2205,2156,49,2.2
20083,2020-09-01,1024,1002,22,2.1
20085,2020-09-01,6946,6656,290,4.2
20087,2020-09-01,9775,9356,419,4.3
20089,2020-09-01,1260,1225,35,2.8
20091,2020-09-01,329150,313495,15655,4.8
20093,2020-09-01,2049,1998,51,2.5
20095,2020-09-01,3360,3211,149,4.4
20097,2020-09-01,1304,1264,40,3.1
20099,2020-09-01,9679,9138,541,5.6
20101,2020-09-01,762,738,24,3.1
20103,2020-09-01,35458,33597,1861,5.2
20105,2020-09-01,1638,1589,49,3
20107,2020-09-01,4286,3990,296,6.9
20109,2020-09-01,1640,1606,34,2.1
20111,2020-09-01,16542,15828,714,4.3
20113,2020-09-01,17123,16576,547,3.2
20115,2020-09-01,5845,5622,223,3.8
20117,2020-09-01,5571,5420,151,2.7
20119,2020-09-01,2185,2125,60,2.7
20121,2020-09-01,16895,16103,792,4.7
20123,2020-09-01,3469,3383,86,2.5
20125,2020-09-01,14771,13648,1123,7.6
20127,2020-09-01,3070,2938,132,4.3
20129,2020-09-01,1176,1134,42,3.6
20131,2020-09-01,5642,5509,133,2.4
20133,2020-09-01,6224,5833,391,6.3
20135,2020-09-01,1342,1295,47,3.5
20137,2020-09-01,2641,2565,76,2.9
20139,2020-09-01,7708,7334,374,4.9
20141,2020-09-01,1978,1926,52,2.6
20143,2020-09-01,2912,2798,114,3.9
20145,2020-09-01,2873,2776,97,3.4
20147,2020-09-01,2633,2555,78,3
20149,2020-09-01,11831,11399,432,3.7
20151,2020-09-01,4920,4757,163,3.3
20153,2020-09-01,1594,1554,40,2.5
20155,2020-09-01,30359,28779,1580,5.2
20157,2020-09-01,2393,2315,78,3.3
20159,2020-09-01,5060,4872,188,3.7
20161,2020-09-01,33671,32131,1540,4.6
20163,2020-09-01,2514,2412,102,4.1
20165,2020-09-01,1550,1482,68,4.4
20167,2020-09-01,3191,3074,117,3.7
20169,2020-09-01,29176,27692,1484,5.1
20171,2020-09-01,2832,2768,64,2.3
20173,2020-09-01,251550,230035,21515,8.6
20175,2020-09-01,9841,9431,410,4.2
20177,2020-09-01,88124,83217,4907,5.6
20179,2020-09-01,1500,1469,31,2.1
20181,2020-09-01,2880,2790,90,3.1
20183,2020-09-01,1963,1921,42,2.1
20185,2020-09-01,2052,1970,82,4
20187,2020-09-01,1063,1044,19,1.8
20189,2020-09-01,2870,2788,82,2.9
20191,2020-09-01,10941,10089,852,7.8
20193,2020-09-01,4161,4050,111,2.7
20195,2020-09-01,1466,1423,43,2.9
20197,2020-09-01,3550,3423,127,3.6
20199,2020-09-01,846,832,14,1.7
20201,2020-09-01,3044,2984,60,2
20203,2020-09-01,1186,1162,24,2
20205,2020-09-01,3913,3625,288,7.4
20207,2020-09-01,1615,1521,94,5.8
20209,2020-09-01,76231,70497,5734,7.5
21001,2020-09-01,6430,6075,355,5.5
21003,2020-09-01,7997,7666,331,4.1
21005,2020-09-01,11053,10513,540,4.9
21007,2020-09-01,3022,2867,155,5.1
21009,2020-09-01,16481,15481,1000,6.1
21011,2020-09-01,4220,3971,249,5.9
21013,2020-09-01,7499,7001,498,6.6
21015,2020-09-01,66157,63332,2825,4.3
21017,2020-09-01,9087,8715,372,4.1
21019,2020-09-01,16770,15638,1132,6.8
21021,2020-09-01,10755,10084,671,6.2
21023,2020-09-01,3528,3367,161,4.6
21025,2020-09-01,2977,2721,256,8.6
21027,2020-09-01,7140,6750,390,5.5
21029,2020-09-01,39549,37826,1723,4.4
21031,2020-09-01,4532,4296,236,5.2
21033,2020-09-01,4963,4704,259,5.2
21035,2020-09-01,17302,16488,814,4.7
21037,2020-09-01,47459,45282,2177,4.6
21039,2020-09-01,2047,1970,77,3.8
21041,2020-09-01,4862,4616,246,5.1
21043,2020-09-01,8860,8200,660,7.4
21045,2020-09-01,6002,5721,281,4.7
21047,2020-09-01,23669,22252,1417,6
21049,2020-09-01,16031,15161,870,5.4
21051,2020-09-01,4728,4367,361,7.6
21053,2020-09-01,3663,3505,158,4.3
21055,2020-09-01,3414,3273,141,4.1
21057,2020-09-01,2943,2832,111,3.8
21059,2020-09-01,43816,41753,2063,4.7
21061,2020-09-01,4245,4029,216,5.1
21063,2020-09-01,1812,1687,125,6.9
21065,2020-09-01,4856,4586,270,5.6
21067,2020-09-01,163238,155415,7823,4.8
21069,2020-09-01,5976,5689,287,4.8
21071,2020-09-01,9776,8952,824,8.4
21073,2020-09-01,23322,22028,1294,5.5
21075,2020-09-01,1985,1860,125,6.3
21077,2020-09-01,3809,3632,177,4.6
21079,2020-09-01,6897,6551,346,5
21081,2020-09-01,10979,10395,584,5.3
21083,2020-09-01,14032,13341,691,4.9
21085,2020-09-01,10274,9670,604,5.9
21087,2020-09-01,4581,4392,189,4.1
21089,2020-09-01,12508,11648,860,6.9
21091,2020-09-01,3661,3507,154,4.2
21093,2020-09-01,44592,42319,2273,5.1
21095,2020-09-01,5815,5168,647,11.1
21097,2020-09-01,8110,7772,338,4.2
21099,2020-09-01,7137,6834,303,4.2
21101,2020-09-01,21096,20255,841,4
21103,2020-09-01,7629,7328,301,3.9
21105,2020-09-01,1607,1536,71,4.4
21107,2020-09-01,15479,14574,905,5.8
21109,2020-09-01,3623,3358,265,7.3
21111,2020-09-01,374936,353901,21035,5.6
21113,2020-09-01,24647,23488,1159,4.7
21115,2020-09-01,5959,5488,471,7.9
21117,2020-09-01,82118,78242,3876,4.7
21119,2020-09-01,3909,3599,310,7.9
21121,2020-09-01,9211,8581,630,6.8
21123,2020-09-01,5424,5160,264,4.9
21125,2020-09-01,22766,21546,1220,5.4
21127,2020-09-01,4874,4541,333,6.8
21129,2020-09-01,1857,1761,96,5.2
21131,2020-09-01,2335,2133,202,8.7
21133,2020-09-01,5673,5150,523,9.2
21135,2020-09-01,4058,3777,281,6.9
21137,2020-09-01,8012,7466,546,6.8
21139,2020-09-01,3162,2967,195,6.2
21141,2020-09-01,11338,10891,447,3.9
21143,2020-09-01,2687,2554,133,4.9
21145,2020-09-01,25320,23855,1465,5.8
21147,2020-09-01,4267,4021,246,5.8
21149,2020-09-01,3888,3709,179,4.6
21151,2020-09-01,41135,39118,2017,4.9
21153,2020-09-01,2956,2557,399,13.5
21155,2020-09-01,8905,8487,418,4.7
21157,2020-09-01,13765,13128,637,4.6
21159,2020-09-01,2644,2380,264,10
21161,2020-09-01,6309,5945,364,5.8
21163,2020-09-01,11121,10552,569,5.1
21165,2020-09-01,2107,1969,138,6.5
21167,2020-09-01,8904,8406,498,5.6
21169,2020-09-01,3613,3399,214,5.9
21171,2020-09-01,4287,4053,234,5.5
21173,2020-09-01,10695,10085,610,5.7
21175,2020-09-01,4196,3981,215,5.1
21177,2020-09-01,9394,8718,676,7.2
21179,2020-09-01,21715,20788,927,4.3
21181,2020-09-01,3087,2942,145,4.7
21183,2020-09-01,9172,8681,491,5.4
21185,2020-09-01,30767,29704,1063,3.5
21187,2020-09-01,4758,4524,234,4.9
21189,2020-09-01,1027,961,66,6.4
21191,2020-09-01,6460,6212,248,3.8
21193,2020-09-01,7284,6682,602,8.3
21195,2020-09-01,16967,15672,1295,7.6
21197,2020-09-01,4590,4314,276,6
21199,2020-09-01,23983,22702,1281,5.3
21201,2020-09-01,765,731,34,4.4
21203,2020-09-01,5806,5476,330,5.7
21205,2020-09-01,9262,8757,505,5.5
21207,2020-09-01,5638,5326,312,5.5
21209,2020-09-01,26951,25834,1117,4.1
21211,2020-09-01,23672,22753,919,3.9
21213,2020-09-01,8199,7793,406,5
21215,2020-09-01,9442,9076,366,3.9
21217,2020-09-01,11171,10671,500,4.5
21219,2020-09-01,5003,4809,194,3.9
21221,2020-09-01,5719,5401,318,5.6
21223,2020-09-01,3602,3427,175,4.9
21225,2020-09-01,5379,5155,224,4.2
21227,2020-09-01,57551,54867,2684,4.7
21229,2020-09-01,5830,5605,225,3.9
21231,2020-09-01,6717,6368,349,5.2
21233,2020-09-01,5233,4997,236,4.5
21235,2020-09-01,12700,11949,751,5.9
21237,2020-09-01,1826,1726,100,5.5
21239,2020-09-01,13918,13350,568,4.1
22001,2020-09-01,24102,22411,1691,7
22003,2020-09-01,8784,7996,788,9
22005,2020-09-01,64200,60249,3951,6.2
22007,2020-09-01,9190,8330,860,9.4
22009,2020-09-01,15272,14176,1096,7.2
22011,2020-09-01,14513,13417,1096,7.6
22013,2020-09-01,5517,5073,444,8
22015,2020-09-01,57711,54410,3301,5.7
22017,2020-09-01,105701,96558,9143,8.6
22019,2020-09-01,96364,84602,11762,12.2
22021,2020-09-01,3778,3536,242,6.4
22023,2020-09-01,3387,3153,234,6.9
22025,2020-09-01,3512,3252,260,7.4
22027,2020-09-01,5745,5376,369,6.4
22029,2020-09-01,7164,6609,555,7.7
22031,2020-09-01,10819,10079,740,6.8
22033,2020-09-01,233774,216474,17300,7.4
22035,2020-09-01,1868,1652,216,11.6
22037,2020-09-01,7987,7487,500,6.3
22039,2020-09-01,11812,10882,930,7.9
22041,2020-09-01,7467,6882,585,7.8
22043,2020-09-01,8219,7713,506,6.2
22045,2020-09-01,29152,26373,2779,9.5
22047,2020-09-01,14407,13003,1404,9.7
22049,2020-09-01,6732,6400,332,4.9
22051,2020-09-01,210989,192281,18708,8.9
22053,2020-09-01,12821,11756,1065,8.3
22055,2020-09-01,115218,107497,7721,6.7
22057,2020-09-01,42437,39880,2557,6
22059,2020-09-01,6759,6444,315,4.7
22061,2020-09-01,20649,19414,1235,6
22063,2020-09-01,68701,64826,3875,5.6
22065,2020-09-01,3533,3252,281,8
22067,2020-09-01,10123,9146,977,9.7
22069,2020-09-01,15976,14838,1138,7.1
22071,2020-09-01,182413,159853,22560,12.4
22073,2020-09-01,73915,68980,4935,6.7
22075,2020-09-01,9690,9092,598,6.2
22077,2020-09-01,9980,9230,750,7.5
22079,2020-09-01,55630,52322,3308,5.9
22081,2020-09-01,3779,3552,227,6
22083,2020-09-01,8289,7685,604,7.3
22085,2020-09-01,9142,8639,503,5.5
22087,2020-09-01,19786,17801,1985,10
22089,2020-09-01,24349,22580,1769,7.3
22091,2020-09-01,4475,3951,524,11.7
22093,2020-09-01,9046,8143,903,10
22095,2020-09-01,19634,17389,2245,11.4
22097,2020-09-01,32392,29537,2855,8.8
22099,2020-09-01,22666,20845,1821,8
22101,2020-09-01,19902,18084,1818,9.1
22103,2020-09-01,114280,107528,6752,5.9
22105,2020-09-01,55957,50745,5212,9.3
22107,2020-09-01,1391,1289,102,7.3
22109,2020-09-01,47414,43905,3509,7.4
22111,2020-09-01,9585,8942,643,6.7
22113,2020-09-01,24400,22689,1711,7
22115,2020-09-01,15690,14601,1089,6.9
22117,2020-09-01,16917,15512,1405,8.3
22119,2020-09-01,14518,13432,1086,7.5
22121,2020-09-01,13749,12795,954,6.9
22123,2020-09-01,3558,3259,299,8.4
22125,2020-09-01,5341,5082,259,4.8
22127,2020-09-01,4827,4488,339,7
23001,2020-09-01,54887,51636,3251,5.9
23003,2020-09-01,29757,28153,1604,5.4
23005,2020-09-01,162395,153546,8849,5.4
23007,2020-09-01,13713,12891,822,6
23009,2020-09-01,28352,27003,1349,4.8
23011,2020-09-01,63186,60135,3051,4.8
23013,2020-09-01,19543,18566,977,5
23015,2020-09-01,16515,15677,838,5.1
23017,2020-09-01,25486,23636,1850,7.3
23019,2020-09-01,76145,72213,3932,5.2
23021,2020-09-01,7235,6869,366,5.1
23023,2020-09-01,19555,18666,889,4.5
23025,2020-09-01,21946,20532,1414,6.4
23027,2020-09-01,20347,19321,1026,5
23029,2020-09-01,13100,12287,813,6.2
23031,2020-09-01,110662,104523,6139,5.5
24001,2020-09-01,29485,27297,2188,7.4
24003,2020-09-01,297171,278938,18233,6.1
24005,2020-09-01,430995,399096,31899,7.4
24009,2020-09-01,46929,44441,2488,5.3
24011,2020-09-01,16485,15510,975,5.9
24013,2020-09-01,88745,84310,4435,5
24015,2020-09-01,48414,45405,3009,6.2
24017,2020-09-01,83279,77184,6095,7.3
24019,2020-09-01,14317,13263,1054,7.4
24021,2020-09-01,128569,120722,7847,6.1
24023,2020-09-01,14145,13325,820,5.8
24025,2020-09-01,131887,124193,7694,5.8
24027,2020-09-01,176381,166652,9729,5.5
24029,2020-09-01,9045,8407,638,7.1
24031,2020-09-01,544759,506716,38043,7
24033,2020-09-01,497158,449671,47487,9.6
24035,2020-09-01,25658,24297,1361,5.3
24037,2020-09-01,51920,49260,2660,5.1
24039,2020-09-01,8396,7675,721,8.6
24041,2020-09-01,17147,16237,910,5.3
24043,2020-09-01,69461,64673,4788,6.9
24045,2020-09-01,48065,44734,3331,6.9
24047,2020-09-01,23570,21608,1962,8.3
24510,2020-09-01,277469,250011,27458,9.9
25001,2020-09-01,112158,101893,10265,9.2
25003,2020-09-01,64042,58067,5975,9.3
25005,2020-09-01,302898,271918,30980,10.2
25007,2020-09-01,10360,9673,687,6.6
25009,2020-09-01,427237,381228,46009,10.8
25011,2020-09-01,39948,36886,3062,7.7
25013,2020-09-01,223919,197841,26078,11.6
25015,2020-09-01,85793,79246,6547,7.6
25017,2020-09-01,899738,826920,72818,8.1
25019,2020-09-01,8576,8060,516,6
25021,2020-09-01,387156,351141,36015,9.3
25023,2020-09-01,280954,253134,27820,9.9
25025,2020-09-01,462258,408545,53713,11.6
25027,2020-09-01,447626,405787,41839,9.3
26001,2020-09-01,4018,3700,318,7.9
26003,2020-09-01,3174,2934,240,7.6
26005,2020-09-01,62885,59301,3584,5.7
26007,2020-09-01,13428,12570,858,6.4
26009,2020-09-01,10910,10153,757,6.9
26011,2020-09-01,6178,5699,479,7.8
26013,2020-09-01,3167,2864,303,9.6
26015,2020-09-01,31760,29903,1857,5.8
26017,2020-09-01,48557,44920,3637,7.5
26019,2020-09-01,9348,8779,569,6.1
26021,2020-09-01,74524,68813,5711,7.7
26023,2020-09-01,19524,18145,1379,7.1
26025,2020-09-01,61551,56231,5320,8.6
26027,2020-09-01,24214,22405,1809,7.5
26029,2020-09-01,13187,12376,811,6.1
26031,2020-09-01,10759,10031,728,6.8
26033,2020-09-01,16596,15472,1124,6.8
26035,2020-09-01,11677,10554,1123,9.6
26037,2020-09-01,39924,37781,2143,5.4
26039,2020-09-01,5412,4950,462,8.5
26041,2020-09-01,17834,16700,1134,6.4
26043,2020-09-01,12749,12007,742,5.8
26045,2020-09-01,55593,51966,3627,6.5
26047,2020-09-01,18847,17706,1141,6.1
26049,2020-09-01,183992,166711,17281,9.4
26051,2020-09-01,9915,9148,767,7.7
26053,2020-09-01,6215,5815,400,6.4
26055,2020-09-01,53129,49989,3140,5.9
26057,2020-09-01,18591,17449,1142,6.1
26059,2020-09-01,20363,18964,1399,6.9
26061,2020-09-01,17138,16170,968,5.6
26063,2020-09-01,16190,15297,893,5.5
26065,2020-09-01,147625,137096,10529,7.1
26067,2020-09-01,29903,28087,1816,6.1
26069,2020-09-01,10339,9533,806,7.8
26071,2020-09-01,5368,5051,317,5.9
26073,2020-09-01,36220,33966,2254,6.2
26075,2020-09-01,74129,68413,5716,7.7
26077,2020-09-01,135559,126367,9192,6.8
26079,2020-09-01,8478,7783,695,8.2
26081,2020-09-01,363428,339300,24128,6.6
26083,2020-09-01,928,870,58,6.3
26085,2020-09-01,3904,3506,398,10.2
26087,2020-09-01,38223,35179,3044,8
26089,2020-09-01,11222,10597,625,5.6
26091,2020-09-01,46282,43158,3124,6.7
26093,2020-09-01,96230,90014,6216,6.5
26095,2020-09-01,2375,2221,154,6.5
26097,2020-09-01,6066,5813,253,4.2
26099,2020-09-01,424193,384638,39555,9.3
26101,2020-09-01,10230,9377,853,8.3
26103,2020-09-01,33733,31819,1914,5.7
26105,2020-09-01,13850,12865,985,7.1
26107,2020-09-01,18898,17537,1361,7.2
26109,2020-09-01,11140,10540,600,5.4
26111,2020-09-01,39891,37379,2512,6.3
26113,2020-09-01,7362,6903,459,6.2
26115,2020-09-01,73088,68051,5037,6.9
26117,2020-09-01,28521,26533,1988,7
26119,2020-09-01,3065,2754,311,10.1
26121,2020-09-01,77724,69778,7946,10.2
26123,2020-09-01,23463,21856,1607,6.8
26125,2020-09-01,634858,585762,49096,7.7
26127,2020-09-01,12107,11108,999,8.3
26129,2020-09-01,8255,7584,671,8.1
26131,2020-09-01,2081,1906,175,8.4
26133,2020-09-01,11824,11101,723,6.1
26135,2020-09-01,3061,2797,264,8.6
26137,2020-09-01,11512,10625,887,7.7
26139,2020-09-01,161299,152578,8721,5.4
26141,2020-09-01,4973,4579,394,7.9
26143,2020-09-01,7710,6963,747,9.7
26145,2020-09-01,85597,78175,7422,8.7
26147,2020-09-01,70676,64818,5858,8.3
26149,2020-09-01,29061,26929,2132,7.3
26151,2020-09-01,19796,18502,1294,6.5
26153,2020-09-01,3408,3192,216,6.3
26155,2020-09-01,34199,31934,2265,6.6
26157,2020-09-01,24361,22661,1700,7
26159,2020-09-01,35672,33241,2431,6.8
26161,2020-09-01,203343,191039,12304,6.1
26163,2020-09-01,771469,674273,97196,12.6
26165,2020-09-01,15632,14522,1110,7.1
27001,2020-09-01,7134,6744,390,5.5
27003,2020-09-01,195058,183921,11137,5.7
27005,2020-09-01,18795,18011,784,4.2
27007,2020-09-01,24452,23343,1109,4.5
27009,2020-09-01,21910,20895,1015,4.6
27011,2020-09-01,2383,2319,64,2.7
27013,2020-09-01,40393,38604,1789,4.4
27015,2020-09-01,14325,13824,501,3.5
27017,2020-09-01,17000,16019,981,5.8
27019,2020-09-01,57343,54742,2601,4.5
27021,2020-09-01,14281,13336,945,6.6
27023,2020-09-01,6799,6569,230,3.4
27025,2020-09-01,29271,27768,1503,5.1
27027,2020-09-01,36116,34972,1144,3.2
27029,2020-09-01,4216,4003,213,5.1
27031,2020-09-01,3005,2863,142,4.7
27033,2020-09-01,6062,5834,228,3.8
27035,2020-09-01,32316,30713,1603,5
27037,2020-09-01,238863,225231,13632,5.7
27039,2020-09-01,11534,11117,417,3.6
27041,2020-09-01,21130,20442,688,3.3
27043,2020-09-01,6874,6549,325,4.7
27045,2020-09-01,11240,10844,396,3.5
27047,2020-09-01,16277,15567,710,4.4
27049,2020-09-01,26696,25536,1160,4.3
27051,2020-09-01,3321,3199,122,3.7
27053,2020-09-01,706824,660392,46432,6.6
27055,2020-09-01,10004,9712,292,2.9
27057,2020-09-01,9746,9308,438,4.5
27059,2020-09-01,20729,19642,1087,5.2
27061,2020-09-01,21162,19843,1319,6.2
27063,2020-09-01,5720,5536,184,3.2
27065,2020-09-01,8843,8413,430,4.9
27067,2020-09-01,24189,23320,869,3.6
27069,2020-09-01,2312,2239,73,3.2
27071,2020-09-01,5693,5391,302,5.3
27073,2020-09-01,3520,3411,109,3.1
27075,2020-09-01,5273,5031,242,4.6
27077,2020-09-01,2361,2260,101,4.3
27079,2020-09-01,15558,14859,699,4.5
27081,2020-09-01,3166,3091,75,2.4
27083,2020-09-01,14396,13907,489,3.4
27085,2020-09-01,19007,18176,831,4.4
27087,2020-09-01,2437,2182,255,10.5
27089,2020-09-01,5138,4983,155,3
27091,2020-09-01,9965,9579,386,3.9
27093,2020-09-01,13158,12696,462,3.5
27095,2020-09-01,12531,11771,760,6.1
27097,2020-09-01,17249,16588,661,3.8
27099,2020-09-01,20690,19816,874,4.2
27101,2020-09-01,4609,4449,160,3.5
27103,2020-09-01,20858,20007,851,4.1
27105,2020-09-01,11391,10987,404,3.5
27107,2020-09-01,3212,3062,150,4.7
27109,2020-09-01,87441,83525,3916,4.5
27111,2020-09-01,30812,29716,1096,3.6
27113,2020-09-01,8413,8141,272,3.2
27115,2020-09-01,14723,13869,854,5.8
27117,2020-09-01,4709,4597,112,2.4
27119,2020-09-01,16169,15517,652,4
27121,2020-09-01,6503,6270,233,3.6
27123,2020-09-01,289830,269960,19870,6.9
27125,2020-09-01,2145,2076,69,3.2
27127,2020-09-01,7621,7301,320,4.2
27129,2020-09-01,8289,7978,311,3.8
27131,2020-09-01,37371,35802,1569,4.2
27133,2020-09-01,5632,5495,137,2.4
27135,2020-09-01,7792,7522,270,3.5
27137,2020-09-01,97449,91792,5657,5.8
27139,2020-09-01,82287,78006,4281,5.2
27141,2020-09-01,50934,48567,2367,4.6
27143,2020-09-01,8277,7935,342,4.1
27145,2020-09-01,90630,86541,4089,4.5
27147,2020-09-01,21470,20569,901,4.2
27149,2020-09-01,5300,5179,121,2.3
27151,2020-09-01,4803,4626,177,3.7
27153,2020-09-01,13556,13072,484,3.6
27155,2020-09-01,1752,1706,46,2.6
27157,2020-09-01,11996,11565,431,3.6
27159,2020-09-01,6018,5740,278,4.6
27161,2020-09-01,9024,8573,451,5
27163,2020-09-01,140632,133653,6979,5
27165,2020-09-01,6445,6230,215,3.3
27167,2020-09-01,3409,3313,96,2.8
27169,2020-09-01,28789,27703,1086,3.8
27171,2020-09-01,73610,70422,3188,4.3
27173,2020-09-01,5274,5119,155,2.9
28001,2020-09-01,11646,10483,1163,10
28003,2020-09-01,16602,15803,799,4.8
28005,2020-09-01,4486,4144,342,7.6
28007,2020-09-01,7212,6657,555,7.7
28009,2020-09-01,3089,2861,228,7.4
28011,2020-09-01,11925,10979,946,7.9
28013,2020-09-01,5458,5111,347,6.4
28015,2020-09-01,3416,3181,235,6.9
28017,2020-09-01,7115,6508,607,8.5
28019,2020-09-01,3793,3595,198,5.2
28021,2020-09-01,3140,2702,438,13.9
28023,2020-09-01,5919,5457,462,7.8
28025,2020-09-01,7822,6967,855,10.9
28027,2020-09-01,8759,7710,1049,12
28029,2020-09-01,11324,10510,814,7.2
28031,2020-09-01,8380,7797,583,7
28033,2020-09-01,92484,87329,5155,5.6
28035,2020-09-01,35180,32633,2547,7.2
28037,2020-09-01,2916,2690,226,7.8
28039,2020-09-01,8810,8076,734,8.3
28041,2020-09-01,4274,3889,385,9
28043,2020-09-01,9650,9017,633,6.6
28045,2020-09-01,19313,17980,1333,6.9
28047,2020-09-01,89394,82882,6512,7.3
28049,2020-09-01,111252,102163,9089,8.2
28051,2020-09-01,5730,4907,823,14.4
28053,2020-09-01,2293,1976,317,13.8
28055,2020-09-01,342,315,27,7.9
28057,2020-09-01,10606,10083,523,4.9
28059,2020-09-01,60054,55550,4504,7.5
28061,2020-09-01,6158,5654,504,8.2
28063,2020-09-01,2000,1638,362,18.1
28065,2020-09-01,4144,3749,395,9.5
28067,2020-09-01,26191,24468,1723,6.6
28069,2020-09-01,3486,3181,305,8.7
28071,2020-09-01,28417,27076,1341,4.7
28073,2020-09-01,32012,30443,1569,4.9
28075,2020-09-01,30280,28311,1969,6.5
28077,2020-09-01,4712,4334,378,8
28079,2020-09-01,8068,7509,559,6.9
28081,2020-09-01,42433,39723,2710,6.4
28083,2020-09-01,10058,9041,1017,10.1
28085,2020-09-01,14774,13839,935,6.3
28087,2020-09-01,25348,23491,1857,7.3
28089,2020-09-01,53992,51362,2630,4.9
28091,2020-09-01,10029,9334,695,6.9
28093,2020-09-01,14778,13674,1104,7.5
28095,2020-09-01,15788,14580,1208,7.7
28097,2020-09-01,4086,3785,301,7.4
28099,2020-09-01,10112,9400,712,7
28101,2020-09-01,8742,8167,575,6.6
28103,2020-09-01,3671,3242,429,11.7
28105,2020-09-01,23081,21613,1468,6.4
28107,2020-09-01,12736,11531,1205,9.5
28109,2020-09-01,23881,22296,1585,6.6
28111,2020-09-01,4462,4129,333,7.5
28113,2020-09-01,15061,13792,1269,8.4
28115,2020-09-01,15081,14262,819,5.4
28117,2020-09-01,11290,10661,629,5.6
28119,2020-09-01,2253,2002,251,11.1
28121,2020-09-01,76729,73667,3062,4
28123,2020-09-01,12909,12254,655,5.1
28125,2020-09-01,1567,1413,154,9.8
28127,2020-09-01,10925,10241,684,6.3
28129,2020-09-01,6747,6399,348,5.2
28131,2020-09-01,6927,6458,469,6.8
28133,2020-09-01,7810,6938,872,11.2
28135,2020-09-01,4998,4622,376,7.5
28137,2020-09-01,12568,11655,913,7.3
28139,2020-09-01,9316,8815,501,5.4
28141,2020-09-01,8878,8458,420,4.7
28143,2020-09-01,4803,4133,670,13.9
28145,2020-09-01,14495,13750,745,5.1
28147,2020-09-01,5034,4630,404,8
28149,2020-09-01,20700,19102,1598,7.7
28151,2020-09-01,17164,15348,1816,10.6
28153,2020-09-01,7623,6945,678,8.9
28155,2020-09-01,4007,3754,253,6.3
28157,2020-09-01,2840,2441,399,14
28159,2020-09-01,7468,6877,591,7.9
28161,2020-09-01,4958,4629,329,6.6
28163,2020-09-01,9678,8828,850,8.8
29001,2020-09-01,10054,9754,300,3
29003,2020-09-01,9433,9171,262,2.8
29005,2020-09-01,2656,2593,63,2.4
29007,2020-09-01,10366,10050,316,3
29009,2020-09-01,15485,14865,620,4
29011,2020-09-01,5125,4966,159,3.1
29013,2020-09-01,7568,7290,278,3.7
29015,2020-09-01,7206,6798,408,5.7
29017,2020-09-01,5051,4842,209,4.1
29019,2020-09-01,96065,93274,2791,2.9
29021,2020-09-01,43267,41770,1497,3.5
29023,2020-09-01,17853,17117,736,4.1
29025,2020-09-01,4192,4066,126,3
29027,2020-09-01,20631,20049,582,2.8
29029,2020-09-01,18243,17531,712,3.9
29031,2020-09-01,37455,36144,1311,3.5
29033,2020-09-01,4563,4424,139,3
29035,2020-09-01,2522,2428,94,3.7
29037,2020-09-01,52970,50953,2017,3.8
29039,2020-09-01,5710,5552,158,2.8
29041,2020-09-01,3669,3579,90,2.5
29043,2020-09-01,43755,42395,1360,3.1
29045,2020-09-01,3132,3027,105,3.4
29047,2020-09-01,132012,126903,5109,3.9
29049,2020-09-01,10354,9978,376,3.6
29051,2020-09-01,37840,36719,1121,3
29053,2020-09-01,7232,7001,231,3.2
29055,2020-09-01,10786,10331,455,4.2
29057,2020-09-01,3519,3424,95,2.7
29059,2020-09-01,6818,6561,257,3.8
29061,2020-09-01,4088,3985,103,2.5
29063,2020-09-01,4660,4535,125,2.7
29065,2020-09-01,6285,6082,203,3.2
29067,2020-09-01,4975,4791,184,3.7
29069,2020-09-01,11270,10674,596,5.3
29071,2020-09-01,50849,48855,1994,3.9
29073,2020-09-01,7563,7319,244,3.2
29075,2020-09-01,3431,3358,73,2.1
29077,2020-09-01,148003,142789,5214,3.5
29079,2020-09-01,4305,4197,108,2.5
29081,2020-09-01,3786,3686,100,2.6
29083,2020-09-01,9590,9240,350,3.6
29085,2020-09-01,3842,3722,120,3.1
29087,2020-09-01,2516,2463,53,2.1
29089,2020-09-01,4756,4627,129,2.7
29091,2020-09-01,16397,15650,747,4.6
29093,2020-09-01,3503,3335,168,4.8
29095,2020-09-01,354299,334715,19584,5.5
29097,2020-09-01,56224,54039,2185,3.9
29099,2020-09-01,113304,108535,4769,4.2
29101,2020-09-01,23297,22467,830,3.6
29103,2020-09-01,1734,1692,42,2.4
29105,2020-09-01,16765,15974,791,4.7
29107,2020-09-01,16232,15649,583,3.6
29109,2020-09-01,17825,17176,649,3.6
29111,2020-09-01,4910,4771,139,2.8
29113,2020-09-01,27130,26089,1041,3.8
29115,2020-09-01,5039,4832,207,4.1
29117,2020-09-01,7326,7151,175,2.4
29119,2020-09-01,10638,10234,404,3.8
29121,2020-09-01,7413,7202,211,2.8
29123,2020-09-01,5539,5290,249,4.5
29125,2020-09-01,3826,3707,119,3.1
29127,2020-09-01,14375,13910,465,3.2
29129,2020-09-01,1870,1834,36,1.9
29131,2020-09-01,12072,11680,392,3.2
29133,2020-09-01,5676,5467,209,3.7
29135,2020-09-01,7062,6870,192,2.7
29137,2020-09-01,3714,3579,135,3.6
29139,2020-09-01,5633,5469,164,2.9
29141,2020-09-01,7883,7591,292,3.7
29143,2020-09-01,8300,7952,348,4.2
29145,2020-09-01,26794,25774,1020,3.8
29147,2020-09-01,11109,10846,263,2.4
29149,2020-09-01,3991,3819,172,4.3
29151,2020-09-01,6847,6711,136,2
29153,2020-09-01,3382,3231,151,4.5
29155,2020-09-01,6396,5996,400,6.3
29157,2020-09-01,9699,9437,262,2.7
29159,2020-09-01,20915,20000,915,4.4
29161,2020-09-01,19508,18873,635,3.3
29163,2020-09-01,7385,7137,248,3.4
29165,2020-09-01,56871,54741,2130,3.7
29167,2020-09-01,14122,13664,458,3.2
29169,2020-09-01,14492,13946,546,3.8
29171,2020-09-01,2197,2131,66,3
29173,2020-09-01,5550,5410,140,2.5
29175,2020-09-01,10231,9817,414,4
29177,2020-09-01,10567,10177,390,3.7
29179,2020-09-01,2969,2845,124,4.2
29181,2020-09-01,4966,4691,275,5.5
29183,2020-09-01,217156,209720,7436,3.4
29185,2020-09-01,3689,3541,148,4
29186,2020-09-01,8986,8699,287,3.2
29187,2020-09-01,26451,25127,1324,5
29189,2020-09-01,514908,489758,25150,4.9
29195,2020-09-01,10757,10450,307,2.9
29197,2020-09-01,1897,1830,67,3.5
29199,2020-09-01,2334,2289,45,1.9
29201,2020-09-01,19288,18571,717,3.7
29203,2020-09-01,3190,3047,143,4.5
29205,2020-09-01,3058,2986,72,2.4
29207,2020-09-01,12934,12491,443,3.4
29209,2020-09-01,13514,12841,673,5
29211,2020-09-01,2669,2597,72,2.7
29213,2020-09-01,26770,25071,1699,6.3
29215,2020-09-01,8745,8406,339,3.9
29217,2020-09-01,9356,9064,292,3.1
29219,2020-09-01,17211,16553,658,3.8
29221,2020-09-01,10098,9610,488,4.8
29223,2020-09-01,5006,4797,209,4.2
29225,2020-09-01,16751,16189,562,3.4
29227,2020-09-01,1160,1125,35,3
29229,2020-09-01,7267,6967,300,4.1
29510,2020-09-01,150069,139404,10665,7.1
30001,2020-09-01,5033,4880,153,3
30003,2020-09-01,4765,4464,301,6.3
30005,2020-09-01,2242,2150,92,4.1
30007,2020-09-01,2539,2410,129,5.1
30009,2020-09-01,5479,5230,249,4.5
30011,2020-09-01,644,624,20,3.1
30013,2020-09-01,37404,35572,1832,4.9
30015,2020-09-01,2433,2353,80,3.3
30017,2020-09-01,6089,5855,234,3.8
30019,2020-09-01,869,847,22,2.5
30021,2020-09-01,4545,4287,258,5.7
30023,2020-09-01,4945,4746,199,4
30025,2020-09-01,1654,1588,66,4
30027,2020-09-01,5628,5458,170,3
30029,2020-09-01,48453,45804,2649,5.5
30031,2020-09-01,70125,67553,2572,3.7
30033,2020-09-01,702,689,13,1.9
30035,2020-09-01,5908,5422,486,8.2
30037,2020-09-01,361,347,14,3.9
30039,2020-09-01,1565,1487,78,5
30041,2020-09-01,7455,7136,319,4.3
30043,2020-09-01,5594,5372,222,4
30045,2020-09-01,1020,979,41,4
30047,2020-09-01,13463,12754,709,5.3
30049,2020-09-01,35310,33948,1362,3.9
30051,2020-09-01,942,923,19,2
30053,2020-09-01,8042,7464,578,7.2
30055,2020-09-01,906,876,30,3.3
30057,2020-09-01,4232,4073,159,3.8
30059,2020-09-01,931,892,39,4.2
30061,2020-09-01,1748,1631,117,6.7
30063,2020-09-01,64763,61700,3063,4.7
30065,2020-09-01,2261,2144,117,5.2
30067,2020-09-01,9212,8766,446,4.8
30069,2020-09-01,266,260,6,2.3
30071,2020-09-01,1846,1780,66,3.6
30073,2020-09-01,2565,2447,118,4.6
30075,2020-09-01,938,916,22,2.3
30077,2020-09-01,2850,2752,98,3.4
30079,2020-09-01,454,420,34,7.5
30081,2020-09-01,20238,19332,906,4.5
30083,2020-09-01,5776,5388,388,6.7
30085,2020-09-01,4343,4116,227,5.2
30087,2020-09-01,3618,3441,177,4.9
30089,2020-09-01,5043,4752,291,5.8
30091,2020-09-01,1753,1680,73,4.2
30093,2020-09-01,16909,15973,936,5.5
30095,2020-09-01,5299,5064,235,4.4
30097,2020-09-01,1789,1738,51,2.9
30099,2020-09-01,2676,2590,86,3.2
30101,2020-09-01,2048,1952,96,4.7
30103,2020-09-01,331,318,13,3.9
30105,2020-09-01,3920,3782,138,3.5
30107,2020-09-01,768,719,49,6.4
30109,2020-09-01,446,427,19,4.3
30111,2020-09-01,81868,78238,3630,4.4
31001,2020-09-01,15927,15463,464,2.9
31003,2020-09-01,3703,3626,77,2.1
31005,2020-09-01,217,205,12,5.5
31007,2020-09-01,354,345,9,2.5
31009,2020-09-01,238,232,6,2.5
31011,2020-09-01,2788,2730,58,2.1
31013,2020-09-01,5129,4914,215,4.2
31015,2020-09-01,1014,987,27,2.7
31017,2020-09-01,1317,1287,30,2.3
31019,2020-09-01,26583,25883,700,2.6
31021,2020-09-01,3391,3289,102,3
31023,2020-09-01,4385,4253,132,3
31025,2020-09-01,13444,13013,431,3.2
31027,2020-09-01,4330,4235,95,2.2
31029,2020-09-01,2139,2106,33,1.5
31031,2020-09-01,3187,3127,60,1.9
31033,2020-09-01,4104,3948,156,3.8
31035,2020-09-01,3090,3019,71,2.3
31037,2020-09-01,5386,5260,126,2.3
31039,2020-09-01,4656,4555,101,2.2
31041,2020-09-01,5965,5857,108,1.8
31043,2020-09-01,10770,10394,376,3.5
31045,2020-09-01,4892,4786,106,2.2
31047,2020-09-01,12712,12363,349,2.7
31049,2020-09-01,902,875,27,3
31051,2020-09-01,2965,2896,69,2.3
31053,2020-09-01,19803,19240,563,2.8
31055,2020-09-01,301519,288758,12761,4.2
31057,2020-09-01,1119,1097,22,2
31059,2020-09-01,2978,2916,62,2.1
31061,2020-09-01,1385,1341,44,3.2
31063,2020-09-01,1467,1435,32,2.2
31065,2020-09-01,2520,2469,51,2
31067,2020-09-01,10547,10239,308,2.9
31069,2020-09-01,1028,1000,28,2.7
31071,2020-09-01,1089,1074,15,1.4
31073,2020-09-01,1079,1059,20,1.9
31075,2020-09-01,396,390,6,1.5
31077,2020-09-01,1177,1146,31,2.6
31079,2020-09-01,31922,30451,1471,4.6
31081,2020-09-01,4653,4520,133,2.9
31083,2020-09-01,1682,1646,36,2.1
31085,2020-09-01,596,585,11,1.8
31087,2020-09-01,1266,1224,42,3.3
31089,2020-09-01,5452,5354,98,1.8
31091,2020-09-01,407,398,9,2.2
31093,2020-09-01,3291,3180,111,3.4
31095,2020-09-01,4009,3911,98,2.4
31097,2020-09-01,2007,1948,59,2.9
31099,2020-09-01,3565,3480,85,2.4
31101,2020-09-01,4367,4262,105,2.4
31103,2020-09-01,560,553,7,1.3
31105,2020-09-01,1896,1836,60,3.2
31107,2020-09-01,4428,4331,97,2.2
31109,2020-09-01,182095,176200,5895,3.2
31111,2020-09-01,17723,17233,490,2.8
31113,2020-09-01,446,438,8,1.8
31115,2020-09-01,383,374,9,2.3
31117,2020-09-01,427,421,6,1.4
31119,2020-09-01,18895,18197,698,3.7
31121,2020-09-01,3917,3801,116,3
31123,2020-09-01,2502,2431,71,2.8
31125,2020-09-01,1877,1832,45,2.4
31127,2020-09-01,3451,3361,90,2.6
31129,2020-09-01,2324,2276,48,2.1
31131,2020-09-01,8184,7962,222,2.7
31133,2020-09-01,1418,1382,36,2.5
31135,2020-09-01,1747,1719,28,1.6
31137,2020-09-01,4690,4577,113,2.4
31139,2020-09-01,3960,3825,135,3.4
31141,2020-09-01,16990,16551,439,2.6
31143,2020-09-01,2736,2679,57,2.1
31145,2020-09-01,5591,5441,150,2.7
31147,2020-09-01,4081,3977,104,2.5
31149,2020-09-01,818,804,14,1.7
31151,2020-09-01,7057,6874,183,2.6
31153,2020-09-01,96519,93504,3015,3.1
31155,2020-09-01,11032,10720,312,2.8
31157,2020-09-01,17469,16848,621,3.6
31159,2020-09-01,9026,8741,285,3.2
31161,2020-09-01,2534,2478,56,2.2
31163,2020-09-01,1586,1550,36,2.3
31165,2020-09-01,708,694,14,2
31167,2020-09-01,3387,3279,108,3.2
31169,2020-09-01,2637,2580,57,2.2
31171,2020-09-01,393,380,13,3.3
31173,2020-09-01,2809,2694,115,4.1
31175,2020-09-01,2020,1981,39,1.9
31177,2020-09-01,11173,10864,309,2.8
31179,2020-09-01,5368,5250,118,2.2
31181,2020-09-01,1533,1491,42,2.7
31183,2020-09-01,512,504,8,1.6
31185,2020-09-01,6964,6797,167,2.4
32001,2020-09-01,11042,10522,520,4.7
32003,2020-09-01,NA,975912,166395,14.6
32005,2020-09-01,23632,21982,1650,7
32007,2020-09-01,26529,25378,1151,4.3
32009,2020-09-01,441,421,20,4.5
32011,2020-09-01,1006,975,31,3.1
32013,2020-09-01,8032,7672,360,4.5
32015,2020-09-01,3164,3032,132,4.2
32017,2020-09-01,2039,1948,91,4.5
32019,2020-09-01,23223,21520,1703,7.3
32021,2020-09-01,2009,1900,109,5.4
32023,2020-09-01,17912,16297,1615,9
32027,2020-09-01,2441,2334,107,4.4
32029,2020-09-01,2033,1883,150,7.4
32031,2020-09-01,253554,236626,16928,6.7
32033,2020-09-01,4574,4400,174,3.8
32510,2020-09-01,26493,24674,1819,6.9
33001,2020-09-01,30353,28731,1622,5.3
33003,2020-09-01,22413,21086,1327,5.9
33005,2020-09-01,39544,37534,2010,5.1
33007,2020-09-01,13903,13093,810,5.8
33009,2020-09-01,47506,45402,2104,4.4
33011,2020-09-01,232647,218927,13720,5.9
33013,2020-09-01,80638,76926,3712,4.6
33015,2020-09-01,178040,167473,10567,5.9
33017,2020-09-01,68465,64882,3583,5.2
33019,2020-09-01,22887,21846,1041,4.5
34001,2020-09-01,112424,101115,11309,10.1
34003,2020-09-01,462268,432237,30031,6.5
34005,2020-09-01,221815,210187,11628,5.2
34007,2020-09-01,244568,228663,15905,6.5
34009,2020-09-01,42350,39483,2867,6.8
34011,2020-09-01,62939,58702,4237,6.7
34013,2020-09-01,353568,323988,29580,8.4
34015,2020-09-01,144044,135827,8217,5.7
34017,2020-09-01,348705,322336,26369,7.6
34019,2020-09-01,60561,57846,2715,4.5
34021,2020-09-01,195516,185615,9901,5.1
34023,2020-09-01,418558,393831,24727,5.9
34025,2020-09-01,313224,295518,17706,5.7
34027,2020-09-01,241588,229462,12126,5
34029,2020-09-01,261022,245975,15047,5.8
34031,2020-09-01,233861,213810,20051,8.6
34033,2020-09-01,27447,25753,1694,6.2
34035,2020-09-01,161041,152789,8252,5.1
34037,2020-09-01,69771,65815,3956,5.7
34039,2020-09-01,262369,244510,17859,6.8
34041,2020-09-01,54079,51288,2791,5.2
35001,2020-09-01,338079,306478,31601,9.3
35003,2020-09-01,1061,974,87,8.2
35005,2020-09-01,27161,24400,2761,10.2
35006,2020-09-01,8949,7971,978,10.9
35007,2020-09-01,5170,4756,414,8
35009,2020-09-01,20961,19561,1400,6.7
35011,2020-09-01,686,649,37,5.4
35013,2020-09-01,94178,85498,8680,9.2
35015,2020-09-01,35235,32165,3070,8.7
35017,2020-09-01,12223,10821,1402,11.5
35019,2020-09-01,1514,1387,127,8.4
35021,2020-09-01,273,258,15,5.5
35023,2020-09-01,2040,1910,130,6.4
35025,2020-09-01,33474,28895,4579,13.7
35027,2020-09-01,8684,7796,888,10.2
35028,2020-09-01,8999,8604,395,4.4
35029,2020-09-01,10533,8860,1673,15.9
35031,2020-09-01,24417,21327,3090,12.7
35033,2020-09-01,2028,1839,189,9.3
35035,2020-09-01,24677,22192,2485,10.1
35037,2020-09-01,3060,2774,286,9.3
35039,2020-09-01,16189,14622,1567,9.7
35041,2020-09-01,7740,7165,575,7.4
35043,2020-09-01,67320,60542,6778,10.1
35045,2020-09-01,51382,45271,6111,11.9
35047,2020-09-01,10625,9638,987,9.3
35049,2020-09-01,72225,65238,6987,9.7
35051,2020-09-01,3773,3327,446,11.8
35053,2020-09-01,6111,5639,472,7.7
35055,2020-09-01,15804,13743,2061,13
35057,2020-09-01,5569,4939,630,11.3
35059,2020-09-01,1616,1517,99,6.1
35061,2020-09-01,30782,27847,2935,9.5
36001,2020-09-01,153491,144836,8655,5.6
36003,2020-09-01,18781,17808,973,5.2
36005,2020-09-01,588448,478869,109579,18.6
36007,2020-09-01,82799,77981,4818,5.8
36009,2020-09-01,32826,30917,1909,5.8
36011,2020-09-01,35256,33397,1859,5.3
36013,2020-09-01,51674,48482,3192,6.2
36015,2020-09-01,35737,33649,2088,5.8
36017,2020-09-01,21662,20682,980,4.5
36019,2020-09-01,36331,34580,1751,4.8
36021,2020-09-01,30475,29128,1347,4.4
36023,2020-09-01,22487,21387,1100,4.9
36025,2020-09-01,18753,17849,904,4.8
36027,2020-09-01,139113,131172,7941,5.7
36029,2020-09-01,435985,407206,28779,6.6
36031,2020-09-01,16439,15679,760,4.6
36033,2020-09-01,19541,18562,979,5
36035,2020-09-01,21332,19993,1339,6.3
36037,2020-09-01,28852,27490,1362,4.7
36039,2020-09-01,20304,19100,1204,5.9
36041,2020-09-01,2267,2176,91,4
36043,2020-09-01,26902,25519,1383,5.1
36045,2020-09-01,41872,39631,2241,5.4
36047,2020-09-01,NA,973244,158089,14
36049,2020-09-01,11252,10764,488,4.3
36051,2020-09-01,29133,27808,1325,4.5
36053,2020-09-01,31054,29532,1522,4.9
36055,2020-09-01,348576,325629,22947,6.6
36057,2020-09-01,21137,19740,1397,6.6
36059,2020-09-01,690082,645162,44920,6.5
36061,2020-09-01,835234,744858,90376,10.8
36063,2020-09-01,96836,90546,6290,6.5
36065,2020-09-01,98615,92920,5695,5.8
36067,2020-09-01,212351,199148,13203,6.2
36069,2020-09-01,52727,50164,2563,4.9
36071,2020-09-01,177421,166201,11220,6.3
36073,2020-09-01,16767,15852,915,5.5
36075,2020-09-01,50081,47124,2957,5.9
36077,2020-09-01,26207,24922,1285,4.9
36079,2020-09-01,49287,46569,2718,5.5
36081,2020-09-01,NA,931346,147872,13.7
36083,2020-09-01,78564,74521,4043,5.1
36085,2020-09-01,204168,180794,23374,11.4
36087,2020-09-01,149220,139691,9529,6.4
36089,2020-09-01,43390,41256,2134,4.9
36091,2020-09-01,115155,109759,5396,4.7
36093,2020-09-01,74606,69803,4803,6.4
36095,2020-09-01,14036,13378,658,4.7
36097,2020-09-01,8111,7720,391,4.8
36099,2020-09-01,15702,14882,820,5.2
36101,2020-09-01,41726,39556,2170,5.2
36103,2020-09-01,753257,707287,45970,6.1
36105,2020-09-01,36676,34266,2410,6.6
36107,2020-09-01,22473,21354,1119,5
36109,2020-09-01,49805,47676,2129,4.3
36111,2020-09-01,88184,83272,4912,5.6
36113,2020-09-01,29909,28354,1555,5.2
36115,2020-09-01,26717,25455,1262,4.7
36117,2020-09-01,41851,39753,2098,5
36119,2020-09-01,467499,435034,32465,6.9
36121,2020-09-01,17589,16831,758,4.3
36123,2020-09-01,11326,10862,464,4.1
37001,2020-09-01,80037,74580,5457,6.8
37003,2020-09-01,16944,15876,1068,6.3
37005,2020-09-01,4605,4318,287,6.2
37007,2020-09-01,10648,9742,906,8.5
37009,2020-09-01,13291,12609,682,5.1
37011,2020-09-01,7999,7594,405,5.1
37013,2020-09-01,19107,17905,1202,6.3
37015,2020-09-01,7748,7262,486,6.3
37017,2020-09-01,15278,14260,1018,6.7
37019,2020-09-01,50859,46921,3938,7.7
37021,2020-09-01,133759,123869,9890,7.4
37023,2020-09-01,38506,35988,2518,6.5
37025,2020-09-01,105554,98495,7059,6.7
37027,2020-09-01,34585,31982,2603,7.5
37029,2020-09-01,4583,4366,217,4.7
37031,2020-09-01,31391,29751,1640,5.2
37033,2020-09-01,9615,8938,677,7
37035,2020-09-01,74447,69123,5324,7.2
37037,2020-09-01,34158,32414,1744,5.1
37039,2020-09-01,11406,10640,766,6.7
37041,2020-09-01,5566,5243,323,5.8
37043,2020-09-01,4240,3966,274,6.5
37045,2020-09-01,49248,45556,3692,7.5
37047,2020-09-01,23123,21288,1835,7.9
37049,2020-09-01,40186,37614,2572,6.4
37051,2020-09-01,123039,111449,11590,9.4
37053,2020-09-01,13607,12908,699,5.1
37055,2020-09-01,18890,17664,1226,6.5
37057,2020-09-01,78253,73057,5196,6.6
37059,2020-09-01,19893,18710,1183,5.9
37061,2020-09-01,25304,24012,1292,5.1
37063,2020-09-01,165076,154197,10879,6.6
37065,2020-09-01,20893,18559,2334,11.2
37067,2020-09-01,182439,169265,13174,7.2
37069,2020-09-01,30057,28055,2002,6.7
37071,2020-09-01,108237,99954,8283,7.7
37073,2020-09-01,5151,4880,271,5.3
37075,2020-09-01,3430,3174,256,7.5
37077,2020-09-01,29397,27757,1640,5.6
37079,2020-09-01,9559,9012,547,5.7
37081,2020-09-01,255276,234104,21172,8.3
37083,2020-09-01,20223,18295,1928,9.5
37085,2020-09-01,52591,48969,3622,6.9
37087,2020-09-01,28206,26291,1915,6.8
37089,2020-09-01,51603,48493,3110,6
37091,2020-09-01,9286,8665,621,6.7
37093,2020-09-01,19292,17645,1647,8.5
37095,2020-09-01,1838,1700,138,7.5
37097,2020-09-01,86706,80854,5852,6.7
37099,2020-09-01,20498,19284,1214,5.9
37101,2020-09-01,95115,89310,5805,6.1
37103,2020-09-01,4234,4003,231,5.5
37105,2020-09-01,25669,23791,1878,7.3
37107,2020-09-01,28531,26786,1745,6.1
37109,2020-09-01,41883,39397,2486,5.9
37111,2020-09-01,20621,19383,1238,6
37113,2020-09-01,15803,14886,917,5.8
37115,2020-09-01,9498,8914,584,6.1
37117,2020-09-01,8861,8233,628,7.1
37119,2020-09-01,608358,561215,47143,7.7
37121,2020-09-01,6022,5620,402,6.7
37123,2020-09-01,11077,10351,726,6.6
37125,2020-09-01,42177,39567,2610,6.2
37127,2020-09-01,41696,38168,3528,8.5
37129,2020-09-01,118874,111225,7649,6.4
37131,2020-09-01,7556,7011,545,7.2
37133,2020-09-01,63863,59656,4207,6.6
37135,2020-09-01,75083,71348,3735,5
37137,2020-09-01,5112,4833,279,5.5
37139,2020-09-01,16673,15588,1085,6.5
37141,2020-09-01,27518,25889,1629,5.9
37143,2020-09-01,4930,4635,295,6
37145,2020-09-01,17716,16502,1214,6.9
37147,2020-09-01,85933,79959,5974,7
37149,2020-09-01,8918,8424,494,5.5
37151,2020-09-01,63617,59391,4226,6.6
37153,2020-09-01,17119,15561,1558,9.1
37155,2020-09-01,50718,46069,4649,9.2
37157,2020-09-01,38721,35758,2963,7.7
37159,2020-09-01,64315,59654,4661,7.2
37161,2020-09-01,25453,23352,2101,8.3
37163,2020-09-01,29672,28060,1612,5.4
37165,2020-09-01,12261,10796,1465,11.9
37167,2020-09-01,30199,28485,1714,5.7
37169,2020-09-01,20886,19664,1222,5.9
37171,2020-09-01,33552,31592,1960,5.8
37173,2020-09-01,7744,7297,447,5.8
37175,2020-09-01,14511,13742,769,5.3
37177,2020-09-01,1406,1301,105,7.5
37179,2020-09-01,118983,112268,6715,5.6
37181,2020-09-01,17904,16105,1799,10
37183,2020-09-01,571952,537131,34821,6.1
37185,2020-09-01,6802,6158,644,9.5
37187,2020-09-01,4363,3993,370,8.5
37189,2020-09-01,30395,29009,1386,4.6
37191,2020-09-01,49245,46092,3153,6.4
37193,2020-09-01,29380,27672,1708,5.8
37195,2020-09-01,34530,31598,2932,8.5
37197,2020-09-01,17098,16084,1014,5.9
37199,2020-09-01,8210,7745,465,5.7
38001,2020-09-01,994,963,31,3.1
38003,2020-09-01,5042,4919,123,2.4
38005,2020-09-01,2189,2078,111,5.1
38007,2020-09-01,484,472,12,2.5
38009,2020-09-01,2967,2854,113,3.8
38011,2020-09-01,1596,1555,41,2.6
38013,2020-09-01,970,932,38,3.9
38015,2020-09-01,49364,47936,1428,2.9
38017,2020-09-01,105967,102859,3108,2.9
38019,2020-09-01,1975,1927,48,2.4
38021,2020-09-01,2232,2190,42,1.9
38023,2020-09-01,1354,1320,34,2.5
38025,2020-09-01,2873,2738,135,4.7
38027,2020-09-01,1190,1159,31,2.6
38029,2020-09-01,1460,1411,49,3.4
38031,2020-09-01,1544,1512,32,2.1
38033,2020-09-01,833,813,20,2.4
38035,2020-09-01,37382,36274,1108,3
38037,2020-09-01,1196,1174,22,1.8
38039,2020-09-01,1005,983,22,2.2
38041,2020-09-01,1360,1317,43,3.2
38043,2020-09-01,1215,1181,34,2.8
38045,2020-09-01,1998,1966,32,1.6
38047,2020-09-01,849,830,19,2.2
38049,2020-09-01,3004,2914,90,3
38051,2020-09-01,1088,1060,28,2.6
38053,2020-09-01,8073,7452,621,7.7
38055,2020-09-01,4644,4496,148,3.2
38057,2020-09-01,3544,3398,146,4.1
38059,2020-09-01,16220,15661,559,3.4
38061,2020-09-01,6541,6217,324,5
38063,2020-09-01,1366,1335,31,2.3
38065,2020-09-01,865,831,34,3.9
38067,2020-09-01,3311,3214,97,2.9
38069,2020-09-01,1625,1580,45,2.8
38071,2020-09-01,5565,5408,157,2.8
38073,2020-09-01,2782,2728,54,1.9
38075,2020-09-01,1197,1154,43,3.6
38077,2020-09-01,8345,8160,185,2.2
38079,2020-09-01,4727,4199,528,11.2
38081,2020-09-01,2645,2601,44,1.7
38083,2020-09-01,680,657,23,3.4
38085,2020-09-01,1232,1189,43,3.5
38087,2020-09-01,389,379,10,2.6
38089,2020-09-01,16549,15418,1131,6.8
38091,2020-09-01,913,894,19,2.1
38093,2020-09-01,10284,10029,255,2.5
38095,2020-09-01,1139,1116,23,2
38097,2020-09-01,4358,4263,95,2.2
38099,2020-09-01,4999,4858,141,2.8
38101,2020-09-01,30586,29151,1435,4.7
38103,2020-09-01,1887,1836,51,2.7
38105,2020-09-01,20101,18013,2088,10.4
39001,2020-09-01,10652,9753,899,8.4
39003,2020-09-01,46687,43198,3489,7.5
39005,2020-09-01,26448,24973,1475,5.6
39007,2020-09-01,42726,39328,3398,8
39009,2020-09-01,27842,25905,1937,7
39011,2020-09-01,24265,22905,1360,5.6
39013,2020-09-01,28307,25586,2721,9.6
39015,2020-09-01,19718,18241,1477,7.5
39017,2020-09-01,196592,182501,14091,7.2
39019,2020-09-01,12737,11717,1020,8
39021,2020-09-01,19696,18502,1194,6.1
39023,2020-09-01,63916,59210,4706,7.4
39025,2020-09-01,107044,100188,6856,6.4
39027,2020-09-01,17762,16380,1382,7.8
39029,2020-09-01,46307,42167,4140,8.9
39031,2020-09-01,13735,12627,1108,8.1
39033,2020-09-01,18615,17162,1453,7.8
39035,2020-09-01,551936,489746,62190,11.3
39037,2020-09-01,25478,24092,1386,5.4
39039,2020-09-01,17701,16600,1101,6.2
39041,2020-09-01,107416,101764,5652,5.3
39043,2020-09-01,35889,32781,3108,8.7
39045,2020-09-01,76485,71509,4976,6.5
39047,2020-09-01,13640,12647,993,7.3
39049,2020-09-01,696280,639248,57032,8.2
39051,2020-09-01,21937,20651,1286,5.9
39053,2020-09-01,12215,11310,905,7.4
39055,2020-09-01,42655,40036,2619,6.1
39057,2020-09-01,82738,77707,5031,6.1
39059,2020-09-01,18080,16695,1385,7.7
39061,2020-09-01,424322,389555,34767,8.2
39063,2020-09-01,41664,39308,2356,5.7
39065,2020-09-01,13907,12986,921,6.6
39067,2020-09-01,6580,5990,590,9
39069,2020-09-01,13067,12304,763,5.8
39071,2020-09-01,17313,16039,1274,7.4
39073,2020-09-01,12715,11892,823,6.5
39075,2020-09-01,21035,20320,715,3.4
39077,2020-09-01,27113,25220,1893,7
39079,2020-09-01,12797,11699,1098,8.6
39081,2020-09-01,27751,24943,2808,10.1
39083,2020-09-01,30725,29032,1693,5.5
39085,2020-09-01,110377,101550,8827,8
39087,2020-09-01,24077,22167,1910,7.9
39089,2020-09-01,88723,83138,5585,6.3
39091,2020-09-01,22007,20634,1373,6.2
39093,2020-09-01,135565,122837,12728,9.4
39095,2020-09-01,210910,191012,19898,9.4
39097,2020-09-01,20352,19202,1150,5.7
39099,2020-09-01,98912,88870,10042,10.2
39101,2020-09-01,27716,25699,2017,7.3
39103,2020-09-01,84799,78794,6005,7.1
39105,2020-09-01,8865,8023,842,9.5
39107,2020-09-01,22992,21985,1007,4.4
39109,2020-09-01,53929,50487,3442,6.4
39111,2020-09-01,5479,4934,545,9.9
39113,2020-09-01,256377,234232,22145,8.6
39115,2020-09-01,6513,6008,505,7.8
39117,2020-09-01,16427,15407,1020,6.2
39119,2020-09-01,39230,36396,2834,7.2
39121,2020-09-01,4546,4147,399,8.8
39123,2020-09-01,20968,19496,1472,7
39125,2020-09-01,8709,8221,488,5.6
39127,2020-09-01,15601,14369,1232,7.9
39129,2020-09-01,25910,24243,1667,6.4
39131,2020-09-01,10522,9617,905,8.6
39133,2020-09-01,84092,78252,5840,6.9
39135,2020-09-01,20959,19694,1265,6
39137,2020-09-01,18487,17755,732,4
39139,2020-09-01,52566,48513,4053,7.7
39141,2020-09-01,34292,31853,2439,7.1
39143,2020-09-01,29592,27678,1914,6.5
39145,2020-09-01,28636,26267,2369,8.3
39147,2020-09-01,27050,25294,1756,6.5
39149,2020-09-01,23602,22082,1520,6.4
39151,2020-09-01,181598,167695,13903,7.7
39153,2020-09-01,265793,243509,22284,8.4
39155,2020-09-01,82944,74567,8377,10.1
39157,2020-09-01,43717,40754,2963,6.8
39159,2020-09-01,28324,26878,1446,5.1
39161,2020-09-01,14560,13828,732,5
39163,2020-09-01,5560,5112,448,8.1
39165,2020-09-01,119190,111933,7257,6.1
39167,2020-09-01,27017,24879,2138,7.9
39169,2020-09-01,60326,57052,3274,5.4
39171,2020-09-01,18480,17320,1160,6.3
39173,2020-09-01,69567,65397,4170,6
39175,2020-09-01,13203,12546,657,5
40001,2020-09-01,8311,7888,423,5.1
40003,2020-09-01,2802,2711,91,3.2
40005,2020-09-01,5114,4778,336,6.6
40007,2020-09-01,2879,2824,55,1.9
40009,2020-09-01,9971,9221,750,7.5
40011,2020-09-01,4785,4521,264,5.5
40013,2020-09-01,22147,21183,964,4.4
40015,2020-09-01,12165,11519,646,5.3
40017,2020-09-01,76941,73088,3853,5
40019,2020-09-01,21735,20507,1228,5.6
40021,2020-09-01,19275,18371,904,4.7
40023,2020-09-01,5592,5194,398,7.1
40025,2020-09-01,1387,1363,24,1.7
40027,2020-09-01,147126,140422,6704,4.6
40029,2020-09-01,2480,2332,148,6
40031,2020-09-01,48702,46125,2577,5.3
40033,2020-09-01,2805,2646,159,5.7
40035,2020-09-01,5930,5661,269,4.5
40037,2020-09-01,31907,30045,1862,5.8
40039,2020-09-01,16128,15335,793,4.9
40041,2020-09-01,18729,17957,772,4.1
40043,2020-09-01,3035,2901,134,4.4
40045,2020-09-01,2152,2049,103,4.8
40047,2020-09-01,26506,25155,1351,5.1
40049,2020-09-01,12850,12100,750,5.8
40051,2020-09-01,27531,26062,1469,5.3
40053,2020-09-01,2674,2593,81,3
40055,2020-09-01,1915,1787,128,6.7
40057,2020-09-01,1239,1195,44,3.6
40059,2020-09-01,1800,1745,55,3.1
40061,2020-09-01,4341,4040,301,6.9
40063,2020-09-01,5552,5175,377,6.8
40065,2020-09-01,10990,10616,374,3.4
40067,2020-09-01,2592,2439,153,5.9
40069,2020-09-01,3356,3115,241,7.2
40071,2020-09-01,18424,17368,1056,5.7
40073,2020-09-01,9151,8791,360,3.9
40075,2020-09-01,3470,3311,159,4.6
40077,2020-09-01,3218,2913,305,9.5
40079,2020-09-01,19467,18250,1217,6.3
40081,2020-09-01,16214,15456,758,4.7
40083,2020-09-01,22747,21759,988,4.3
40085,2020-09-01,6253,6029,224,3.6
40087,2020-09-01,20388,19414,974,4.8
40089,2020-09-01,15321,14385,936,6.1
40091,2020-09-01,7442,6915,527,7.1
40093,2020-09-01,3906,3726,180,4.6
40095,2020-09-01,7110,6759,351,4.9
40097,2020-09-01,19854,18947,907,4.6
40099,2020-09-01,6555,6200,355,5.4
40101,2020-09-01,30494,28931,1563,5.1
40103,2020-09-01,5685,5495,190,3.3
40105,2020-09-01,4725,4498,227,4.8
40107,2020-09-01,4636,4364,272,5.9
40109,2020-09-01,398785,377152,21633,5.4
40111,2020-09-01,15807,14770,1037,6.6
40113,2020-09-01,20876,19676,1200,5.7
40115,2020-09-01,14760,14145,615,4.2
40117,2020-09-01,7420,7004,416,5.6
40119,2020-09-01,39022,37425,1597,4.1
40121,2020-09-01,17490,16326,1164,6.7
40123,2020-09-01,19627,18790,837,4.3
40125,2020-09-01,33307,31570,1737,5.2
40127,2020-09-01,4386,4129,257,5.9
40129,2020-09-01,1878,1789,89,4.7
40131,2020-09-01,45362,43099,2263,5
40133,2020-09-01,9783,9134,649,6.6
40135,2020-09-01,16559,15597,962,5.8
40137,2020-09-01,19306,17901,1405,7.3
40139,2020-09-01,12083,11858,225,1.9
40141,2020-09-01,3054,2943,111,3.6
40143,2020-09-01,327574,308708,18866,5.8
40145,2020-09-01,38205,36272,1933,5.1
40147,2020-09-01,22520,21399,1121,5
40149,2020-09-01,5248,4909,339,6.5
40151,2020-09-01,4739,4606,133,2.8
40153,2020-09-01,9114,8500,614,6.7
41001,2020-09-01,7117,6677,440,6.2
41003,2020-09-01,44701,42225,2476,5.5
41005,2020-09-01,210987,195466,15521,7.4
41007,2020-09-01,18952,17503,1449,7.6
41009,2020-09-01,23196,21432,1764,7.6
41011,2020-09-01,25369,23288,2081,8.2
41013,2020-09-01,10058,9283,775,7.7
41015,2020-09-01,8926,8256,670,7.5
41017,2020-09-01,92302,85972,6330,6.9
41019,2020-09-01,45280,41966,3314,7.3
41021,2020-09-01,971,913,58,6
41023,2020-09-01,3176,2996,180,5.7
41025,2020-09-01,3543,3370,173,4.9
41027,2020-09-01,14524,13797,727,5
41029,2020-09-01,101690,94185,7505,7.4
41031,2020-09-01,9946,9231,715,7.2
41033,2020-09-01,34099,31591,2508,7.4
41035,2020-09-01,28723,26620,2103,7.3
41037,2020-09-01,3682,3511,171,4.6
41039,2020-09-01,179812,166348,13464,7.5
41041,2020-09-01,20005,18038,1967,9.8
41043,2020-09-01,57312,52914,4398,7.7
41045,2020-09-01,12476,11910,566,4.5
41047,2020-09-01,154774,144182,10592,6.8
41049,2020-09-01,5721,5471,250,4.4
41051,2020-09-01,444192,405036,39156,8.8
41053,2020-09-01,37738,35227,2511,6.7
41055,2020-09-01,958,904,54,5.6
41057,2020-09-01,11444,10584,860,7.5
41059,2020-09-01,36306,34319,1987,5.5
41061,2020-09-01,11612,10922,690,5.9
41063,2020-09-01,3477,3304,173,5
41065,2020-09-01,12355,11558,797,6.5
41067,2020-09-01,309572,289516,20056,6.5
41069,2020-09-01,701,676,25,3.6
41071,2020-09-01,52519,49159,3360,6.4
42001,2020-09-01,55648,52828,2820,5.1
42003,2020-09-01,639556,588117,51439,8
42005,2020-09-01,31506,29046,2460,7.8
42007,2020-09-01,83131,75907,7224,8.7
42009,2020-09-01,23422,21650,1772,7.6
42011,2020-09-01,225059,207810,17249,7.7
42013,2020-09-01,58448,54542,3906,6.7
42015,2020-09-01,28438,26756,1682,5.9
42017,2020-09-01,336578,312260,24318,7.2
42019,2020-09-01,96892,90863,6029,6.2
42021,2020-09-01,56640,52493,4147,7.3
42023,2020-09-01,2049,1819,230,11.2
42025,2020-09-01,31524,29097,2427,7.7
42027,2020-09-01,77507,74005,3502,4.5
42029,2020-09-01,277892,262419,15473,5.6
42031,2020-09-01,16975,15992,983,5.8
42033,2020-09-01,35693,33189,2504,7
42035,2020-09-01,17915,16740,1175,6.6
42037,2020-09-01,33886,31821,2065,6.1
42039,2020-09-01,36941,34216,2725,7.4
42041,2020-09-01,132696,125486,7210,5.4
42043,2020-09-01,147072,135925,11147,7.6
42045,2020-09-01,299753,274897,24856,8.3
42047,2020-09-01,15102,13664,1438,9.5
42049,2020-09-01,124703,114360,10343,8.3
42051,2020-09-01,56485,50940,5545,9.8
42053,2020-09-01,1785,1645,140,7.8
42055,2020-09-01,77603,72539,5064,6.5
42057,2020-09-01,8141,7286,855,10.5
42059,2020-09-01,16548,15268,1280,7.7
42061,2020-09-01,19843,18180,1663,8.4
42063,2020-09-01,39015,36307,2708,6.9
42065,2020-09-01,20009,18658,1351,6.8
42067,2020-09-01,12318,11717,601,4.9
42069,2020-09-01,100619,92276,8343,8.3
42071,2020-09-01,292325,275020,17305,5.9
42073,2020-09-01,39528,36123,3405,8.6
42075,2020-09-01,72476,67661,4815,6.6
42077,2020-09-01,191767,175955,15812,8.2
42079,2020-09-01,151965,137185,14780,9.7
42081,2020-09-01,52955,48949,4006,7.6
42083,2020-09-01,16901,15670,1231,7.3
42085,2020-09-01,46722,42758,3964,8.5
42087,2020-09-01,21078,19505,1573,7.5
42089,2020-09-01,79692,71793,7899,9.9
42091,2020-09-01,443715,413827,29888,6.7
42093,2020-09-01,9194,8759,435,4.7
42095,2020-09-01,159175,147349,11826,7.4
42097,2020-09-01,41884,38716,3168,7.6
42099,2020-09-01,24540,23277,1263,5.1
42101,2020-09-01,736699,648384,88315,12
42103,2020-09-01,24508,22301,2207,9
42105,2020-09-01,7119,6593,526,7.4
42107,2020-09-01,65902,60864,5038,7.6
42109,2020-09-01,19694,18725,969,4.9
42111,2020-09-01,32657,30346,2311,7.1
42113,2020-09-01,2577,2404,173,6.7
42115,2020-09-01,19604,18450,1154,5.9
42117,2020-09-01,19094,17705,1389,7.3
42119,2020-09-01,19386,18395,991,5.1
42121,2020-09-01,21786,20186,1600,7.3
42123,2020-09-01,18643,17392,1251,6.7
42125,2020-09-01,105199,96849,8350,7.9
42127,2020-09-01,21015,19486,1529,7.3
42129,2020-09-01,176534,163817,12717,7.2
42131,2020-09-01,12876,12022,854,6.6
42133,2020-09-01,235110,219951,15159,6.4
44001,2020-09-01,25728,23744,1984,7.7
44003,2020-09-01,91036,82655,8381,9.2
44005,2020-09-01,43876,40383,3493,8
44007,2020-09-01,332319,294542,37777,11.4
44009,2020-09-01,68136,62805,5331,7.8
45001,2020-09-01,10035,9559,476,4.7
45003,2020-09-01,73447,70824,2623,3.6
45005,2020-09-01,2612,2399,213,8.2
45007,2020-09-01,93386,89402,3984,4.3
45009,2020-09-01,4955,4577,378,7.6
45011,2020-09-01,8016,7532,484,6
45013,2020-09-01,78364,75443,2921,3.7
45015,2020-09-01,102539,97913,4626,4.5
45017,2020-09-01,6589,6243,346,5.3
45019,2020-09-01,210604,199501,11103,5.3
45021,2020-09-01,25914,24187,1727,6.7
45023,2020-09-01,13477,12373,1104,8.2
45025,2020-09-01,22038,20944,1094,5
45027,2020-09-01,12654,11950,704,5.6
45029,2020-09-01,16941,16037,904,5.3
45031,2020-09-01,30594,28870,1724,5.6
45033,2020-09-01,13175,12494,681,5.2
45035,2020-09-01,77238,73556,3682,4.8
45037,2020-09-01,10470,10090,380,3.6
45039,2020-09-01,9682,9034,648,6.7
45041,2020-09-01,67341,64043,3298,4.9
45043,2020-09-01,26083,24507,1576,6
45045,2020-09-01,261469,250641,10828,4.1
45047,2020-09-01,31548,29863,1685,5.3
45049,2020-09-01,8376,8023,353,4.2
45051,2020-09-01,142811,134018,8793,6.2
45053,2020-09-01,12796,12266,530,4.1
45055,2020-09-01,29146,27945,1201,4.1
45057,2020-09-01,40735,38395,2340,5.7
45059,2020-09-01,31023,29450,1573,5.1
45061,2020-09-01,6647,6202,445,6.7
45063,2020-09-01,149544,144446,5098,3.4
45065,2020-09-01,3364,3176,188,5.6
45067,2020-09-01,13024,12096,928,7.1
45069,2020-09-01,9395,8594,801,8.5
45071,2020-09-01,18799,18072,727,3.9
45073,2020-09-01,35182,33955,1227,3.5
45075,2020-09-01,35867,33030,2837,7.9
45077,2020-09-01,58368,56271,2097,3.6
45079,2020-09-01,201247,190955,10292,5.1
45081,2020-09-01,8645,8384,261,3
45083,2020-09-01,152389,144404,7985,5.2
45085,2020-09-01,43358,40828,2530,5.8
45087,2020-09-01,11814,10883,931,7.9
45089,2020-09-01,12153,11312,841,6.9
45091,2020-09-01,138483,131449,7034,5.1
46003,2020-09-01,1523,1470,53,3.5
46005,2020-09-01,9491,9175,316,3.3
46007,2020-09-01,1087,1035,52,4.8
46009,2020-09-01,2906,2799,107,3.7
46011,2020-09-01,19166,18520,646,3.4
46013,2020-09-01,20696,19982,714,3.4
46015,2020-09-01,2452,2366,86,3.5
46017,2020-09-01,643,608,35,5.4
46019,2020-09-01,5085,4863,222,4.4
46021,2020-09-01,781,755,26,3.3
46023,2020-09-01,3852,3625,227,5.9
46025,2020-09-01,1912,1841,71,3.7
46027,2020-09-01,7504,7258,246,3.3
46029,2020-09-01,15696,15081,615,3.9
46031,2020-09-01,1354,1291,63,4.7
46033,2020-09-01,3974,3790,184,4.6
46035,2020-09-01,11222,10700,522,4.7
46037,2020-09-01,2770,2663,107,3.9
46039,2020-09-01,2219,2121,98,4.4
46041,2020-09-01,2248,2075,173,7.7
46043,2020-09-01,1583,1538,45,2.8
46045,2020-09-01,2027,1979,48,2.4
46047,2020-09-01,3006,2850,156,5.2
46049,2020-09-01,1058,1020,38,3.6
46051,2020-09-01,4436,4312,124,2.8
46053,2020-09-01,2041,1976,65,3.2
46055,2020-09-01,1032,1006,26,2.5
46057,2020-09-01,3360,3267,93,2.8
46059,2020-09-01,1741,1699,42,2.4
46061,2020-09-01,1734,1659,75,4.3
46063,2020-09-01,746,723,23,3.1
46065,2020-09-01,9942,9681,261,2.6
46067,2020-09-01,3589,3486,103,2.9
46069,2020-09-01,689,667,22,3.2
46071,2020-09-01,1311,1261,50,3.8
46073,2020-09-01,1124,1094,30,2.7
46075,2020-09-01,581,559,22,3.8
46077,2020-09-01,2638,2555,83,3.1
46079,2020-09-01,6662,6448,214,3.2
46081,2020-09-01,13739,13192,547,4
46083,2020-09-01,34250,33246,1004,2.9
46085,2020-09-01,1711,1625,86,5
46087,2020-09-01,3061,2967,94,3.1
46089,2020-09-01,1030,982,48,4.7
46091,2020-09-01,2396,2309,87,3.6
46093,2020-09-01,13907,13390,517,3.7
46095,2020-09-01,739,701,38,5.1
46097,2020-09-01,1198,1131,67,5.6
46099,2020-09-01,112289,108300,3989,3.6
46101,2020-09-01,4110,3914,196,4.8
46102,2020-09-01,3549,3188,361,10.2
46103,2020-09-01,56175,53778,2397,4.3
46105,2020-09-01,1450,1389,61,4.2
46107,2020-09-01,1048,1018,30,2.9
46109,2020-09-01,4986,4786,200,4
46111,2020-09-01,1181,1124,57,4.8
46115,2020-09-01,3174,3064,110,3.5
46117,2020-09-01,1841,1788,53,2.9
46119,2020-09-01,802,782,20,2.5
46121,2020-09-01,3085,2919,166,5.4
46123,2020-09-01,3021,2946,75,2.5
46125,2020-09-01,4660,4525,135,2.9
46127,2020-09-01,8486,8127,359,4.2
46129,2020-09-01,2126,2019,107,5
46135,2020-09-01,11919,11469,450,3.8
46137,2020-09-01,935,893,42,4.5
47001,2020-09-01,34677,32891,1786,5.2
47003,2020-09-01,20843,19653,1190,5.7
47005,2020-09-01,6802,6375,427,6.3
47007,2020-09-01,4342,4085,257,5.9
47009,2020-09-01,63598,60555,3043,4.8
47011,2020-09-01,52872,50038,2834,5.4
47013,2020-09-01,14724,13947,777,5.3
47015,2020-09-01,6417,6130,287,4.5
47017,2020-09-01,11915,11282,633,5.3
47019,2020-09-01,23420,22139,1281,5.5
47021,2020-09-01,21534,20525,1009,4.7
47023,2020-09-01,8293,7915,378,4.6
47025,2020-09-01,12787,12202,585,4.6
47027,2020-09-01,2715,2571,144,5.3
47029,2020-09-01,14843,13773,1070,7.2
47031,2020-09-01,25323,23937,1386,5.5
47033,2020-09-01,6783,6475,308,4.5
47035,2020-09-01,23434,22116,1318,5.6
47037,2020-09-01,409999,378259,31740,7.7
47039,2020-09-01,4469,4193,276,6.2
47041,2020-09-01,7488,7023,465,6.2
47043,2020-09-01,26364,25162,1202,4.6
47045,2020-09-01,16469,15467,1002,6.1
47047,2020-09-01,18729,17674,1055,5.6
47049,2020-09-01,7415,7034,381,5.1
47051,2020-09-01,19721,18754,967,4.9
47053,2020-09-01,21818,20574,1244,5.7
47055,2020-09-01,14546,13704,842,5.8
47057,2020-09-01,9520,9000,520,5.5
47059,2020-09-01,29080,27233,1847,6.4
47061,2020-09-01,4963,4644,319,6.4
47063,2020-09-01,27936,26415,1521,5.4
47065,2020-09-01,187150,176414,10736,5.7
47067,2020-09-01,2101,1958,143,6.8
47069,2020-09-01,9459,8767,692,7.3
47071,2020-09-01,10498,9916,582,5.5
47073,2020-09-01,22902,21569,1333,5.8
47075,2020-09-01,7776,7088,688,8.8
47077,2020-09-01,12156,11436,720,5.9
47079,2020-09-01,13883,13145,738,5.3
47081,2020-09-01,11162,10670,492,4.4
47083,2020-09-01,3227,3030,197,6.1
47085,2020-09-01,8733,8320,413,4.7
47087,2020-09-01,4665,4394,271,5.8
47089,2020-09-01,24422,23119,1303,5.3
47091,2020-09-01,7654,7311,343,4.5
47093,2020-09-01,244658,233204,11454,4.7
47095,2020-09-01,1722,1598,124,7.2
47097,2020-09-01,9722,8968,754,7.8
47099,2020-09-01,19048,17999,1049,5.5
47101,2020-09-01,5079,4793,286,5.6
47103,2020-09-01,15697,14742,955,6.1
47105,2020-09-01,23372,22298,1074,4.6
47107,2020-09-01,23553,22185,1368,5.8
47109,2020-09-01,8553,7953,600,7
47111,2020-09-01,11029,10476,553,5
47113,2020-09-01,48763,45346,3417,7
47115,2020-09-01,12579,11863,716,5.7
47117,2020-09-01,15448,14510,938,6.1
47119,2020-09-01,48844,45968,2876,5.9
47121,2020-09-01,5273,4919,354,6.7
47123,2020-09-01,20192,19100,1092,5.4
47125,2020-09-01,85644,80211,5433,6.3
47127,2020-09-01,3580,3461,119,3.3
47129,2020-09-01,7814,7426,388,5
47131,2020-09-01,12486,11800,686,5.5
47133,2020-09-01,10090,9657,433,4.3
47135,2020-09-01,2985,2801,184,6.2
47137,2020-09-01,2315,2226,89,3.8
47139,2020-09-01,7567,7183,384,5.1
47141,2020-09-01,35617,33873,1744,4.9
47143,2020-09-01,13213,12330,883,6.7
47145,2020-09-01,23220,22083,1137,4.9
47147,2020-09-01,37257,35392,1865,5
47149,2020-09-01,182046,171979,10067,5.5
47151,2020-09-01,8155,7638,517,6.3
47153,2020-09-01,6259,5896,363,5.8
47155,2020-09-01,53330,50036,3294,6.2
47157,2020-09-01,455664,408932,46732,10.3
47159,2020-09-01,9216,8809,407,4.4
47161,2020-09-01,5418,5168,250,4.6
47163,2020-09-01,68158,64174,3984,5.8
47165,2020-09-01,101272,95724,5548,5.5
47167,2020-09-01,27484,25886,1598,5.8
47169,2020-09-01,5329,5048,281,5.3
47171,2020-09-01,6888,6461,427,6.2
47173,2020-09-01,7630,7225,405,5.3
47175,2020-09-01,2050,1918,132,6.4
47177,2020-09-01,16142,15156,986,6.1
47179,2020-09-01,58817,55860,2957,5
47181,2020-09-01,6056,5741,315,5.2
47183,2020-09-01,15470,14745,725,4.7
47185,2020-09-01,12121,11492,629,5.2
47187,2020-09-01,125203,120494,4709,3.8
47189,2020-09-01,75614,71549,4065,5.4
48001,2020-09-01,23625,22110,1515,6.4
48003,2020-09-01,10051,9144,907,9
48005,2020-09-01,35755,32734,3021,8.4
48007,2020-09-01,9221,8379,842,9.1
48009,2020-09-01,4078,3847,231,5.7
48011,2020-09-01,893,854,39,4.4
48013,2020-09-01,22285,20160,2125,9.5
48015,2020-09-01,13952,12959,993,7.1
48017,2020-09-01,2313,2197,116,5
48019,2020-09-01,10014,9388,626,6.3
48021,2020-09-01,43507,40807,2700,6.2
48023,2020-09-01,1770,1700,70,4
48025,2020-09-01,10096,8929,1167,11.6
48027,2020-09-01,145119,134296,10823,7.5
48029,2020-09-01,963880,886979,76901,8
48031,2020-09-01,6473,6203,270,4.2
48033,2020-09-01,405,390,15,3.7
48035,2020-09-01,8242,7762,480,5.8
48037,2020-09-01,40790,37807,2983,7.3
48039,2020-09-01,180686,163798,16888,9.3
48041,2020-09-01,121289,114825,6464,5.3
48043,2020-09-01,4177,3897,280,6.7
48045,2020-09-01,550,526,24,4.4
48047,2020-09-01,2680,2370,310,11.6
48049,2020-09-01,15305,14244,1061,6.9
48051,2020-09-01,8597,8015,582,6.8
48053,2020-09-01,23327,22151,1176,5
48055,2020-09-01,19953,18648,1305,6.5
48057,2020-09-01,12110,11339,771,6.4
48059,2020-09-01,6161,5803,358,5.8
48061,2020-09-01,167348,149131,18217,10.9
48063,2020-09-01,4967,4554,413,8.3
48065,2020-09-01,2897,2772,125,4.3
48067,2020-09-01,12528,11445,1083,8.6
48069,2020-09-01,3285,3154,131,4
48071,2020-09-01,19883,17720,2163,10.9
48073,2020-09-01,21085,19102,1983,9.4
48075,2020-09-01,2831,2711,120,4.2
48077,2020-09-01,4859,4567,292,6
48079,2020-09-01,1094,1001,93,8.5
48081,2020-09-01,1437,1347,90,6.3
48083,2020-09-01,2858,2620,238,8.3
48085,2020-09-01,572431,535735,36696,6.4
48087,2020-09-01,1068,1017,51,4.8
48089,2020-09-01,9603,8997,606,6.3
48091,2020-09-01,73328,68629,4699,6.4
48093,2020-09-01,5549,5212,337,6.1
48095,2020-09-01,1287,1228,59,4.6
48097,2020-09-01,20163,18715,1448,7.2
48099,2020-09-01,24164,22486,1678,6.9
48101,2020-09-01,504,477,27,5.4
48103,2020-09-01,1622,1361,261,16.1
48105,2020-09-01,1642,1481,161,9.8
48107,2020-09-01,2423,2295,128,5.3
48109,2020-09-01,1000,914,86,8.6
48111,2020-09-01,3658,3547,111,3
48113,2020-09-01,NA,NA,113673,8.1
48115,2020-09-01,4779,4316,463,9.7
48117,2020-09-01,8187,7865,322,3.9
48119,2020-09-01,2380,2243,137,5.8
48121,2020-09-01,503741,470723,33018,6.6
48123,2020-09-01,9825,9135,690,7
48125,2020-09-01,654,606,48,7.3
48127,2020-09-01,7176,6707,469,6.5
48129,2020-09-01,1306,1243,63,4.8
48131,2020-09-01,5110,4388,722,14.1
48133,2020-09-01,7608,7060,548,7.2
48135,2020-09-01,88001,76546,11455,13
48137,2020-09-01,1094,1040,54,4.9
48139,2020-09-01,93975,88057,5918,6.3
48141,2020-09-01,365748,334426,31322,8.6
48143,2020-09-01,20379,19174,1205,5.9
48145,2020-09-01,6732,6305,427,6.3
48147,2020-09-01,17463,16627,836,4.8
48149,2020-09-01,11822,11184,638,5.4
48151,2020-09-01,1565,1477,88,5.6
48153,2020-09-01,2459,2313,146,5.9
48155,2020-09-01,568,543,25,4.4
48157,2020-09-01,394407,360728,33679,8.5
48159,2020-09-01,4552,4279,273,6
48161,2020-09-01,6294,5698,596,9.5
48163,2020-09-01,10190,9562,628,6.2
48165,2020-09-01,9664,9026,638,6.6
48167,2020-09-01,166848,151268,15580,9.3
48169,2020-09-01,2153,1985,168,7.8
48171,2020-09-01,13255,12626,629,4.7
48173,2020-09-01,755,718,37,4.9
48175,2020-09-01,3253,2971,282,8.7
48177,2020-09-01,9465,8875,590,6.2
48179,2020-09-01,8167,7434,733,9
48181,2020-09-01,65142,61208,3934,6
48183,2020-09-01,57648,52361,5287,9.2
48185,2020-09-01,11350,10348,1002,8.8
48187,2020-09-01,81324,76243,5081,6.2
48189,2020-09-01,11688,10896,792,6.8
48191,2020-09-01,1020,951,69,6.8
48193,2020-09-01,3580,3391,189,5.3
48195,2020-09-01,2548,2445,103,4
48197,2020-09-01,1692,1611,81,4.8
48199,2020-09-01,24699,22285,2414,9.8
48201,2020-09-01,NA,NA,233553,9.9
48203,2020-09-01,28883,26343,2540,8.8
48205,2020-09-01,2617,2565,52,2
48207,2020-09-01,2204,2070,134,6.1
48209,2020-09-01,122238,114418,7820,6.4
48211,2020-09-01,1745,1666,79,4.5
48213,2020-09-01,36735,34136,2599,7.1
48215,2020-09-01,359953,314415,45538,12.7
48217,2020-09-01,16444,15361,1083,6.6
48219,2020-09-01,11181,10221,960,8.6
48221,2020-09-01,27647,25641,2006,7.3
48223,2020-09-01,17171,16199,972,5.7
48225,2020-09-01,9954,9379,575,5.8
48227,2020-09-01,14509,13187,1322,9.1
48229,2020-09-01,1817,1666,151,8.3
48231,2020-09-01,43996,41036,2960,6.7
48233,2020-09-01,8413,7772,641,7.6
48235,2020-09-01,752,695,57,7.6
48237,2020-09-01,3319,3052,267,8
48239,2020-09-01,7438,6967,471,6.3
48241,2020-09-01,12877,11253,1624,12.6
48243,2020-09-01,953,902,51,5.4
48245,2020-09-01,107011,92966,14045,13.1
48247,2020-09-01,1845,1617,228,12.4
48249,2020-09-01,17588,15036,2552,14.5
48251,2020-09-01,82231,76589,5642,6.9
48253,2020-09-01,5814,5366,448,7.7
48255,2020-09-01,7319,6778,541,7.4
48257,2020-09-01,65906,61271,4635,7
48259,2020-09-01,21869,20746,1123,5.1
48261,2020-09-01,183,173,10,5.5
48263,2020-09-01,462,443,19,4.1
48265,2020-09-01,22036,20804,1232,5.6
48267,2020-09-01,1795,1682,113,6.3
48269,2020-09-01,222,219,3,1.4
48271,2020-09-01,1340,1257,83,6.2
48273,2020-09-01,13458,12189,1269,9.4
48275,2020-09-01,1392,1301,91,6.5
48277,2020-09-01,24143,22510,1633,6.8
48279,2020-09-01,5145,4865,280,5.4
48281,2020-09-01,9146,8639,507,5.5
48283,2020-09-01,4233,3933,300,7.1
48285,2020-09-01,8194,7659,535,6.5
48287,2020-09-01,9909,9414,495,5
48289,2020-09-01,6294,5778,516,8.2
48291,2020-09-01,33984,29933,4051,11.9
48293,2020-09-01,8716,8008,708,8.1
48295,2020-09-01,1544,1468,76,4.9
48297,2020-09-01,5609,5141,468,8.3
48299,2020-09-01,8641,8121,520,6
48301,2020-09-01,695,691,4,0.6
48303,2020-09-01,157795,148264,9531,6
48305,2020-09-01,2732,2578,154,5.6
48307,2020-09-01,3274,2996,278,8.5
48309,2020-09-01,122945,115156,7789,6.3
48311,2020-09-01,852,826,26,3.1
48313,2020-09-01,4512,4136,376,8.3
48315,2020-09-01,4178,3790,388,9.3
48317,2020-09-01,2664,2490,174,6.5
48319,2020-09-01,1731,1623,108,6.2
48321,2020-09-01,17052,15091,1961,11.5
48323,2020-09-01,24779,20733,4046,16.3
48325,2020-09-01,21791,20360,1431,6.6
48327,2020-09-01,841,794,47,5.6
48329,2020-09-01,102593,92779,9814,9.6
48331,2020-09-01,9623,8882,741,7.7
48333,2020-09-01,1835,1748,87,4.7
48335,2020-09-01,2381,2143,238,10
48337,2020-09-01,9249,8586,663,7.2
48339,2020-09-01,284863,261509,23354,8.2
48341,2020-09-01,10510,10066,444,4.2
48343,2020-09-01,5005,4317,688,13.7
48345,2020-09-01,451,428,23,5.1
48347,2020-09-01,27399,25399,2000,7.3
48349,2020-09-01,23811,22336,1475,6.2
48351,2020-09-01,5094,4479,615,12.1
48353,2020-09-01,7194,6769,425,5.9
48355,2020-09-01,164872,148736,16136,9.8
48357,2020-09-01,4067,3804,263,6.5
48359,2020-09-01,875,840,35,4
48361,2020-09-01,36123,31864,4259,11.8
48363,2020-09-01,13619,12538,1081,7.9
48365,2020-09-01,9999,9099,900,9
48367,2020-09-01,67171,62948,4223,6.3
48369,2020-09-01,4607,4470,137,3
48371,2020-09-01,6317,5686,631,10
48373,2020-09-01,18188,16424,1764,9.7
48375,2020-09-01,54001,50881,3120,5.8
48377,2020-09-01,3292,2721,571,17.3
48379,2020-09-01,6065,5758,307,5.1
48381,2020-09-01,69780,66584,3196,4.6
48383,2020-09-01,1988,1755,233,11.7
48385,2020-09-01,975,892,83,8.5
48387,2020-09-01,4972,4624,348,7
48389,2020-09-01,12342,11540,802,6.5
48391,2020-09-01,3135,2842,293,9.3
48393,2020-09-01,407,382,25,6.1
48395,2020-09-01,7819,7295,524,6.7
48397,2020-09-01,52718,49498,3220,6.1
48399,2020-09-01,4479,4250,229,5.1
48401,2020-09-01,22600,20752,1848,8.2
48403,2020-09-01,3688,3223,465,12.6
48405,2020-09-01,3511,3171,340,9.7
48407,2020-09-01,11725,10662,1063,9.1
48409,2020-09-01,29428,26168,3260,11.1
48411,2020-09-01,2456,2343,113,4.6
48413,2020-09-01,1250,1147,103,8.2
48415,2020-09-01,6568,5994,574,8.7
48417,2020-09-01,1824,1718,106,5.8
48419,2020-09-01,11000,10125,875,8
48421,2020-09-01,1314,1273,41,3.1
48423,2020-09-01,108864,101108,7756,7.1
48425,2020-09-01,4350,4054,296,6.8
48427,2020-09-01,26035,21292,4743,18.2
48429,2020-09-01,3976,3672,304,7.6
48431,2020-09-01,563,521,42,7.5
48433,2020-09-01,548,514,34,6.2
48435,2020-09-01,1320,1178,142,10.8
48437,2020-09-01,2520,2380,140,5.6
48439,2020-09-01,NA,NA,83956,7.7
48441,2020-09-01,67587,63740,3847,5.7
48443,2020-09-01,359,339,20,5.6
48445,2020-09-01,4862,4450,412,8.5
48447,2020-09-01,611,572,39,6.4
48449,2020-09-01,12914,11954,960,7.4
48451,2020-09-01,53106,49380,3726,7
48453,2020-09-01,757984,708771,49213,6.5
48455,2020-09-01,5267,4786,481,9.1
48457,2020-09-01,7154,6336,818,11.4
48459,2020-09-01,17589,16089,1500,8.5
48461,2020-09-01,1659,1540,119,7.2
48463,2020-09-01,11117,10316,801,7.2
48465,2020-09-01,22275,20397,1878,8.4
48467,2020-09-01,26012,24289,1723,6.6
48469,2020-09-01,42583,38872,3711,8.7
48471,2020-09-01,23971,22052,1919,8
48473,2020-09-01,23539,21508,2031,8.6
48475,2020-09-01,8028,7284,744,9.3
48477,2020-09-01,15174,14261,913,6
48479,2020-09-01,118065,107128,10937,9.3
48481,2020-09-01,21570,19873,1697,7.9
48483,2020-09-01,2220,2056,164,7.4
48485,2020-09-01,56306,52238,4068,7.2
48487,2020-09-01,4887,4581,306,6.3
48489,2020-09-01,6712,5891,821,12.2
48491,2020-09-01,318500,299562,18938,5.9
48493,2020-09-01,24807,23300,1507,6.1
48495,2020-09-01,4027,3554,473,11.7
48497,2020-09-01,31874,29709,2165,6.8
48499,2020-09-01,17587,16338,1249,7.1
48501,2020-09-01,3924,3422,502,12.8
48503,2020-09-01,7863,7418,445,5.7
48505,2020-09-01,4937,4270,667,13.5
48507,2020-09-01,3301,2749,552,16.7
49001,2020-09-01,2802,2686,116,4.1
49003,2020-09-01,26807,25842,965,3.6
49005,2020-09-01,66407,64413,1994,3
49007,2020-09-01,8655,8188,467,5.4
49009,2020-09-01,424,410,14,3.3
49011,2020-09-01,182312,174948,7364,4
49013,2020-09-01,7821,7092,729,9.3
49015,2020-09-01,4430,4220,210,4.7
49017,2020-09-01,2974,2795,179,6
49019,2020-09-01,6690,6260,430,6.4
49021,2020-09-01,25541,24390,1151,4.5
49023,2020-09-01,5895,5723,172,2.9
49025,2020-09-01,4018,3828,190,4.7
49027,2020-09-01,5968,5766,202,3.4
49029,2020-09-01,5770,5590,180,3.1
49031,2020-09-01,498,471,27,5.4
49033,2020-09-01,1336,1302,34,2.5
49035,2020-09-01,657904,623562,34342,5.2
49037,2020-09-01,5910,5294,616,10.4
49039,2020-09-01,12676,12197,479,3.8
49041,2020-09-01,9981,9559,422,4.2
49043,2020-09-01,23204,21629,1575,6.8
49045,2020-09-01,34961,33219,1742,5
49047,2020-09-01,13796,12299,1497,10.9
49049,2020-09-01,320977,308637,12340,3.8
49051,2020-09-01,16238,15328,910,5.6
49053,2020-09-01,80234,75956,4278,5.3
49055,2020-09-01,1484,1414,70,4.7
49057,2020-09-01,133764,127485,6279,4.7
50001,2020-09-01,19685,19029,656,3.3
50003,2020-09-01,16704,15879,825,4.9
50005,2020-09-01,14082,13527,555,3.9
50007,2020-09-01,89416,86067,3349,3.7
50009,2020-09-01,2517,2420,97,3.9
50011,2020-09-01,25299,24266,1033,4.1
50013,2020-09-01,3733,3567,166,4.4
50015,2020-09-01,12568,11881,687,5.5
50017,2020-09-01,15550,15049,501,3.2
50019,2020-09-01,11970,11300,670,5.6
50021,2020-09-01,28410,26881,1529,5.4
50023,2020-09-01,32148,31012,1136,3.5
50025,2020-09-01,20678,19599,1079,5.2
50027,2020-09-01,27728,26652,1076,3.9
51001,2020-09-01,15924,14997,927,5.8
51003,2020-09-01,55961,53163,2798,5
51005,2020-09-01,6556,6178,378,5.8
51007,2020-09-01,6046,5708,338,5.6
51009,2020-09-01,14134,13356,778,5.5
51011,2020-09-01,6725,6343,382,5.7
51013,2020-09-01,149747,142934,6813,4.5
51015,2020-09-01,37307,35827,1480,4
51017,2020-09-01,2564,2395,169,6.6
51019,2020-09-01,35995,34263,1732,4.8
51021,2020-09-01,2711,2583,128,4.7
51023,2020-09-01,16574,15926,648,3.9
51025,2020-09-01,5713,5240,473,8.3
51027,2020-09-01,6239,5690,549,8.8
51029,2020-09-01,6282,5860,422,6.7
51031,2020-09-01,24569,23107,1462,6
51033,2020-09-01,14852,13900,952,6.4
51035,2020-09-01,12927,12122,805,6.2
51036,2020-09-01,3553,3329,224,6.3
51037,2020-09-01,5074,4810,264,5.2
51041,2020-09-01,182297,171825,10472,5.7
51043,2020-09-01,7282,6972,310,4.3
51045,2020-09-01,2191,2088,103,4.7
51047,2020-09-01,23604,22544,1060,4.5
51049,2020-09-01,4504,4217,287,6.4
51051,2020-09-01,4629,4288,341,7.4
51053,2020-09-01,13272,12420,852,6.4
51057,2020-09-01,5336,4944,392,7.3
51059,2020-09-01,621413,585527,35886,5.8
51061,2020-09-01,35721,34211,1510,4.2
51063,2020-09-01,7813,7491,322,4.1
51065,2020-09-01,13615,12955,660,4.8
51067,2020-09-01,25309,24012,1297,5.1
51069,2020-09-01,45028,43091,1937,4.3
51071,2020-09-01,7590,7194,396,5.2
51073,2020-09-01,18935,17954,981,5.2
51075,2020-09-01,10736,10248,488,4.5
51077,2020-09-01,7793,7426,367,4.7
51079,2020-09-01,10223,9759,464,4.5
51081,2020-09-01,4222,3903,319,7.6
51083,2020-09-01,15284,14294,990,6.5
51085,2020-09-01,56992,54446,2546,4.5
51087,2020-09-01,178519,166783,11736,6.6
51089,2020-09-01,23572,21841,1731,7.3
51091,2020-09-01,1128,1088,40,3.5
51093,2020-09-01,18749,17779,970,5.2
51095,2020-09-01,35870,33550,2320,6.5
51097,2020-09-01,3740,3543,197,5.3
51099,2020-09-01,12843,12281,562,4.4
51101,2020-09-01,8828,8368,460,5.2
51103,2020-09-01,5371,5040,331,6.2
51105,2020-09-01,7914,7427,487,6.2
51107,2020-09-01,216474,205253,11221,5.2
51109,2020-09-01,19519,18572,947,4.9
51111,2020-09-01,5001,4711,290,5.8
51113,2020-09-01,7129,6883,246,3.5
51115,2020-09-01,3962,3786,176,4.4
51117,2020-09-01,11985,11157,828,6.9
51119,2020-09-01,5150,4900,250,4.9
51121,2020-09-01,47958,46011,1947,4.1
51125,2020-09-01,7249,6861,388,5.4
51127,2020-09-01,11976,11465,511,4.3
51131,2020-09-01,5115,4735,380,7.4
51133,2020-09-01,5420,5116,304,5.6
51135,2020-09-01,6894,6517,377,5.5
51137,2020-09-01,16999,16141,858,5
51139,2020-09-01,11684,11035,649,5.6
51141,2020-09-01,7020,6605,415,5.9
51143,2020-09-01,28854,27076,1778,6.2
51145,2020-09-01,13545,12969,576,4.3
51147,2020-09-01,10199,9582,617,6
51149,2020-09-01,14683,13739,944,6.4
51153,2020-09-01,241671,225995,15676,6.5
51155,2020-09-01,15701,14650,1051,6.7
51157,2020-09-01,3528,3373,155,4.4
51159,2020-09-01,3888,3709,179,4.6
51161,2020-09-01,47340,45180,2160,4.6
51163,2020-09-01,10615,10136,479,4.5
51165,2020-09-01,39931,38370,1561,3.9
51167,2020-09-01,10769,10128,641,6
51169,2020-09-01,8643,8205,438,5.1
51171,2020-09-01,21587,20536,1051,4.9
51173,2020-09-01,13094,12352,742,5.7
51175,2020-09-01,8696,8235,461,5.3
51177,2020-09-01,65192,61437,3755,5.8
51179,2020-09-01,70051,66196,3855,5.5
51181,2020-09-01,3541,3350,191,5.4
51183,2020-09-01,3753,3407,346,9.2
51185,2020-09-01,15033,13928,1105,7.4
51187,2020-09-01,19770,18708,1062,5.4
51191,2020-09-01,25296,24002,1294,5.1
51193,2020-09-01,9063,8558,505,5.6
51195,2020-09-01,13060,12100,960,7.4
51197,2020-09-01,13290,12405,885,6.7
51199,2020-09-01,31699,30076,1623,5.1
51510,2020-09-01,99716,93618,6098,6.1
51520,2020-09-01,6958,6423,535,7.7
51530,2020-09-01,3601,3458,143,4
51540,2020-09-01,26231,24635,1596,6.1
51550,2020-09-01,119777,112389,7388,6.2
51570,2020-09-01,8649,8032,617,7.1
51580,2020-09-01,2324,2132,192,8.3
51590,2020-09-01,18731,16921,1810,9.7
51595,2020-09-01,2372,2059,313,13.2
51600,2020-09-01,13112,12414,698,5.3
51610,2020-09-01,8248,7944,304,3.7
51620,2020-09-01,3603,3236,367,10.2
51630,2020-09-01,13919,12920,999,7.2
51640,2020-09-01,2836,2665,171,6
51650,2020-09-01,64244,58424,5820,9.1
51660,2020-09-01,24073,22753,1320,5.5
51670,2020-09-01,9890,8739,1151,11.6
51678,2020-09-01,2055,1932,123,6
51680,2020-09-01,34671,32139,2532,7.3
51683,2020-09-01,21678,20290,1388,6.4
51685,2020-09-01,9269,8621,648,7
51690,2020-09-01,5657,5013,644,11.4
51700,2020-09-01,88985,80890,8095,9.1
51710,2020-09-01,112061,101673,10388,9.3
51720,2020-09-01,1650,1536,114,6.9
51730,2020-09-01,13750,11593,2157,15.7
51735,2020-09-01,6088,5864,224,3.7
51740,2020-09-01,44970,40131,4839,10.8
51750,2020-09-01,8347,7887,460,5.5
51760,2020-09-01,118912,107813,11099,9.3
51770,2020-09-01,48474,44763,3711,7.7
51775,2020-09-01,12492,11856,636,5.1
51790,2020-09-01,12404,11702,702,5.7
51800,2020-09-01,43850,40823,3027,6.9
51810,2020-09-01,227155,213754,13401,5.9
51820,2020-09-01,10865,10211,654,6
51830,2020-09-01,6568,6063,505,7.7
51840,2020-09-01,13967,13191,776,5.6
53001,2020-09-01,10764,10173,591,5.5
53003,2020-09-01,10077,9553,524,5.2
53005,2020-09-01,110894,103020,7874,7.1
53007,2020-09-01,47721,44518,3203,6.7
53009,2020-09-01,28969,26150,2819,9.7
53011,2020-09-01,238477,217207,21270,8.9
53013,2020-09-01,1734,1619,115,6.6
53015,2020-09-01,49057,44491,4566,9.3
53017,2020-09-01,22791,21218,1573,6.9
53019,2020-09-01,2548,2288,260,10.2
53021,2020-09-01,47358,43907,3451,7.3
53023,2020-09-01,824,760,64,7.8
53025,2020-09-01,51380,47576,3804,7.4
53027,2020-09-01,28823,25525,3298,11.4
53029,2020-09-01,36536,33611,2925,8
53031,2020-09-01,13067,11904,1163,8.9
53033,2020-09-01,NA,NA,88576,6.9
53035,2020-09-01,131486,121676,9810,7.5
53037,2020-09-01,21429,19711,1718,8
53039,2020-09-01,10414,9620,794,7.6
53041,2020-09-01,34166,31093,3073,9
53043,2020-09-01,4733,4456,277,5.9
53045,2020-09-01,24625,22054,2571,10.4
53047,2020-09-01,19429,17904,1525,7.8
53049,2020-09-01,8197,7320,877,10.7
53051,2020-09-01,4860,4354,506,10.4
53053,2020-09-01,449839,407344,42495,9.4
53055,2020-09-01,7907,7347,560,7.1
53057,2020-09-01,62862,57176,5686,9
53059,2020-09-01,5447,4913,534,9.8
53061,2020-09-01,438415,405793,32622,7.4
53063,2020-09-01,249991,228921,21070,8.4
53065,2020-09-01,18053,16491,1562,8.7
53067,2020-09-01,143737,132417,11320,7.9
53069,2020-09-01,1356,1228,128,9.4
53071,2020-09-01,30759,28795,1964,6.4
53073,2020-09-01,117505,107117,10388,8.8
53075,2020-09-01,22235,20851,1384,6.2
53077,2020-09-01,142365,131141,11224,7.9
54001,2020-09-01,6984,6422,562,8
54003,2020-09-01,56578,53184,3394,6
54005,2020-09-01,7411,6626,785,10.6
54007,2020-09-01,4733,4261,472,10
54009,2020-09-01,9886,9005,881,8.9
54011,2020-09-01,41952,38824,3128,7.5
54013,2020-09-01,2154,1862,292,13.6
54015,2020-09-01,3070,2725,345,11.2
54017,2020-09-01,3858,3636,222,5.8
54019,2020-09-01,16390,14907,1483,9
54021,2020-09-01,2314,2117,197,8.5
54023,2020-09-01,5797,5460,337,5.8
54025,2020-09-01,15359,14312,1047,6.8
54027,2020-09-01,10480,9951,529,5
54029,2020-09-01,12957,11749,1208,9.3
54031,2020-09-01,5919,5561,358,6
54033,2020-09-01,33948,31396,2552,7.5
54035,2020-09-01,12209,11152,1057,8.7
54037,2020-09-01,29953,28209,1744,5.8
54039,2020-09-01,81397,74036,7361,9
54041,2020-09-01,6142,5483,659,10.7
54043,2020-09-01,7250,6567,683,9.4
54045,2020-09-01,10082,8687,1395,13.8
54047,2020-09-01,4302,3712,590,13.7
54049,2020-09-01,25109,23098,2011,8
54051,2020-09-01,13030,11891,1139,8.7
54053,2020-09-01,9514,8729,785,8.3
54055,2020-09-01,20012,18012,2000,10
54057,2020-09-01,12058,11226,832,6.9
54059,2020-09-01,6288,5296,992,15.8
54061,2020-09-01,54961,51789,3172,5.8
54063,2020-09-01,5858,5474,384,6.6
54065,2020-09-01,7981,7560,421,5.3
54067,2020-09-01,8657,7766,891,10.3
54069,2020-09-01,19745,18146,1599,8.1
54071,2020-09-01,3646,3490,156,4.3
54073,2020-09-01,2898,2626,272,9.4
54075,2020-09-01,4041,3741,300,7.4
54077,2020-09-01,15688,14730,958,6.1
54079,2020-09-01,26773,25003,1770,6.6
54081,2020-09-01,30861,28229,2632,8.5
54083,2020-09-01,11884,10905,979,8.2
54085,2020-09-01,4154,3818,336,8.1
54087,2020-09-01,4685,4152,533,11.4
54089,2020-09-01,4019,3711,308,7.7
54091,2020-09-01,7544,7029,515,6.8
54093,2020-09-01,3216,2981,235,7.3
54095,2020-09-01,2975,2668,307,10.3
54097,2020-09-01,8898,8018,880,9.9
54099,2020-09-01,15814,14592,1222,7.7
54101,2020-09-01,3118,2833,285,9.1
54103,2020-09-01,6306,5713,593,9.4
54105,2020-09-01,2292,2090,202,8.8
54107,2020-09-01,37067,34081,2986,8.1
54109,2020-09-01,5991,5331,660,11
55001,2020-09-01,8079,7535,544,6.7
55003,2020-09-01,7703,7280,423,5.5
55005,2020-09-01,23736,22882,854,3.6
55007,2020-09-01,7320,6927,393,5.4
55009,2020-09-01,144714,138566,6148,4.2
55011,2020-09-01,6259,5966,293,4.7
55013,2020-09-01,6949,6546,403,5.8
55015,2020-09-01,27142,26313,829,3.1
55017,2020-09-01,32803,31525,1278,3.9
55019,2020-09-01,17116,16649,467,2.7
55021,2020-09-01,31928,30635,1293,4
55023,2020-09-01,7300,6989,311,4.3
55025,2020-09-01,328934,316598,12336,3.8
55027,2020-09-01,47180,45486,1694,3.6
55029,2020-09-01,13883,13305,578,4.2
55031,2020-09-01,23121,21638,1483,6.4
55033,2020-09-01,23058,22251,807,3.5
55035,2020-09-01,59027,56770,2257,3.8
55037,2020-09-01,2226,2108,118,5.3
55039,2020-09-01,58752,56753,1999,3.4
55041,2020-09-01,4211,3759,452,10.7
55043,2020-09-01,26643,25694,949,3.6
55045,2020-09-01,20975,20301,674,3.2
55047,2020-09-01,9051,8699,352,3.9
55049,2020-09-01,13672,13147,525,3.8
55051,2020-09-01,2575,2371,204,7.9
55053,2020-09-01,10328,9581,747,7.2
55055,2020-09-01,46120,44383,1737,3.8
55057,2020-09-01,13610,12901,709,5.2
55059,2020-09-01,90147,85260,4887,5.4
55061,2020-09-01,10800,10524,276,2.6
55063,2020-09-01,67121,64707,2414,3.6
55065,2020-09-01,9829,9559,270,2.7
55067,2020-09-01,9199,8764,435,4.7
55069,2020-09-01,15015,14466,549,3.7
55071,2020-09-01,41040,39425,1615,3.9
55073,2020-09-01,73953,71427,2526,3.4
55075,2020-09-01,19416,18365,1051,5.4
55077,2020-09-01,7697,7363,334,4.3
55078,2020-09-01,1659,1452,207,12.5
55079,2020-09-01,482164,447389,34775,7.2
55081,2020-09-01,23667,22561,1106,4.7
55083,2020-09-01,20585,19806,779,3.8
55085,2020-09-01,17150,16344,806,4.7
55087,2020-09-01,102986,99014,3972,3.9
55089,2020-09-01,49484,47463,2021,4.1
55091,2020-09-01,3952,3824,128,3.2
55093,2020-09-01,25379,24257,1122,4.4
55095,2020-09-01,24387,23333,1054,4.3
55097,2020-09-01,37720,36255,1465,3.9
55099,2020-09-01,6311,6078,233,3.7
55101,2020-09-01,102158,96515,5643,5.5
55103,2020-09-01,8997,8695,302,3.4
55105,2020-09-01,85793,81385,4408,5.1
55107,2020-09-01,6515,6252,263,4
55109,2020-09-01,50911,48528,2383,4.7
55111,2020-09-01,35626,33986,1640,4.6
55113,2020-09-01,7673,7250,423,5.5
55115,2020-09-01,20704,19845,859,4.1
55117,2020-09-01,62769,60469,2300,3.7
55119,2020-09-01,10619,10320,299,2.8
55121,2020-09-01,15764,15061,703,4.5
55123,2020-09-01,14981,14463,518,3.5
55125,2020-09-01,9656,9215,441,4.6
55127,2020-09-01,56482,54133,2349,4.2
55129,2020-09-01,7722,7386,336,4.4
55131,2020-09-01,77735,74580,3155,4.1
55133,2020-09-01,227298,217813,9485,4.2
55135,2020-09-01,25602,24651,951,3.7
55137,2020-09-01,11234,10792,442,3.9
55139,2020-09-01,93135,89877,3258,3.5
55141,2020-09-01,35291,33665,1626,4.6
56001,2020-09-01,21978,21298,680,3.1
56003,2020-09-01,5434,5202,232,4.3
56005,2020-09-01,24184,22459,1725,7.1
56007,2020-09-01,7917,7603,314,4
56009,2020-09-01,9265,8735,530,5.7
56011,2020-09-01,3927,3782,145,3.7
56013,2020-09-01,19457,18341,1116,5.7
56015,2020-09-01,6843,6571,272,4
56017,2020-09-01,2256,2145,111,4.9
56019,2020-09-01,4273,4051,222,5.2
56021,2020-09-01,47486,45089,2397,5
56023,2020-09-01,8947,8574,373,4.2
56025,2020-09-01,38452,35034,3418,8.9
56027,2020-09-01,1305,1260,45,3.4
56029,2020-09-01,15270,14584,686,4.5
56031,2020-09-01,4933,4722,211,4.3
56033,2020-09-01,16187,15537,650,4
56035,2020-09-01,4209,3945,264,6.3
56037,2020-09-01,21500,20011,1489,6.9
56039,2020-09-01,14183,13591,592,4.2
56041,2020-09-01,9153,8577,576,6.3
56043,2020-09-01,3962,3776,186,4.7
56045,2020-09-01,3901,3760,141,3.6
72001,2020-09-01,3955,3473,482,12.2
72003,2020-09-01,11287,10208,1079,9.6
72005,2020-09-01,13861,12452,1409,10.2
72007,2020-09-01,6233,5573,660,10.6
72009,2020-09-01,6086,5520,566,9.3
72011,2020-09-01,8386,7688,698,8.3
72013,2020-09-01,23799,21684,2115,8.9
72015,2020-09-01,4269,3885,384,9
72017,2020-09-01,5539,4911,628,11.3
72019,2020-09-01,6963,6217,746,10.7
72021,2020-09-01,63857,57472,6385,10
72023,2020-09-01,13084,11898,1186,9.1
72025,2020-09-01,45709,41734,3975,8.7
72027,2020-09-01,9453,8678,775,8.2
72029,2020-09-01,15566,14047,1519,9.8
72031,2020-09-01,60137,54206,5931,9.9
72033,2020-09-01,7681,6838,843,11
72035,2020-09-01,15211,14086,1125,7.4
72037,2020-09-01,3526,3149,377,10.7
72039,2020-09-01,3639,3144,495,13.6
72041,2020-09-01,14510,13569,941,6.5
72043,2020-09-01,9273,8301,972,10.5
72045,2020-09-01,4689,4185,504,10.7
72047,2020-09-01,8732,7571,1161,13.3
72049,2020-09-01,934,844,90,9.6
72051,2020-09-01,12721,11696,1025,8.1
72053,2020-09-01,10460,9227,1233,11.8
72054,2020-09-01,3162,2760,402,12.7
72055,2020-09-01,3867,3402,465,12
72057,2020-09-01,10167,9333,834,8.2
72059,2020-09-01,5032,4504,528,10.5
72061,2020-09-01,36277,34040,2237,6.2
72063,2020-09-01,17039,15929,1110,6.5
72065,2020-09-01,12926,11932,994,7.7
72067,2020-09-01,5125,4657,468,9.1
72069,2020-09-01,16049,14718,1331,8.3
72071,2020-09-01,11123,10129,994,8.9
72073,2020-09-01,3907,3550,357,9.1
72075,2020-09-01,14846,13672,1174,7.9
72077,2020-09-01,11674,10522,1152,9.9
72079,2020-09-01,4960,4371,589,11.9
72081,2020-09-01,6748,5966,782,11.6
72083,2020-09-01,2494,2231,263,10.5
72085,2020-09-01,10617,9643,974,9.2
72087,2020-09-01,8158,7271,887,10.9
72089,2020-09-01,5984,5272,712,11.9
72091,2020-09-01,10957,9965,992,9.1
72093,2020-09-01,1757,1612,145,8.3
72095,2020-09-01,2588,2342,246,9.5
72097,2020-09-01,20447,18624,1823,8.9
72099,2020-09-01,9930,8913,1017,10.2
72101,2020-09-01,7663,6765,898,11.7
72103,2020-09-01,7673,7009,664,8.7
72105,2020-09-01,7000,6005,995,14.2
72107,2020-09-01,4734,4109,625,13.2
72109,2020-09-01,3878,3487,391,10.1
72111,2020-09-01,5477,4862,615,11.2
72113,2020-09-01,43663,39671,3992,9.1
72115,2020-09-01,5988,5364,624,10.4
72117,2020-09-01,4355,3906,449,10.3
72119,2020-09-01,16455,14664,1791,10.9
72121,2020-09-01,5668,5132,536,9.5
72123,2020-09-01,6648,5924,724,10.9
72125,2020-09-01,9108,8298,810,8.9
72127,2020-09-01,131522,119766,11756,8.9
72129,2020-09-01,10945,9964,981,9
72131,2020-09-01,9752,8640,1112,11.4
72133,2020-09-01,7241,6593,648,8.9
72135,2020-09-01,26032,23907,2125,8.2
72137,2020-09-01,28192,25731,2461,8.7
72139,2020-09-01,25937,24144,1793,6.9
72141,2020-09-01,6220,5642,578,9.3
72143,2020-09-01,9413,8328,1085,11.5
72145,2020-09-01,12794,11165,1629,12.7
72147,2020-09-01,2503,2211,292,11.7
72149,2020-09-01,6721,6064,657,9.8
72151,2020-09-01,8043,7198,845,10.5
72153,2020-09-01,9251,8199,1052,11.4
01001,2020-10-01,25237,24120,1117,4.4
01003,2020-10-01,95828,91145,4683,4.9
01005,2020-10-01,9633,8887,746,7.7
01007,2020-10-01,8607,8116,491,5.7
01009,2020-10-01,24646,23830,816,3.3
01011,2020-10-01,5085,4773,312,6.1
01013,2020-10-01,9946,9144,802,8.1
01015,2020-10-01,44797,41889,2908,6.5
01017,2020-10-01,16761,15770,991,5.9
01019,2020-10-01,12082,11677,405,3.4
01021,2020-10-01,19454,18640,814,4.2
01023,2020-10-01,4709,4439,270,5.7
01025,2020-10-01,8306,7629,677,8.2
01027,2020-10-01,6649,6420,229,3.4
01029,2020-10-01,5808,5602,206,3.5
01031,2020-10-01,22974,22141,833,3.6
01033,2020-10-01,23483,22213,1270,5.4
01035,2020-10-01,4947,4599,348,7
01037,2020-10-01,4866,4638,228,4.7
01039,2020-10-01,16370,15732,638,3.9
01041,2020-10-01,6803,6506,297,4.4
01043,2020-10-01,40907,39631,1276,3.1
01045,2020-10-01,21743,20780,963,4.4
01047,2020-10-01,15865,14235,1630,10.3
01049,2020-10-01,33128,32003,1125,3.4
01051,2020-10-01,36237,34620,1617,4.5
01053,2020-10-01,15886,15015,871,5.5
01055,2020-10-01,41107,38446,2661,6.5
01057,2020-10-01,6948,6645,303,4.4
01059,2020-10-01,15490,14993,497,3.2
01061,2020-10-01,10921,10518,403,3.7
01063,2020-10-01,3216,2890,326,10.1
01065,2020-10-01,6348,5757,591,9.3
01067,2020-10-01,6845,6537,308,4.5
01069,2020-10-01,46069,43597,2472,5.4
01071,2020-10-01,24237,23304,933,3.8
01073,2020-10-01,317889,298055,19834,6.2
01075,2020-10-01,6104,5880,224,3.7
01077,2020-10-01,41997,40180,1817,4.3
01079,2020-10-01,14086,13479,607,4.3
01081,2020-10-01,76044,72591,3453,4.5
01083,2020-10-01,43341,41778,1563,3.6
01085,2020-10-01,3768,3215,553,14.7
01087,2020-10-01,8533,7708,825,9.7
01089,2020-10-01,184379,176373,8006,4.3
01091,2020-10-01,8313,7809,504,6.1
01093,2020-10-01,14169,13575,594,4.2
01095,2020-10-01,47128,45595,1533,3.3
01097,2020-10-01,189142,174225,14917,7.9
01099,2020-10-01,8144,7557,587,7.2
01101,2020-10-01,105884,96910,8974,8.5
01103,2020-10-01,57339,55066,2273,4
01105,2020-10-01,3801,3405,396,10.4
01107,2020-10-01,7914,7441,473,6
01109,2020-10-01,16799,16040,759,4.5
01111,2020-10-01,10067,9735,332,3.3
01113,2020-10-01,23107,22015,1092,4.7
01115,2020-10-01,39668,38003,1665,4.2
01117,2020-10-01,112918,109182,3736,3.3
01119,2020-10-01,5129,4803,326,6.4
01121,2020-10-01,37792,35639,2153,5.7
01123,2020-10-01,20191,19037,1154,5.7
01125,2020-10-01,104844,98767,6077,5.8
01127,2020-10-01,24913,23640,1273,5.1
01129,2020-10-01,7223,6736,487,6.7
01131,2020-10-01,3140,2679,461,14.7
01133,2020-10-01,10524,10107,417,4
02013,2020-10-01,2854,2805,49,1.7
02016,2020-10-01,3152,3073,79,2.5
02020,2020-10-01,152613,144544,8069,5.3
02050,2020-10-01,6967,6387,580,8.3
02060,2020-10-01,293,274,19,6.5
02068,2020-10-01,814,745,69,8.5
02070,2020-10-01,1803,1702,101,5.6
02090,2020-10-01,45896,43922,1974,4.3
02100,2020-10-01,1022,931,91,8.9
02105,2020-10-01,987,895,92,9.3
02110,2020-10-01,16421,15657,764,4.7
02122,2020-10-01,25409,23678,1731,6.8
02130,2020-10-01,6441,6027,414,6.4
02150,2020-10-01,5850,5637,213,3.6
02158,2020-10-01,2545,2263,282,11.1
02164,2020-10-01,701,658,43,6.1
02170,2020-10-01,47924,45285,2639,5.5
02180,2020-10-01,4155,3879,276,6.6
02185,2020-10-01,2856,2697,159,5.6
02188,2020-10-01,3026,2780,246,8.1
02195,2020-10-01,1276,1205,71,5.6
02198,2020-10-01,2759,2597,162,5.9
02220,2020-10-01,3946,3766,180,4.6
02230,2020-10-01,790,704,86,10.9
02240,2020-10-01,2805,2665,140,5
02261,2020-10-01,4312,4039,273,6.3
02275,2020-10-01,975,926,49,5
02282,2020-10-01,221,206,15,6.8
02290,2020-10-01,2482,2321,161,6.5
04001,2020-10-01,20060,17548,2512,12.5
04003,2020-10-01,52130,48745,3385,6.5
04005,2020-10-01,69805,63077,6728,9.6
04007,2020-10-01,20993,19399,1594,7.6
04009,2020-10-01,15788,14806,982,6.2
04011,2020-10-01,4652,4374,278,6
04012,2020-10-01,9866,9221,645,6.5
04013,2020-10-01,NA,NA,175267,7.4
04015,2020-10-01,87146,79311,7835,9
04017,2020-10-01,40765,36896,3869,9.5
04019,2020-10-01,498262,459295,38967,7.8
04021,2020-10-01,191093,176810,14283,7.5
04023,2020-10-01,19284,16816,2468,12.8
04025,2020-10-01,110001,102529,7472,6.8
04027,2020-10-01,96981,81906,15075,15.5
05001,2020-10-01,9278,8909,369,4
05003,2020-10-01,7379,6709,670,9.1
05005,2020-10-01,15850,15029,821,5.2
05007,2020-10-01,136224,130452,5772,4.2
05009,2020-10-01,15743,15043,700,4.4
05011,2020-10-01,4400,4178,222,5
05013,2020-10-01,2391,2278,113,4.7
05015,2020-10-01,12587,11975,612,4.9
05017,2020-10-01,3191,2843,348,10.9
05019,2020-10-01,9437,8947,490,5.2
05021,2020-10-01,5480,5227,253,4.6
05023,2020-10-01,8939,8349,590,6.6
05025,2020-10-01,3117,2921,196,6.3
05027,2020-10-01,9203,8588,615,6.7
05029,2020-10-01,8012,7585,427,5.3
05031,2020-10-01,56541,53863,2678,4.7
05033,2020-10-01,25746,24443,1303,5.1
05035,2020-10-01,21040,19374,1666,7.9
05037,2020-10-01,7324,6906,418,5.7
05039,2020-10-01,2681,2558,123,4.6
05041,2020-10-01,5296,4937,359,6.8
05043,2020-10-01,7625,7154,471,6.2
05045,2020-10-01,58979,56112,2867,4.9
05047,2020-10-01,7348,6975,373,5.1
05049,2020-10-01,4954,4734,220,4.4
05051,2020-10-01,40997,37917,3080,7.5
05053,2020-10-01,7937,7556,381,4.8
05055,2020-10-01,19719,18783,936,4.7
05057,2020-10-01,9560,9136,424,4.4
05059,2020-10-01,13652,12903,749,5.5
05061,2020-10-01,5475,5223,252,4.6
05063,2020-10-01,16425,15591,834,5.1
05065,2020-10-01,4762,4434,328,6.9
05067,2020-10-01,5536,5172,364,6.6
05069,2020-10-01,26760,24469,2291,8.6
05071,2020-10-01,9932,9408,524,5.3
05073,2020-10-01,2469,2270,199,8.1
05075,2020-10-01,6909,6530,379,5.5
05077,2020-10-01,2762,2565,197,7.1
05079,2020-10-01,3788,3578,210,5.5
05081,2020-10-01,5446,5125,321,5.9
05083,2020-10-01,8153,7665,488,6
05085,2020-10-01,32743,31022,1721,5.3
05087,2020-10-01,7429,7141,288,3.9
05089,2020-10-01,6499,6138,361,5.6
05091,2020-10-01,19585,18410,1175,6
05093,2020-10-01,17190,15726,1464,8.5
05095,2020-10-01,2743,2561,182,6.6
05097,2020-10-01,2904,2728,176,6.1
05099,2020-10-01,3529,3342,187,5.3
05101,2020-10-01,3264,3138,126,3.9
05103,2020-10-01,9479,8986,493,5.2
05105,2020-10-01,4019,3824,195,4.9
05107,2020-10-01,6226,5678,548,8.8
05109,2020-10-01,4223,3988,235,5.6
05111,2020-10-01,10445,9937,508,4.9
05113,2020-10-01,7943,7479,464,5.8
05115,2020-10-01,28254,26884,1370,4.8
05117,2020-10-01,3542,3360,182,5.1
05119,2020-10-01,184164,169990,14174,7.7
05121,2020-10-01,7299,6914,385,5.3
05123,2020-10-01,8082,7461,621,7.7
05125,2020-10-01,55816,53155,2661,4.8
05127,2020-10-01,4296,4113,183,4.3
05129,2020-10-01,2812,2659,153,5.4
05131,2020-10-01,54404,51397,3007,5.5
05133,2020-10-01,5430,5124,306,5.6
05135,2020-10-01,5667,5305,362,6.4
05137,2020-10-01,4673,4368,305,6.5
05139,2020-10-01,15401,14198,1203,7.8
05141,2020-10-01,5632,5261,371,6.6
05143,2020-10-01,124504,119055,5449,4.4
05145,2020-10-01,32759,30974,1785,5.4
05147,2020-10-01,2699,2541,158,5.9
05149,2020-10-01,8281,7927,354,4.3
06001,2020-10-01,829574,766119,63455,7.6
06003,2020-10-01,463,421,42,9.1
06005,2020-10-01,14553,13480,1073,7.4
06007,2020-10-01,96203,89334,6869,7.1
06009,2020-10-01,20674,19348,1326,6.4
06011,2020-10-01,9982,9068,914,9.2
06013,2020-10-01,551581,509344,42237,7.7
06015,2020-10-01,9382,8664,718,7.7
06017,2020-10-01,91799,86128,5671,6.2
06019,2020-10-01,449041,408907,40134,8.9
06021,2020-10-01,13159,12360,799,6.1
06023,2020-10-01,61379,57392,3987,6.5
06025,2020-10-01,68078,55683,12395,18.2
06027,2020-10-01,8470,7938,532,6.3
06029,2020-10-01,378798,340278,38520,10.2
06031,2020-10-01,56079,51044,5035,9
06033,2020-10-01,29603,27403,2200,7.4
06035,2020-10-01,10077,9569,508,5
06037,2020-10-01,NA,NA,591383,12
06039,2020-10-01,61648,56605,5043,8.2
06041,2020-10-01,137489,130272,7217,5.2
06043,2020-10-01,7683,7124,559,7.3
06045,2020-10-01,37236,34573,2663,7.2
06047,2020-10-01,116060,105638,10422,9
06049,2020-10-01,3199,3020,179,5.6
06051,2020-10-01,7250,6550,700,9.7
06053,2020-10-01,195440,180661,14779,7.6
06055,2020-10-01,73597,68869,4728,6.4
06057,2020-10-01,47125,44189,2936,6.2
06059,2020-10-01,NA,NA,118310,7.3
06061,2020-10-01,187389,176599,10790,5.8
06063,2020-10-01,7939,7411,528,6.7
06065,2020-10-01,NA,NA,97068,8.7
06067,2020-10-01,724042,665537,58505,8.1
06069,2020-10-01,31414,29128,2286,7.3
06071,2020-10-01,984899,898738,86161,8.7
06073,2020-10-01,NA,NA,120033,7.5
06075,2020-10-01,579346,540681,38665,6.7
06077,2020-10-01,328635,296953,31682,9.6
06079,2020-10-01,134203,126327,7876,5.9
06081,2020-10-01,453446,427269,26177,5.8
06083,2020-10-01,218297,204884,13413,6.1
06085,2020-10-01,NA,997532,60790,5.7
06087,2020-10-01,131294,122180,9114,6.9
06089,2020-10-01,74796,69760,5036,6.7
06091,2020-10-01,1325,1255,70,5.3
06093,2020-10-01,16427,15263,1164,7.1
06095,2020-10-01,207576,190502,17074,8.2
06097,2020-10-01,257909,242360,15549,6
06099,2020-10-01,239738,218691,21047,8.8
06101,2020-10-01,42263,38594,3669,8.7
06103,2020-10-01,25316,23563,1753,6.9
06105,2020-10-01,4373,4106,267,6.1
06107,2020-10-01,193275,172918,20357,10.5
06109,2020-10-01,20124,18513,1611,8
06111,2020-10-01,419394,390453,28941,6.9
06113,2020-10-01,107511,101118,6393,5.9
06115,2020-10-01,29037,26442,2595,8.9
08001,2020-10-01,279020,259736,19284,6.9
08003,2020-10-01,9032,8564,468,5.2
08005,2020-10-01,373099,347305,25794,6.9
08007,2020-10-01,7301,6910,391,5.4
08009,2020-10-01,2377,2337,40,1.7
08011,2020-10-01,2121,2044,77,3.6
08013,2020-10-01,192301,182349,9952,5.2
08014,2020-10-01,40504,38298,2206,5.4
08015,2020-10-01,9113,8656,457,5
08017,2020-10-01,1271,1243,28,2.2
08019,2020-10-01,6180,5783,397,6.4
08021,2020-10-01,4357,4179,178,4.1
08023,2020-10-01,1897,1779,118,6.2
08025,2020-10-01,1547,1467,80,5.2
08027,2020-10-01,2105,2021,84,4
08029,2020-10-01,14498,13736,762,5.3
08031,2020-10-01,428311,397149,31162,7.3
08033,2020-10-01,1264,1208,56,4.4
08035,2020-10-01,194758,185650,9108,4.7
08037,2020-10-01,32345,30000,2345,7.2
08039,2020-10-01,15387,14845,542,3.5
08041,2020-10-01,345043,324460,20583,6
08043,2020-10-01,14813,13780,1033,7
08045,2020-10-01,30132,28490,1642,5.4
08047,2020-10-01,3885,3617,268,6.9
08049,2020-10-01,8055,7540,515,6.4
08051,2020-10-01,11000,10528,472,4.3
08053,2020-10-01,395,382,13,3.3
08055,2020-10-01,2640,2434,206,7.8
08057,2020-10-01,1082,1053,29,2.7
08059,2020-10-01,339807,319931,19876,5.8
08061,2020-10-01,1070,1050,20,1.9
08063,2020-10-01,4546,4444,102,2.2
08065,2020-10-01,4495,4197,298,6.6
08067,2020-10-01,31541,29836,1705,5.4
08069,2020-10-01,205059,194643,10416,5.1
08071,2020-10-01,6693,6259,434,6.5
08073,2020-10-01,2555,2456,99,3.9
08075,2020-10-01,11665,11209,456,3.9
08077,2020-10-01,78970,74493,4477,5.7
08079,2020-10-01,337,318,19,5.6
08081,2020-10-01,7324,7009,315,4.3
08083,2020-10-01,13134,12440,694,5.3
08085,2020-10-01,22401,21265,1136,5.1
08087,2020-10-01,16977,16174,803,4.7
08089,2020-10-01,8804,8327,477,5.4
08091,2020-10-01,2421,2289,132,5.5
08093,2020-10-01,11245,10729,516,4.6
08095,2020-10-01,2816,2767,49,1.7
08097,2020-10-01,10571,9781,790,7.5
08099,2020-10-01,6900,6636,264,3.8
08101,2020-10-01,77470,71447,6023,7.8
08103,2020-10-01,3152,3017,135,4.3
08105,2020-10-01,5948,5656,292,4.9
08107,2020-10-01,15163,14307,856,5.6
08109,2020-10-01,3782,3583,199,5.3
08111,2020-10-01,465,445,20,4.3
08113,2020-10-01,4596,4232,364,7.9
08115,2020-10-01,1179,1140,39,3.3
08117,2020-10-01,18385,16953,1432,7.8
08119,2020-10-01,12852,12129,723,5.6
08121,2020-10-01,3131,3056,75,2.4
08123,2020-10-01,171525,160938,10587,6.2
08125,2020-10-01,5918,5778,140,2.4
09001,2020-10-01,456804,429408,27396,6
09003,2020-10-01,474258,445622,28636,6
09005,2020-10-01,101289,96592,4697,4.6
09007,2020-10-01,91790,87671,4119,4.5
09009,2020-10-01,449800,422727,27073,6
09011,2020-10-01,131223,122624,8599,6.6
09013,2020-10-01,84376,80941,3435,4.1
09015,2020-10-01,61886,58611,3275,5.3
10001,2020-10-01,80344,75585,4759,5.9
10003,2020-10-01,293111,276296,16815,5.7
10005,2020-10-01,105672,100795,4877,4.6
11001,2020-10-01,405870,372532,33338,8.2
12001,2020-10-01,137993,132118,5875,4.3
12003,2020-10-01,11693,11186,507,4.3
12005,2020-10-01,81762,78117,3645,4.5
12007,2020-10-01,10998,10495,503,4.6
12009,2020-10-01,284489,270354,14135,5
12011,2020-10-01,NA,944346,72844,7.2
12013,2020-10-01,4675,4469,206,4.4
12015,2020-10-01,72516,68838,3678,5.1
12017,2020-10-01,45466,42582,2884,6.3
12019,2020-10-01,105865,101706,4159,3.9
12021,2020-10-01,175894,167128,8766,5
12023,2020-10-01,29899,28352,1547,5.2
12027,2020-10-01,14658,14082,576,3.9
12029,2020-10-01,5815,5569,246,4.2
12031,2020-10-01,490147,463423,26724,5.5
12033,2020-10-01,144109,136373,7736,5.4
12035,2020-10-01,46185,43647,2538,5.5
12037,2020-10-01,4376,4184,192,4.4
12039,2020-10-01,18913,17724,1189,6.3
12041,2020-10-01,7023,6740,283,4
12043,2020-10-01,5392,5176,216,4
12045,2020-10-01,5546,5296,250,4.5
12047,2020-10-01,4418,4128,290,6.6
12049,2020-10-01,8450,8018,432,5.1
12051,2020-10-01,15480,14467,1013,6.5
12053,2020-10-01,70818,66620,4198,5.9
12055,2020-10-01,36627,34478,2149,5.9
12057,2020-10-01,743364,701642,41722,5.6
12059,2020-10-01,6864,6579,285,4.2
12061,2020-10-01,64320,60773,3547,5.5
12063,2020-10-01,16967,16164,803,4.7
12065,2020-10-01,5407,5139,268,5
12067,2020-10-01,2784,2676,108,3.9
12069,2020-10-01,151345,141725,9620,6.4
12071,2020-10-01,346291,327694,18597,5.4
12073,2020-10-01,149332,141862,7470,5
12075,2020-10-01,16623,15836,787,4.7
12077,2020-10-01,2559,2443,116,4.5
12079,2020-10-01,7594,7139,455,6
12081,2020-10-01,175789,166973,8816,5
12083,2020-10-01,141736,134041,7695,5.4
12085,2020-10-01,73374,70298,3076,4.2
12086,2020-10-01,NA,NA,110612,8.5
12087,2020-10-01,48216,46063,2153,4.5
12089,2020-10-01,40491,38898,1593,3.9
12091,2020-10-01,94329,90811,3518,3.7
12093,2020-10-01,17526,16760,766,4.4
12095,2020-10-01,741426,679670,61756,8.3
12097,2020-10-01,181819,163453,18366,10.1
12099,2020-10-01,705021,662767,42254,6
12101,2020-10-01,234506,221934,12572,5.4
12103,2020-10-01,488242,463226,25016,5.1
12105,2020-10-01,307848,285945,21903,7.1
12107,2020-10-01,26349,24488,1861,7.1
12109,2020-10-01,130047,125312,4735,3.6
12111,2020-10-01,144967,136355,8612,5.9
12113,2020-10-01,80692,77713,2979,3.7
12115,2020-10-01,184274,175529,8745,4.7
12117,2020-10-01,240911,227680,13231,5.5
12119,2020-10-01,32522,30687,1835,5.6
12121,2020-10-01,17958,17110,848,4.7
12123,2020-10-01,8300,7824,476,5.7
12125,2020-10-01,4525,4340,185,4.1
12127,2020-10-01,251357,236938,14419,5.7
12129,2020-10-01,14149,13661,488,3.4
12131,2020-10-01,30807,29565,1242,4
12133,2020-10-01,9290,8864,426,4.6
13001,2020-10-01,9454,9171,283,3
13003,2020-10-01,4328,4214,114,2.6
13005,2020-10-01,4758,4601,157,3.3
13007,2020-10-01,1124,1077,47,4.2
13009,2020-10-01,18291,17399,892,4.9
13011,2020-10-01,9940,9684,256,2.6
13013,2020-10-01,39906,38619,1287,3.2
13015,2020-10-01,49991,48110,1881,3.8
13017,2020-10-01,5380,5094,286,5.3
13019,2020-10-01,7499,7245,254,3.4
13021,2020-10-01,67636,63818,3818,5.6
13023,2020-10-01,4464,4241,223,5
13025,2020-10-01,6539,6299,240,3.7
13027,2020-10-01,7085,6826,259,3.7
13029,2020-10-01,17912,17309,603,3.4
13031,2020-10-01,37762,36124,1638,4.3
13033,2020-10-01,8841,8373,468,5.3
13035,2020-10-01,10667,10210,457,4.3
13037,2020-10-01,2302,2224,78,3.4
13039,2020-10-01,20366,19718,648,3.2
13043,2020-10-01,5719,5527,192,3.4
13045,2020-10-01,54776,52525,2251,4.1
13047,2020-10-01,33417,32643,774,2.3
13049,2020-10-01,4739,4620,119,2.5
13051,2020-10-01,138861,131698,7163,5.2
13053,2020-10-01,1916,1831,85,4.4
13055,2020-10-01,9760,9325,435,4.5
13057,2020-10-01,134035,130131,3904,2.9
13059,2020-10-01,58706,56168,2538,4.3
13061,2020-10-01,934,857,77,8.2
13063,2020-10-01,140862,129838,11024,7.8
13065,2020-10-01,2484,2402,82,3.3
13067,2020-10-01,422497,406281,16216,3.8
13069,2020-10-01,19124,18359,765,4
13071,2020-10-01,21530,20806,724,3.4
13073,2020-10-01,72190,70268,1922,2.7
13075,2020-10-01,8234,7959,275,3.3
13077,2020-10-01,74130,71263,2867,3.9
13079,2020-10-01,5487,5288,199,3.6
13081,2020-10-01,9723,9127,596,6.1
13083,2020-10-01,8186,7997,189,2.3
13085,2020-10-01,12164,11810,354,2.9
13087,2020-10-01,11363,10944,419,3.7
13089,2020-10-01,402228,379647,22581,5.6
13091,2020-10-01,6805,6518,287,4.2
13093,2020-10-01,5108,4830,278,5.4
13095,2020-10-01,37848,35274,2574,6.8
13097,2020-10-01,73315,69541,3774,5.1
13099,2020-10-01,4473,4262,211,4.7
13101,2020-10-01,1944,1892,52,2.7
13103,2020-10-01,30224,29236,988,3.3
13105,2020-10-01,7816,7415,401,5.1
13107,2020-10-01,8185,7710,475,5.8
13109,2020-10-01,4957,4769,188,3.8
13111,2020-10-01,12477,12182,295,2.4
13113,2020-10-01,57303,55357,1946,3.4
13115,2020-10-01,44641,43030,1611,3.6
13117,2020-10-01,120178,116900,3278,2.7
13119,2020-10-01,9982,9616,366,3.7
13121,2020-10-01,560845,529209,31636,5.6
13123,2020-10-01,11461,11143,318,2.8
13125,2020-10-01,1228,1197,31,2.5
13127,2020-10-01,35371,33770,1601,4.5
13129,2020-10-01,29066,28147,919,3.2
13131,2020-10-01,10226,9906,320,3.1
13133,2020-10-01,7087,6802,285,4
13135,2020-10-01,488077,467756,20321,4.2
13137,2020-10-01,18736,18110,626,3.3
13139,2020-10-01,100965,98064,2901,2.9
13141,2020-10-01,2573,2397,176,6.8
13143,2020-10-01,12428,11965,463,3.7
13145,2020-10-01,15975,15532,443,2.8
13147,2020-10-01,10998,10595,403,3.7
13149,2020-10-01,5201,4997,204,3.9
13151,2020-10-01,115376,109531,5845,5.1
13153,2020-10-01,67825,65258,2567,3.8
13155,2020-10-01,3445,3317,128,3.7
13157,2020-10-01,38268,37218,1050,2.7
13159,2020-10-01,6854,6628,226,3.3
13161,2020-10-01,5815,5608,207,3.6
13163,2020-10-01,6582,6263,319,4.8
13165,2020-10-01,3134,2989,145,4.6
13167,2020-10-01,3963,3830,133,3.4
13169,2020-10-01,13389,12981,408,3
13171,2020-10-01,8149,7801,348,4.3
13173,2020-10-01,3831,3701,130,3.4
13175,2020-10-01,18855,17998,857,4.5
13177,2020-10-01,14239,13791,448,3.1
13179,2020-10-01,26455,25333,1122,4.2
13181,2020-10-01,3427,3301,126,3.7
13183,2020-10-01,8137,7904,233,2.9
13185,2020-10-01,52976,50784,2192,4.1
13187,2020-10-01,16548,16106,442,2.7
13189,2020-10-01,8538,8092,446,5.2
13191,2020-10-01,5545,5319,226,4.1
13193,2020-10-01,4613,4338,275,6
13195,2020-10-01,13135,12711,424,3.2
13197,2020-10-01,3159,3051,108,3.4
13199,2020-10-01,8898,8388,510,5.7
13201,2020-10-01,2682,2609,73,2.7
13205,2020-10-01,8322,7905,417,5
13207,2020-10-01,12758,12320,438,3.4
13209,2020-10-01,3794,3650,144,3.8
13211,2020-10-01,9150,8837,313,3.4
13213,2020-10-01,14882,14229,653,4.4
13215,2020-10-01,75349,71107,4242,5.6
13217,2020-10-01,51969,49393,2576,5
13219,2020-10-01,19180,18767,413,2.2
13221,2020-10-01,6816,6611,205,3
13223,2020-10-01,84992,82055,2937,3.5
13225,2020-10-01,11523,10923,600,5.2
13227,2020-10-01,15017,14584,433,2.9
13229,2020-10-01,8480,8215,265,3.1
13231,2020-10-01,8773,8505,268,3.1
13233,2020-10-01,18355,17676,679,3.7
13235,2020-10-01,3892,3755,137,3.5
13237,2020-10-01,8146,7807,339,4.2
13239,2020-10-01,825,793,32,3.9
13241,2020-10-01,7097,6886,211,3
13243,2020-10-01,2612,2507,105,4
13245,2020-10-01,82825,78195,4630,5.6
13247,2020-10-01,44755,42391,2364,5.3
13249,2020-10-01,2287,2220,67,2.9
13251,2020-10-01,5152,4861,291,5.6
13253,2020-10-01,2999,2893,106,3.5
13255,2020-10-01,28648,27100,1548,5.4
13257,2020-10-01,10659,10228,431,4
13259,2020-10-01,2612,2504,108,4.1
13261,2020-10-01,13393,12663,730,5.5
13263,2020-10-01,2761,2630,131,4.7
13265,2020-10-01,567,543,24,4.2
13267,2020-10-01,9365,9089,276,2.9
13269,2020-10-01,2876,2723,153,5.3
13271,2020-10-01,3559,3306,253,7.1
13273,2020-10-01,3440,3223,217,6.3
13275,2020-10-01,16763,15996,767,4.6
13277,2020-10-01,20396,19656,740,3.6
13279,2020-10-01,11725,11219,506,4.3
13281,2020-10-01,3687,3536,151,4.1
13283,2020-10-01,2563,2457,106,4.1
13285,2020-10-01,38078,36361,1717,4.5
13287,2020-10-01,3178,2988,190,6
13289,2020-10-01,2791,2656,135,4.8
13291,2020-10-01,10266,9999,267,2.6
13293,2020-10-01,11266,10757,509,4.5
13295,2020-10-01,31214,30353,861,2.8
13297,2020-10-01,45462,43889,1573,3.5
13299,2020-10-01,15211,14635,576,3.8
13301,2020-10-01,2800,2683,117,4.2
13303,2020-10-01,6665,6318,347,5.2
13305,2020-10-01,10965,10532,433,3.9
13307,2020-10-01,1038,996,42,4
13309,2020-10-01,1571,1500,71,4.5
13311,2020-10-01,16717,16334,383,2.3
13313,2020-10-01,41945,40214,1731,4.1
13315,2020-10-01,2727,2605,122,4.5
13317,2020-10-01,3858,3679,179,4.6
13319,2020-10-01,4019,3868,151,3.8
13321,2020-10-01,8628,8273,355,4.1
15001,2020-10-01,87949,76109,11840,13.5
15003,2020-10-01,434382,380715,53667,12.4
15007,2020-10-01,34800,28041,6759,19.4
15009,2020-10-01,82093,63895,18198,22.2
16001,2020-10-01,260479,246911,13568,5.2
16003,2020-10-01,1835,1689,146,8
16005,2020-10-01,41775,39672,2103,5
16007,2020-10-01,3239,3126,113,3.5
16009,2020-10-01,4267,4007,260,6.1
16011,2020-10-01,26238,25314,924,3.5
16013,2020-10-01,12305,11532,773,6.3
16015,2020-10-01,3642,3361,281,7.7
16017,2020-10-01,21554,20102,1452,6.7
16019,2020-10-01,60539,58155,2384,3.9
16021,2020-10-01,5752,5439,313,5.4
16023,2020-10-01,1521,1467,54,3.6
16025,2020-10-01,730,702,28,3.8
16027,2020-10-01,107346,101319,6027,5.6
16029,2020-10-01,4406,4249,157,3.6
16031,2020-10-01,13689,13229,460,3.4
16033,2020-10-01,428,413,15,3.5
16035,2020-10-01,3149,2913,236,7.5
16037,2020-10-01,2344,2234,110,4.7
16039,2020-10-01,12352,11783,569,4.6
16041,2020-10-01,7448,7200,248,3.3
16043,2020-10-01,9259,8996,263,2.8
16045,2020-10-01,8590,8075,515,6
16047,2020-10-01,8661,8331,330,3.8
16049,2020-10-01,6922,6488,434,6.3
16051,2020-10-01,15035,14539,496,3.3
16053,2020-10-01,12792,12302,490,3.8
16055,2020-10-01,79264,74146,5118,6.5
16057,2020-10-01,20708,19753,955,4.6
16059,2020-10-01,3810,3594,216,5.7
16061,2020-10-01,1739,1621,118,6.8
16063,2020-10-01,2783,2649,134,4.8
16065,2020-10-01,24901,24225,676,2.7
16067,2020-10-01,12715,12293,422,3.3
16069,2020-10-01,20124,19181,943,4.7
16071,2020-10-01,2514,2423,91,3.6
16073,2020-10-01,5546,5246,300,5.4
16075,2020-10-01,12448,11839,609,4.9
16077,2020-10-01,4951,4793,158,3.2
16079,2020-10-01,5611,5139,472,8.4
16081,2020-10-01,7005,6684,321,4.6
16083,2020-10-01,43237,41173,2064,4.8
16085,2020-10-01,5622,5261,361,6.4
16087,2020-10-01,4987,4754,233,4.7
17001,2020-10-01,33085,31762,1323,4
17003,2020-10-01,2014,1866,148,7.3
17005,2020-10-01,8050,7704,346,4.3
17007,2020-10-01,25771,24270,1501,5.8
17009,2020-10-01,3115,3042,73,2.3
17011,2020-10-01,17899,17135,764,4.3
17013,2020-10-01,2364,2270,94,4
17015,2020-10-01,7884,7521,363,4.6
17017,2020-10-01,6380,6125,255,4
17019,2020-10-01,116745,111340,5405,4.6
17021,2020-10-01,14584,13844,740,5.1
17023,2020-10-01,7842,7514,328,4.2
17025,2020-10-01,6446,6146,300,4.7
17027,2020-10-01,20905,20222,683,3.3
17029,2020-10-01,25077,23799,1278,5.1
17031,2020-10-01,NA,NA,235441,9.4
17033,2020-10-01,8805,8425,380,4.3
17035,2020-10-01,6350,6121,229,3.6
17037,2020-10-01,55103,52029,3074,5.6
17039,2020-10-01,7621,7291,330,4.3
17041,2020-10-01,10671,10289,382,3.6
17043,2020-10-01,476013,446316,29697,6.2
17045,2020-10-01,9037,8695,342,3.8
17047,2020-10-01,2774,2657,117,4.2
17049,2020-10-01,19755,18983,772,3.9
17051,2020-10-01,10336,9859,477,4.6
17053,2020-10-01,6999,6744,255,3.6
17055,2020-10-01,16629,15646,983,5.9
17057,2020-10-01,15308,14517,791,5.2
17059,2020-10-01,2326,2191,135,5.8
17061,2020-10-01,6378,6106,272,4.3
17063,2020-10-01,23494,22093,1401,6
17065,2020-10-01,4553,4400,153,3.4
17067,2020-10-01,8885,8547,338,3.8
17069,2020-10-01,1375,1299,76,5.5
17071,2020-10-01,3780,3648,132,3.5
17073,2020-10-01,25396,24231,1165,4.6
17075,2020-10-01,15268,14688,580,3.8
17077,2020-10-01,29269,27741,1528,5.2
17079,2020-10-01,5132,4960,172,3.4
17081,2020-10-01,17850,16849,1001,5.6
17083,2020-10-01,11164,10660,504,4.5
17085,2020-10-01,11018,10532,486,4.4
17087,2020-10-01,4254,4027,227,5.3
17089,2020-10-01,271839,255683,16156,5.9
17091,2020-10-01,57741,54436,3305,5.7
17093,2020-10-01,64097,60154,3943,6.2
17095,2020-10-01,22002,20637,1365,6.2
17097,2020-10-01,376504,355724,20780,5.5
17099,2020-10-01,55239,52163,3076,5.6
17101,2020-10-01,5824,5525,299,5.1
17103,2020-10-01,18128,17363,765,4.2
17105,2020-10-01,17305,16609,696,4
17107,2020-10-01,12916,12359,557,4.3
17109,2020-10-01,14116,13461,655,4.6
17111,2020-10-01,154740,145242,9498,6.1
17113,2020-10-01,89442,85377,4065,4.5
17115,2020-10-01,49143,45523,3620,7.4
17117,2020-10-01,23446,22475,971,4.1
17119,2020-10-01,137249,130344,6905,5
17121,2020-10-01,17662,16675,987,5.6
17123,2020-10-01,5264,5009,255,4.8
17125,2020-10-01,6518,6201,317,4.9
17127,2020-10-01,5605,5302,303,5.4
17129,2020-10-01,6592,6334,258,3.9
17131,2020-10-01,8256,7894,362,4.4
17133,2020-10-01,19070,18447,623,3.3
17135,2020-10-01,11693,11064,629,5.4
17137,2020-10-01,17078,16325,753,4.4
17139,2020-10-01,7957,7682,275,3.5
17141,2020-10-01,25080,23854,1226,4.9
17143,2020-10-01,83779,77565,6214,7.4
17145,2020-10-01,8612,8157,455,5.3
17147,2020-10-01,9241,8926,315,3.4
17149,2020-10-01,7404,7155,249,3.4
17151,2020-10-01,1754,1671,83,4.7
17153,2020-10-01,2064,1909,155,7.5
17155,2020-10-01,3202,3064,138,4.3
17157,2020-10-01,14580,13997,583,4
17159,2020-10-01,7330,7008,322,4.4
17161,2020-10-01,72438,68150,4288,5.9
17163,2020-10-01,130433,122171,8262,6.3
17165,2020-10-01,9962,9349,613,6.2
17167,2020-10-01,103058,97252,5806,5.6
17169,2020-10-01,3352,3227,125,3.7
17171,2020-10-01,2694,2597,97,3.6
17173,2020-10-01,11099,10671,428,3.9
17175,2020-10-01,2511,2397,114,4.5
17177,2020-10-01,22763,21633,1130,5
17179,2020-10-01,62142,58945,3197,5.1
17181,2020-10-01,7745,7367,378,4.9
17183,2020-10-01,34588,32459,2129,6.2
17185,2020-10-01,6124,5870,254,4.1
17187,2020-10-01,8813,8456,357,4.1
17189,2020-10-01,9476,9218,258,2.7
17191,2020-10-01,7456,7125,331,4.4
17193,2020-10-01,6765,6492,273,4
17195,2020-10-01,28857,27447,1410,4.9
17197,2020-10-01,335731,311224,24507,7.3
17199,2020-10-01,33189,31521,1668,5
17201,2020-10-01,138434,128412,10022,7.2
17203,2020-10-01,18285,17544,741,4.1
18001,2020-10-01,16416,15864,552,3.4
18003,2020-10-01,188222,178088,10134,5.4
18005,2020-10-01,44904,43032,1872,4.2
18007,2020-10-01,4563,4391,172,3.8
18009,2020-10-01,4569,4330,239,5.2
18011,2020-10-01,36893,35634,1259,3.4
18013,2020-10-01,7894,7536,358,4.5
18015,2020-10-01,10213,9815,398,3.9
18017,2020-10-01,16844,16058,786,4.7
18019,2020-10-01,61233,57950,3283,5.4
18021,2020-10-01,11884,11279,605,5.1
18023,2020-10-01,16890,16202,688,4.1
18025,2020-10-01,4757,4526,231,4.9
18027,2020-10-01,16525,16038,487,2.9
18029,2020-10-01,25580,24389,1191,4.7
18031,2020-10-01,14106,13519,587,4.2
18033,2020-10-01,21418,20505,913,4.3
18035,2020-10-01,53492,50492,3000,5.6
18037,2020-10-01,22335,21528,807,3.6
18039,2020-10-01,108742,103664,5078,4.7
18041,2020-10-01,8052,7480,572,7.1
18043,2020-10-01,41169,39214,1955,4.7
18045,2020-10-01,7758,7450,308,4
18047,2020-10-01,11246,10800,446,4
18049,2020-10-01,9616,9180,436,4.5
18051,2020-10-01,19250,18513,737,3.8
18053,2020-10-01,31442,29921,1521,4.8
18055,2020-10-01,13353,12746,607,4.5
18057,2020-10-01,186813,180055,6758,3.6
18059,2020-10-01,41107,39371,1736,4.2
18061,2020-10-01,19983,19130,853,4.3
18063,2020-10-01,91548,87963,3585,3.9
18065,2020-10-01,21660,20657,1003,4.6
18067,2020-10-01,37464,35198,2266,6
18069,2020-10-01,17536,16807,729,4.2
18071,2020-10-01,21949,20933,1016,4.6
18073,2020-10-01,16154,15434,720,4.5
18075,2020-10-01,8746,8409,337,3.9
18077,2020-10-01,14634,13942,692,4.7
18079,2020-10-01,13345,12688,657,4.9
18081,2020-10-01,84635,81200,3435,4.1
18083,2020-10-01,17864,17109,755,4.2
18085,2020-10-01,40971,39159,1812,4.4
18087,2020-10-01,16889,16280,609,3.6
18089,2020-10-01,231985,213973,18012,7.8
18091,2020-10-01,48273,44902,3371,7
18093,2020-10-01,20592,19525,1067,5.2
18095,2020-10-01,60805,57337,3468,5.7
18097,2020-10-01,512128,476772,35356,6.9
18099,2020-10-01,21636,20640,996,4.6
18101,2020-10-01,5447,5253,194,3.6
18103,2020-10-01,14865,14027,838,5.6
18105,2020-10-01,70983,67843,3140,4.4
18107,2020-10-01,18838,18120,718,3.8
18109,2020-10-01,36936,35457,1479,4
18111,2020-10-01,6873,6595,278,4
18113,2020-10-01,21547,20475,1072,5
18115,2020-10-01,3153,3008,145,4.6
18117,2020-10-01,7567,6888,679,9
18119,2020-10-01,9480,9046,434,4.6
18121,2020-10-01,6958,6691,267,3.8
18123,2020-10-01,8657,8257,400,4.6
18125,2020-10-01,5847,5599,248,4.2
18127,2020-10-01,86269,81622,4647,5.4
18129,2020-10-01,13864,13402,462,3.3
18131,2020-10-01,6255,5988,267,4.3
18133,2020-10-01,17070,16330,740,4.3
18135,2020-10-01,11284,10780,504,4.5
18137,2020-10-01,13945,13355,590,4.2
18139,2020-10-01,8886,8517,369,4.2
18141,2020-10-01,131512,122689,8823,6.7
18143,2020-10-01,10488,9904,584,5.6
18145,2020-10-01,23662,22641,1021,4.3
18147,2020-10-01,10024,9604,420,4.2
18149,2020-10-01,9465,8896,569,6
18151,2020-10-01,19154,18373,781,4.1
18153,2020-10-01,8224,7819,405,4.9
18155,2020-10-01,4537,4279,258,5.7
18157,2020-10-01,98552,93775,4777,4.8
18159,2020-10-01,8949,8619,330,3.7
18161,2020-10-01,3505,3386,119,3.4
18163,2020-10-01,97351,92351,5000,5.1
18165,2020-10-01,6796,6457,339,5
18167,2020-10-01,47361,44612,2749,5.8
18169,2020-10-01,14341,13706,635,4.4
18171,2020-10-01,4070,3920,150,3.7
18173,2020-10-01,33595,32364,1231,3.7
18175,2020-10-01,13658,13018,640,4.7
18177,2020-10-01,29114,27522,1592,5.5
18179,2020-10-01,14513,13971,542,3.7
18181,2020-10-01,13160,12677,483,3.7
18183,2020-10-01,17772,17112,660,3.7
19001,2020-10-01,4008,3917,91,2.3
19003,2020-10-01,2026,1972,54,2.7
19005,2020-10-01,6969,6820,149,2.1
19007,2020-10-01,5640,5452,188,3.3
19009,2020-10-01,2916,2853,63,2.2
19011,2020-10-01,12757,12403,354,2.8
19013,2020-10-01,66721,64354,2367,3.5
19015,2020-10-01,14475,14148,327,2.3
19017,2020-10-01,13287,13028,259,1.9
19019,2020-10-01,10445,10161,284,2.7
19021,2020-10-01,12019,11743,276,2.3
19023,2020-10-01,7529,7359,170,2.3
19025,2020-10-01,4039,3943,96,2.4
19027,2020-10-01,10417,10182,235,2.3
19029,2020-10-01,6517,6365,152,2.3
19031,2020-10-01,10368,10122,246,2.4
19033,2020-10-01,22131,21459,672,3
19035,2020-10-01,5975,5853,122,2
19037,2020-10-01,6360,6213,147,2.3
19039,2020-10-01,4531,4395,136,3
19041,2020-10-01,8119,7926,193,2.4
19043,2020-10-01,9353,9116,237,2.5
19045,2020-10-01,21887,21004,883,4
19047,2020-10-01,7647,7430,217,2.8
19049,2020-10-01,47046,46017,1029,2.2
19051,2020-10-01,4001,3892,109,2.7
19053,2020-10-01,4132,4057,75,1.8
19055,2020-10-01,9976,9757,219,2.2
19057,2020-10-01,17831,17008,823,4.6
19059,2020-10-01,8398,8145,253,3
19061,2020-10-01,53326,51526,1800,3.4
19063,2020-10-01,5026,4865,161,3.2
19065,2020-10-01,10149,9855,294,2.9
19067,2020-10-01,7986,7713,273,3.4
19069,2020-10-01,5289,5166,123,2.3
19071,2020-10-01,3511,3442,69,2
19073,2020-10-01,5268,5134,134,2.5
19075,2020-10-01,6242,6089,153,2.5
19077,2020-10-01,5314,5164,150,2.8
19079,2020-10-01,6616,6450,166,2.5
19081,2020-10-01,5696,5552,144,2.5
19083,2020-10-01,7614,7412,202,2.7
19085,2020-10-01,7129,6962,167,2.3
19087,2020-10-01,9437,9165,272,2.9
19089,2020-10-01,4975,4847,128,2.6
19091,2020-10-01,4778,4668,110,2.3
19093,2020-10-01,4054,3975,79,1.9
19095,2020-10-01,10172,9938,234,2.3
19097,2020-10-01,10379,10013,366,3.5
19099,2020-10-01,18845,18264,581,3.1
19101,2020-10-01,10138,9778,360,3.6
19103,2020-10-01,84203,81710,2493,3
19105,2020-10-01,10086,9799,287,2.8
19107,2020-10-01,4972,4842,130,2.6
19109,2020-10-01,8011,7852,159,2
19111,2020-10-01,15734,15116,618,3.9
19113,2020-10-01,116821,112141,4680,4
19115,2020-10-01,5897,5739,158,2.7
19117,2020-10-01,4466,4368,98,2.2
19119,2020-10-01,6574,6486,88,1.3
19121,2020-10-01,8087,7835,252,3.1
19123,2020-10-01,11349,11035,314,2.8
19125,2020-10-01,17868,17459,409,2.3
19127,2020-10-01,16679,16014,665,4
19129,2020-10-01,7157,7000,157,2.2
19131,2020-10-01,6878,6749,129,1.9
19133,2020-10-01,4063,3964,99,2.4
19135,2020-10-01,3835,3723,112,2.9
19137,2020-10-01,4691,4550,141,3
19139,2020-10-01,21105,20386,719,3.4
19141,2020-10-01,7887,7733,154,2
19143,2020-10-01,3341,3286,55,1.6
19145,2020-10-01,6025,5867,158,2.6
19147,2020-10-01,4434,4322,112,2.5
19149,2020-10-01,14410,14108,302,2.1
19151,2020-10-01,4636,4551,85,1.8
19153,2020-10-01,257168,247753,9415,3.7
19155,2020-10-01,47349,45952,1397,3
19157,2020-10-01,10065,9806,259,2.6
19159,2020-10-01,2329,2279,50,2.1
19161,2020-10-01,5021,4919,102,2
19163,2020-10-01,84717,81025,3692,4.4
19165,2020-10-01,6292,6170,122,1.9
19167,2020-10-01,20033,19763,270,1.3
19169,2020-10-01,59972,58787,1185,2
19171,2020-10-01,8885,8605,280,3.2
19173,2020-10-01,3024,2957,67,2.2
19175,2020-10-01,6008,5802,206,3.4
19177,2020-10-01,3436,3348,88,2.6
19179,2020-10-01,16914,16231,683,4
19181,2020-10-01,26838,26145,693,2.6
19183,2020-10-01,11573,11312,261,2.3
19185,2020-10-01,2734,2660,74,2.7
19187,2020-10-01,18582,18006,576,3.1
19189,2020-10-01,4880,4723,157,3.2
19191,2020-10-01,10769,10504,265,2.5
19193,2020-10-01,54530,52887,1643,3
19195,2020-10-01,3986,3884,102,2.6
19197,2020-10-01,6672,6501,171,2.6
20001,2020-10-01,6608,6325,283,4.3
20003,2020-10-01,4377,4232,145,3.3
20005,2020-10-01,6972,6597,375,5.4
20007,2020-10-01,2394,2326,68,2.8
20009,2020-10-01,14284,13730,554,3.9
20011,2020-10-01,6847,6520,327,4.8
20013,2020-10-01,5341,5162,179,3.4
20015,2020-10-01,32864,31176,1688,5.1
20017,2020-10-01,1458,1388,70,4.8
20019,2020-10-01,1479,1397,82,5.5
20021,2020-10-01,10304,9907,397,3.9
20023,2020-10-01,1388,1362,26,1.9
20025,2020-10-01,1186,1165,21,1.8
20027,2020-10-01,3981,3831,150,3.8
20029,2020-10-01,3905,3764,141,3.6
20031,2020-10-01,4118,3972,146,3.5
20033,2020-10-01,896,873,23,2.6
20035,2020-10-01,17436,16553,883,5.1
20037,2020-10-01,19453,18576,877,4.5
20039,2020-10-01,1290,1251,39,3
20041,2020-10-01,9265,8924,341,3.7
20043,2020-10-01,4167,4041,126,3
20045,2020-10-01,65834,62644,3190,4.8
20047,2020-10-01,1601,1562,39,2.4
20049,2020-10-01,1205,1161,44,3.7
20051,2020-10-01,17730,17252,478,2.7
20053,2020-10-01,2837,2752,85,3
20055,2020-10-01,21585,20954,631,2.9
20057,2020-10-01,17687,17144,543,3.1
20059,2020-10-01,14648,14012,636,4.3
20061,2020-10-01,12002,11311,691,5.8
20063,2020-10-01,1530,1499,31,2
20065,2020-10-01,1189,1137,52,4.4
20067,2020-10-01,3303,3176,127,3.8
20069,2020-10-01,3499,3432,67,1.9
20071,2020-10-01,912,898,14,1.5
20073,2020-10-01,3254,3119,135,4.1
20075,2020-10-01,1765,1732,33,1.9
20077,2020-10-01,2823,2697,126,4.5
20079,2020-10-01,17092,16381,711,4.2
20081,2020-10-01,2305,2256,49,2.1
20083,2020-10-01,1072,1049,23,2.1
20085,2020-10-01,7188,6932,256,3.6
20087,2020-10-01,10153,9758,395,3.9
20089,2020-10-01,1309,1281,28,2.1
20091,2020-10-01,341390,327223,14167,4.1
20093,2020-10-01,2136,2088,48,2.2
20095,2020-10-01,3516,3364,152,4.3
20097,2020-10-01,1339,1307,32,2.4
20099,2020-10-01,10006,9542,464,4.6
20101,2020-10-01,825,807,18,2.2
20103,2020-10-01,36617,35037,1580,4.3
20105,2020-10-01,1765,1720,45,2.5
20107,2020-10-01,4410,4181,229,5.2
20109,2020-10-01,1720,1686,34,2
20111,2020-10-01,17185,16522,663,3.9
20113,2020-10-01,17727,17211,516,2.9
20115,2020-10-01,6104,5901,203,3.3
20117,2020-10-01,5748,5615,133,2.3
20119,2020-10-01,2239,2188,51,2.3
20121,2020-10-01,17524,16806,718,4.1
20123,2020-10-01,3628,3543,85,2.3
20125,2020-10-01,15147,14276,871,5.8
20127,2020-10-01,3177,3067,110,3.5
20129,2020-10-01,1239,1207,32,2.6
20131,2020-10-01,5845,5699,146,2.5
20133,2020-10-01,6467,6106,361,5.6
20135,2020-10-01,1389,1348,41,3
20137,2020-10-01,2748,2687,61,2.2
20139,2020-10-01,7984,7665,319,4
20141,2020-10-01,2077,2029,48,2.3
20143,2020-10-01,3059,2944,115,3.8
20145,2020-10-01,2996,2901,95,3.2
20147,2020-10-01,2742,2668,74,2.7
20149,2020-10-01,12259,11828,431,3.5
20151,2020-10-01,5127,4963,164,3.2
20153,2020-10-01,1618,1580,38,2.3
20155,2020-10-01,30855,29462,1393,4.5
20157,2020-10-01,2493,2427,66,2.6
20159,2020-10-01,5225,5036,189,3.6
20161,2020-10-01,34617,33249,1368,4
20163,2020-10-01,2603,2505,98,3.8
20165,2020-10-01,1635,1572,63,3.9
20167,2020-10-01,3426,3305,121,3.5
20169,2020-10-01,30173,28838,1335,4.4
20171,2020-10-01,2986,2922,64,2.1
20173,2020-10-01,257895,239764,18131,7
20175,2020-10-01,10110,9712,398,3.9
20177,2020-10-01,91016,86602,4414,4.8
20179,2020-10-01,1571,1542,29,1.8
20181,2020-10-01,3014,2927,87,2.9
20183,2020-10-01,2106,2058,48,2.3
20185,2020-10-01,2180,2102,78,3.6
20187,2020-10-01,1129,1103,26,2.3
20189,2020-10-01,2963,2892,71,2.4
20191,2020-10-01,11230,10521,709,6.3
20193,2020-10-01,4375,4269,106,2.4
20195,2020-10-01,1516,1478,38,2.5
20197,2020-10-01,3695,3567,128,3.5
20199,2020-10-01,883,863,20,2.3
20201,2020-10-01,3202,3139,63,2
20203,2020-10-01,1274,1246,28,2.2
20205,2020-10-01,4028,3791,237,5.9
20207,2020-10-01,1686,1613,73,4.3
20209,2020-10-01,78215,73485,4730,6
21001,2020-10-01,6637,6169,468,7.1
21003,2020-10-01,8382,7919,463,5.5
21005,2020-10-01,11306,10607,699,6.2
21007,2020-10-01,3119,2899,220,7.1
21009,2020-10-01,17014,15584,1430,8.4
21011,2020-10-01,4416,4078,338,7.7
21013,2020-10-01,7769,7137,632,8.1
21015,2020-10-01,67808,63919,3889,5.7
21017,2020-10-01,9706,9188,518,5.3
21019,2020-10-01,17213,15815,1398,8.1
21021,2020-10-01,11126,10212,914,8.2
21023,2020-10-01,3651,3431,220,6
21025,2020-10-01,3074,2752,322,10.5
21027,2020-10-01,7499,6942,557,7.4
21029,2020-10-01,40488,38123,2365,5.8
21031,2020-10-01,4706,4391,315,6.7
21033,2020-10-01,5153,4814,339,6.6
21035,2020-10-01,17643,16514,1129,6.4
21037,2020-10-01,48513,45686,2827,5.8
21039,2020-10-01,2116,2013,103,4.9
21041,2020-10-01,5014,4707,307,6.1
21043,2020-10-01,9106,8312,794,8.7
21045,2020-10-01,6206,5843,363,5.8
21047,2020-10-01,24561,22760,1801,7.3
21049,2020-10-01,16683,15532,1151,6.9
21051,2020-10-01,4884,4385,499,10.2
21053,2020-10-01,3757,3564,193,5.1
21055,2020-10-01,3547,3348,199,5.6
21057,2020-10-01,2975,2835,140,4.7
21059,2020-10-01,44926,42152,2774,6.2
21061,2020-10-01,4413,4102,311,7
21063,2020-10-01,1912,1734,178,9.3
21065,2020-10-01,5026,4654,372,7.4
21067,2020-10-01,169571,158985,10586,6.2
21069,2020-10-01,6179,5800,379,6.1
21071,2020-10-01,10139,9030,1109,10.9
21073,2020-10-01,24008,22225,1783,7.4
21075,2020-10-01,2018,1875,143,7.1
21077,2020-10-01,3961,3700,261,6.6
21079,2020-10-01,7114,6655,459,6.5
21081,2020-10-01,11315,10530,785,6.9
21083,2020-10-01,14583,13617,966,6.6
21085,2020-10-01,10616,9789,827,7.8
21087,2020-10-01,4751,4487,264,5.6
21089,2020-10-01,12900,11803,1097,8.5
21091,2020-10-01,3756,3541,215,5.7
21093,2020-10-01,45788,42705,3083,6.7
21095,2020-10-01,6011,5191,820,13.6
21097,2020-10-01,8381,7913,468,5.6
21099,2020-10-01,7418,6982,436,5.9
21101,2020-10-01,21701,20447,1254,5.8
21103,2020-10-01,7871,7479,392,5
21105,2020-10-01,1705,1616,89,5.2
21107,2020-10-01,15878,14679,1199,7.6
21109,2020-10-01,3749,3397,352,9.4
21111,2020-10-01,384945,356553,28392,7.4
21113,2020-10-01,25588,24022,1566,6.1
21115,2020-10-01,6154,5520,634,10.3
21117,2020-10-01,84108,78930,5178,6.2
21119,2020-10-01,4042,3626,416,10.3
21121,2020-10-01,9557,8733,824,8.6
21123,2020-10-01,5640,5256,384,6.8
21125,2020-10-01,23540,21918,1622,6.9
21127,2020-10-01,5028,4607,421,8.4
21129,2020-10-01,1923,1790,133,6.9
21131,2020-10-01,2426,2151,275,11.3
21133,2020-10-01,5932,5230,702,11.8
21135,2020-10-01,4207,3854,353,8.4
21137,2020-10-01,8317,7571,746,9
21139,2020-10-01,3244,2979,265,8.2
21141,2020-10-01,11686,11091,595,5.1
21143,2020-10-01,2703,2538,165,6.1
21145,2020-10-01,25914,23889,2025,7.8
21147,2020-10-01,4441,4100,341,7.7
21149,2020-10-01,4014,3792,222,5.5
21151,2020-10-01,42517,39828,2689,6.3
21153,2020-10-01,3126,2603,523,16.7
21155,2020-10-01,9142,8585,557,6.1
21157,2020-10-01,13919,13036,883,6.3
21159,2020-10-01,2685,2368,317,11.8
21161,2020-10-01,6539,6028,511,7.8
21163,2020-10-01,11458,10680,778,6.8
21165,2020-10-01,2198,1990,208,9.5
21167,2020-10-01,9217,8555,662,7.2
21169,2020-10-01,3759,3474,285,7.6
21171,2020-10-01,4395,4170,225,5.1
21173,2020-10-01,11045,10199,846,7.7
21175,2020-10-01,4309,4021,288,6.7
21177,2020-10-01,9650,8770,880,9.1
21179,2020-10-01,22291,21043,1248,5.6
21181,2020-10-01,3194,3011,183,5.7
21183,2020-10-01,9416,8766,650,6.9
21185,2020-10-01,31501,30013,1488,4.7
21187,2020-10-01,4941,4603,338,6.8
21189,2020-10-01,1077,994,83,7.7
21191,2020-10-01,6647,6304,343,5.2
21193,2020-10-01,7504,6709,795,10.6
21195,2020-10-01,17585,15819,1766,10
21197,2020-10-01,4776,4384,392,8.2
21199,2020-10-01,24870,23085,1785,7.2
21201,2020-10-01,805,758,47,5.8
21203,2020-10-01,6021,5580,441,7.3
21205,2020-10-01,9490,8790,700,7.4
21207,2020-10-01,5784,5350,434,7.5
21209,2020-10-01,27950,26449,1501,5.4
21211,2020-10-01,24404,23128,1276,5.2
21213,2020-10-01,8426,7895,531,6.3
21215,2020-10-01,9665,9167,498,5.2
21217,2020-10-01,11556,10911,645,5.6
21219,2020-10-01,5181,4950,231,4.5
21221,2020-10-01,5963,5568,395,6.6
21223,2020-10-01,3743,3487,256,6.8
21225,2020-10-01,5555,5241,314,5.7
21227,2020-10-01,59700,55629,4071,6.8
21229,2020-10-01,6065,5758,307,5.1
21231,2020-10-01,6985,6503,482,6.9
21233,2020-10-01,5415,5087,328,6.1
21235,2020-10-01,13198,12136,1062,8
21237,2020-10-01,1887,1740,147,7.8
21239,2020-10-01,14771,14016,755,5.1
22001,2020-10-01,24125,22231,1894,7.9
22003,2020-10-01,8808,8013,795,9
22005,2020-10-01,64654,60158,4496,7
22007,2020-10-01,9310,8307,1003,10.8
22009,2020-10-01,15351,14127,1224,8
22011,2020-10-01,14447,13449,998,6.9
22013,2020-10-01,5526,5047,479,8.7
22015,2020-10-01,57709,53837,3872,6.7
22017,2020-10-01,106522,95535,10987,10.3
22019,2020-10-01,97823,86178,11645,11.9
22021,2020-10-01,3784,3523,261,6.9
22023,2020-10-01,3447,3212,235,6.8
22025,2020-10-01,3518,3240,278,7.9
22027,2020-10-01,5765,5353,412,7.1
22029,2020-10-01,7201,6610,591,8.2
22031,2020-10-01,10817,9974,843,7.8
22033,2020-10-01,236119,216138,19981,8.5
22035,2020-10-01,1886,1649,237,12.6
22037,2020-10-01,8055,7473,582,7.2
22039,2020-10-01,11874,10849,1025,8.6
22041,2020-10-01,7496,6863,633,8.4
22043,2020-10-01,8192,7654,538,6.6
22045,2020-10-01,29304,26149,3155,10.8
22047,2020-10-01,14635,12989,1646,11.2
22049,2020-10-01,6764,6385,379,5.6
22051,2020-10-01,214323,191795,22528,10.5
22053,2020-10-01,12899,11815,1084,8.4
22055,2020-10-01,115217,106561,8656,7.5
22057,2020-10-01,42528,39576,2952,6.9
22059,2020-10-01,6782,6429,353,5.2
22061,2020-10-01,20769,19377,1392,6.7
22063,2020-10-01,69135,64717,4418,6.4
22065,2020-10-01,3548,3238,310,8.7
22067,2020-10-01,10229,9119,1110,10.9
22069,2020-10-01,16004,14805,1199,7.5
22071,2020-10-01,187773,159421,28352,15.1
22073,2020-10-01,74265,68550,5715,7.7
22075,2020-10-01,9752,9072,680,7
22077,2020-10-01,10039,9215,824,8.2
22079,2020-10-01,55713,51938,3775,6.8
22081,2020-10-01,3794,3539,255,6.7
22083,2020-10-01,8320,7660,660,7.9
22085,2020-10-01,9171,8622,549,6
22087,2020-10-01,20190,17749,2441,12.1
22089,2020-10-01,24619,22524,2095,8.5
22091,2020-10-01,4541,3945,596,13.1
22093,2020-10-01,9171,8127,1044,11.4
22095,2020-10-01,20045,17348,2697,13.5
22097,2020-10-01,32645,29415,3230,9.9
22099,2020-10-01,22691,20677,2014,8.9
22101,2020-10-01,20145,18047,2098,10.4
22103,2020-10-01,114969,107222,7747,6.7
22105,2020-10-01,56380,50472,5908,10.5
22107,2020-10-01,1402,1288,114,8.1
22109,2020-10-01,47674,43581,4093,8.6
22111,2020-10-01,9591,8890,701,7.3
22113,2020-10-01,24446,22490,1956,8
22115,2020-10-01,15651,14571,1080,6.9
22117,2020-10-01,17036,15473,1563,9.2
22119,2020-10-01,14542,13293,1249,8.6
22121,2020-10-01,13867,12776,1091,7.9
22123,2020-10-01,3577,3254,323,9
22125,2020-10-01,5396,5074,322,6
22127,2020-10-01,4846,4479,367,7.6
23001,2020-10-01,54671,51903,2768,5.1
23003,2020-10-01,29760,28377,1383,4.6
23005,2020-10-01,161141,153589,7552,4.7
23007,2020-10-01,13777,13099,678,4.9
23009,2020-10-01,27905,26724,1181,4.2
23011,2020-10-01,62893,60186,2707,4.3
23013,2020-10-01,19420,18582,838,4.3
23015,2020-10-01,16288,15565,723,4.4
23017,2020-10-01,25350,23766,1584,6.2
23019,2020-10-01,76453,73006,3447,4.5
23021,2020-10-01,7247,6867,380,5.2
23023,2020-10-01,19515,18728,787,4
23025,2020-10-01,21821,20549,1272,5.8
23027,2020-10-01,20329,19422,907,4.5
23029,2020-10-01,13432,12707,725,5.4
23031,2020-10-01,109529,104099,5430,5
24001,2020-10-01,30021,27842,2179,7.3
24003,2020-10-01,304744,285902,18842,6.2
24005,2020-10-01,441946,409000,32946,7.5
24009,2020-10-01,48008,45380,2628,5.5
24011,2020-10-01,16975,15967,1008,5.9
24013,2020-10-01,91082,86574,4508,4.9
24015,2020-10-01,49806,46741,3065,6.2
24017,2020-10-01,85132,78732,6400,7.5
24019,2020-10-01,14713,13620,1093,7.4
24021,2020-10-01,130758,122607,8151,6.2
24023,2020-10-01,14536,13701,835,5.7
24025,2020-10-01,134982,127249,7733,5.7
24027,2020-10-01,181038,170807,10231,5.7
24029,2020-10-01,9311,8713,598,6.4
24031,2020-10-01,556347,515088,41259,7.4
24033,2020-10-01,511224,458986,52238,10.2
24035,2020-10-01,26423,25028,1395,5.3
24037,2020-10-01,53294,50563,2731,5.1
24039,2020-10-01,8539,7811,728,8.5
24041,2020-10-01,17768,16727,1041,5.9
24043,2020-10-01,70733,65966,4767,6.7
24045,2020-10-01,48834,45224,3610,7.4
24047,2020-10-01,24042,21898,2144,8.9
24510,2020-10-01,284548,256037,28511,10
25001,2020-10-01,104623,97513,7110,6.8
25003,2020-10-01,61159,56945,4214,6.9
25005,2020-10-01,289961,269604,20357,7
25007,2020-10-01,9034,8536,498,5.5
25009,2020-10-01,410312,379042,31270,7.6
25011,2020-10-01,39095,36904,2191,5.6
25013,2020-10-01,215401,197826,17575,8.2
25015,2020-10-01,84193,79249,4944,5.9
25017,2020-10-01,875490,822870,52620,6
25019,2020-10-01,7485,7091,394,5.3
25021,2020-10-01,374208,349290,24918,6.7
25023,2020-10-01,270184,251174,19010,7
25025,2020-10-01,440969,406478,34491,7.8
25027,2020-10-01,430699,401506,29193,6.8
26001,2020-10-01,3920,3701,219,5.6
26003,2020-10-01,3268,3095,173,5.3
26005,2020-10-01,62163,59774,2389,3.8
26007,2020-10-01,13249,12700,549,4.1
26009,2020-10-01,10600,10099,501,4.7
26011,2020-10-01,6041,5720,321,5.3
26013,2020-10-01,3106,2906,200,6.4
26015,2020-10-01,31348,30152,1196,3.8
26017,2020-10-01,47708,45250,2458,5.2
26019,2020-10-01,9144,8786,358,3.9
26021,2020-10-01,72903,69128,3775,5.2
26023,2020-10-01,19196,18295,901,4.7
26025,2020-10-01,60695,57109,3586,5.9
26027,2020-10-01,23929,22731,1198,5
26029,2020-10-01,12916,12373,543,4.2
26031,2020-10-01,10262,9749,513,5
26033,2020-10-01,16376,15646,730,4.5
26035,2020-10-01,11488,10721,767,6.7
26037,2020-10-01,39896,38512,1384,3.5
26039,2020-10-01,5287,4986,301,5.7
26041,2020-10-01,17567,16784,783,4.5
26043,2020-10-01,12616,12101,515,4.1
26045,2020-10-01,55447,53104,2343,4.2
26047,2020-10-01,18245,17480,765,4.2
26049,2020-10-01,180451,168975,11476,6.4
26051,2020-10-01,9740,9217,523,5.4
26053,2020-10-01,6165,5851,314,5.1
26055,2020-10-01,52096,50067,2029,3.9
26057,2020-10-01,18386,17614,772,4.2
26059,2020-10-01,20051,19129,922,4.6
26061,2020-10-01,16967,16328,639,3.8
26063,2020-10-01,15900,15333,567,3.6
26065,2020-10-01,147193,140114,7079,4.8
26067,2020-10-01,29691,28502,1189,4
26069,2020-10-01,10124,9579,545,5.4
26071,2020-10-01,5322,5095,227,4.3
26073,2020-10-01,35721,34248,1473,4.1
26075,2020-10-01,73211,69398,3813,5.2
26077,2020-10-01,134848,128748,6100,4.5
26079,2020-10-01,8228,7794,434,5.3
26081,2020-10-01,358576,342737,15839,4.4
26083,2020-10-01,913,875,38,4.2
26085,2020-10-01,3792,3519,273,7.2
26087,2020-10-01,40355,38114,2241,5.6
26089,2020-10-01,10981,10586,395,3.6
26091,2020-10-01,45822,43686,2136,4.7
26093,2020-10-01,102136,97618,4518,4.4
26095,2020-10-01,2327,2228,99,4.3
26097,2020-10-01,5448,5262,186,3.4
26099,2020-10-01,446844,417544,29300,6.6
26101,2020-10-01,10135,9602,533,5.3
26103,2020-10-01,33388,32132,1256,3.8
26105,2020-10-01,13645,12972,673,4.9
26107,2020-10-01,18563,17650,913,4.9
26109,2020-10-01,11074,10601,473,4.3
26111,2020-10-01,39483,37838,1645,4.2
26113,2020-10-01,7195,6903,292,4.1
26115,2020-10-01,72563,68753,3810,5.3
26117,2020-10-01,28060,26751,1309,4.7
26119,2020-10-01,2986,2790,196,6.6
26121,2020-10-01,75692,70316,5376,7.1
26123,2020-10-01,23035,21974,1061,4.6
26125,2020-10-01,671770,635652,36118,5.4
26127,2020-10-01,11776,11109,667,5.7
26129,2020-10-01,8071,7630,441,5.5
26131,2020-10-01,2031,1917,114,5.6
26133,2020-10-01,11666,11184,482,4.1
26135,2020-10-01,2987,2808,179,6
26137,2020-10-01,11328,10736,592,5.2
26139,2020-10-01,159596,153947,5649,3.5
26141,2020-10-01,4858,4600,258,5.3
26143,2020-10-01,7471,6990,481,6.4
26145,2020-10-01,83936,79016,4920,5.9
26147,2020-10-01,74631,70288,4343,5.8
26149,2020-10-01,28562,27191,1371,4.8
26151,2020-10-01,19419,18578,841,4.3
26153,2020-10-01,3389,3238,151,4.5
26155,2020-10-01,33734,32261,1473,4.4
26157,2020-10-01,23950,22836,1114,4.7
26159,2020-10-01,35301,33688,1613,4.6
26161,2020-10-01,201857,193848,8009,4
26163,2020-10-01,806884,732567,74317,9.2
26165,2020-10-01,15354,14628,726,4.7
27001,2020-10-01,7077,6777,300,4.2
27003,2020-10-01,191189,183329,7860,4.1
27005,2020-10-01,18840,18256,584,3.1
27007,2020-10-01,24343,23466,877,3.6
27009,2020-10-01,21877,21016,861,3.9
27011,2020-10-01,2496,2442,54,2.2
27013,2020-10-01,40667,39432,1235,3
27015,2020-10-01,14571,14178,393,2.7
27017,2020-10-01,16734,16055,679,4.1
27019,2020-10-01,56784,54802,1982,3.5
27021,2020-10-01,14040,13396,644,4.6
27023,2020-10-01,6954,6756,198,2.8
27025,2020-10-01,28876,27752,1124,3.9
27027,2020-10-01,35855,34938,917,2.6
27029,2020-10-01,4245,4075,170,4
27031,2020-10-01,2991,2888,103,3.4
27033,2020-10-01,6308,6048,260,4.1
27035,2020-10-01,31847,30644,1203,3.8
27037,2020-10-01,233826,224483,9343,4
27039,2020-10-01,11766,11261,505,4.3
27041,2020-10-01,21058,20544,514,2.4
27043,2020-10-01,7081,6816,265,3.7
27045,2020-10-01,11476,11156,320,2.8
27047,2020-10-01,16432,15901,531,3.2
27049,2020-10-01,26740,25912,828,3.1
27051,2020-10-01,3405,3314,91,2.7
27053,2020-10-01,688845,657347,31498,4.6
27055,2020-10-01,10060,9833,227,2.3
27057,2020-10-01,9714,9373,341,3.5
27059,2020-10-01,20457,19634,823,4
27061,2020-10-01,21059,19907,1152,5.5
27063,2020-10-01,6006,5753,253,4.2
27065,2020-10-01,8814,8463,351,4
27067,2020-10-01,24473,23757,716,2.9
27069,2020-10-01,2429,2353,76,3.1
27071,2020-10-01,5681,5449,232,4.1
27073,2020-10-01,3701,3602,99,2.7
27075,2020-10-01,5214,5040,174,3.3
27077,2020-10-01,2385,2309,76,3.2
27079,2020-10-01,15520,14993,527,3.4
27081,2020-10-01,3355,3285,70,2.1
27083,2020-10-01,14685,14314,371,2.5
27085,2020-10-01,19052,18383,669,3.5
27087,2020-10-01,2372,2225,147,6.2
27089,2020-10-01,5368,5228,140,2.6
27091,2020-10-01,10303,9889,414,4
27093,2020-10-01,13316,12953,363,2.7
27095,2020-10-01,12386,11801,585,4.7
27097,2020-10-01,17647,17009,638,3.6
27099,2020-10-01,20811,20074,737,3.5
27101,2020-10-01,4811,4672,139,2.9
27103,2020-10-01,21081,20492,589,2.8
27105,2020-10-01,11748,11354,394,3.4
27107,2020-10-01,3357,3242,115,3.4
27109,2020-10-01,86232,83074,3158,3.7
27111,2020-10-01,31080,30224,856,2.8
27113,2020-10-01,8459,8221,238,2.8
27115,2020-10-01,14621,14005,616,4.2
27117,2020-10-01,4872,4774,98,2
27119,2020-10-01,16607,16070,537,3.2
27121,2020-10-01,6606,6440,166,2.5
27123,2020-10-01,282347,268903,13444,4.8
27125,2020-10-01,2196,2130,66,3
27127,2020-10-01,7856,7611,245,3.1
27129,2020-10-01,8666,8416,250,2.9
27131,2020-10-01,37077,35927,1150,3.1
27133,2020-10-01,5786,5680,106,1.8
27135,2020-10-01,7847,7632,215,2.7
27137,2020-10-01,96048,91802,4246,4.4
27139,2020-10-01,80820,77770,3050,3.8
27141,2020-10-01,50295,48510,1785,3.5
27143,2020-10-01,8513,8253,260,3.1
27145,2020-10-01,90504,87313,3191,3.5
27147,2020-10-01,21449,20743,706,3.3
27149,2020-10-01,5484,5378,106,1.9
27151,2020-10-01,4985,4820,165,3.3
27153,2020-10-01,13880,13455,425,3.1
27155,2020-10-01,1865,1828,37,2
27157,2020-10-01,12167,11840,327,2.7
27159,2020-10-01,6078,5819,259,4.3
27161,2020-10-01,9124,8789,335,3.7
27163,2020-10-01,138186,133353,4833,3.5
27165,2020-10-01,6672,6490,182,2.7
27167,2020-10-01,3562,3478,84,2.4
27169,2020-10-01,28846,28032,814,2.8
27171,2020-10-01,72761,70411,2350,3.2
27173,2020-10-01,5458,5324,134,2.5
28001,2020-10-01,11804,10599,1205,10.2
28003,2020-10-01,16373,15541,832,5.1
28005,2020-10-01,4463,4074,389,8.7
28007,2020-10-01,7144,6594,550,7.7
28009,2020-10-01,3102,2877,225,7.3
28011,2020-10-01,11691,10720,971,8.3
28013,2020-10-01,5357,5014,343,6.4
28015,2020-10-01,3377,3133,244,7.2
28017,2020-10-01,7015,6433,582,8.3
28019,2020-10-01,3664,3458,206,5.6
28021,2020-10-01,3099,2676,423,13.6
28023,2020-10-01,5841,5385,456,7.8
28025,2020-10-01,7615,6804,811,10.7
28027,2020-10-01,8493,7515,978,11.5
28029,2020-10-01,11277,10418,859,7.6
28031,2020-10-01,8300,7682,618,7.4
28033,2020-10-01,92597,87869,4728,5.1
28035,2020-10-01,35173,32668,2505,7.1
28037,2020-10-01,2891,2669,222,7.7
28039,2020-10-01,8693,7995,698,8
28041,2020-10-01,4186,3824,362,8.6
28043,2020-10-01,9612,8993,619,6.4
28045,2020-10-01,19404,17996,1408,7.3
28047,2020-10-01,89515,83043,6472,7.2
28049,2020-10-01,110587,101642,8945,8.1
28051,2020-10-01,5727,4925,802,14
28053,2020-10-01,2208,1896,312,14.1
28055,2020-10-01,327,300,27,8.3
28057,2020-10-01,10522,9994,528,5
28059,2020-10-01,60185,55684,4501,7.5
28061,2020-10-01,6071,5537,534,8.8
28063,2020-10-01,1947,1612,335,17.2
28065,2020-10-01,4099,3717,382,9.3
28067,2020-10-01,25814,24017,1797,7
28069,2020-10-01,3432,3122,310,9
28071,2020-10-01,28066,26727,1339,4.8
28073,2020-10-01,32125,30498,1627,5.1
28075,2020-10-01,30086,28024,2062,6.9
28077,2020-10-01,4672,4283,389,8.3
28079,2020-10-01,7925,7386,539,6.8
28081,2020-10-01,42121,39481,2640,6.3
28083,2020-10-01,9959,8923,1036,10.4
28085,2020-10-01,14714,13753,961,6.5
28087,2020-10-01,25196,23275,1921,7.6
28089,2020-10-01,53808,51090,2718,5.1
28091,2020-10-01,9875,9167,708,7.2
28093,2020-10-01,14749,13738,1011,6.9
28095,2020-10-01,15623,14457,1166,7.5
28097,2020-10-01,4023,3727,296,7.4
28099,2020-10-01,9829,9142,687,7
28101,2020-10-01,8642,8088,554,6.4
28103,2020-10-01,3607,3184,423,11.7
28105,2020-10-01,22850,21376,1474,6.5
28107,2020-10-01,12607,11391,1216,9.6
28109,2020-10-01,23846,22183,1663,7
28111,2020-10-01,4457,4125,332,7.4
28113,2020-10-01,14980,13635,1345,9
28115,2020-10-01,14962,14154,808,5.4
28117,2020-10-01,11117,10487,630,5.7
28119,2020-10-01,2184,1928,256,11.7
28121,2020-10-01,76523,73287,3236,4.2
28123,2020-10-01,12780,12085,695,5.4
28125,2020-10-01,1518,1366,152,10
28127,2020-10-01,10860,10157,703,6.5
28129,2020-10-01,6625,6251,374,5.6
28131,2020-10-01,6870,6396,474,6.9
28133,2020-10-01,7637,6766,871,11.4
28135,2020-10-01,4848,4473,375,7.7
28137,2020-10-01,12569,11684,885,7
28139,2020-10-01,9316,8798,518,5.6
28141,2020-10-01,8728,8302,426,4.9
28143,2020-10-01,4753,4129,624,13.1
28145,2020-10-01,14406,13661,745,5.2
28147,2020-10-01,4976,4553,423,8.5
28149,2020-10-01,20539,18960,1579,7.7
28151,2020-10-01,16917,15134,1783,10.5
28153,2020-10-01,7429,6754,675,9.1
28155,2020-10-01,3956,3695,261,6.6
28157,2020-10-01,2852,2405,447,15.7
28159,2020-10-01,7375,6775,600,8.1
28161,2020-10-01,4835,4507,328,6.8
28163,2020-10-01,9566,8715,851,8.9
29001,2020-10-01,10085,9780,305,3
29003,2020-10-01,9494,9268,226,2.4
29005,2020-10-01,2744,2688,56,2
29007,2020-10-01,10432,10122,310,3
29009,2020-10-01,15640,15038,602,3.8
29011,2020-10-01,5220,5072,148,2.8
29013,2020-10-01,7627,7379,248,3.3
29015,2020-10-01,7180,6872,308,4.3
29017,2020-10-01,5105,4923,182,3.6
29019,2020-10-01,95574,93107,2467,2.6
29021,2020-10-01,43281,41874,1407,3.3
29023,2020-10-01,17801,17129,672,3.8
29025,2020-10-01,4252,4127,125,2.9
29027,2020-10-01,20658,20112,546,2.6
29029,2020-10-01,18232,17590,642,3.5
29031,2020-10-01,37419,36217,1202,3.2
29033,2020-10-01,4890,4520,370,7.6
29035,2020-10-01,2539,2447,92,3.6
29037,2020-10-01,52516,50744,1772,3.4
29039,2020-10-01,5796,5643,153,2.6
29041,2020-10-01,3748,3659,89,2.4
29043,2020-10-01,43600,42393,1207,2.8
29045,2020-10-01,3202,3086,116,3.6
29047,2020-10-01,130683,125934,4749,3.6
29049,2020-10-01,10341,9987,354,3.4
29051,2020-10-01,37698,36734,964,2.6
29053,2020-10-01,7250,7039,211,2.9
29055,2020-10-01,10743,10336,407,3.8
29057,2020-10-01,3583,3494,89,2.5
29059,2020-10-01,6862,6638,224,3.3
29061,2020-10-01,4226,4114,112,2.7
29063,2020-10-01,4734,4614,120,2.5
29065,2020-10-01,6301,6097,204,3.2
29067,2020-10-01,5000,4811,189,3.8
29069,2020-10-01,11380,10860,520,4.6
29071,2020-10-01,50574,48743,1831,3.6
29073,2020-10-01,7601,7373,228,3
29075,2020-10-01,3529,3456,73,2.1
29077,2020-10-01,146979,142459,4520,3.1
29079,2020-10-01,4442,4294,148,3.3
29081,2020-10-01,3893,3793,100,2.6
29083,2020-10-01,9572,9236,336,3.5
29085,2020-10-01,3881,3763,118,3
29087,2020-10-01,2590,2542,48,1.9
29089,2020-10-01,4783,4664,119,2.5
29091,2020-10-01,16394,15677,717,4.4
29093,2020-10-01,3489,3334,155,4.4
29095,2020-10-01,349380,332145,17235,4.9
29097,2020-10-01,56320,54374,1946,3.5
29099,2020-10-01,112180,108049,4131,3.7
29101,2020-10-01,23305,22448,857,3.7
29103,2020-10-01,1804,1763,41,2.3
29105,2020-10-01,16700,16040,660,4
29107,2020-10-01,16217,15684,533,3.3
29109,2020-10-01,17991,17342,649,3.6
29111,2020-10-01,4958,4832,126,2.5
29113,2020-10-01,27004,26067,937,3.5
29115,2020-10-01,5057,4875,182,3.6
29117,2020-10-01,7408,7234,174,2.3
29119,2020-10-01,10702,10339,363,3.4
29121,2020-10-01,7482,7286,196,2.6
29123,2020-10-01,5505,5294,211,3.8
29125,2020-10-01,3871,3749,122,3.2
29127,2020-10-01,14341,13946,395,2.8
29129,2020-10-01,1973,1936,37,1.9
29131,2020-10-01,12098,11725,373,3.1
29133,2020-10-01,5791,5574,217,3.7
29135,2020-10-01,7160,6979,181,2.5
29137,2020-10-01,3735,3621,114,3.1
29139,2020-10-01,5682,5533,149,2.6
29141,2020-10-01,7975,7691,284,3.6
29143,2020-10-01,8395,8080,315,3.8
29145,2020-10-01,26935,26046,889,3.3
29147,2020-10-01,11224,10948,276,2.5
29149,2020-10-01,4057,3878,179,4.4
29151,2020-10-01,6938,6803,135,1.9
29153,2020-10-01,3430,3285,145,4.2
29155,2020-10-01,6394,6034,360,5.6
29157,2020-10-01,9682,9465,217,2.2
29159,2020-10-01,20854,20098,756,3.6
29161,2020-10-01,19449,18849,600,3.1
29163,2020-10-01,7403,7181,222,3
29165,2020-10-01,56165,54339,1826,3.3
29167,2020-10-01,14254,13840,414,2.9
29169,2020-10-01,14402,13891,511,3.5
29171,2020-10-01,2275,2227,48,2.1
29173,2020-10-01,5588,5456,132,2.4
29175,2020-10-01,10209,9834,375,3.7
29177,2020-10-01,10532,10145,387,3.7
29179,2020-10-01,2951,2853,98,3.3
29181,2020-10-01,4963,4725,238,4.8
29183,2020-10-01,215170,208629,6541,3
29185,2020-10-01,3761,3621,140,3.7
29186,2020-10-01,8968,8702,266,3
29187,2020-10-01,26077,24965,1112,4.3
29189,2020-10-01,508937,487415,21522,4.2
29195,2020-10-01,10838,10563,275,2.5
29197,2020-10-01,1937,1883,54,2.8
29199,2020-10-01,2409,2369,40,1.7
29201,2020-10-01,19380,18680,700,3.6
29203,2020-10-01,3272,3135,137,4.2
29205,2020-10-01,3140,3064,76,2.4
29207,2020-10-01,13103,12659,444,3.4
29209,2020-10-01,13484,12894,590,4.4
29211,2020-10-01,2752,2663,89,3.2
29213,2020-10-01,26381,25045,1336,5.1
29215,2020-10-01,8868,8538,330,3.7
29217,2020-10-01,9504,9225,279,2.9
29219,2020-10-01,17114,16539,575,3.4
29221,2020-10-01,10032,9594,438,4.4
29223,2020-10-01,5003,4814,189,3.8
29225,2020-10-01,16818,16331,487,2.9
29227,2020-10-01,1201,1169,32,2.7
29229,2020-10-01,7431,7143,288,3.9
29510,2020-10-01,147572,138640,8932,6.1
30001,2020-10-01,5148,4999,149,2.9
30003,2020-10-01,4780,4517,263,5.5
30005,2020-10-01,2331,2244,87,3.7
30007,2020-10-01,2558,2433,125,4.9
30009,2020-10-01,5546,5298,248,4.5
30011,2020-10-01,709,691,18,2.5
30013,2020-10-01,37389,35741,1648,4.4
30015,2020-10-01,2567,2488,79,3.1
30017,2020-10-01,6138,5923,215,3.5
30019,2020-10-01,906,886,20,2.2
30021,2020-10-01,4629,4403,226,4.9
30023,2020-10-01,4897,4721,176,3.6
30025,2020-10-01,1708,1652,56,3.3
30027,2020-10-01,5760,5595,165,2.9
30029,2020-10-01,47731,45341,2390,5
30031,2020-10-01,69925,67458,2467,3.5
30033,2020-10-01,761,747,14,1.8
30035,2020-10-01,5699,5247,452,7.9
30037,2020-10-01,373,360,13,3.5
30039,2020-10-01,1564,1494,70,4.5
30041,2020-10-01,7483,7174,309,4.1
30043,2020-10-01,5635,5416,219,3.9
30045,2020-10-01,1082,1042,40,3.7
30047,2020-10-01,13355,12745,610,4.6
30049,2020-10-01,35216,33976,1240,3.5
30051,2020-10-01,1018,993,25,2.5
30053,2020-10-01,8070,7559,511,6.3
30055,2020-10-01,971,946,25,2.6
30057,2020-10-01,4180,4012,168,4
30059,2020-10-01,970,933,37,3.8
30061,2020-10-01,1706,1598,108,6.3
30063,2020-10-01,64940,62230,2710,4.2
30065,2020-10-01,2333,2225,108,4.6
30067,2020-10-01,9124,8714,410,4.5
30069,2020-10-01,294,285,9,3.1
30071,2020-10-01,1933,1870,63,3.3
30073,2020-10-01,2692,2581,111,4.1
30075,2020-10-01,1014,986,28,2.8
30077,2020-10-01,2884,2795,89,3.1
30079,2020-10-01,474,446,28,5.9
30081,2020-10-01,20515,19671,844,4.1
30083,2020-10-01,5895,5578,317,5.4
30085,2020-10-01,4435,4224,211,4.8
30087,2020-10-01,3748,3572,176,4.7
30089,2020-10-01,5039,4778,261,5.2
30091,2020-10-01,1819,1741,78,4.3
30093,2020-10-01,16808,16008,800,4.8
30095,2020-10-01,5374,5168,206,3.8
30097,2020-10-01,1861,1811,50,2.7
30099,2020-10-01,2767,2681,86,3.1
30101,2020-10-01,2108,2017,91,4.3
30103,2020-10-01,345,332,13,3.8
30105,2020-10-01,4033,3897,136,3.4
30107,2020-10-01,816,776,40,4.9
30109,2020-10-01,469,450,19,4.1
30111,2020-10-01,81585,78289,3296,4
31001,2020-10-01,16074,15690,384,2.4
31003,2020-10-01,3802,3732,70,1.8
31005,2020-10-01,223,215,8,3.6
31007,2020-10-01,369,362,7,1.9
31009,2020-10-01,246,239,7,2.8
31011,2020-10-01,2865,2811,54,1.9
31013,2020-10-01,5244,5048,196,3.7
31015,2020-10-01,1036,1016,20,1.9
31017,2020-10-01,1340,1310,30,2.2
31019,2020-10-01,27134,26598,536,2
31021,2020-10-01,3430,3346,84,2.4
31023,2020-10-01,4438,4332,106,2.4
31025,2020-10-01,13440,13096,344,2.6
31027,2020-10-01,4393,4304,89,2
31029,2020-10-01,2214,2183,31,1.4
31031,2020-10-01,3241,3189,52,1.6
31033,2020-10-01,4137,3997,140,3.4
31035,2020-10-01,3132,3077,55,1.8
31037,2020-10-01,5447,5347,100,1.8
31039,2020-10-01,4728,4644,84,1.8
31041,2020-10-01,6080,5979,101,1.7
31043,2020-10-01,10778,10452,326,3
31045,2020-10-01,4875,4785,90,1.8
31047,2020-10-01,12885,12596,289,2.2
31049,2020-10-01,930,905,25,2.7
31051,2020-10-01,3001,2941,60,2
31053,2020-10-01,19963,19509,454,2.3
31055,2020-10-01,299971,290120,9851,3.3
31057,2020-10-01,1155,1136,19,1.6
31059,2020-10-01,3044,2990,54,1.8
31061,2020-10-01,1422,1384,38,2.7
31063,2020-10-01,1508,1480,28,1.9
31065,2020-10-01,2580,2531,49,1.9
31067,2020-10-01,10579,10319,260,2.5
31069,2020-10-01,1035,1013,22,2.1
31071,2020-10-01,1104,1087,17,1.5
31073,2020-10-01,1081,1063,18,1.7
31075,2020-10-01,408,402,6,1.5
31077,2020-10-01,1200,1175,25,2.1
31079,2020-10-01,31445,30257,1188,3.8
31081,2020-10-01,4632,4527,105,2.3
31083,2020-10-01,1683,1651,32,1.9
31085,2020-10-01,616,608,8,1.3
31087,2020-10-01,1274,1239,35,2.7
31089,2020-10-01,5583,5490,93,1.7
31091,2020-10-01,374,367,7,1.9
31093,2020-10-01,3273,3185,88,2.7
31095,2020-10-01,4085,4019,66,1.6
31097,2020-10-01,2018,1967,51,2.5
31099,2020-10-01,3633,3557,76,2.1
31101,2020-10-01,4365,4267,98,2.2
31103,2020-10-01,580,574,6,1
31105,2020-10-01,1906,1861,45,2.4
31107,2020-10-01,4509,4418,91,2
31109,2020-10-01,181737,176922,4815,2.6
31111,2020-10-01,17874,17460,414,2.3
31113,2020-10-01,459,453,6,1.3
31115,2020-10-01,390,383,7,1.8
31117,2020-10-01,434,428,6,1.4
31119,2020-10-01,19083,18489,594,3.1
31121,2020-10-01,3906,3808,98,2.5
31123,2020-10-01,2542,2482,60,2.4
31125,2020-10-01,1903,1865,38,2
31127,2020-10-01,3506,3437,69,2
31129,2020-10-01,2386,2345,41,1.7
31131,2020-10-01,8292,8100,192,2.3
31133,2020-10-01,1440,1411,29,2
31135,2020-10-01,1792,1769,23,1.3
31137,2020-10-01,4751,4667,84,1.8
31139,2020-10-01,4019,3896,123,3.1
31141,2020-10-01,17283,16892,391,2.3
31143,2020-10-01,2805,2754,51,1.8
31145,2020-10-01,5699,5547,152,2.7
31147,2020-10-01,4088,4001,87,2.1
31149,2020-10-01,849,837,12,1.4
31151,2020-10-01,7165,7014,151,2.1
31153,2020-10-01,96343,93972,2371,2.5
31155,2020-10-01,11058,10789,269,2.4
31157,2020-10-01,17819,17314,505,2.8
31159,2020-10-01,9061,8816,245,2.7
31161,2020-10-01,2585,2532,53,2.1
31163,2020-10-01,1610,1579,31,1.9
31165,2020-10-01,727,717,10,1.4
31167,2020-10-01,3433,3334,99,2.9
31169,2020-10-01,2689,2643,46,1.7
31171,2020-10-01,407,396,11,2.7
31173,2020-10-01,2838,2748,90,3.2
31175,2020-10-01,2048,2009,39,1.9
31177,2020-10-01,11208,10950,258,2.3
31179,2020-10-01,5532,5434,98,1.8
31181,2020-10-01,1568,1534,34,2.2
31183,2020-10-01,551,544,7,1.3
31185,2020-10-01,7072,6923,149,2.1
32001,2020-10-01,11254,10746,508,4.5
32003,2020-10-01,NA,982666,156207,13.7
32005,2020-10-01,23603,22053,1550,6.6
32007,2020-10-01,26769,25639,1130,4.2
32009,2020-10-01,461,437,24,5.2
32011,2020-10-01,1094,1064,30,2.7
32013,2020-10-01,8257,7906,351,4.3
32015,2020-10-01,3229,3085,144,4.5
32017,2020-10-01,2117,2018,99,4.7
32019,2020-10-01,23330,21687,1643,7
32021,2020-10-01,2008,1904,104,5.2
32023,2020-10-01,18027,16417,1610,8.9
32027,2020-10-01,2534,2438,96,3.8
32029,2020-10-01,2022,1884,138,6.8
32031,2020-10-01,253397,237417,15980,6.3
32033,2020-10-01,4612,4447,165,3.6
32510,2020-10-01,26316,24575,1741,6.6
33001,2020-10-01,29763,28664,1099,3.7
33003,2020-10-01,21792,20883,909,4.2
33005,2020-10-01,39217,37815,1402,3.6
33007,2020-10-01,13530,12964,566,4.2
33009,2020-10-01,46951,45530,1421,3
33011,2020-10-01,229478,220262,9216,4
33013,2020-10-01,79535,76969,2566,3.2
33015,2020-10-01,174493,167550,6943,4
33017,2020-10-01,67019,64621,2398,3.6
33019,2020-10-01,22651,21915,736,3.2
34001,2020-10-01,115350,101538,13812,12
34003,2020-10-01,470791,436818,33973,7.2
34005,2020-10-01,227587,212819,14768,6.5
34007,2020-10-01,251569,231223,20346,8.1
34009,2020-10-01,42304,38582,3722,8.8
34011,2020-10-01,65290,59990,5300,8.1
34013,2020-10-01,362368,326261,36107,10
34015,2020-10-01,147821,137408,10413,7
34017,2020-10-01,354349,325574,28775,8.1
34019,2020-10-01,61919,58506,3413,5.5
34021,2020-10-01,201551,188921,12630,6.3
34023,2020-10-01,429353,399051,30302,7.1
34025,2020-10-01,321102,299877,21225,6.6
34027,2020-10-01,246352,231165,15187,6.2
34029,2020-10-01,268287,249484,18803,7
34031,2020-10-01,240613,216049,24564,10.2
34033,2020-10-01,28830,26640,2190,7.6
34035,2020-10-01,164376,153925,10451,6.4
34037,2020-10-01,71311,66460,4851,6.8
34039,2020-10-01,267943,246142,21801,8.1
34041,2020-10-01,55656,52247,3409,6.1
35001,2020-10-01,330699,306186,24513,7.4
35003,2020-10-01,1020,944,76,7.5
35005,2020-10-01,26521,24270,2251,8.5
35006,2020-10-01,8798,7969,829,9.4
35007,2020-10-01,5070,4733,337,6.6
35009,2020-10-01,20719,19551,1168,5.6
35011,2020-10-01,679,644,35,5.2
35013,2020-10-01,91917,85100,6817,7.4
35015,2020-10-01,34726,32180,2546,7.3
35017,2020-10-01,11949,10774,1175,9.8
35019,2020-10-01,1496,1386,110,7.4
35021,2020-10-01,269,255,14,5.2
35023,2020-10-01,1992,1882,110,5.5
35025,2020-10-01,32501,28779,3722,11.5
35027,2020-10-01,8399,7689,710,8.5
35028,2020-10-01,8895,8576,319,3.6
35029,2020-10-01,9845,8505,1340,13.6
35031,2020-10-01,23673,21175,2498,10.6
35033,2020-10-01,1919,1780,139,7.2
35035,2020-10-01,24068,22091,1977,8.2
35037,2020-10-01,3000,2766,234,7.8
35039,2020-10-01,15754,14536,1218,7.7
35041,2020-10-01,7588,7123,465,6.1
35043,2020-10-01,65778,60620,5158,7.8
35045,2020-10-01,49988,45354,4634,9.3
35047,2020-10-01,10440,9644,796,7.6
35049,2020-10-01,69556,64230,5326,7.7
35051,2020-10-01,3701,3357,344,9.3
35053,2020-10-01,5988,5598,390,6.5
35055,2020-10-01,15076,13525,1551,10.3
35057,2020-10-01,5704,5223,481,8.4
35059,2020-10-01,1593,1509,84,5.3
35061,2020-10-01,30059,27715,2344,7.8
36001,2020-10-01,152072,143279,8793,5.8
36003,2020-10-01,18668,17635,1033,5.5
36005,2020-10-01,581052,481075,99977,17.2
36007,2020-10-01,81555,76512,5043,6.2
36009,2020-10-01,32334,30388,1946,6
36011,2020-10-01,34559,32704,1855,5.4
36013,2020-10-01,50970,47461,3509,6.9
36015,2020-10-01,35039,32810,2229,6.4
36017,2020-10-01,21292,20240,1052,4.9
36019,2020-10-01,35755,33879,1876,5.2
36021,2020-10-01,29978,28610,1368,4.6
36023,2020-10-01,22256,21075,1181,5.3
36025,2020-10-01,18423,17481,942,5.1
36027,2020-10-01,138235,130241,7994,5.8
36029,2020-10-01,434041,404848,29193,6.7
36031,2020-10-01,15749,14938,811,5.1
36033,2020-10-01,19076,18076,1000,5.2
36035,2020-10-01,21204,19796,1408,6.6
36037,2020-10-01,28178,26776,1402,5
36039,2020-10-01,19845,18634,1211,6.1
36041,2020-10-01,2115,2023,92,4.3
36043,2020-10-01,26892,25155,1737,6.5
36045,2020-10-01,41013,38666,2347,5.7
36047,2020-10-01,NA,978239,147286,13.1
36049,2020-10-01,11008,10461,547,5
36051,2020-10-01,28793,27426,1367,4.7
36053,2020-10-01,30488,28908,1580,5.2
36055,2020-10-01,347153,323700,23453,6.8
36057,2020-10-01,20860,19452,1408,6.7
36059,2020-10-01,683705,639269,44436,6.5
36061,2020-10-01,833239,748749,84490,10.1
36063,2020-10-01,96336,89893,6443,6.7
36065,2020-10-01,97626,91834,5792,5.9
36067,2020-10-01,209432,196125,13307,6.4
36069,2020-10-01,52326,49688,2638,5
36071,2020-10-01,175644,164622,11022,6.3
36073,2020-10-01,16540,15572,968,5.9
36075,2020-10-01,49426,46340,3086,6.2
36077,2020-10-01,26150,24729,1421,5.4
36079,2020-10-01,49025,46313,2712,5.5
36081,2020-10-01,NA,935941,137944,12.8
36083,2020-10-01,77808,73685,4123,5.3
36085,2020-10-01,203319,181683,21636,10.6
36087,2020-10-01,148101,138708,9393,6.3
36089,2020-10-01,42678,40449,2229,5.2
36091,2020-10-01,113984,108493,5491,4.8
36093,2020-10-01,73859,69047,4812,6.5
36095,2020-10-01,13847,13132,715,5.2
36097,2020-10-01,7915,7478,437,5.5
36099,2020-10-01,15333,14502,831,5.4
36101,2020-10-01,41074,38710,2364,5.8
36103,2020-10-01,746469,700328,46141,6.2
36105,2020-10-01,35742,33413,2329,6.5
36107,2020-10-01,22077,20910,1167,5.3
36109,2020-10-01,49486,47274,2212,4.5
36111,2020-10-01,86760,81838,4922,5.7
36113,2020-10-01,29666,27997,1669,5.6
36115,2020-10-01,26281,24942,1339,5.1
36117,2020-10-01,41394,39200,2194,5.3
36119,2020-10-01,463776,432089,31687,6.8
36121,2020-10-01,17119,16293,826,4.8
36123,2020-10-01,11070,10587,483,4.4
37001,2020-10-01,81141,76377,4764,5.9
37003,2020-10-01,17198,16283,915,5.3
37005,2020-10-01,4631,4382,249,5.4
37007,2020-10-01,10785,10008,777,7.2
37009,2020-10-01,13474,12851,623,4.6
37011,2020-10-01,8023,7657,366,4.6
37013,2020-10-01,19291,18222,1069,5.5
37015,2020-10-01,7942,7491,451,5.7
37017,2020-10-01,15286,14367,919,6
37019,2020-10-01,50771,47293,3478,6.9
37021,2020-10-01,134544,126415,8129,6
37023,2020-10-01,39081,36868,2213,5.7
37025,2020-10-01,107104,100989,6115,5.7
37027,2020-10-01,35021,32753,2268,6.5
37029,2020-10-01,4636,4429,207,4.5
37031,2020-10-01,31488,30003,1485,4.7
37033,2020-10-01,9767,9149,618,6.3
37035,2020-10-01,75345,70776,4569,6.1
37037,2020-10-01,34890,33311,1579,4.5
37039,2020-10-01,11449,10771,678,5.9
37041,2020-10-01,5673,5388,285,5
37043,2020-10-01,4290,4039,251,5.9
37045,2020-10-01,50236,46905,3331,6.6
37047,2020-10-01,23367,21703,1664,7.1
37049,2020-10-01,40644,38327,2317,5.7
37051,2020-10-01,123601,113396,10205,8.3
37053,2020-10-01,13819,13200,619,4.5
37055,2020-10-01,17965,16901,1064,5.9
37057,2020-10-01,79080,74578,4502,5.7
37059,2020-10-01,20165,19113,1052,5.2
37061,2020-10-01,25720,24515,1205,4.7
37063,2020-10-01,167794,158373,9421,5.6
37065,2020-10-01,21158,19097,2061,9.7
37067,2020-10-01,184259,172735,11524,6.3
37069,2020-10-01,30639,28840,1799,5.9
37071,2020-10-01,109756,102451,7305,6.7
37073,2020-10-01,5257,5004,253,4.8
37075,2020-10-01,3438,3201,237,6.9
37077,2020-10-01,29787,28336,1451,4.9
37079,2020-10-01,9714,9215,499,5.1
37081,2020-10-01,256121,237830,18291,7.1
37083,2020-10-01,20378,18658,1720,8.4
37085,2020-10-01,53339,50000,3339,6.3
37087,2020-10-01,28450,26841,1609,5.7
37089,2020-10-01,52265,49538,2727,5.2
37091,2020-10-01,9408,8846,562,6
37093,2020-10-01,19453,17972,1481,7.6
37095,2020-10-01,1861,1744,117,6.3
37097,2020-10-01,87933,82906,5027,5.7
37099,2020-10-01,20785,19749,1036,5
37101,2020-10-01,96929,91869,5060,5.2
37103,2020-10-01,4321,4109,212,4.9
37105,2020-10-01,25962,24277,1685,6.5
37107,2020-10-01,28830,27242,1588,5.5
37109,2020-10-01,42645,40393,2252,5.3
37111,2020-10-01,20644,19473,1171,5.7
37113,2020-10-01,15913,15097,816,5.1
37115,2020-10-01,9613,9103,510,5.3
37117,2020-10-01,8941,8377,564,6.3
37119,2020-10-01,615443,575107,40336,6.6
37121,2020-10-01,6067,5680,387,6.4
37123,2020-10-01,11086,10444,642,5.8
37125,2020-10-01,42662,40384,2278,5.3
37127,2020-10-01,42343,39232,3111,7.3
37129,2020-10-01,119570,112996,6574,5.5
37131,2020-10-01,7677,7163,514,6.7
37133,2020-10-01,65448,61633,3815,5.8
37135,2020-10-01,76538,73257,3281,4.3
37137,2020-10-01,5191,4936,255,4.9
37139,2020-10-01,16764,15773,991,5.9
37141,2020-10-01,27812,26361,1451,5.2
37143,2020-10-01,4978,4713,265,5.3
37145,2020-10-01,18045,16972,1073,5.9
37147,2020-10-01,86493,81382,5111,5.9
37149,2020-10-01,9004,8547,457,5.1
37151,2020-10-01,64110,60409,3701,5.8
37153,2020-10-01,17250,15854,1396,8.1
37155,2020-10-01,50739,46596,4143,8.2
37157,2020-10-01,38976,36360,2616,6.7
37159,2020-10-01,65231,61170,4061,6.2
37161,2020-10-01,25601,23735,1866,7.3
37163,2020-10-01,30192,28750,1442,4.8
37165,2020-10-01,12246,10975,1271,10.4
37167,2020-10-01,30643,29114,1529,5
37169,2020-10-01,21189,20076,1113,5.3
37171,2020-10-01,33997,32273,1724,5.1
37173,2020-10-01,7699,7322,377,4.9
37175,2020-10-01,14608,13923,685,4.7
37177,2020-10-01,1359,1269,90,6.6
37179,2020-10-01,120892,115133,5759,4.8
37181,2020-10-01,17947,16348,1599,8.9
37183,2020-10-01,582186,551842,30344,5.2
37185,2020-10-01,6749,6183,566,8.4
37187,2020-10-01,4347,4013,334,7.7
37189,2020-10-01,30959,29726,1233,4
37191,2020-10-01,49564,46697,2867,5.8
37193,2020-10-01,29720,28170,1550,5.2
37195,2020-10-01,34729,32086,2643,7.6
37197,2020-10-01,17349,16453,896,5.2
37199,2020-10-01,8327,7895,432,5.2
38001,2020-10-01,1003,972,31,3.1
38003,2020-10-01,5101,4980,121,2.4
38005,2020-10-01,2234,2114,120,5.4
38007,2020-10-01,403,387,16,4
38009,2020-10-01,3006,2889,117,3.9
38011,2020-10-01,1607,1563,44,2.7
38013,2020-10-01,994,946,48,4.8
38015,2020-10-01,49667,48173,1494,3
38017,2020-10-01,106140,102959,3181,3
38019,2020-10-01,2006,1960,46,2.3
38021,2020-10-01,2278,2227,51,2.2
38023,2020-10-01,1392,1346,46,3.3
38025,2020-10-01,2892,2753,139,4.8
38027,2020-10-01,1191,1154,37,3.1
38029,2020-10-01,1499,1449,50,3.3
38031,2020-10-01,1549,1509,40,2.6
38033,2020-10-01,855,832,23,2.7
38035,2020-10-01,38182,37067,1115,2.9
38037,2020-10-01,1253,1232,21,1.7
38039,2020-10-01,1020,999,21,2.1
38041,2020-10-01,1419,1369,50,3.5
38043,2020-10-01,1265,1225,40,3.2
38045,2020-10-01,2051,2012,39,1.9
38047,2020-10-01,868,852,16,1.8
38049,2020-10-01,3087,2969,118,3.8
38051,2020-10-01,1105,1077,28,2.5
38053,2020-10-01,8007,7329,678,8.5
38055,2020-10-01,4696,4552,144,3.1
38057,2020-10-01,3520,3371,149,4.2
38059,2020-10-01,16371,15781,590,3.6
38061,2020-10-01,6633,6278,355,5.4
38063,2020-10-01,1400,1351,49,3.5
38065,2020-10-01,884,849,35,4
38067,2020-10-01,3340,3242,98,2.9
38069,2020-10-01,1668,1624,44,2.6
38071,2020-10-01,5563,5407,156,2.8
38073,2020-10-01,2822,2765,57,2
38075,2020-10-01,1232,1186,46,3.7
38077,2020-10-01,8501,8325,176,2.1
38079,2020-10-01,4716,4209,507,10.8
38081,2020-10-01,2728,2657,71,2.6
38083,2020-10-01,711,685,26,3.7
38085,2020-10-01,1253,1209,44,3.5
38087,2020-10-01,408,398,10,2.5
38089,2020-10-01,16554,15347,1207,7.3
38091,2020-10-01,948,926,22,2.3
38093,2020-10-01,10409,10151,258,2.5
38095,2020-10-01,1177,1154,23,2
38097,2020-10-01,4430,4341,89,2
38099,2020-10-01,5096,4949,147,2.9
38101,2020-10-01,30979,29453,1526,4.9
38103,2020-10-01,1921,1867,54,2.8
38105,2020-10-01,19880,17588,2292,11.5
39001,2020-10-01,11224,10550,674,6
39003,2020-10-01,48111,45204,2907,6
39005,2020-10-01,27634,26450,1184,4.3
39007,2020-10-01,44044,41438,2606,5.9
39009,2020-10-01,29950,28455,1495,5
39011,2020-10-01,24129,23120,1009,4.2
39013,2020-10-01,28378,26488,1890,6.7
39015,2020-10-01,20144,18999,1145,5.7
39017,2020-10-01,201045,190300,10745,5.3
39019,2020-10-01,13091,12269,822,6.3
39021,2020-10-01,20594,19664,930,4.5
39023,2020-10-01,65373,61719,3654,5.6
39025,2020-10-01,109606,104422,5184,4.7
39027,2020-10-01,18440,17378,1062,5.8
39029,2020-10-01,47837,44842,2995,6.3
39031,2020-10-01,14487,13628,859,5.9
39033,2020-10-01,18864,17788,1076,5.7
39035,2020-10-01,605003,560405,44598,7.4
39037,2020-10-01,25944,24893,1051,4.1
39039,2020-10-01,17728,16888,840,4.7
39041,2020-10-01,111060,106702,4358,3.9
39043,2020-10-01,35873,33396,2477,6.9
39045,2020-10-01,78753,75010,3743,4.8
39047,2020-10-01,14256,13515,741,5.2
39049,2020-10-01,713674,670557,43117,6
39051,2020-10-01,22561,21574,987,4.4
39053,2020-10-01,12973,12308,665,5.1
39055,2020-10-01,47718,45743,1975,4.1
39057,2020-10-01,84876,80991,3885,4.6
39059,2020-10-01,18833,17704,1129,6
39061,2020-10-01,432202,406066,26136,6
39063,2020-10-01,42463,40665,1798,4.2
39065,2020-10-01,14284,13575,709,5
39067,2020-10-01,6928,6457,471,6.8
39069,2020-10-01,13461,12838,623,4.6
39071,2020-10-01,18125,17117,1008,5.6
39073,2020-10-01,13094,12467,627,4.8
39075,2020-10-01,21723,21175,548,2.5
39077,2020-10-01,27634,26141,1493,5.4
39079,2020-10-01,13375,12589,786,5.9
39081,2020-10-01,28014,25930,2084,7.4
39083,2020-10-01,32049,30737,1312,4.1
39085,2020-10-01,122655,116212,6443,5.3
39087,2020-10-01,24450,23137,1313,5.4
39089,2020-10-01,91357,87164,4193,4.6
39091,2020-10-01,22446,21438,1008,4.5
39093,2020-10-01,149752,140591,9161,6.1
39095,2020-10-01,214511,199531,14980,7
39097,2020-10-01,21025,20146,879,4.2
39099,2020-10-01,99902,92498,7404,7.4
39101,2020-10-01,28749,27186,1563,5.4
39103,2020-10-01,94417,90160,4257,4.5
39105,2020-10-01,9513,8882,631,6.6
39107,2020-10-01,23720,22933,787,3.3
39109,2020-10-01,55262,52639,2623,4.7
39111,2020-10-01,6091,5677,414,6.8
39113,2020-10-01,260944,244125,16819,6.4
39115,2020-10-01,6789,6369,420,6.2
39117,2020-10-01,16952,16149,803,4.7
39119,2020-10-01,41154,38997,2157,5.2
39121,2020-10-01,4818,4487,331,6.9
39123,2020-10-01,21184,20020,1164,5.5
39125,2020-10-01,8860,8481,379,4.3
39127,2020-10-01,16060,15074,986,6.1
39129,2020-10-01,26695,25426,1269,4.8
39131,2020-10-01,10882,10197,685,6.3
39133,2020-10-01,85937,81485,4452,5.2
39135,2020-10-01,21718,20763,955,4.4
39137,2020-10-01,18962,18377,585,3.1
39139,2020-10-01,53567,50448,3119,5.8
39141,2020-10-01,35413,33574,1839,5.2
39143,2020-10-01,30067,28543,1524,5.1
39145,2020-10-01,30101,28306,1795,6
39147,2020-10-01,27432,26110,1322,4.8
39149,2020-10-01,24162,23020,1142,4.7
39151,2020-10-01,186250,175678,10572,5.7
39153,2020-10-01,270382,253614,16768,6.2
39155,2020-10-01,83797,77591,6206,7.4
39157,2020-10-01,45040,42772,2268,5
39159,2020-10-01,29271,28172,1099,3.8
39161,2020-10-01,14739,14146,593,4
39163,2020-10-01,5789,5448,341,5.9
39165,2020-10-01,122243,116687,5556,4.5
39167,2020-10-01,27691,26134,1557,5.6
39169,2020-10-01,61867,59376,2491,4
39171,2020-10-01,18694,17760,934,5
39173,2020-10-01,71558,68319,3239,4.5
39175,2020-10-01,13080,12580,500,3.8
40001,2020-10-01,8447,7985,462,5.5
40003,2020-10-01,2923,2817,106,3.6
40005,2020-10-01,5156,4753,403,7.8
40007,2020-10-01,2963,2896,67,2.3
40009,2020-10-01,10012,9148,864,8.6
40011,2020-10-01,4828,4531,297,6.2
40013,2020-10-01,22054,20916,1138,5.2
40015,2020-10-01,12401,11646,755,6.1
40017,2020-10-01,76357,72089,4268,5.6
40019,2020-10-01,21761,20307,1454,6.7
40021,2020-10-01,19399,18310,1089,5.6
40023,2020-10-01,5619,5175,444,7.9
40025,2020-10-01,1518,1486,32,2.1
40027,2020-10-01,145291,137799,7492,5.2
40029,2020-10-01,2495,2321,174,7
40031,2020-10-01,48331,45345,2986,6.2
40033,2020-10-01,2850,2665,185,6.5
40035,2020-10-01,6015,5690,325,5.4
40037,2020-10-01,31810,29649,2161,6.8
40039,2020-10-01,16090,15208,882,5.5
40041,2020-10-01,18790,17857,933,5
40043,2020-10-01,3115,2956,159,5.1
40045,2020-10-01,2235,2110,125,5.6
40047,2020-10-01,26139,24588,1551,5.9
40049,2020-10-01,12913,12052,861,6.7
40051,2020-10-01,27530,25840,1690,6.1
40053,2020-10-01,2816,2718,98,3.5
40055,2020-10-01,2035,1872,163,8
40057,2020-10-01,1293,1246,47,3.6
40059,2020-10-01,1918,1853,65,3.4
40061,2020-10-01,4367,4024,343,7.9
40063,2020-10-01,5701,5243,458,8
40065,2020-10-01,11050,10608,442,4
40067,2020-10-01,2650,2475,175,6.6
40069,2020-10-01,3400,3121,279,8.2
40071,2020-10-01,18491,17251,1240,6.7
40073,2020-10-01,9317,8892,425,4.6
40075,2020-10-01,3538,3350,188,5.3
40077,2020-10-01,3259,2892,367,11.3
40079,2020-10-01,19550,18103,1447,7.4
40081,2020-10-01,16170,15283,887,5.5
40083,2020-10-01,22678,21516,1162,5.1
40085,2020-10-01,6314,6033,281,4.5
40087,2020-10-01,20385,19288,1097,5.4
40089,2020-10-01,15564,14474,1090,7
40091,2020-10-01,7493,6862,631,8.4
40093,2020-10-01,4022,3804,218,5.4
40095,2020-10-01,7121,6716,405,5.7
40097,2020-10-01,19819,18743,1076,5.4
40099,2020-10-01,6561,6141,420,6.4
40101,2020-10-01,30245,28439,1806,6
40103,2020-10-01,5677,5466,211,3.7
40105,2020-10-01,4765,4491,274,5.8
40107,2020-10-01,4675,4362,313,6.7
40109,2020-10-01,394857,370154,24703,6.3
40111,2020-10-01,15905,14668,1237,7.8
40113,2020-10-01,20949,19544,1405,6.7
40115,2020-10-01,14825,14108,717,4.8
40117,2020-10-01,7487,6960,527,7
40119,2020-10-01,38842,37018,1824,4.7
40121,2020-10-01,17525,16158,1367,7.8
40123,2020-10-01,19509,18546,963,4.9
40125,2020-10-01,33127,31089,2038,6.2
40127,2020-10-01,4527,4216,311,6.9
40129,2020-10-01,1943,1849,94,4.8
40131,2020-10-01,45258,42593,2665,5.9
40133,2020-10-01,9770,9020,750,7.7
40135,2020-10-01,16514,15443,1071,6.5
40137,2020-10-01,19205,17601,1604,8.4
40139,2020-10-01,12476,12183,293,2.3
40141,2020-10-01,3149,3025,124,3.9
40143,2020-10-01,325616,303995,21621,6.6
40145,2020-10-01,38034,35797,2237,5.9
40147,2020-10-01,22397,21050,1347,6
40149,2020-10-01,5395,4997,398,7.4
40151,2020-10-01,4802,4652,150,3.1
40153,2020-10-01,9207,8497,710,7.7
41001,2020-10-01,7508,7091,417,5.6
41003,2020-10-01,48170,45926,2244,4.7
41005,2020-10-01,222623,208578,14045,6.3
41007,2020-10-01,19637,18324,1313,6.7
41009,2020-10-01,24538,22898,1640,6.7
41011,2020-10-01,26624,24801,1823,6.8
41013,2020-10-01,10445,9694,751,7.2
41015,2020-10-01,9238,8633,605,6.5
41017,2020-10-01,97197,91312,5885,6.1
41019,2020-10-01,47479,44614,2865,6
41021,2020-10-01,1012,963,49,4.8
41023,2020-10-01,3301,3135,166,5
41025,2020-10-01,3689,3516,173,4.7
41027,2020-10-01,14390,13705,685,4.8
41029,2020-10-01,106789,100119,6670,6.2
41031,2020-10-01,10418,9731,687,6.6
41033,2020-10-01,35770,33437,2333,6.5
41035,2020-10-01,30289,28294,1995,6.6
41037,2020-10-01,3790,3622,168,4.4
41039,2020-10-01,188913,177161,11752,6.2
41041,2020-10-01,20254,18605,1649,8.1
41043,2020-10-01,60396,56593,3803,6.3
41045,2020-10-01,13128,12617,511,3.9
41047,2020-10-01,161906,152240,9666,6
41049,2020-10-01,5953,5710,243,4.1
41051,2020-10-01,467383,432179,35204,7.5
41053,2020-10-01,39888,37659,2229,5.6
41055,2020-10-01,992,944,48,4.8
41057,2020-10-01,11816,11065,751,6.4
41059,2020-10-01,38102,36107,1995,5.2
41061,2020-10-01,12298,11638,660,5.4
41063,2020-10-01,3564,3389,175,4.9
41065,2020-10-01,12886,12149,737,5.7
41067,2020-10-01,327637,309102,18535,5.7
41069,2020-10-01,740,710,30,4.1
41071,2020-10-01,55394,52324,3070,5.5
42001,2020-10-01,55675,53184,2491,4.5
42003,2020-10-01,632360,587820,44540,7
42005,2020-10-01,31222,29064,2158,6.9
42007,2020-10-01,82260,75897,6363,7.7
42009,2020-10-01,23435,21894,1541,6.6
42011,2020-10-01,222527,207379,15148,6.8
42013,2020-10-01,57662,54200,3462,6
42015,2020-10-01,28385,26789,1596,5.6
42017,2020-10-01,333278,312210,21068,6.3
42019,2020-10-01,96088,90873,5215,5.4
42021,2020-10-01,55785,52136,3649,6.5
42023,2020-10-01,1978,1828,150,7.6
42025,2020-10-01,31241,29105,2136,6.8
42027,2020-10-01,76643,73454,3189,4.2
42029,2020-10-01,276800,263281,13519,4.9
42031,2020-10-01,16937,16044,893,5.3
42033,2020-10-01,35385,33128,2257,6.4
42035,2020-10-01,17846,16753,1093,6.1
42037,2020-10-01,33663,31803,1860,5.5
42039,2020-10-01,37380,34935,2445,6.5
42041,2020-10-01,131737,125328,6409,4.9
42043,2020-10-01,145726,135685,10041,6.9
42045,2020-10-01,298277,276545,21732,7.3
42047,2020-10-01,14842,13629,1213,8.2
42049,2020-10-01,122861,113451,9410,7.7
42051,2020-10-01,55754,50946,4808,8.6
42053,2020-10-01,1758,1638,120,6.8
42055,2020-10-01,76987,72518,4469,5.8
42057,2020-10-01,8132,7330,802,9.9
42059,2020-10-01,16489,15318,1171,7.1
42061,2020-10-01,19849,18308,1541,7.8
42063,2020-10-01,38728,36384,2344,6.1
42065,2020-10-01,20230,19020,1210,6
42067,2020-10-01,12355,11804,551,4.5
42069,2020-10-01,100242,92742,7500,7.5
42071,2020-10-01,289513,274534,14979,5.2
42073,2020-10-01,39385,36380,3005,7.6
42075,2020-10-01,72129,67901,4228,5.9
42077,2020-10-01,189961,175876,14085,7.4
42079,2020-10-01,150935,137872,13063,8.7
42081,2020-10-01,52391,48708,3683,7
42083,2020-10-01,16798,15693,1105,6.6
42085,2020-10-01,46159,42594,3565,7.7
42087,2020-10-01,20790,19539,1251,6
42089,2020-10-01,78140,71320,6820,8.7
42091,2020-10-01,439952,413746,26206,6
42093,2020-10-01,9167,8758,409,4.5
42095,2020-10-01,157623,147290,10333,6.6
42097,2020-10-01,41849,39003,2846,6.8
42099,2020-10-01,24417,23303,1114,4.6
42101,2020-10-01,725457,646904,78553,10.8
42103,2020-10-01,24077,22161,1916,8
42105,2020-10-01,7070,6602,468,6.6
42107,2020-10-01,65851,61276,4575,6.9
42109,2020-10-01,19800,18914,886,4.5
42111,2020-10-01,32621,30528,2093,6.4
42113,2020-10-01,2563,2399,164,6.4
42115,2020-10-01,19645,18590,1055,5.4
42117,2020-10-01,18948,17741,1207,6.4
42119,2020-10-01,19433,18547,886,4.6
42121,2020-10-01,22061,20559,1502,6.8
42123,2020-10-01,18710,17564,1146,6.1
42125,2020-10-01,104200,96833,7367,7.1
42127,2020-10-01,20786,19427,1359,6.5
42129,2020-10-01,175041,163745,11296,6.5
42131,2020-10-01,12866,12102,764,5.9
42133,2020-10-01,233437,219922,13515,5.8
44001,2020-10-01,25222,23906,1316,5.2
44003,2020-10-01,88071,83220,4851,5.5
44005,2020-10-01,42812,40658,2154,5
44007,2020-10-01,320106,296554,23552,7.4
44009,2020-10-01,66274,63008,3266,4.9
45001,2020-10-01,10089,9673,416,4.1
45003,2020-10-01,74313,71912,2401,3.2
45005,2020-10-01,2669,2472,197,7.4
45007,2020-10-01,93625,90243,3382,3.6
45009,2020-10-01,5021,4692,329,6.6
45011,2020-10-01,8112,7675,437,5.4
45013,2020-10-01,79608,77046,2562,3.2
45015,2020-10-01,103180,99271,3909,3.8
45017,2020-10-01,6654,6360,294,4.4
45019,2020-10-01,210735,201883,8852,4.2
45021,2020-10-01,25920,24574,1346,5.2
45023,2020-10-01,13526,12666,860,6.4
45025,2020-10-01,22295,21343,952,4.3
45027,2020-10-01,12809,12203,606,4.7
45029,2020-10-01,17037,16259,778,4.6
45031,2020-10-01,30885,29429,1456,4.7
45033,2020-10-01,13400,12794,606,4.5
45035,2020-10-01,77578,74572,3006,3.9
45037,2020-10-01,10609,10271,338,3.2
45039,2020-10-01,9735,9201,534,5.5
45041,2020-10-01,67754,65003,2751,4.1
45043,2020-10-01,26202,24876,1326,5.1
45045,2020-10-01,262098,252940,9158,3.5
45047,2020-10-01,31779,30320,1459,4.6
45049,2020-10-01,8558,8248,310,3.6
45051,2020-10-01,141520,134254,7266,5.1
45053,2020-10-01,12908,12456,452,3.5
45055,2020-10-01,29509,28454,1055,3.6
45057,2020-10-01,41151,39231,1920,4.7
45059,2020-10-01,31074,29736,1338,4.3
45061,2020-10-01,6717,6346,371,5.5
45063,2020-10-01,151379,146855,4524,3
45065,2020-10-01,3371,3214,157,4.7
45067,2020-10-01,13105,12297,808,6.2
45069,2020-10-01,9394,8754,640,6.8
45071,2020-10-01,19145,18522,623,3.3
45073,2020-10-01,35561,34477,1084,3
45075,2020-10-01,35971,33634,2337,6.5
45077,2020-10-01,58577,56738,1839,3.1
45079,2020-10-01,202738,194057,8681,4.3
45081,2020-10-01,8874,8635,239,2.7
45083,2020-10-01,153254,146776,6478,4.2
45085,2020-10-01,43640,41574,2066,4.7
45087,2020-10-01,11776,11056,720,6.1
45089,2020-10-01,12229,11538,691,5.7
45091,2020-10-01,139847,134130,5717,4.1
46003,2020-10-01,1535,1495,40,2.6
46005,2020-10-01,9608,9321,287,3
46007,2020-10-01,1087,1037,50,4.6
46009,2020-10-01,2938,2838,100,3.4
46011,2020-10-01,19705,19063,642,3.3
46013,2020-10-01,20922,20281,641,3.1
46015,2020-10-01,2487,2409,78,3.1
46017,2020-10-01,646,611,35,5.4
46019,2020-10-01,5104,4917,187,3.7
46021,2020-10-01,780,761,19,2.4
46023,2020-10-01,3843,3661,182,4.7
46025,2020-10-01,1963,1896,67,3.4
46027,2020-10-01,7768,7524,244,3.1
46029,2020-10-01,15705,15170,535,3.4
46031,2020-10-01,1380,1325,55,4
46033,2020-10-01,3958,3793,165,4.2
46035,2020-10-01,11168,10857,311,2.8
46037,2020-10-01,2765,2667,98,3.5
46039,2020-10-01,2243,2164,79,3.5
46041,2020-10-01,2236,2099,137,6.1
46043,2020-10-01,1588,1551,37,2.3
46045,2020-10-01,2076,2025,51,2.5
46047,2020-10-01,3005,2840,165,5.5
46049,2020-10-01,1113,1080,33,3
46051,2020-10-01,4465,4358,107,2.4
46053,2020-10-01,2099,2035,64,3
46055,2020-10-01,1095,1070,25,2.3
46057,2020-10-01,3388,3302,86,2.5
46059,2020-10-01,1845,1802,43,2.3
46061,2020-10-01,1758,1694,64,3.6
46063,2020-10-01,765,741,24,3.1
46065,2020-10-01,9963,9730,233,2.3
46067,2020-10-01,3700,3602,98,2.6
46069,2020-10-01,710,692,18,2.5
46071,2020-10-01,1275,1231,44,3.5
46073,2020-10-01,1161,1136,25,2.2
46075,2020-10-01,552,535,17,3.1
46077,2020-10-01,2665,2597,68,2.6
46079,2020-10-01,6674,6477,197,3
46081,2020-10-01,13744,13235,509,3.7
46083,2020-10-01,34235,33328,907,2.6
46085,2020-10-01,1730,1670,60,3.5
46087,2020-10-01,3085,3000,85,2.8
46089,2020-10-01,1036,987,49,4.7
46091,2020-10-01,2451,2371,80,3.3
46093,2020-10-01,13693,13255,438,3.2
46095,2020-10-01,748,716,32,4.3
46097,2020-10-01,1238,1185,53,4.3
46099,2020-10-01,112015,108506,3509,3.1
46101,2020-10-01,4106,3987,119,2.9
46102,2020-10-01,3652,3244,408,11.2
46103,2020-10-01,55187,53116,2071,3.8
46105,2020-10-01,1471,1416,55,3.7
46107,2020-10-01,1052,1020,32,3
46109,2020-10-01,5028,4842,186,3.7
46111,2020-10-01,1190,1151,39,3.3
46115,2020-10-01,3226,3128,98,3
46117,2020-10-01,1862,1811,51,2.7
46119,2020-10-01,821,802,19,2.3
46121,2020-10-01,3106,2944,162,5.2
46123,2020-10-01,3139,3065,74,2.4
46125,2020-10-01,4698,4576,122,2.6
46127,2020-10-01,8555,8239,316,3.7
46129,2020-10-01,2124,2031,93,4.4
46135,2020-10-01,11929,11510,419,3.5
46137,2020-10-01,946,907,39,4.1
47001,2020-10-01,35157,32852,2305,6.6
47003,2020-10-01,20954,19537,1417,6.8
47005,2020-10-01,6867,6307,560,8.2
47007,2020-10-01,4450,4062,388,8.7
47009,2020-10-01,64309,60516,3793,5.9
47011,2020-10-01,53505,49959,3546,6.6
47013,2020-10-01,15084,13938,1146,7.6
47015,2020-10-01,6531,6145,386,5.9
47017,2020-10-01,12137,11208,929,7.7
47019,2020-10-01,23752,22050,1702,7.2
47021,2020-10-01,21701,20544,1157,5.3
47023,2020-10-01,8395,7905,490,5.8
47025,2020-10-01,13001,12160,841,6.5
47027,2020-10-01,2752,2531,221,8
47029,2020-10-01,14791,13617,1174,7.9
47031,2020-10-01,25415,23763,1652,6.5
47033,2020-10-01,6911,6487,424,6.1
47035,2020-10-01,23774,22019,1755,7.4
47037,2020-10-01,406846,378632,28214,6.9
47039,2020-10-01,4520,4146,374,8.3
47041,2020-10-01,7604,6973,631,8.3
47043,2020-10-01,26672,25203,1469,5.5
47045,2020-10-01,16682,15339,1343,8.1
47047,2020-10-01,19229,17815,1414,7.4
47049,2020-10-01,7591,7010,581,7.7
47051,2020-10-01,20123,18901,1222,6.1
47053,2020-10-01,22118,20459,1659,7.5
47055,2020-10-01,14655,13641,1014,6.9
47057,2020-10-01,9702,9004,698,7.2
47059,2020-10-01,29388,27049,2339,8
47061,2020-10-01,5056,4632,424,8.4
47063,2020-10-01,28325,26458,1867,6.6
47065,2020-10-01,188171,175615,12556,6.7
47067,2020-10-01,2141,1938,203,9.5
47069,2020-10-01,9601,8715,886,9.2
47071,2020-10-01,10508,9710,798,7.6
47073,2020-10-01,23287,21565,1722,7.4
47075,2020-10-01,7834,7093,741,9.5
47077,2020-10-01,12289,11384,905,7.4
47079,2020-10-01,14031,12981,1050,7.5
47081,2020-10-01,11358,10689,669,5.9
47083,2020-10-01,3293,3024,269,8.2
47085,2020-10-01,8799,8249,550,6.3
47087,2020-10-01,4704,4361,343,7.3
47089,2020-10-01,24752,23157,1595,6.4
47091,2020-10-01,7794,7280,514,6.6
47093,2020-10-01,246792,232974,13818,5.6
47095,2020-10-01,1770,1592,178,10.1
47097,2020-10-01,9943,8941,1002,10.1
47099,2020-10-01,19289,17994,1295,6.7
47101,2020-10-01,5168,4778,390,7.5
47103,2020-10-01,15848,14670,1178,7.4
47105,2020-10-01,23748,22322,1426,6
47107,2020-10-01,23712,22067,1645,6.9
47109,2020-10-01,8733,7916,817,9.4
47111,2020-10-01,11264,10538,726,6.4
47113,2020-10-01,48976,45204,3772,7.7
47115,2020-10-01,12742,11809,933,7.3
47117,2020-10-01,15440,14421,1019,6.6
47119,2020-10-01,49171,46042,3129,6.4
47121,2020-10-01,5324,4881,443,8.3
47123,2020-10-01,20367,19008,1359,6.7
47125,2020-10-01,86966,80365,6601,7.6
47127,2020-10-01,3616,3450,166,4.6
47129,2020-10-01,8010,7431,579,7.2
47131,2020-10-01,12718,11713,1005,7.9
47133,2020-10-01,10186,9586,600,5.9
47135,2020-10-01,3046,2801,245,8
47137,2020-10-01,2301,2165,136,5.9
47139,2020-10-01,7719,7176,543,7
47141,2020-10-01,35893,33679,2214,6.2
47143,2020-10-01,13394,12265,1129,8.4
47145,2020-10-01,23662,22076,1586,6.7
47147,2020-10-01,37700,35498,2202,5.8
47149,2020-10-01,182634,172217,10417,5.7
47151,2020-10-01,8254,7583,671,8.1
47153,2020-10-01,6354,5871,483,7.6
47155,2020-10-01,52241,49369,2872,5.5
47157,2020-10-01,461973,411230,50743,11
47159,2020-10-01,9333,8830,503,5.4
47161,2020-10-01,5518,5142,376,6.8
47163,2020-10-01,69314,64130,5184,7.5
47165,2020-10-01,101735,95828,5907,5.8
47167,2020-10-01,28150,26059,2091,7.4
47169,2020-10-01,5386,5060,326,6.1
47171,2020-10-01,7077,6460,617,8.7
47173,2020-10-01,7725,7215,510,6.6
47175,2020-10-01,2047,1887,160,7.8
47177,2020-10-01,16258,15030,1228,7.6
47179,2020-10-01,59396,55658,3738,6.3
47181,2020-10-01,6153,5682,471,7.7
47183,2020-10-01,15805,14784,1021,6.5
47185,2020-10-01,12209,11419,790,6.5
47187,2020-10-01,126409,120623,5786,4.6
47189,2020-10-01,75965,71674,4291,5.6
48001,2020-10-01,23629,22349,1280,5.4
48003,2020-10-01,9963,9210,753,7.6
48005,2020-10-01,35559,33072,2487,7
48007,2020-10-01,9108,8409,699,7.7
48009,2020-10-01,4066,3872,194,4.8
48011,2020-10-01,901,867,34,3.8
48013,2020-10-01,22100,20350,1750,7.9
48015,2020-10-01,13931,13080,851,6.1
48017,2020-10-01,2371,2268,103,4.3
48019,2020-10-01,9969,9465,504,5.1
48021,2020-10-01,43587,41365,2222,5.1
48023,2020-10-01,1782,1723,59,3.3
48025,2020-10-01,10000,9015,985,9.9
48027,2020-10-01,143612,134749,8863,6.2
48029,2020-10-01,954789,893606,61183,6.4
48031,2020-10-01,6479,6264,215,3.3
48033,2020-10-01,414,400,14,3.4
48035,2020-10-01,8246,7867,379,4.6
48037,2020-10-01,40433,38010,2423,6
48039,2020-10-01,178793,165039,13754,7.7
48041,2020-10-01,122334,116976,5358,4.4
48043,2020-10-01,4149,3927,222,5.4
48045,2020-10-01,564,540,24,4.3
48047,2020-10-01,2658,2388,270,10.2
48049,2020-10-01,15275,14380,895,5.9
48051,2020-10-01,8647,8170,477,5.5
48053,2020-10-01,23322,22344,978,4.2
48055,2020-10-01,19962,18901,1061,5.3
48057,2020-10-01,12130,11481,649,5.4
48059,2020-10-01,6083,5789,294,4.8
48061,2020-10-01,164646,149300,15346,9.3
48063,2020-10-01,4967,4614,353,7.1
48065,2020-10-01,2922,2813,109,3.7
48067,2020-10-01,12507,11560,947,7.6
48069,2020-10-01,3360,3248,112,3.3
48071,2020-10-01,19576,17845,1731,8.8
48073,2020-10-01,20958,19337,1621,7.7
48075,2020-10-01,2835,2739,96,3.4
48077,2020-10-01,4856,4608,248,5.1
48079,2020-10-01,1119,1041,78,7
48081,2020-10-01,1436,1362,74,5.2
48083,2020-10-01,2846,2654,192,6.7
48085,2020-10-01,569387,539829,29558,5.2
48087,2020-10-01,1088,1043,45,4.1
48089,2020-10-01,9600,9094,506,5.3
48091,2020-10-01,72877,69069,3808,5.2
48093,2020-10-01,5593,5298,295,5.3
48095,2020-10-01,1331,1280,51,3.8
48097,2020-10-01,20150,18930,1220,6.1
48099,2020-10-01,23959,22568,1391,5.8
48101,2020-10-01,512,490,22,4.3
48103,2020-10-01,1605,1368,237,14.8
48105,2020-10-01,1625,1502,123,7.6
48107,2020-10-01,2472,2356,116,4.7
48109,2020-10-01,992,922,70,7.1
48111,2020-10-01,3715,3621,94,2.5
48113,2020-10-01,NA,NA,91478,6.6
48115,2020-10-01,4791,4389,402,8.4
48117,2020-10-01,8357,8052,305,3.6
48119,2020-10-01,2390,2271,119,5
48121,2020-10-01,501099,474464,26635,5.3
48123,2020-10-01,9787,9224,563,5.8
48125,2020-10-01,663,624,39,5.9
48127,2020-10-01,7184,6762,422,5.9
48129,2020-10-01,1314,1263,51,3.9
48131,2020-10-01,5033,4431,602,12
48133,2020-10-01,7580,7123,457,6
48135,2020-10-01,86195,76513,9682,11.2
48137,2020-10-01,1104,1053,51,4.6
48139,2020-10-01,93584,88732,4852,5.2
48141,2020-10-01,361342,335528,25814,7.1
48143,2020-10-01,20634,19613,1021,4.9
48145,2020-10-01,6720,6366,354,5.3
48147,2020-10-01,17509,16815,694,4
48149,2020-10-01,11848,11319,529,4.5
48151,2020-10-01,1586,1511,75,4.7
48153,2020-10-01,2502,2376,126,5
48155,2020-10-01,578,556,22,3.8
48157,2020-10-01,390730,363174,27556,7.1
48159,2020-10-01,4565,4330,235,5.1
48161,2020-10-01,6260,5774,486,7.8
48163,2020-10-01,10244,9720,524,5.1
48165,2020-10-01,9739,9178,561,5.8
48167,2020-10-01,164790,152353,12437,7.5
48169,2020-10-01,2139,2002,137,6.4
48171,2020-10-01,13252,12741,511,3.9
48173,2020-10-01,779,749,30,3.9
48175,2020-10-01,3221,2982,239,7.4
48177,2020-10-01,9567,9067,500,5.2
48179,2020-10-01,8120,7500,620,7.6
48181,2020-10-01,64411,61167,3244,5
48183,2020-10-01,57028,52639,4389,7.7
48185,2020-10-01,11370,10515,855,7.5
48187,2020-10-01,81000,76881,4119,5.1
48189,2020-10-01,11763,11069,694,5.9
48191,2020-10-01,1035,973,62,6
48193,2020-10-01,3589,3430,159,4.4
48195,2020-10-01,2599,2504,95,3.7
48197,2020-10-01,1714,1640,74,4.3
48199,2020-10-01,24578,22618,1960,8
48201,2020-10-01,NA,NA,181489,7.8
48203,2020-10-01,28753,26583,2170,7.5
48205,2020-10-01,2664,2619,45,1.7
48207,2020-10-01,2229,2119,110,4.9
48209,2020-10-01,122078,115897,6181,5.1
48211,2020-10-01,1765,1691,74,4.2
48213,2020-10-01,36564,34400,2164,5.9
48215,2020-10-01,352867,316430,36437,10.3
48217,2020-10-01,16441,15542,899,5.5
48219,2020-10-01,11148,10345,803,7.2
48221,2020-10-01,27622,25999,1623,5.9
48223,2020-10-01,17202,16394,808,4.7
48225,2020-10-01,10009,9491,518,5.2
48227,2020-10-01,14437,13319,1118,7.7
48229,2020-10-01,1844,1697,147,8
48231,2020-10-01,43778,41359,2419,5.5
48233,2020-10-01,8373,7835,538,6.4
48235,2020-10-01,754,703,51,6.8
48237,2020-10-01,3293,3077,216,6.6
48239,2020-10-01,7454,7054,400,5.4
48241,2020-10-01,12694,11406,1288,10.1
48243,2020-10-01,967,925,42,4.3
48245,2020-10-01,105458,94334,11124,10.5
48247,2020-10-01,1812,1621,191,10.5
48249,2020-10-01,17298,15163,2135,12.3
48251,2020-10-01,82368,77728,4640,5.6
48253,2020-10-01,5775,5391,384,6.6
48255,2020-10-01,7313,6846,467,6.4
48257,2020-10-01,65603,61774,3829,5.8
48259,2020-10-01,21844,20921,923,4.2
48261,2020-10-01,193,182,11,5.7
48263,2020-10-01,469,455,14,3
48265,2020-10-01,22016,21004,1012,4.6
48267,2020-10-01,1811,1717,94,5.2
48269,2020-10-01,232,229,3,1.3
48271,2020-10-01,1344,1275,69,5.1
48273,2020-10-01,13380,12347,1033,7.7
48275,2020-10-01,1425,1345,80,5.6
48277,2020-10-01,24104,22744,1360,5.6
48279,2020-10-01,5228,4982,246,4.7
48281,2020-10-01,9109,8676,433,4.8
48283,2020-10-01,4200,3968,232,5.5
48285,2020-10-01,8157,7721,436,5.3
48287,2020-10-01,9928,9521,407,4.1
48289,2020-10-01,6312,5856,456,7.2
48291,2020-10-01,33615,30170,3445,10.2
48293,2020-10-01,8677,8090,587,6.8
48295,2020-10-01,1550,1492,58,3.7
48297,2020-10-01,5584,5189,395,7.1
48299,2020-10-01,8612,8173,439,5.1
48301,2020-10-01,702,699,3,0.4
48303,2020-10-01,157202,149287,7915,5
48305,2020-10-01,2773,2637,136,4.9
48307,2020-10-01,3279,3037,242,7.4
48309,2020-10-01,122025,115536,6489,5.3
48311,2020-10-01,856,838,18,2.1
48313,2020-10-01,4524,4209,315,7
48315,2020-10-01,4144,3818,326,7.9
48317,2020-10-01,2688,2538,150,5.6
48319,2020-10-01,1743,1649,94,5.4
48321,2020-10-01,16854,15278,1576,9.4
48323,2020-10-01,24193,20831,3362,13.9
48325,2020-10-01,21793,20570,1223,5.6
48327,2020-10-01,845,806,39,4.6
48329,2020-10-01,101870,93676,8194,8
48331,2020-10-01,9636,9015,621,6.4
48333,2020-10-01,1861,1786,75,4
48335,2020-10-01,2369,2166,203,8.6
48337,2020-10-01,9233,8680,553,6
48339,2020-10-01,282561,263168,19393,6.9
48341,2020-10-01,10579,10196,383,3.6
48343,2020-10-01,4967,4366,601,12.1
48345,2020-10-01,462,441,21,4.5
48347,2020-10-01,27314,25683,1631,6
48349,2020-10-01,23788,22578,1210,5.1
48351,2020-10-01,5033,4555,478,9.5
48353,2020-10-01,7203,6834,369,5.1
48355,2020-10-01,162389,149259,13130,8.1
48357,2020-10-01,4086,3863,223,5.5
48359,2020-10-01,888,855,33,3.7
48361,2020-10-01,35680,32312,3368,9.4
48363,2020-10-01,13604,12716,888,6.5
48365,2020-10-01,9958,9210,748,7.5
48367,2020-10-01,67382,63878,3504,5.2
48369,2020-10-01,4704,4577,127,2.7
48371,2020-10-01,6311,5754,557,8.8
48373,2020-10-01,18043,16567,1476,8.2
48375,2020-10-01,53853,51144,2709,5
48377,2020-10-01,3203,2756,447,14
48379,2020-10-01,6049,5805,244,4
48381,2020-10-01,69804,67073,2731,3.9
48383,2020-10-01,1971,1777,194,9.8
48385,2020-10-01,970,906,64,6.6
48387,2020-10-01,4980,4676,304,6.1
48389,2020-10-01,12365,11663,702,5.7
48391,2020-10-01,3125,2874,251,8
48393,2020-10-01,408,389,19,4.7
48395,2020-10-01,7901,7453,448,5.7
48397,2020-10-01,52442,49857,2585,4.9
48399,2020-10-01,4516,4322,194,4.3
48401,2020-10-01,22484,20879,1605,7.1
48403,2020-10-01,3633,3267,366,10.1
48405,2020-10-01,3491,3216,275,7.9
48407,2020-10-01,11624,10752,872,7.5
48409,2020-10-01,29043,26319,2724,9.4
48411,2020-10-01,2475,2379,96,3.9
48413,2020-10-01,1255,1168,87,6.9
48415,2020-10-01,6535,6042,493,7.5
48417,2020-10-01,1833,1740,93,5.1
48419,2020-10-01,10993,10270,723,6.6
48421,2020-10-01,1359,1315,44,3.2
48423,2020-10-01,107985,101581,6404,5.9
48425,2020-10-01,4342,4111,231,5.3
48427,2020-10-01,25248,21398,3850,15.2
48429,2020-10-01,3989,3713,276,6.9
48431,2020-10-01,579,545,34,5.9
48433,2020-10-01,553,525,28,5.1
48435,2020-10-01,1314,1190,124,9.4
48437,2020-10-01,2539,2420,119,4.7
48439,2020-10-01,NA,NA,68338,6.3
48441,2020-10-01,66763,63611,3152,4.7
48443,2020-10-01,361,347,14,3.9
48445,2020-10-01,4901,4552,349,7.1
48447,2020-10-01,620,590,30,4.8
48449,2020-10-01,12872,12078,794,6.2
48451,2020-10-01,52632,49585,3047,5.8
48453,2020-10-01,755852,717395,38457,5.1
48455,2020-10-01,5250,4858,392,7.5
48457,2020-10-01,7091,6446,645,9.1
48459,2020-10-01,17437,16188,1249,7.2
48461,2020-10-01,1666,1558,108,6.5
48463,2020-10-01,11089,10410,679,6.1
48465,2020-10-01,22068,20511,1557,7.1
48467,2020-10-01,25947,24515,1432,5.5
48469,2020-10-01,42013,38945,3068,7.3
48471,2020-10-01,23843,22240,1603,6.7
48473,2020-10-01,23420,21708,1712,7.3
48475,2020-10-01,7959,7343,616,7.7
48477,2020-10-01,15219,14426,793,5.2
48479,2020-10-01,116013,107067,8946,7.7
48481,2020-10-01,21540,20149,1391,6.5
48483,2020-10-01,2247,2094,153,6.8
48485,2020-10-01,55741,52319,3422,6.1
48487,2020-10-01,4937,4649,288,5.8
48489,2020-10-01,6621,5949,672,10.1
48491,2020-10-01,318658,303556,15102,4.7
48493,2020-10-01,24727,23496,1231,5
48495,2020-10-01,3966,3574,392,9.9
48497,2020-10-01,31955,30167,1788,5.6
48499,2020-10-01,17541,16491,1050,6
48501,2020-10-01,3883,3480,403,10.4
48503,2020-10-01,7882,7510,372,4.7
48505,2020-10-01,4880,4281,599,12.3
48507,2020-10-01,3235,2784,451,13.9
49001,2020-10-01,2827,2735,92,3.3
49003,2020-10-01,26548,25813,735,2.8
49005,2020-10-01,66220,64687,1533,2.3
49007,2020-10-01,8531,8146,385,4.5
49009,2020-10-01,398,383,15,3.8
49011,2020-10-01,179483,173712,5771,3.2
49013,2020-10-01,7618,7037,581,7.6
49015,2020-10-01,4331,4177,154,3.6
49017,2020-10-01,2864,2722,142,5
49019,2020-10-01,6413,6112,301,4.7
49021,2020-10-01,25531,24625,906,3.5
49023,2020-10-01,5836,5699,137,2.3
49025,2020-10-01,3774,3642,132,3.5
49027,2020-10-01,6058,5898,160,2.6
49029,2020-10-01,5706,5559,147,2.6
49031,2020-10-01,480,461,19,4
49033,2020-10-01,1096,1073,23,2.1
49035,2020-10-01,647902,621541,26361,4.1
49037,2020-10-01,5664,5206,458,8.1
49039,2020-10-01,12568,12169,399,3.2
49041,2020-10-01,9860,9530,330,3.3
49043,2020-10-01,22649,21429,1220,5.4
49045,2020-10-01,34506,33154,1352,3.9
49047,2020-10-01,13476,12255,1221,9.1
49049,2020-10-01,316717,306961,9756,3.1
49051,2020-10-01,15836,15121,715,4.5
49053,2020-10-01,79263,75983,3280,4.1
49055,2020-10-01,1464,1411,53,3.6
49057,2020-10-01,131680,126775,4905,3.7
50001,2020-10-01,19755,19393,362,1.8
50003,2020-10-01,16619,16153,466,2.8
50005,2020-10-01,13996,13697,299,2.1
50007,2020-10-01,89449,87540,1909,2.1
50009,2020-10-01,2523,2468,55,2.2
50011,2020-10-01,25434,24837,597,2.3
50013,2020-10-01,3737,3628,109,2.9
50015,2020-10-01,12416,12015,401,3.2
50017,2020-10-01,15458,15172,286,1.9
50019,2020-10-01,11840,11464,376,3.2
50021,2020-10-01,28106,27211,895,3.2
50023,2020-10-01,31993,31353,640,2
50025,2020-10-01,20500,19892,608,3
50027,2020-10-01,27518,26909,609,2.2
51001,2020-10-01,16286,15537,749,4.6
51003,2020-10-01,56532,54301,2231,3.9
51005,2020-10-01,6656,6364,292,4.4
51007,2020-10-01,6114,5837,277,4.5
51009,2020-10-01,14211,13592,619,4.4
51011,2020-10-01,6813,6488,325,4.8
51013,2020-10-01,149552,143540,6012,4
51015,2020-10-01,37946,36718,1228,3.2
51017,2020-10-01,2543,2423,120,4.7
51019,2020-10-01,36257,34846,1411,3.9
51021,2020-10-01,2735,2634,101,3.7
51023,2020-10-01,16647,16104,543,3.3
51025,2020-10-01,5789,5377,412,7.1
51027,2020-10-01,6320,5861,459,7.3
51029,2020-10-01,6391,6023,368,5.8
51031,2020-10-01,24588,23455,1133,4.6
51033,2020-10-01,14792,14005,787,5.3
51035,2020-10-01,13002,12398,604,4.6
51036,2020-10-01,3571,3395,176,4.9
51037,2020-10-01,5227,5009,218,4.2
51041,2020-10-01,180874,172443,8431,4.7
51043,2020-10-01,7391,7144,247,3.3
51045,2020-10-01,2195,2118,77,3.5
51047,2020-10-01,23791,22918,873,3.7
51049,2020-10-01,4519,4294,225,5
51051,2020-10-01,4653,4369,284,6.1
51053,2020-10-01,13292,12596,696,5.2
51057,2020-10-01,5381,5067,314,5.8
51059,2020-10-01,618938,588717,30221,4.9
51061,2020-10-01,36153,34896,1257,3.5
51063,2020-10-01,8043,7782,261,3.2
51065,2020-10-01,13702,13173,529,3.9
51067,2020-10-01,25496,24417,1079,4.2
51069,2020-10-01,45314,43775,1539,3.4
51071,2020-10-01,7618,7315,303,4
51073,2020-10-01,19054,18277,777,4.1
51075,2020-10-01,10770,10372,398,3.7
51077,2020-10-01,8060,7774,286,3.5
51079,2020-10-01,10334,9966,368,3.6
51081,2020-10-01,4223,3973,250,5.9
51083,2020-10-01,15332,14523,809,5.3
51085,2020-10-01,56888,54794,2094,3.7
51087,2020-10-01,176635,167184,9451,5.4
51089,2020-10-01,23817,22420,1397,5.9
51091,2020-10-01,1235,1204,31,2.5
51093,2020-10-01,18913,18124,789,4.2
51095,2020-10-01,35773,33981,1792,5
51097,2020-10-01,3826,3666,160,4.2
51099,2020-10-01,12880,12423,457,3.5
51101,2020-10-01,8849,8474,375,4.2
51103,2020-10-01,5421,5151,270,5
51105,2020-10-01,7890,7529,361,4.6
51107,2020-10-01,215593,206451,9142,4.2
51109,2020-10-01,19756,19011,745,3.8
51111,2020-10-01,5134,4889,245,4.8
51113,2020-10-01,7334,7135,199,2.7
51115,2020-10-01,3991,3844,147,3.7
51117,2020-10-01,12281,11588,693,5.6
51119,2020-10-01,5236,5040,196,3.7
51121,2020-10-01,47957,46372,1585,3.3
51125,2020-10-01,7422,7113,309,4.2
51127,2020-10-01,11974,11557,417,3.5
51131,2020-10-01,5425,5096,329,6.1
51133,2020-10-01,5604,5350,254,4.5
51135,2020-10-01,6947,6622,325,4.7
51137,2020-10-01,17272,16567,705,4.1
51139,2020-10-01,11876,11355,521,4.4
51141,2020-10-01,7107,6775,332,4.7
51143,2020-10-01,29287,27953,1334,4.6
51145,2020-10-01,13518,13058,460,3.4
51147,2020-10-01,10353,9865,488,4.7
51149,2020-10-01,14607,13803,804,5.5
51153,2020-10-01,239946,226974,12972,5.4
51155,2020-10-01,15554,14776,778,5
51157,2020-10-01,3604,3480,124,3.4
51159,2020-10-01,3978,3829,149,3.7
51161,2020-10-01,47222,45453,1769,3.7
51163,2020-10-01,10920,10509,411,3.8
51165,2020-10-01,40787,39512,1275,3.1
51167,2020-10-01,10869,10347,522,4.8
51169,2020-10-01,8669,8336,333,3.8
51171,2020-10-01,21939,21106,833,3.8
51173,2020-10-01,13176,12568,608,4.6
51175,2020-10-01,9012,8643,369,4.1
51177,2020-10-01,64847,61844,3003,4.6
51179,2020-10-01,69589,66433,3156,4.5
51181,2020-10-01,3601,3449,152,4.2
51183,2020-10-01,3875,3582,293,7.6
51185,2020-10-01,15113,14231,882,5.8
51187,2020-10-01,19724,18894,830,4.2
51191,2020-10-01,25312,24308,1004,4
51193,2020-10-01,9306,8870,436,4.7
51195,2020-10-01,13155,12393,762,5.8
51197,2020-10-01,13437,12787,650,4.8
51199,2020-10-01,31637,30372,1265,4
51510,2020-10-01,99414,94045,5369,5.4
51520,2020-10-01,6912,6486,426,6.2
51530,2020-10-01,3660,3534,126,3.4
51540,2020-10-01,26213,24992,1221,4.7
51550,2020-10-01,119467,113510,5957,5
51570,2020-10-01,8551,8056,495,5.8
51580,2020-10-01,2333,2186,147,6.3
51590,2020-10-01,18802,17331,1471,7.8
51595,2020-10-01,2360,2116,244,10.3
51600,2020-10-01,13048,12481,567,4.3
51610,2020-10-01,8246,7984,262,3.2
51620,2020-10-01,3622,3319,303,8.4
51630,2020-10-01,13735,12954,781,5.7
51640,2020-10-01,2849,2716,133,4.7
51650,2020-10-01,63550,58970,4580,7.2
51660,2020-10-01,24108,23076,1032,4.3
51670,2020-10-01,9695,8755,940,9.7
51678,2020-10-01,2062,1960,102,4.9
51680,2020-10-01,34572,32522,2050,5.9
51683,2020-10-01,21510,20379,1131,5.3
51685,2020-10-01,9204,8678,526,5.7
51690,2020-10-01,5659,5136,523,9.2
51700,2020-10-01,87934,81574,6360,7.2
51710,2020-10-01,110892,102525,8367,7.5
51720,2020-10-01,1676,1579,97,5.8
51730,2020-10-01,13445,11622,1823,13.6
51735,2020-10-01,6161,5983,178,2.9
51740,2020-10-01,44455,40481,3974,8.9
51750,2020-10-01,8275,7920,355,4.3
51760,2020-10-01,117034,108185,8849,7.6
51770,2020-10-01,48040,45008,3032,6.3
51775,2020-10-01,12411,11900,511,4.1
51790,2020-10-01,12416,11869,547,4.4
51800,2020-10-01,43701,41244,2457,5.6
51810,2020-10-01,226432,215920,10512,4.6
51820,2020-10-01,10866,10332,534,4.9
51830,2020-10-01,6514,6119,395,6.1
51840,2020-10-01,14125,13477,648,4.6
53001,2020-10-01,10386,9960,426,4.1
53003,2020-10-01,10722,10331,391,3.6
53005,2020-10-01,113061,107245,5816,5.1
53007,2020-10-01,45510,43115,2395,5.3
53009,2020-10-01,30547,28502,2045,6.7
53011,2020-10-01,254084,238020,16064,6.3
53013,2020-10-01,1837,1750,87,4.7
53015,2020-10-01,51299,47876,3423,6.7
53017,2020-10-01,22265,21081,1184,5.3
53019,2020-10-01,2646,2458,188,7.1
53021,2020-10-01,46817,44227,2590,5.5
53023,2020-10-01,909,856,53,5.8
53025,2020-10-01,50847,48070,2777,5.5
53027,2020-10-01,30297,27758,2539,8.4
53029,2020-10-01,38670,36423,2247,5.8
53031,2020-10-01,13527,12673,854,6.3
53033,2020-10-01,NA,NA,59294,4.7
53035,2020-10-01,139733,132286,7447,5.3
53037,2020-10-01,22922,21658,1264,5.5
53039,2020-10-01,10505,9926,579,5.5
53041,2020-10-01,36712,34442,2270,6.2
53043,2020-10-01,5022,4802,220,4.4
53045,2020-10-01,26063,24131,1932,7.4
53047,2020-10-01,20003,18863,1140,5.7
53049,2020-10-01,8424,7749,675,8
53051,2020-10-01,5136,4753,383,7.5
53053,2020-10-01,473625,442043,31582,6.7
53055,2020-10-01,8472,8056,416,4.9
53057,2020-10-01,65760,61512,4248,6.5
53059,2020-10-01,5783,5386,397,6.9
53061,2020-10-01,430609,408149,22460,5.2
53063,2020-10-01,263947,248639,15308,5.8
53065,2020-10-01,19141,18006,1135,5.9
53067,2020-10-01,152978,144514,8464,5.5
53069,2020-10-01,1479,1388,91,6.2
53071,2020-10-01,31891,30418,1473,4.6
53073,2020-10-01,124808,116994,7814,6.3
53075,2020-10-01,23540,22555,985,4.2
53077,2020-10-01,138086,129658,8428,6.1
54001,2020-10-01,6923,6507,416,6
54003,2020-10-01,56478,54038,2440,4.3
54005,2020-10-01,7274,6725,549,7.5
54007,2020-10-01,4609,4264,345,7.5
54009,2020-10-01,9716,9088,628,6.5
54011,2020-10-01,41601,39346,2255,5.4
54013,2020-10-01,2127,1906,221,10.4
54015,2020-10-01,3008,2761,247,8.2
54017,2020-10-01,3821,3660,161,4.2
54019,2020-10-01,16242,15168,1074,6.6
54021,2020-10-01,2358,2203,155,6.6
54023,2020-10-01,5781,5550,231,4
54025,2020-10-01,15025,14263,762,5.1
54027,2020-10-01,10482,10079,403,3.8
54029,2020-10-01,12736,11869,867,6.8
54031,2020-10-01,5810,5540,270,4.6
54033,2020-10-01,33751,31886,1865,5.5
54035,2020-10-01,12108,11359,749,6.2
54037,2020-10-01,29943,28718,1225,4.1
54039,2020-10-01,80314,75116,5198,6.5
54041,2020-10-01,5938,5457,481,8.1
54043,2020-10-01,7121,6653,468,6.6
54045,2020-10-01,9844,8867,977,9.9
54047,2020-10-01,4176,3749,427,10.2
54049,2020-10-01,24965,23531,1434,5.7
54051,2020-10-01,12787,11943,844,6.6
54053,2020-10-01,9496,8933,563,5.9
54055,2020-10-01,19650,18218,1432,7.3
54057,2020-10-01,12008,11411,597,5
54059,2020-10-01,6035,5351,684,11.3
54061,2020-10-01,54998,52735,2263,4.1
54063,2020-10-01,5779,5490,289,5
54065,2020-10-01,7900,7582,318,4
54067,2020-10-01,8481,7843,638,7.5
54069,2020-10-01,19364,18229,1135,5.9
54071,2020-10-01,3667,3557,110,3
54073,2020-10-01,2848,2651,197,6.9
54075,2020-10-01,4013,3786,227,5.7
54077,2020-10-01,15634,14945,689,4.4
54079,2020-10-01,26608,25351,1257,4.7
54081,2020-10-01,30624,28753,1871,6.1
54083,2020-10-01,11808,11092,716,6.1
54085,2020-10-01,4101,3860,241,5.9
54087,2020-10-01,4624,4212,412,8.9
54089,2020-10-01,3956,3724,232,5.9
54091,2020-10-01,7522,7148,374,5
54093,2020-10-01,3150,2982,168,5.3
54095,2020-10-01,2933,2708,225,7.7
54097,2020-10-01,8694,8034,660,7.6
54099,2020-10-01,15670,14795,875,5.6
54101,2020-10-01,3058,2840,218,7.1
54103,2020-10-01,6261,5822,439,7
54105,2020-10-01,2297,2124,173,7.5
54107,2020-10-01,36793,34661,2132,5.8
54109,2020-10-01,5844,5381,463,7.9
55001,2020-10-01,8140,7508,632,7.8
55003,2020-10-01,7759,7251,508,6.5
55005,2020-10-01,23766,22813,953,4
55007,2020-10-01,7394,6915,479,6.5
55009,2020-10-01,144859,137803,7056,4.9
55011,2020-10-01,6295,6004,291,4.6
55013,2020-10-01,6997,6533,464,6.6
55015,2020-10-01,27246,26226,1020,3.7
55017,2020-10-01,33281,31797,1484,4.5
55019,2020-10-01,17272,16717,555,3.2
55021,2020-10-01,32112,30674,1438,4.5
55023,2020-10-01,7337,6990,347,4.7
55025,2020-10-01,330230,316355,13875,4.2
55027,2020-10-01,47191,45284,1907,4
55029,2020-10-01,13926,13255,671,4.8
55031,2020-10-01,23071,21651,1420,6.2
55033,2020-10-01,22542,21601,941,4.2
55035,2020-10-01,59638,57137,2501,4.2
55037,2020-10-01,2249,2100,149,6.6
55039,2020-10-01,58916,56590,2326,3.9
55041,2020-10-01,4212,3754,458,10.9
55043,2020-10-01,25895,24781,1114,4.3
55045,2020-10-01,21179,20382,797,3.8
55047,2020-10-01,9124,8689,435,4.8
55049,2020-10-01,13806,13232,574,4.2
55051,2020-10-01,2583,2364,219,8.5
55053,2020-10-01,10335,9578,757,7.3
55055,2020-10-01,46135,44137,1998,4.3
55057,2020-10-01,13597,12831,766,5.6
55059,2020-10-01,89910,84420,5490,6.1
55061,2020-10-01,10914,10547,367,3.4
55063,2020-10-01,66908,64155,2753,4.1
55065,2020-10-01,9902,9568,334,3.4
55067,2020-10-01,9227,8744,483,5.2
55069,2020-10-01,15009,14371,638,4.3
55071,2020-10-01,41049,39175,1874,4.6
55073,2020-10-01,73673,70821,2852,3.9
55075,2020-10-01,19420,18252,1168,6
55077,2020-10-01,7760,7353,407,5.2
55078,2020-10-01,1717,1451,266,15.5
55079,2020-10-01,482800,444027,38773,8
55081,2020-10-01,23566,22491,1075,4.6
55083,2020-10-01,20735,19773,962,4.6
55085,2020-10-01,17167,16245,922,5.4
55087,2020-10-01,102869,98409,4460,4.3
55089,2020-10-01,49548,47197,2351,4.7
55091,2020-10-01,3975,3841,134,3.4
55093,2020-10-01,25400,24290,1110,4.4
55095,2020-10-01,24459,23281,1178,4.8
55097,2020-10-01,36812,35138,1674,4.5
55099,2020-10-01,6377,6074,303,4.8
55101,2020-10-01,102537,95993,6544,6.4
55103,2020-10-01,8999,8667,332,3.7
55105,2020-10-01,85824,80986,4838,5.6
55107,2020-10-01,6558,6248,310,4.7
55109,2020-10-01,50915,48519,2396,4.7
55111,2020-10-01,35764,33861,1903,5.3
55113,2020-10-01,7714,7237,477,6.2
55115,2020-10-01,20900,19837,1063,5.1
55117,2020-10-01,62518,59887,2631,4.2
55119,2020-10-01,10701,10334,367,3.4
55121,2020-10-01,15810,15040,770,4.9
55123,2020-10-01,15063,14477,586,3.9
55125,2020-10-01,9725,9199,526,5.4
55127,2020-10-01,55436,52741,2695,4.9
55129,2020-10-01,7709,7344,365,4.7
55131,2020-10-01,77554,74099,3455,4.5
55133,2020-10-01,227142,216237,10905,4.8
55135,2020-10-01,25742,24559,1183,4.6
55137,2020-10-01,11282,10758,524,4.6
55139,2020-10-01,93119,89165,3954,4.2
55141,2020-10-01,35379,33493,1886,5.3
56001,2020-10-01,21896,21252,644,2.9
56003,2020-10-01,5364,5160,204,3.8
56005,2020-10-01,23975,22423,1552,6.5
56007,2020-10-01,7836,7561,275,3.5
56009,2020-10-01,9246,8749,497,5.4
56011,2020-10-01,3866,3728,138,3.6
56013,2020-10-01,19296,18265,1031,5.3
56015,2020-10-01,6749,6501,248,3.7
56017,2020-10-01,2234,2136,98,4.4
56019,2020-10-01,4206,4015,191,4.5
56021,2020-10-01,48929,46740,2189,4.5
56023,2020-10-01,8901,8546,355,4
56025,2020-10-01,39629,36586,3043,7.7
56027,2020-10-01,1285,1240,45,3.5
56029,2020-10-01,15112,14480,632,4.2
56031,2020-10-01,4864,4677,187,3.8
56033,2020-10-01,16130,15455,675,4.2
56035,2020-10-01,4139,3904,235,5.7
56037,2020-10-01,21300,20006,1294,6.1
56039,2020-10-01,14147,13521,626,4.4
56041,2020-10-01,9076,8568,508,5.6
56043,2020-10-01,3905,3751,154,3.9
56045,2020-10-01,3877,3748,129,3.3
72001,2020-10-01,3918,3497,421,10.7
72003,2020-10-01,11077,10138,939,8.5
72005,2020-10-01,13609,12373,1236,9.1
72007,2020-10-01,6104,5524,580,9.5
72009,2020-10-01,5994,5482,512,8.5
72011,2020-10-01,8256,7628,628,7.6
72013,2020-10-01,23504,21593,1911,8.1
72015,2020-10-01,4186,3827,359,8.6
72017,2020-10-01,5447,4896,551,10.1
72019,2020-10-01,6828,6189,639,9.4
72021,2020-10-01,62446,56939,5507,8.8
72023,2020-10-01,12943,11884,1059,8.2
72025,2020-10-01,44929,41389,3540,7.9
72027,2020-10-01,9343,8626,717,7.7
72029,2020-10-01,15280,13944,1336,8.7
72031,2020-10-01,58934,53775,5159,8.8
72033,2020-10-01,7509,6759,750,10
72035,2020-10-01,14965,13945,1020,6.8
72037,2020-10-01,3435,3107,328,9.5
72039,2020-10-01,3532,3096,436,12.3
72041,2020-10-01,14314,13473,841,5.9
72043,2020-10-01,9061,8199,862,9.5
72045,2020-10-01,4617,4161,456,9.9
72047,2020-10-01,8544,7555,989,11.6
72049,2020-10-01,882,805,77,8.7
72051,2020-10-01,12515,11600,915,7.3
72053,2020-10-01,10206,9145,1061,10.4
72054,2020-10-01,3107,2754,353,11.4
72055,2020-10-01,3839,3432,407,10.6
72057,2020-10-01,9979,9189,790,7.9
72059,2020-10-01,4538,4087,451,9.9
72061,2020-10-01,35534,33580,1954,5.5
72063,2020-10-01,16814,15830,984,5.9
72065,2020-10-01,12791,11891,900,7
72067,2020-10-01,5005,4596,409,8.2
72069,2020-10-01,15869,14626,1243,7.8
72071,2020-10-01,10964,10077,887,8.1
72073,2020-10-01,3964,3617,347,8.8
72075,2020-10-01,14749,13674,1075,7.3
72077,2020-10-01,11497,10483,1014,8.8
72079,2020-10-01,4947,4435,512,10.3
72081,2020-10-01,6706,6023,683,10.2
72083,2020-10-01,2483,2255,228,9.2
72085,2020-10-01,10462,9587,875,8.4
72087,2020-10-01,8030,7232,798,9.9
72089,2020-10-01,5848,5219,629,10.8
72091,2020-10-01,10971,10090,881,8
72093,2020-10-01,1748,1623,125,7.2
72095,2020-10-01,2552,2324,228,8.9
72097,2020-10-01,20057,18409,1648,8.2
72099,2020-10-01,9755,8866,889,9.1
72101,2020-10-01,7537,6756,781,10.4
72103,2020-10-01,7527,6940,587,7.8
72105,2020-10-01,6803,5986,817,12
72107,2020-10-01,4609,4078,531,11.5
72109,2020-10-01,3796,3440,356,9.4
72111,2020-10-01,5363,4815,548,10.2
72113,2020-10-01,42790,39218,3572,8.3
72115,2020-10-01,5863,5311,552,9.4
72117,2020-10-01,4270,3874,396,9.3
72119,2020-10-01,16172,14602,1570,9.7
72121,2020-10-01,5607,5138,469,8.4
72123,2020-10-01,6428,5746,682,10.6
72125,2020-10-01,9019,8257,762,8.4
72127,2020-10-01,128494,118005,10489,8.2
72129,2020-10-01,10777,9916,861,8
72131,2020-10-01,9542,8564,978,10.2
72133,2020-10-01,8207,7587,620,7.6
72135,2020-10-01,25626,23745,1881,7.3
72137,2020-10-01,27786,25566,2220,8
72139,2020-10-01,25559,23931,1628,6.4
72141,2020-10-01,6163,5650,513,8.3
72143,2020-10-01,9268,8295,973,10.5
72145,2020-10-01,12548,11152,1396,11.1
72147,2020-10-01,2389,2135,254,10.6
72149,2020-10-01,6563,5929,634,9.7
72151,2020-10-01,7959,7172,787,9.9
72153,2020-10-01,9190,8260,930,10.1
01001,2020-11-01,25334,24482,852,3.4
01003,2020-11-01,92160,88745,3415,3.7
01005,2020-11-01,9733,9190,543,5.6
01007,2020-11-01,8627,8251,376,4.4
01009,2020-11-01,24849,24210,639,2.6
01011,2020-11-01,5223,4990,233,4.5
01013,2020-11-01,9826,9248,578,5.9
01015,2020-11-01,44578,42462,2116,4.7
01017,2020-11-01,16776,16057,719,4.3
01019,2020-11-01,12193,11871,322,2.6
01021,2020-11-01,19578,18969,609,3.1
01023,2020-11-01,5152,4937,215,4.2
01025,2020-11-01,8571,8050,521,6.1
01027,2020-11-01,6855,6665,190,2.8
01029,2020-11-01,6069,5914,155,2.6
01031,2020-11-01,23681,23029,652,2.8
01033,2020-11-01,23391,22447,944,4
01035,2020-11-01,4977,4732,245,4.9
01037,2020-11-01,4924,4752,172,3.5
01039,2020-11-01,16739,16242,497,3
01041,2020-11-01,6781,6555,226,3.3
01043,2020-11-01,41846,40861,985,2.4
01045,2020-11-01,22528,21768,760,3.4
01047,2020-11-01,15908,14721,1187,7.5
01049,2020-11-01,34471,33604,867,2.5
01051,2020-11-01,36326,35125,1201,3.3
01053,2020-11-01,16433,15796,637,3.9
01055,2020-11-01,41023,39132,1891,4.6
01057,2020-11-01,7081,6854,227,3.2
01059,2020-11-01,15712,15319,393,2.5
01061,2020-11-01,10944,10628,316,2.9
01063,2020-11-01,3227,2986,241,7.5
01065,2020-11-01,6289,5876,413,6.6
01067,2020-11-01,6829,6584,245,3.6
01069,2020-11-01,45789,43922,1867,4.1
01071,2020-11-01,24153,23427,726,3
01073,2020-11-01,317174,302762,14412,4.5
01075,2020-11-01,6317,6145,172,2.7
01077,2020-11-01,41928,40551,1377,3.3
01079,2020-11-01,14088,13631,457,3.2
01081,2020-11-01,76026,73458,2568,3.4
01083,2020-11-01,43480,42304,1176,2.7
01085,2020-11-01,3665,3274,391,10.7
01087,2020-11-01,8597,8019,578,6.7
01089,2020-11-01,184393,178479,5914,3.2
01091,2020-11-01,8644,8258,386,4.5
01093,2020-11-01,14987,14556,431,2.9
01095,2020-11-01,48278,47088,1190,2.5
01097,2020-11-01,186964,176136,10828,5.8
01099,2020-11-01,8197,7750,447,5.5
01101,2020-11-01,104876,98429,6447,6.1
01103,2020-11-01,57433,55676,1757,3.1
01105,2020-11-01,3826,3521,305,8
01107,2020-11-01,7924,7567,357,4.5
01109,2020-11-01,17848,17268,580,3.2
01111,2020-11-01,10451,10181,270,2.6
01113,2020-11-01,23013,22179,834,3.6
01115,2020-11-01,39809,38591,1218,3.1
01117,2020-11-01,113657,110883,2774,2.4
01119,2020-11-01,5211,4962,249,4.8
01121,2020-11-01,38914,37338,1576,4
01123,2020-11-01,19501,18631,870,4.5
01125,2020-11-01,104619,100202,4417,4.2
01127,2020-11-01,24971,23984,987,4
01129,2020-11-01,7368,6993,375,5.1
01131,2020-11-01,3144,2799,345,11
01133,2020-11-01,10684,10359,325,3
02013,2020-11-01,1655,1585,70,4.2
02016,2020-11-01,2812,2684,128,4.6
02020,2020-11-01,151239,142188,9051,6
02050,2020-11-01,7347,6660,687,9.4
02060,2020-11-01,253,233,20,7.9
02068,2020-11-01,535,458,77,14.4
02070,2020-11-01,1696,1580,116,6.8
02090,2020-11-01,45133,42887,2246,5
02100,2020-11-01,943,838,105,11.1
02105,2020-11-01,949,849,100,10.5
02110,2020-11-01,16313,15484,829,5.1
02122,2020-11-01,25085,23009,2076,8.3
02130,2020-11-01,6356,5864,492,7.7
02150,2020-11-01,5609,5280,329,5.9
02158,2020-11-01,2740,2359,381,13.9
02164,2020-11-01,606,562,44,7.3
02170,2020-11-01,47657,44519,3138,6.6
02180,2020-11-01,4116,3807,309,7.5
02185,2020-11-01,2907,2724,183,6.3
02188,2020-11-01,3082,2786,296,9.6
02195,2020-11-01,1250,1163,87,7
02198,2020-11-01,2784,2592,192,6.9
02220,2020-11-01,3947,3741,206,5.2
02230,2020-11-01,577,481,96,16.6
02240,2020-11-01,2898,2712,186,6.4
02261,2020-11-01,3994,3663,331,8.3
02275,2020-11-01,971,909,62,6.4
02282,2020-11-01,226,209,17,7.5
02290,2020-11-01,2412,2224,188,7.8
04001,2020-11-01,19844,17316,2528,12.7
04003,2020-11-01,51669,48302,3367,6.5
04005,2020-11-01,69137,62435,6702,9.7
04007,2020-11-01,20849,19229,1620,7.8
04009,2020-11-01,15714,14714,1000,6.4
04011,2020-11-01,4575,4299,276,6
04012,2020-11-01,9975,9338,637,6.4
04013,2020-11-01,NA,NA,172503,7.4
04015,2020-11-01,86303,78707,7596,8.8
04017,2020-11-01,39962,36085,3877,9.7
04019,2020-11-01,498372,459898,38474,7.7
04021,2020-11-01,191190,177017,14173,7.4
04023,2020-11-01,19447,17133,2314,11.9
04025,2020-11-01,108841,101470,7371,6.8
04027,2020-11-01,96947,83123,13824,14.3
05001,2020-11-01,9213,8812,401,4.4
05003,2020-11-01,7302,6642,660,9
05005,2020-11-01,15717,14866,851,5.4
05007,2020-11-01,135200,129395,5805,4.3
05009,2020-11-01,15563,14851,712,4.6
05011,2020-11-01,4385,4138,247,5.6
05013,2020-11-01,2373,2255,118,5
05015,2020-11-01,12420,11796,624,5
05017,2020-11-01,3158,2803,355,11.2
05019,2020-11-01,9359,8858,501,5.4
05021,2020-11-01,5411,5145,266,4.9
05023,2020-11-01,8823,8212,611,6.9
05025,2020-11-01,3071,2868,203,6.6
05027,2020-11-01,9163,8522,641,7
05029,2020-11-01,7967,7503,464,5.8
05031,2020-11-01,56043,53407,2636,4.7
05033,2020-11-01,25574,24265,1309,5.1
05035,2020-11-01,20868,19228,1640,7.9
05037,2020-11-01,7253,6825,428,5.9
05039,2020-11-01,2664,2531,133,5
05041,2020-11-01,5241,4882,359,6.8
05043,2020-11-01,7559,7072,487,6.4
05045,2020-11-01,58336,55382,2954,5.1
05047,2020-11-01,7269,6884,385,5.3
05049,2020-11-01,4882,4639,243,5
05051,2020-11-01,40519,37501,3018,7.4
05053,2020-11-01,7859,7466,393,5
05055,2020-11-01,19535,18561,974,5
05057,2020-11-01,9472,9032,440,4.6
05059,2020-11-01,13517,12768,749,5.5
05061,2020-11-01,5421,5164,257,4.7
05063,2020-11-01,16229,15420,809,5
05065,2020-11-01,4703,4359,344,7.3
05067,2020-11-01,5503,5111,392,7.1
05069,2020-11-01,26435,24124,2311,8.7
05071,2020-11-01,9844,9297,547,5.6
05073,2020-11-01,2441,2231,210,8.6
05075,2020-11-01,6833,6447,386,5.6
05077,2020-11-01,2736,2533,203,7.4
05079,2020-11-01,3732,3507,225,6
05081,2020-11-01,5397,5069,328,6.1
05083,2020-11-01,8070,7572,498,6.2
05085,2020-11-01,32342,30605,1737,5.4
05087,2020-11-01,7339,7046,293,4
05089,2020-11-01,6435,6036,399,6.2
05091,2020-11-01,19404,18164,1240,6.4
05093,2020-11-01,17097,15584,1513,8.8
05095,2020-11-01,2737,2532,205,7.5
05097,2020-11-01,2860,2667,193,6.7
05099,2020-11-01,3494,3307,187,5.4
05101,2020-11-01,3218,3085,133,4.1
05103,2020-11-01,9444,8921,523,5.5
05105,2020-11-01,3966,3763,203,5.1
05107,2020-11-01,6171,5606,565,9.2
05109,2020-11-01,4183,3923,260,6.2
05111,2020-11-01,10348,9830,518,5
05113,2020-11-01,7867,7365,502,6.4
05115,2020-11-01,28056,26603,1453,5.2
05117,2020-11-01,3491,3301,190,5.4
05119,2020-11-01,181725,167916,13809,7.6
05121,2020-11-01,7249,6821,428,5.9
05123,2020-11-01,8013,7384,629,7.8
05125,2020-11-01,55154,52493,2661,4.8
05127,2020-11-01,4253,4060,193,4.5
05129,2020-11-01,2759,2607,152,5.5
05131,2020-11-01,54109,51037,3072,5.7
05133,2020-11-01,5375,5048,327,6.1
05135,2020-11-01,5611,5219,392,7
05137,2020-11-01,4604,4273,331,7.2
05139,2020-11-01,15280,14060,1220,8
05141,2020-11-01,5571,5171,400,7.2
05143,2020-11-01,123545,118034,5511,4.5
05145,2020-11-01,32545,30618,1927,5.9
05147,2020-11-01,2682,2510,172,6.4
05149,2020-11-01,8194,7822,372,4.5
06001,2020-11-01,814133,759131,55002,6.8
06003,2020-11-01,518,482,36,6.9
06005,2020-11-01,14193,13208,985,6.9
06007,2020-11-01,93288,86958,6330,6.8
06009,2020-11-01,20155,18969,1186,5.9
06011,2020-11-01,9531,8485,1046,11
06013,2020-11-01,541366,504361,37005,6.8
06015,2020-11-01,9068,8373,695,7.7
06017,2020-11-01,90066,84940,5126,5.7
06019,2020-11-01,440520,402901,37619,8.5
06021,2020-11-01,12487,11735,752,6
06023,2020-11-01,60349,56693,3656,6.1
06025,2020-11-01,65826,55153,10673,16.2
06027,2020-11-01,8226,7748,478,5.8
06029,2020-11-01,370187,335478,34709,9.4
06031,2020-11-01,54769,49945,4824,8.8
06033,2020-11-01,28703,26636,2067,7.2
06035,2020-11-01,9642,9141,501,5.2
06037,2020-11-01,NA,NA,588980,11.9
06039,2020-11-01,59928,55091,4837,8.1
06041,2020-11-01,134651,128308,6343,4.7
06043,2020-11-01,7239,6684,555,7.7
06045,2020-11-01,36030,33587,2443,6.8
06047,2020-11-01,111958,101850,10108,9
06049,2020-11-01,3057,2870,187,6.1
06051,2020-11-01,7309,6722,587,8
06053,2020-11-01,188744,174277,14467,7.7
06055,2020-11-01,71141,66863,4278,6
06057,2020-11-01,46447,43824,2623,5.6
06059,2020-11-01,NA,NA,101547,6.4
06061,2020-11-01,183923,174316,9607,5.2
06063,2020-11-01,7408,6873,535,7.2
06065,2020-11-01,NA,NA,85643,7.8
06067,2020-11-01,709047,657076,51971,7.3
06069,2020-11-01,30763,28635,2128,6.9
06071,2020-11-01,969431,892480,76951,7.9
06073,2020-11-01,NA,NA,105010,6.6
06075,2020-11-01,566401,534126,32275,5.7
06077,2020-11-01,321880,293019,28861,9
06079,2020-11-01,131451,124255,7196,5.5
06081,2020-11-01,444607,422017,22590,5.1
06083,2020-11-01,213227,200855,12372,5.8
06085,2020-11-01,NA,988767,53123,5.1
06087,2020-11-01,127632,119006,8626,6.8
06089,2020-11-01,72945,68183,4762,6.5
06091,2020-11-01,1277,1212,65,5.1
06093,2020-11-01,15890,14730,1160,7.3
06095,2020-11-01,203564,188277,15287,7.5
06097,2020-11-01,250429,236642,13787,5.5
06099,2020-11-01,234915,215559,19356,8.2
06101,2020-11-01,41121,37571,3550,8.6
06103,2020-11-01,24400,22736,1664,6.8
06105,2020-11-01,4244,3985,259,6.1
06107,2020-11-01,192218,173525,18693,9.7
06109,2020-11-01,19663,18212,1451,7.4
06111,2020-11-01,412507,386561,25946,6.3
06113,2020-11-01,105655,99569,6086,5.8
06115,2020-11-01,28399,25936,2463,8.7
08001,2020-11-01,282799,262833,19966,7.1
08003,2020-11-01,8600,8103,497,5.8
08005,2020-11-01,378262,352532,25730,6.8
08007,2020-11-01,6946,6541,405,5.8
08009,2020-11-01,2139,2090,49,2.3
08011,2020-11-01,1935,1844,91,4.7
08013,2020-11-01,194958,185066,9892,5.1
08014,2020-11-01,41045,38859,2186,5.3
08015,2020-11-01,8931,8460,471,5.3
08017,2020-11-01,1141,1111,30,2.6
08019,2020-11-01,6278,5859,419,6.7
08021,2020-11-01,4085,3870,215,5.3
08023,2020-11-01,1781,1655,126,7.1
08025,2020-11-01,1503,1415,88,5.9
08027,2020-11-01,2120,2029,91,4.3
08029,2020-11-01,14443,13630,813,5.6
08031,2020-11-01,434198,403061,31137,7.2
08033,2020-11-01,1175,1112,63,5.4
08035,2020-11-01,197444,188351,9093,4.6
08037,2020-11-01,31383,28936,2447,7.8
08039,2020-11-01,15333,14748,585,3.8
08041,2020-11-01,350749,329553,21196,6
08043,2020-11-01,15124,14004,1120,7.4
08045,2020-11-01,28919,27225,1694,5.9
08047,2020-11-01,3923,3670,253,6.4
08049,2020-11-01,8240,7693,547,6.6
08051,2020-11-01,10386,9852,534,5.1
08053,2020-11-01,354,340,14,4
08055,2020-11-01,2623,2394,229,8.7
08057,2020-11-01,971,935,36,3.7
08059,2020-11-01,344572,324562,20010,5.8
08061,2020-11-01,972,949,23,2.4
08063,2020-11-01,4363,4247,116,2.7
08065,2020-11-01,4433,4128,305,6.9
08067,2020-11-01,30478,28651,1827,6
08069,2020-11-01,205877,195210,10667,5.2
08071,2020-11-01,6443,5959,484,7.5
08073,2020-11-01,2373,2267,106,4.5
08075,2020-11-01,11103,10607,496,4.5
08077,2020-11-01,79580,74763,4817,6.1
08079,2020-11-01,335,312,23,6.9
08081,2020-11-01,7144,6816,328,4.6
08083,2020-11-01,12372,11643,729,5.9
08085,2020-11-01,21332,20157,1175,5.5
08087,2020-11-01,15917,15066,851,5.3
08089,2020-11-01,8422,7908,514,6.1
08091,2020-11-01,2233,2081,152,6.8
08093,2020-11-01,11323,10826,497,4.4
08095,2020-11-01,2459,2398,61,2.5
08097,2020-11-01,10482,9410,1072,10.2
08099,2020-11-01,6410,6123,287,4.5
08101,2020-11-01,79093,72498,6595,8.3
08103,2020-11-01,3009,2867,142,4.7
08105,2020-11-01,5460,5102,358,6.6
08107,2020-11-01,15141,14269,872,5.8
08109,2020-11-01,3499,3256,243,6.9
08111,2020-11-01,355,335,20,5.6
08113,2020-11-01,4333,3843,490,11.3
08115,2020-11-01,1062,1023,39,3.7
08117,2020-11-01,19688,18344,1344,6.8
08119,2020-11-01,13064,12354,710,5.4
08121,2020-11-01,2840,2753,87,3.1
08123,2020-11-01,171808,160766,11042,6.4
08125,2020-11-01,5271,5121,150,2.8
09001,2020-11-01,466438,430489,35949,7.7
09003,2020-11-01,483427,444718,38709,8
09005,2020-11-01,102902,96283,6619,6.4
09007,2020-11-01,93113,87322,5791,6.2
09009,2020-11-01,458175,420854,37321,8.1
09011,2020-11-01,133155,121600,11555,8.7
09013,2020-11-01,85716,80781,4935,5.8
09015,2020-11-01,63127,58483,4644,7.4
10001,2020-11-01,80369,76396,3973,4.9
10003,2020-11-01,296100,281958,14142,4.8
10005,2020-11-01,104428,100170,4258,4.1
11001,2020-11-01,409289,375016,34273,8.4
12001,2020-11-01,136645,130550,6095,4.5
12003,2020-11-01,11714,11170,544,4.6
12005,2020-11-01,80480,76515,3965,4.9
12007,2020-11-01,10981,10435,546,5
12009,2020-11-01,284319,270044,14275,5
12011,2020-11-01,NA,939914,70528,7
12013,2020-11-01,4630,4403,227,4.9
12015,2020-11-01,72225,68517,3708,5.1
12017,2020-11-01,45478,42481,2997,6.6
12019,2020-11-01,105925,101573,4352,4.1
12021,2020-11-01,178404,170019,8385,4.7
12023,2020-11-01,29818,28189,1629,5.5
12027,2020-11-01,14594,13982,612,4.2
12029,2020-11-01,5734,5456,278,4.8
12031,2020-11-01,489932,462589,27343,5.6
12033,2020-11-01,143961,135845,8116,5.6
12035,2020-11-01,45979,43385,2594,5.6
12037,2020-11-01,4407,4189,218,4.9
12039,2020-11-01,18430,17126,1304,7.1
12041,2020-11-01,6967,6658,309,4.4
12043,2020-11-01,5393,5158,235,4.4
12045,2020-11-01,5450,5189,261,4.8
12047,2020-11-01,4278,3969,309,7.2
12049,2020-11-01,8500,8029,471,5.5
12051,2020-11-01,15460,14455,1005,6.5
12053,2020-11-01,70759,66479,4280,6
12055,2020-11-01,36703,34402,2301,6.3
12057,2020-11-01,744214,702313,41901,5.6
12059,2020-11-01,6829,6525,304,4.5
12061,2020-11-01,64824,61264,3560,5.5
12063,2020-11-01,16991,16080,911,5.4
12065,2020-11-01,5379,5083,296,5.5
12067,2020-11-01,2781,2658,123,4.4
12069,2020-11-01,150149,140779,9370,6.2
12071,2020-11-01,344692,326146,18546,5.4
12073,2020-11-01,148277,140367,7910,5.3
12075,2020-11-01,16545,15699,846,5.1
12077,2020-11-01,2544,2421,123,4.8
12079,2020-11-01,7590,7131,459,6
12081,2020-11-01,176103,167262,8841,5
12083,2020-11-01,141752,133648,8104,5.7
12085,2020-11-01,72851,69752,3099,4.3
12086,2020-11-01,NA,NA,106956,8.2
12087,2020-11-01,48931,46861,2070,4.2
12089,2020-11-01,40496,38827,1669,4.1
12091,2020-11-01,93343,89542,3801,4.1
12093,2020-11-01,17561,16750,811,4.6
12095,2020-11-01,732539,675403,57136,7.8
12097,2020-11-01,179178,162472,16706,9.3
12099,2020-11-01,701387,660347,41040,5.9
12101,2020-11-01,234385,221545,12840,5.5
12103,2020-11-01,487717,462368,25349,5.2
12105,2020-11-01,306823,285217,21606,7
12107,2020-11-01,26316,24394,1922,7.3
12109,2020-11-01,130007,125118,4889,3.8
12111,2020-11-01,144008,135274,8734,6.1
12113,2020-11-01,80635,77460,3175,3.9
12115,2020-11-01,183938,175081,8857,4.8
12117,2020-11-01,239273,226241,13032,5.4
12119,2020-11-01,32350,30421,1929,6
12121,2020-11-01,17862,16970,892,5
12123,2020-11-01,8281,7755,526,6.4
12125,2020-11-01,4503,4296,207,4.6
12127,2020-11-01,250073,235412,14661,5.9
12129,2020-11-01,14044,13527,517,3.7
12131,2020-11-01,30439,29133,1306,4.3
12133,2020-11-01,9300,8843,457,4.9
13001,2020-11-01,9674,9317,357,3.7
13003,2020-11-01,4386,4247,139,3.2
13005,2020-11-01,4873,4678,195,4
13007,2020-11-01,1174,1110,64,5.5
13009,2020-11-01,18512,17426,1086,5.9
13011,2020-11-01,10175,9875,300,2.9
13013,2020-11-01,40279,38721,1558,3.9
13015,2020-11-01,50595,48254,2341,4.6
13017,2020-11-01,5471,5103,368,6.7
13019,2020-11-01,7671,7348,323,4.2
13021,2020-11-01,69494,64825,4669,6.7
13023,2020-11-01,4565,4304,261,5.7
13025,2020-11-01,6606,6304,302,4.6
13027,2020-11-01,7321,6983,338,4.6
13029,2020-11-01,18222,17457,765,4.2
13031,2020-11-01,38420,36390,2030,5.3
13033,2020-11-01,9013,8414,599,6.6
13035,2020-11-01,10829,10244,585,5.4
13037,2020-11-01,2423,2319,104,4.3
13039,2020-11-01,20600,19788,812,3.9
13043,2020-11-01,5797,5566,231,4
13045,2020-11-01,55384,52631,2753,5
13047,2020-11-01,33712,32744,968,2.9
13049,2020-11-01,4816,4655,161,3.3
13051,2020-11-01,141536,132831,8705,6.2
13053,2020-11-01,1945,1832,113,5.8
13055,2020-11-01,9863,9345,518,5.3
13057,2020-11-01,134989,130259,4730,3.5
13059,2020-11-01,59342,56307,3035,5.1
13061,2020-11-01,970,864,106,10.9
13063,2020-11-01,143817,130181,13636,9.5
13065,2020-11-01,2549,2443,106,4.2
13067,2020-11-01,426407,406773,19634,4.6
13069,2020-11-01,19479,18517,962,4.9
13071,2020-11-01,21950,21075,875,4
13073,2020-11-01,72508,70133,2375,3.3
13075,2020-11-01,8398,8047,351,4.2
13077,2020-11-01,74932,71432,3500,4.7
13079,2020-11-01,5613,5390,223,4
13081,2020-11-01,10007,9229,778,7.8
13083,2020-11-01,8225,7984,241,2.9
13085,2020-11-01,12255,11818,437,3.6
13087,2020-11-01,11615,11094,521,4.5
13089,2020-11-01,407864,380227,27637,6.8
13091,2020-11-01,6891,6535,356,5.2
13093,2020-11-01,5219,4896,323,6.2
13095,2020-11-01,38470,35320,3150,8.2
13097,2020-11-01,74291,69641,4650,6.3
13099,2020-11-01,4552,4280,272,6
13101,2020-11-01,2023,1957,66,3.3
13103,2020-11-01,30750,29521,1229,4
13105,2020-11-01,7953,7453,500,6.3
13107,2020-11-01,8363,7776,587,7
13109,2020-11-01,5034,4788,246,4.9
13111,2020-11-01,12621,12242,379,3
13113,2020-11-01,57823,55474,2349,4.1
13115,2020-11-01,45118,43128,1990,4.4
13117,2020-11-01,121090,117124,3966,3.3
13119,2020-11-01,10176,9727,449,4.4
13121,2020-11-01,568792,530149,38643,6.8
13123,2020-11-01,11513,11088,425,3.7
13125,2020-11-01,1240,1202,38,3.1
13127,2020-11-01,35744,33748,1996,5.6
13129,2020-11-01,29383,28226,1157,3.9
13131,2020-11-01,10437,10021,416,4
13133,2020-11-01,7193,6827,366,5.1
13135,2020-11-01,492711,468174,24537,5
13137,2020-11-01,18964,18188,776,4.1
13139,2020-11-01,101997,98444,3553,3.5
13141,2020-11-01,2651,2432,219,8.3
13143,2020-11-01,12532,11973,559,4.5
13145,2020-11-01,16003,15467,536,3.3
13147,2020-11-01,11192,10687,505,4.5
13149,2020-11-01,5277,5013,264,5
13151,2020-11-01,117072,109881,7191,6.1
13153,2020-11-01,69015,65944,3071,4.4
13155,2020-11-01,3520,3354,166,4.7
13157,2020-11-01,39318,38059,1259,3.2
13159,2020-11-01,6927,6650,277,4
13161,2020-11-01,5913,5635,278,4.7
13163,2020-11-01,6721,6320,401,6
13165,2020-11-01,3152,2982,170,5.4
13167,2020-11-01,4060,3880,180,4.4
13169,2020-11-01,13703,13200,503,3.7
13171,2020-11-01,8234,7801,433,5.3
13173,2020-11-01,3926,3753,173,4.4
13175,2020-11-01,19233,18173,1060,5.5
13177,2020-11-01,14334,13812,522,3.6
13179,2020-11-01,27015,25608,1407,5.2
13181,2020-11-01,3480,3323,157,4.5
13183,2020-11-01,8316,8018,298,3.6
13185,2020-11-01,54229,51516,2713,5
13187,2020-11-01,16568,16050,518,3.1
13189,2020-11-01,8639,8091,548,6.3
13191,2020-11-01,5652,5359,293,5.2
13193,2020-11-01,4716,4413,303,6.4
13195,2020-11-01,13248,12726,522,3.9
13197,2020-11-01,3174,3039,135,4.3
13199,2020-11-01,9044,8414,630,7
13201,2020-11-01,2760,2660,100,3.6
13205,2020-11-01,8557,8035,522,6.1
13207,2020-11-01,13055,12514,541,4.1
13209,2020-11-01,3846,3669,177,4.6
13211,2020-11-01,9280,8872,408,4.4
13213,2020-11-01,15091,14260,831,5.5
13215,2020-11-01,75807,70680,5127,6.8
13217,2020-11-01,52739,49526,3213,6.1
13219,2020-11-01,19297,18791,506,2.6
13221,2020-11-01,6913,6659,254,3.7
13223,2020-11-01,85837,82274,3563,4.2
13225,2020-11-01,11729,11065,664,5.7
13227,2020-11-01,15146,14611,535,3.5
13229,2020-11-01,8611,8286,325,3.8
13231,2020-11-01,8840,8522,318,3.6
13233,2020-11-01,18532,17666,866,4.7
13235,2020-11-01,3960,3806,154,3.9
13237,2020-11-01,8284,7847,437,5.3
13239,2020-11-01,851,806,45,5.3
13241,2020-11-01,7106,6844,262,3.7
13243,2020-11-01,2657,2516,141,5.3
13245,2020-11-01,83910,78144,5766,6.9
13247,2020-11-01,45422,42460,2962,6.5
13249,2020-11-01,2306,2228,78,3.4
13251,2020-11-01,5238,4882,356,6.8
13253,2020-11-01,3073,2926,147,4.8
13255,2020-11-01,29080,27165,1915,6.6
13257,2020-11-01,10826,10279,547,5.1
13259,2020-11-01,2657,2528,129,4.9
13261,2020-11-01,13642,12737,905,6.6
13263,2020-11-01,2791,2624,167,6
13265,2020-11-01,579,547,32,5.5
13267,2020-11-01,9556,9197,359,3.8
13269,2020-11-01,2883,2710,173,6
13271,2020-11-01,3664,3345,319,8.7
13273,2020-11-01,3520,3235,285,8.1
13275,2020-11-01,16916,15956,960,5.7
13277,2020-11-01,21000,20085,915,4.4
13279,2020-11-01,11899,11258,641,5.4
13281,2020-11-01,3597,3412,185,5.1
13283,2020-11-01,2595,2457,138,5.3
13285,2020-11-01,38699,36512,2187,5.7
13287,2020-11-01,3287,3029,258,7.8
13289,2020-11-01,2880,2711,169,5.9
13291,2020-11-01,10401,10068,333,3.2
13293,2020-11-01,11394,10788,606,5.3
13295,2020-11-01,31560,30480,1080,3.4
13297,2020-11-01,45911,44004,1907,4.2
13299,2020-11-01,15485,14762,723,4.7
13301,2020-11-01,2827,2684,143,5.1
13303,2020-11-01,6802,6365,437,6.4
13305,2020-11-01,11132,10574,558,5
13307,2020-11-01,1054,1005,49,4.6
13309,2020-11-01,1616,1519,97,6
13311,2020-11-01,16704,16229,475,2.8
13313,2020-11-01,42397,40237,2160,5.1
13315,2020-11-01,2761,2616,145,5.3
13317,2020-11-01,3943,3715,228,5.8
13319,2020-11-01,4012,3821,191,4.8
13321,2020-11-01,8778,8329,449,5.1
15001,2020-11-01,90833,81629,9204,10.1
15003,2020-11-01,453688,412513,41175,9.1
15007,2020-11-01,35697,30745,4952,13.9
15009,2020-11-01,82913,69412,13501,16.3
16001,2020-11-01,259747,247516,12231,4.7
16003,2020-11-01,1795,1639,156,8.7
16005,2020-11-01,41401,39470,1931,4.7
16007,2020-11-01,3119,3004,115,3.7
16009,2020-11-01,4224,3970,254,6
16011,2020-11-01,24589,23660,929,3.8
16013,2020-11-01,12152,11452,700,5.8
16015,2020-11-01,3626,3365,261,7.2
16017,2020-11-01,21773,20428,1345,6.2
16019,2020-11-01,60390,58164,2226,3.7
16021,2020-11-01,5640,5336,304,5.4
16023,2020-11-01,1448,1400,48,3.3
16025,2020-11-01,686,661,25,3.6
16027,2020-11-01,105934,100320,5614,5.3
16029,2020-11-01,4171,4009,162,3.9
16031,2020-11-01,12929,12496,433,3.3
16033,2020-11-01,385,371,14,3.6
16035,2020-11-01,3119,2895,224,7.2
16037,2020-11-01,2168,2054,114,5.3
16039,2020-11-01,12325,11787,538,4.4
16041,2020-11-01,7123,6890,233,3.3
16043,2020-11-01,8599,8299,300,3.5
16045,2020-11-01,8522,8032,490,5.7
16047,2020-11-01,8582,8273,309,3.6
16049,2020-11-01,6825,6408,417,6.1
16051,2020-11-01,14656,14215,441,3
16053,2020-11-01,12518,12042,476,3.8
16055,2020-11-01,78403,73440,4963,6.3
16057,2020-11-01,20730,19879,851,4.1
16059,2020-11-01,3707,3478,229,6.2
16061,2020-11-01,1697,1578,119,7
16063,2020-11-01,2642,2512,130,4.9
16065,2020-11-01,24166,23555,611,2.5
16067,2020-11-01,12254,11805,449,3.7
16069,2020-11-01,20012,19124,888,4.4
16071,2020-11-01,2425,2338,87,3.6
16073,2020-11-01,5370,5072,298,5.5
16075,2020-11-01,12321,11708,613,5
16077,2020-11-01,4178,3991,187,4.5
16079,2020-11-01,5691,5194,497,8.7
16081,2020-11-01,6575,6193,382,5.8
16083,2020-11-01,42501,40565,1936,4.6
16085,2020-11-01,5524,5123,401,7.3
16087,2020-11-01,4961,4730,231,4.7
17001,2020-11-01,31320,30054,1266,4
17003,2020-11-01,1931,1787,144,7.5
17005,2020-11-01,7527,7208,319,4.2
17007,2020-11-01,24407,22887,1520,6.2
17009,2020-11-01,2867,2794,73,2.5
17011,2020-11-01,16613,15820,793,4.8
17013,2020-11-01,2222,2131,91,4.1
17015,2020-11-01,7132,6808,324,4.5
17017,2020-11-01,5949,5664,285,4.8
17019,2020-11-01,110547,105394,5153,4.7
17021,2020-11-01,13725,13012,713,5.2
17023,2020-11-01,7200,6876,324,4.5
17025,2020-11-01,5911,5610,301,5.1
17027,2020-11-01,19792,19103,689,3.5
17029,2020-11-01,23896,22670,1226,5.1
17031,2020-11-01,NA,NA,195561,7.8
17033,2020-11-01,8341,7954,387,4.6
17035,2020-11-01,5938,5695,243,4.1
17037,2020-11-01,52153,49201,2952,5.7
17039,2020-11-01,7134,6785,349,4.9
17041,2020-11-01,10087,9707,380,3.8
17043,2020-11-01,480254,454639,25615,5.3
17045,2020-11-01,8378,8039,339,4
17047,2020-11-01,2573,2462,111,4.3
17049,2020-11-01,18817,18055,762,4
17051,2020-11-01,9577,9121,456,4.8
17053,2020-11-01,6406,6129,277,4.3
17055,2020-11-01,15757,14803,954,6.1
17057,2020-11-01,14339,13566,773,5.4
17059,2020-11-01,2144,2021,123,5.7
17061,2020-11-01,5942,5659,283,4.8
17063,2020-11-01,23666,22388,1278,5.4
17065,2020-11-01,4209,4057,152,3.6
17067,2020-11-01,8142,7824,318,3.9
17069,2020-11-01,1308,1228,80,6.1
17071,2020-11-01,3495,3374,121,3.5
17073,2020-11-01,23829,22672,1157,4.9
17075,2020-11-01,14054,13475,579,4.1
17077,2020-11-01,28074,26602,1472,5.2
17079,2020-11-01,4677,4488,189,4
17081,2020-11-01,16909,15939,970,5.7
17083,2020-11-01,10629,10147,482,4.5
17085,2020-11-01,10014,9546,468,4.7
17087,2020-11-01,4019,3800,219,5.4
17089,2020-11-01,259055,243059,15996,6.2
17091,2020-11-01,54821,51455,3366,6.1
17093,2020-11-01,64547,61168,3379,5.2
17095,2020-11-01,20682,19396,1286,6.2
17097,2020-11-01,360151,339380,20771,5.8
17099,2020-11-01,52247,49148,3099,5.9
17101,2020-11-01,5535,5223,312,5.6
17103,2020-11-01,17014,16231,783,4.6
17105,2020-11-01,16022,15355,667,4.2
17107,2020-11-01,12129,11571,558,4.6
17109,2020-11-01,13390,12760,630,4.7
17111,2020-11-01,155745,147537,8208,5.3
17113,2020-11-01,85035,81061,3974,4.7
17115,2020-11-01,46652,43003,3649,7.8
17117,2020-11-01,22160,21240,920,4.2
17119,2020-11-01,131512,124997,6515,5
17121,2020-11-01,16781,15831,950,5.7
17123,2020-11-01,4868,4613,255,5.2
17125,2020-11-01,5981,5660,321,5.4
17127,2020-11-01,5327,5021,306,5.7
17129,2020-11-01,6199,5945,254,4.1
17131,2020-11-01,7657,7307,350,4.6
17133,2020-11-01,18223,17634,589,3.2
17135,2020-11-01,10931,10323,608,5.6
17137,2020-11-01,16092,15320,772,4.8
17139,2020-11-01,7444,7181,263,3.5
17141,2020-11-01,23714,22469,1245,5.3
17143,2020-11-01,79531,73495,6036,7.6
17145,2020-11-01,8087,7674,413,5.1
17147,2020-11-01,8614,8282,332,3.9
17149,2020-11-01,6731,6478,253,3.8
17151,2020-11-01,1601,1521,80,5
17153,2020-11-01,1902,1750,152,8
17155,2020-11-01,3025,2882,143,4.7
17157,2020-11-01,13730,13150,580,4.2
17159,2020-11-01,6918,6608,310,4.5
17161,2020-11-01,68721,64828,3893,5.7
17163,2020-11-01,125000,117302,7698,6.2
17165,2020-11-01,9418,8852,566,6
17167,2020-11-01,98288,92419,5869,6
17169,2020-11-01,3031,2904,127,4.2
17171,2020-11-01,2499,2391,108,4.3
17173,2020-11-01,10322,9913,409,4
17175,2020-11-01,2288,2168,120,5.2
17177,2020-11-01,21175,20069,1106,5.2
17179,2020-11-01,58689,55554,3135,5.3
17181,2020-11-01,7272,6903,369,5.1
17183,2020-11-01,32569,30557,2012,6.2
17185,2020-11-01,5791,5548,243,4.2
17187,2020-11-01,8226,7855,371,4.5
17189,2020-11-01,8860,8607,253,2.9
17191,2020-11-01,6806,6504,302,4.4
17193,2020-11-01,6346,6083,263,4.1
17195,2020-11-01,27342,25966,1376,5
17197,2020-11-01,337686,316814,20872,6.2
17199,2020-11-01,31995,30339,1656,5.2
17201,2020-11-01,131481,121798,9683,7.4
17203,2020-11-01,17165,16438,727,4.2
18001,2020-11-01,16075,15574,501,3.1
18003,2020-11-01,184621,175333,9288,5
18005,2020-11-01,44387,42659,1728,3.9
18007,2020-11-01,4474,4311,163,3.6
18009,2020-11-01,4439,4224,215,4.8
18011,2020-11-01,36277,35141,1136,3.1
18013,2020-11-01,7782,7452,330,4.2
18015,2020-11-01,10044,9672,372,3.7
18017,2020-11-01,16586,15850,736,4.4
18019,2020-11-01,60350,57453,2897,4.8
18021,2020-11-01,11678,11105,573,4.9
18023,2020-11-01,16636,15974,662,4
18025,2020-11-01,4688,4446,242,5.2
18027,2020-11-01,16240,15782,458,2.8
18029,2020-11-01,25111,24039,1072,4.3
18031,2020-11-01,13920,13342,578,4.2
18033,2020-11-01,21094,20250,844,4
18035,2020-11-01,52430,49801,2629,5
18037,2020-11-01,21891,21114,777,3.5
18039,2020-11-01,106943,102156,4787,4.5
18041,2020-11-01,7894,7359,535,6.8
18043,2020-11-01,40585,38869,1716,4.2
18045,2020-11-01,7599,7314,285,3.8
18047,2020-11-01,11040,10635,405,3.7
18049,2020-11-01,9406,8988,418,4.4
18051,2020-11-01,18983,18296,687,3.6
18053,2020-11-01,31064,29715,1349,4.3
18055,2020-11-01,13114,12532,582,4.4
18057,2020-11-01,183574,177559,6015,3.3
18059,2020-11-01,40384,38818,1566,3.9
18061,2020-11-01,19737,18964,773,3.9
18063,2020-11-01,89959,86720,3239,3.6
18065,2020-11-01,21298,20354,944,4.4
18067,2020-11-01,36196,34145,2051,5.7
18069,2020-11-01,17163,16493,670,3.9
18071,2020-11-01,21578,20696,882,4.1
18073,2020-11-01,15817,15148,669,4.2
18075,2020-11-01,8594,8294,300,3.5
18077,2020-11-01,14347,13710,637,4.4
18079,2020-11-01,13164,12534,630,4.8
18081,2020-11-01,83154,80043,3111,3.7
18083,2020-11-01,17519,16827,692,3.9
18085,2020-11-01,40237,38510,1727,4.3
18087,2020-11-01,16357,15775,582,3.6
18089,2020-11-01,227650,210663,16987,7.5
18091,2020-11-01,47635,44338,3297,6.9
18093,2020-11-01,20357,19386,971,4.8
18095,2020-11-01,59697,56519,3178,5.3
18097,2020-11-01,502257,470294,31963,6.4
18099,2020-11-01,21228,20326,902,4.2
18101,2020-11-01,5332,5151,181,3.4
18103,2020-11-01,14509,13737,772,5.3
18105,2020-11-01,69729,67075,2654,3.8
18107,2020-11-01,18497,17836,661,3.6
18109,2020-11-01,36348,34982,1366,3.8
18111,2020-11-01,6745,6480,265,3.9
18113,2020-11-01,21070,20054,1016,4.8
18115,2020-11-01,3103,2967,136,4.4
18117,2020-11-01,7247,6730,517,7.1
18119,2020-11-01,9330,8938,392,4.2
18121,2020-11-01,6742,6487,255,3.8
18123,2020-11-01,8490,8108,382,4.5
18125,2020-11-01,5731,5492,239,4.2
18127,2020-11-01,84744,80367,4377,5.2
18129,2020-11-01,13639,13196,443,3.2
18131,2020-11-01,6114,5872,242,4
18133,2020-11-01,16750,16094,656,3.9
18135,2020-11-01,10856,10376,480,4.4
18137,2020-11-01,13741,13214,527,3.8
18139,2020-11-01,8681,8349,332,3.8
18141,2020-11-01,129498,121557,7941,6.1
18143,2020-11-01,10345,9814,531,5.1
18145,2020-11-01,23254,22318,936,4
18147,2020-11-01,9374,8979,395,4.2
18149,2020-11-01,9277,8719,558,6
18151,2020-11-01,18849,18125,724,3.8
18153,2020-11-01,8053,7680,373,4.6
18155,2020-11-01,4470,4228,242,5.4
18157,2020-11-01,97054,92656,4398,4.5
18159,2020-11-01,8705,8407,298,3.4
18161,2020-11-01,3439,3329,110,3.2
18163,2020-11-01,95555,91022,4533,4.7
18165,2020-11-01,6679,6351,328,4.9
18167,2020-11-01,46521,43962,2559,5.5
18169,2020-11-01,14084,13514,570,4
18171,2020-11-01,3984,3849,135,3.4
18173,2020-11-01,33055,31921,1134,3.4
18175,2020-11-01,13433,12873,560,4.2
18177,2020-11-01,28736,27248,1488,5.2
18179,2020-11-01,14235,13728,507,3.6
18181,2020-11-01,12812,12356,456,3.6
18183,2020-11-01,17441,16827,614,3.5
19001,2020-11-01,4019,3920,99,2.5
19003,2020-11-01,2040,1991,49,2.4
19005,2020-11-01,6980,6781,199,2.9
19007,2020-11-01,5568,5364,204,3.7
19009,2020-11-01,2935,2867,68,2.3
19011,2020-11-01,12546,12148,398,3.2
19013,2020-11-01,65115,62570,2545,3.9
19015,2020-11-01,14114,13767,347,2.5
19017,2020-11-01,13091,12784,307,2.3
19019,2020-11-01,10339,9992,347,3.4
19021,2020-11-01,12007,11709,298,2.5
19023,2020-11-01,7488,7268,220,2.9
19025,2020-11-01,4027,3915,112,2.8
19027,2020-11-01,10254,10007,247,2.4
19029,2020-11-01,6429,6263,166,2.6
19031,2020-11-01,10254,9966,288,2.8
19033,2020-11-01,21787,21033,754,3.5
19035,2020-11-01,5972,5824,148,2.5
19037,2020-11-01,6329,6170,159,2.5
19039,2020-11-01,4493,4351,142,3.2
19041,2020-11-01,8034,7815,219,2.7
19043,2020-11-01,9268,8976,292,3.2
19045,2020-11-01,21671,20754,917,4.2
19047,2020-11-01,7749,7470,279,3.6
19049,2020-11-01,45998,44899,1099,2.4
19051,2020-11-01,3970,3858,112,2.8
19053,2020-11-01,4086,3999,87,2.1
19055,2020-11-01,9943,9701,242,2.4
19057,2020-11-01,17461,16648,813,4.7
19059,2020-11-01,8102,7843,259,3.2
19061,2020-11-01,52470,50591,1879,3.6
19063,2020-11-01,4922,4787,135,2.7
19065,2020-11-01,10070,9727,343,3.4
19067,2020-11-01,7961,7661,300,3.8
19069,2020-11-01,5290,5137,153,2.9
19071,2020-11-01,3481,3404,77,2.2
19073,2020-11-01,5217,5072,145,2.8
19075,2020-11-01,6215,6040,175,2.8
19077,2020-11-01,5286,5127,159,3
19079,2020-11-01,6557,6359,198,3
19081,2020-11-01,5655,5500,155,2.7
19083,2020-11-01,7582,7357,225,3
19085,2020-11-01,7073,6898,175,2.5
19087,2020-11-01,9329,9031,298,3.2
19089,2020-11-01,4948,4827,121,2.4
19091,2020-11-01,4729,4616,113,2.4
19093,2020-11-01,4042,3950,92,2.3
19095,2020-11-01,10083,9850,233,2.3
19097,2020-11-01,10259,9845,414,4
19099,2020-11-01,18550,17855,695,3.7
19101,2020-11-01,9942,9599,343,3.5
19103,2020-11-01,81720,79221,2499,3.1
19105,2020-11-01,9971,9633,338,3.4
19107,2020-11-01,4966,4812,154,3.1
19109,2020-11-01,8034,7855,179,2.2
19111,2020-11-01,15349,14705,644,4.2
19113,2020-11-01,113374,108552,4822,4.3
19115,2020-11-01,5871,5677,194,3.3
19117,2020-11-01,4395,4290,105,2.4
19119,2020-11-01,6563,6448,115,1.8
19121,2020-11-01,7942,7681,261,3.3
19123,2020-11-01,11207,10857,350,3.1
19125,2020-11-01,17540,17086,454,2.6
19127,2020-11-01,16501,15710,791,4.8
19129,2020-11-01,7069,6907,162,2.3
19131,2020-11-01,6721,6590,131,1.9
19133,2020-11-01,4036,3905,131,3.2
19135,2020-11-01,3803,3691,112,2.9
19137,2020-11-01,4662,4514,148,3.2
19139,2020-11-01,20714,19918,796,3.8
19141,2020-11-01,7801,7624,177,2.3
19143,2020-11-01,3370,3308,62,1.8
19145,2020-11-01,6023,5820,203,3.4
19147,2020-11-01,4410,4287,123,2.8
19149,2020-11-01,14150,13811,339,2.4
19151,2020-11-01,4594,4488,106,2.3
19153,2020-11-01,250393,241055,9338,3.7
19155,2020-11-01,46452,44991,1461,3.1
19157,2020-11-01,9966,9685,281,2.8
19159,2020-11-01,2314,2259,55,2.4
19161,2020-11-01,5017,4905,112,2.2
19163,2020-11-01,82358,78677,3681,4.5
19165,2020-11-01,6249,6111,138,2.2
19167,2020-11-01,19923,19610,313,1.6
19169,2020-11-01,57867,56625,1242,2.1
19171,2020-11-01,8763,8461,302,3.4
19173,2020-11-01,3018,2942,76,2.5
19175,2020-11-01,6016,5796,220,3.7
19177,2020-11-01,3394,3302,92,2.7
19179,2020-11-01,16626,15997,629,3.8
19181,2020-11-01,26186,25442,744,2.8
19183,2020-11-01,11379,11099,280,2.5
19185,2020-11-01,2744,2659,85,3.1
19187,2020-11-01,18322,17679,643,3.5
19189,2020-11-01,4821,4646,175,3.6
19191,2020-11-01,10696,10396,300,2.8
19193,2020-11-01,52943,51159,1784,3.4
19195,2020-11-01,3961,3840,121,3.1
19197,2020-11-01,6647,6453,194,2.9
20001,2020-11-01,6664,6368,296,4.4
20003,2020-11-01,4418,4261,157,3.6
20005,2020-11-01,7015,6657,358,5.1
20007,2020-11-01,2425,2352,73,3
20009,2020-11-01,14502,13903,599,4.1
20011,2020-11-01,6912,6583,329,4.8
20013,2020-11-01,5383,5205,178,3.3
20015,2020-11-01,32938,31241,1697,5.2
20017,2020-11-01,1439,1388,51,3.5
20019,2020-11-01,1481,1409,72,4.9
20021,2020-11-01,10363,9988,375,3.6
20023,2020-11-01,1403,1376,27,1.9
20025,2020-11-01,1219,1194,25,2.1
20027,2020-11-01,4016,3865,151,3.8
20029,2020-11-01,3972,3810,162,4.1
20031,2020-11-01,3982,3828,154,3.9
20033,2020-11-01,917,895,22,2.4
20035,2020-11-01,17449,16486,963,5.5
20037,2020-11-01,19734,18852,882,4.5
20039,2020-11-01,1354,1314,40,3
20041,2020-11-01,9328,8961,367,3.9
20043,2020-11-01,4195,4071,124,3
20045,2020-11-01,66141,62973,3168,4.8
20047,2020-11-01,1711,1657,54,3.2
20049,2020-11-01,1206,1170,36,3
20051,2020-11-01,18045,17407,638,3.5
20053,2020-11-01,2852,2765,87,3.1
20055,2020-11-01,21964,21249,715,3.3
20057,2020-11-01,17956,17343,613,3.4
20059,2020-11-01,14899,14229,670,4.5
20061,2020-11-01,12059,11408,651,5.4
20063,2020-11-01,1565,1505,60,3.8
20065,2020-11-01,1195,1144,51,4.3
20067,2020-11-01,3332,3180,152,4.6
20069,2020-11-01,3549,3472,77,2.2
20071,2020-11-01,911,895,16,1.8
20073,2020-11-01,3239,3106,133,4.1
20075,2020-11-01,1795,1752,43,2.4
20077,2020-11-01,2842,2723,119,4.2
20079,2020-11-01,17227,16415,812,4.7
20081,2020-11-01,2336,2283,53,2.3
20083,2020-11-01,1101,1076,25,2.3
20085,2020-11-01,7255,6984,271,3.7
20087,2020-11-01,10233,9826,407,4
20089,2020-11-01,1315,1284,31,2.4
20091,2020-11-01,345060,330179,14881,4.3
20093,2020-11-01,2175,2121,54,2.5
20095,2020-11-01,3538,3375,163,4.6
20097,2020-11-01,1383,1324,59,4.3
20099,2020-11-01,10116,9642,474,4.7
20101,2020-11-01,827,805,22,2.7
20103,2020-11-01,36938,35369,1569,4.2
20105,2020-11-01,1793,1736,57,3.2
20107,2020-11-01,4436,4215,221,5
20109,2020-11-01,1747,1680,67,3.8
20111,2020-11-01,17415,16698,717,4.1
20113,2020-11-01,17905,17301,604,3.4
20115,2020-11-01,6237,5987,250,4
20117,2020-11-01,5852,5671,181,3.1
20119,2020-11-01,2262,2190,72,3.2
20121,2020-11-01,17732,16961,771,4.3
20123,2020-11-01,3677,3567,110,3
20125,2020-11-01,15116,14314,802,5.3
20127,2020-11-01,3169,3077,92,2.9
20129,2020-11-01,1249,1213,36,2.9
20131,2020-11-01,5941,5770,171,2.9
20133,2020-11-01,6474,6115,359,5.5
20135,2020-11-01,1410,1359,51,3.6
20137,2020-11-01,2790,2706,84,3
20139,2020-11-01,8050,7713,337,4.2
20141,2020-11-01,2092,2035,57,2.7
20143,2020-11-01,3101,2967,134,4.3
20145,2020-11-01,3004,2906,98,3.3
20147,2020-11-01,2784,2688,96,3.4
20149,2020-11-01,12359,11862,497,4
20151,2020-11-01,5174,5006,168,3.2
20153,2020-11-01,1652,1616,36,2.2
20155,2020-11-01,31207,29715,1492,4.8
20157,2020-11-01,2543,2462,81,3.2
20159,2020-11-01,5299,5074,225,4.2
20161,2020-11-01,34874,33359,1515,4.3
20163,2020-11-01,2673,2566,107,4
20165,2020-11-01,1625,1570,55,3.4
20167,2020-11-01,3437,3318,119,3.5
20169,2020-11-01,30600,29219,1381,4.5
20171,2020-11-01,3031,2941,90,3
20173,2020-11-01,257727,240210,17517,6.8
20175,2020-11-01,10325,9849,476,4.6
20177,2020-11-01,91905,87223,4682,5.1
20179,2020-11-01,1604,1572,32,2
20181,2020-11-01,3054,2942,112,3.7
20183,2020-11-01,2123,2062,61,2.9
20185,2020-11-01,2201,2129,72,3.3
20187,2020-11-01,1155,1115,40,3.5
20189,2020-11-01,2993,2915,78,2.6
20191,2020-11-01,11278,10551,727,6.4
20193,2020-11-01,4459,4320,139,3.1
20195,2020-11-01,1544,1500,44,2.8
20197,2020-11-01,3741,3598,143,3.8
20199,2020-11-01,886,865,21,2.4
20201,2020-11-01,3242,3159,83,2.6
20203,2020-11-01,1281,1250,31,2.4
20205,2020-11-01,4067,3825,242,6
20207,2020-11-01,1688,1617,71,4.2
20209,2020-11-01,78507,74195,4312,5.5
21001,2020-11-01,6855,6486,369,5.4
21003,2020-11-01,8606,8266,340,4
21005,2020-11-01,11904,11371,533,4.5
21007,2020-11-01,3217,3041,176,5.5
21009,2020-11-01,17425,16337,1088,6.2
21011,2020-11-01,4519,4254,265,5.9
21013,2020-11-01,7980,7488,492,6.2
21015,2020-11-01,70048,67022,3026,4.3
21017,2020-11-01,10007,9618,389,3.9
21019,2020-11-01,17631,16514,1117,6.3
21021,2020-11-01,11514,10831,683,5.9
21023,2020-11-01,3770,3593,177,4.7
21025,2020-11-01,3145,2901,244,7.8
21027,2020-11-01,7629,7193,436,5.7
21029,2020-11-01,42032,40205,1827,4.3
21031,2020-11-01,4828,4594,234,4.8
21033,2020-11-01,5314,5049,265,5
21035,2020-11-01,18321,17391,930,5.1
21037,2020-11-01,50130,47911,2219,4.4
21039,2020-11-01,2171,2089,82,3.8
21041,2020-11-01,5181,4951,230,4.4
21043,2020-11-01,9407,8720,687,7.3
21045,2020-11-01,6422,6147,275,4.3
21047,2020-11-01,25317,23914,1403,5.5
21049,2020-11-01,17237,16347,890,5.2
21051,2020-11-01,5040,4656,384,7.6
21053,2020-11-01,3883,3737,146,3.8
21055,2020-11-01,3647,3500,147,4
21057,2020-11-01,3071,2956,115,3.7
21059,2020-11-01,46268,44130,2138,4.6
21061,2020-11-01,4524,4289,235,5.2
21063,2020-11-01,1945,1814,131,6.7
21065,2020-11-01,5136,4867,269,5.2
21067,2020-11-01,175300,167359,7941,4.5
21069,2020-11-01,6351,6062,289,4.6
21071,2020-11-01,10342,9510,832,8
21073,2020-11-01,25176,23826,1350,5.4
21075,2020-11-01,2070,1973,97,4.7
21077,2020-11-01,4074,3874,200,4.9
21079,2020-11-01,7355,7020,335,4.6
21081,2020-11-01,11646,11036,610,5.2
21083,2020-11-01,15014,14235,779,5.2
21085,2020-11-01,11013,10369,644,5.8
21087,2020-11-01,4933,4749,184,3.7
21089,2020-11-01,13203,12321,882,6.7
21091,2020-11-01,3886,3706,180,4.6
21093,2020-11-01,46710,44352,2358,5
21095,2020-11-01,6096,5464,632,10.4
21097,2020-11-01,8692,8329,363,4.2
21099,2020-11-01,7619,7276,343,4.5
21101,2020-11-01,22408,21430,978,4.4
21103,2020-11-01,8169,7871,298,3.6
21105,2020-11-01,1727,1659,68,3.9
21107,2020-11-01,16417,15487,930,5.7
21109,2020-11-01,3844,3574,270,7
21111,2020-11-01,397565,376067,21498,5.4
21113,2020-11-01,26477,25293,1184,4.5
21115,2020-11-01,6301,5807,494,7.8
21117,2020-11-01,86798,82767,4031,4.6
21119,2020-11-01,4165,3829,336,8.1
21121,2020-11-01,9878,9210,668,6.8
21123,2020-11-01,5748,5460,288,5
21125,2020-11-01,24346,23116,1230,5.1
21127,2020-11-01,5166,4836,330,6.4
21129,2020-11-01,1964,1853,111,5.7
21131,2020-11-01,2499,2271,228,9.1
21133,2020-11-01,5988,5465,523,8.7
21135,2020-11-01,4365,4058,307,7
21137,2020-11-01,8596,8027,569,6.6
21139,2020-11-01,3336,3127,209,6.3
21141,2020-11-01,12073,11634,439,3.6
21143,2020-11-01,2739,2607,132,4.8
21145,2020-11-01,26709,25094,1615,6
21147,2020-11-01,4567,4282,285,6.2
21149,2020-11-01,4139,3963,176,4.3
21151,2020-11-01,43985,41936,2049,4.7
21153,2020-11-01,3187,2745,442,13.9
21155,2020-11-01,9483,9041,442,4.7
21157,2020-11-01,14394,13676,718,5
21159,2020-11-01,2713,2487,226,8.3
21161,2020-11-01,6754,6362,392,5.8
21163,2020-11-01,11689,11089,600,5.1
21165,2020-11-01,2244,2078,166,7.4
21167,2020-11-01,9407,8890,517,5.5
21169,2020-11-01,3859,3636,223,5.8
21171,2020-11-01,4569,4377,192,4.2
21173,2020-11-01,11320,10657,663,5.9
21175,2020-11-01,4435,4195,240,5.4
21177,2020-11-01,9782,9089,693,7.1
21179,2020-11-01,23168,22192,976,4.2
21181,2020-11-01,3308,3169,139,4.2
21183,2020-11-01,9685,9197,488,5
21185,2020-11-01,32774,31641,1133,3.5
21187,2020-11-01,5018,4755,263,5.2
21189,2020-11-01,1097,1028,69,6.3
21191,2020-11-01,6870,6607,263,3.8
21193,2020-11-01,7676,7090,586,7.6
21195,2020-11-01,17898,16541,1357,7.6
21197,2020-11-01,4886,4608,278,5.7
21199,2020-11-01,25470,24101,1369,5.4
21201,2020-11-01,824,792,32,3.9
21203,2020-11-01,6217,5874,343,5.5
21205,2020-11-01,9596,9067,529,5.5
21207,2020-11-01,5917,5575,342,5.8
21209,2020-11-01,28984,27837,1147,4
21211,2020-11-01,25313,24354,959,3.8
21213,2020-11-01,8698,8314,384,4.4
21215,2020-11-01,10052,9666,386,3.8
21217,2020-11-01,12261,11748,513,4.2
21219,2020-11-01,5384,5204,180,3.3
21221,2020-11-01,6171,5843,328,5.3
21223,2020-11-01,3866,3670,196,5.1
21225,2020-11-01,5747,5509,238,4.1
21227,2020-11-01,61018,58200,2818,4.6
21229,2020-11-01,6315,6071,244,3.9
21231,2020-11-01,7271,6875,396,5.4
21233,2020-11-01,5536,5281,255,4.6
21235,2020-11-01,13603,12801,802,5.9
21237,2020-11-01,1899,1790,109,5.7
21239,2020-11-01,15265,14683,582,3.8
22001,2020-11-01,23753,22060,1693,7.1
22003,2020-11-01,8701,7991,710,8.2
22005,2020-11-01,63741,59730,4011,6.3
22007,2020-11-01,9152,8234,918,10
22009,2020-11-01,15076,13975,1101,7.3
22011,2020-11-01,14265,13426,839,5.9
22013,2020-11-01,5444,5008,436,8
22015,2020-11-01,57287,53954,3333,5.8
22017,2020-11-01,105620,95793,9827,9.3
22019,2020-11-01,97262,87654,9608,9.9
22021,2020-11-01,3732,3499,233,6.2
22023,2020-11-01,3458,3260,198,5.7
22025,2020-11-01,3421,3171,250,7.3
22027,2020-11-01,5697,5331,366,6.4
22029,2020-11-01,6989,6482,507,7.3
22031,2020-11-01,10706,9975,731,6.8
22033,2020-11-01,232510,214645,17865,7.7
22035,2020-11-01,1842,1617,225,12.2
22037,2020-11-01,7926,7404,522,6.6
22039,2020-11-01,11657,10772,885,7.6
22041,2020-11-01,7333,6762,571,7.8
22043,2020-11-01,8038,7545,493,6.1
22045,2020-11-01,28857,25985,2872,10
22047,2020-11-01,14341,12847,1494,10.4
22049,2020-11-01,6663,6326,337,5.1
22051,2020-11-01,212611,192873,19738,9.3
22053,2020-11-01,12722,11786,936,7.4
22055,2020-11-01,114048,106505,7543,6.6
22057,2020-11-01,42414,39834,2580,6.1
22059,2020-11-01,6729,6417,312,4.6
22061,2020-11-01,20549,19326,1223,6
22063,2020-11-01,68010,64180,3830,5.6
22065,2020-11-01,3456,3173,283,8.2
22067,2020-11-01,10051,9061,990,9.8
22069,2020-11-01,15783,14731,1052,6.7
22071,2020-11-01,185485,160284,25201,13.6
22073,2020-11-01,73334,68289,5045,6.9
22075,2020-11-01,9634,9040,594,6.2
22077,2020-11-01,9823,9070,753,7.7
22079,2020-11-01,54537,51261,3276,6
22081,2020-11-01,3728,3495,233,6.3
22083,2020-11-01,8150,7576,574,7
22085,2020-11-01,8964,8508,456,5.1
22087,2020-11-01,19916,17789,2127,10.7
22089,2020-11-01,24508,22648,1860,7.6
22091,2020-11-01,4461,3904,557,12.5
22093,2020-11-01,9108,8159,949,10.4
22095,2020-11-01,19892,17461,2431,12.2
22097,2020-11-01,32178,29301,2877,8.9
22099,2020-11-01,22387,20614,1773,7.9
22101,2020-11-01,19865,17987,1878,9.5
22103,2020-11-01,114387,107740,6647,5.8
22105,2020-11-01,55021,49742,5279,9.6
22107,2020-11-01,1329,1226,103,7.8
22109,2020-11-01,47437,43799,3638,7.7
22111,2020-11-01,9405,8780,625,6.6
22113,2020-11-01,24123,22373,1750,7.3
22115,2020-11-01,15443,14532,911,5.9
22117,2020-11-01,16821,15431,1390,8.3
22119,2020-11-01,14425,13317,1108,7.7
22121,2020-11-01,13687,12693,994,7.3
22123,2020-11-01,3470,3183,287,8.3
22125,2020-11-01,5307,5016,291,5.5
22127,2020-11-01,4738,4412,326,6.9
23001,2020-11-01,54066,51494,2572,4.8
23003,2020-11-01,29096,27736,1360,4.7
23005,2020-11-01,159597,152704,6893,4.3
23007,2020-11-01,13972,13297,675,4.8
23009,2020-11-01,26451,25129,1322,5
23011,2020-11-01,61737,59182,2555,4.1
23013,2020-11-01,19052,18211,841,4.4
23015,2020-11-01,15922,15150,772,4.8
23017,2020-11-01,25161,23605,1556,6.2
23019,2020-11-01,75388,72107,3281,4.4
23021,2020-11-01,7148,6804,344,4.8
23023,2020-11-01,19226,18482,744,3.9
23025,2020-11-01,22028,20733,1295,5.9
23027,2020-11-01,19878,18974,904,4.5
23029,2020-11-01,13783,13054,729,5.3
23031,2020-11-01,108306,102863,5443,5
24001,2020-11-01,29719,27791,1928,6.5
24003,2020-11-01,304555,288227,16328,5.4
24005,2020-11-01,440556,412456,28100,6.4
24009,2020-11-01,47763,45429,2334,4.9
24011,2020-11-01,16747,15889,858,5.1
24013,2020-11-01,90936,86916,4020,4.4
24015,2020-11-01,49201,46491,2710,5.5
24017,2020-11-01,84480,78952,5528,6.5
24019,2020-11-01,14499,13517,982,6.8
24021,2020-11-01,130001,122958,7043,5.4
24023,2020-11-01,14399,13626,773,5.4
24025,2020-11-01,135056,128348,6708,5
24027,2020-11-01,181120,172222,8898,4.9
24029,2020-11-01,9072,8526,546,6
24031,2020-11-01,552026,516301,35725,6.5
24033,2020-11-01,505282,459788,45494,9
24035,2020-11-01,26176,24952,1224,4.7
24037,2020-11-01,53045,50613,2432,4.6
24039,2020-11-01,8165,7512,653,8
24041,2020-11-01,17576,16614,962,5.5
24043,2020-11-01,70635,66518,4117,5.8
24045,2020-11-01,47392,44136,3256,6.9
24047,2020-11-01,23570,21293,2277,9.7
24510,2020-11-01,282936,258548,24388,8.6
25001,2020-11-01,101585,94728,6857,6.8
25003,2020-11-01,60048,56093,3955,6.6
25005,2020-11-01,288368,269914,18454,6.4
25007,2020-11-01,8273,7680,593,7.2
25009,2020-11-01,406852,379080,27772,6.8
25011,2020-11-01,38709,36690,2019,5.2
25013,2020-11-01,214389,198277,16112,7.5
25015,2020-11-01,84109,79402,4707,5.6
25017,2020-11-01,868980,821776,47204,5.4
25019,2020-11-01,6562,6130,432,6.6
25021,2020-11-01,370780,348654,22126,6
25023,2020-11-01,268181,250863,17318,6.5
25025,2020-11-01,435144,405701,29443,6.8
25027,2020-11-01,430706,404220,26486,6.1
26001,2020-11-01,3819,3627,192,5
26003,2020-11-01,3094,2896,198,6.4
26005,2020-11-01,61419,59228,2191,3.6
26007,2020-11-01,13174,12634,540,4.1
26009,2020-11-01,10202,9706,496,4.9
26011,2020-11-01,5896,5566,330,5.6
26013,2020-11-01,3092,2894,198,6.4
26015,2020-11-01,31074,29964,1110,3.6
26017,2020-11-01,47238,44947,2291,4.8
26019,2020-11-01,9041,8674,367,4.1
26021,2020-11-01,71844,68471,3373,4.7
26023,2020-11-01,18859,18038,821,4.4
26025,2020-11-01,60477,57296,3181,5.3
26027,2020-11-01,23727,22682,1045,4.4
26029,2020-11-01,12586,12039,547,4.3
26031,2020-11-01,9771,9087,684,7
26033,2020-11-01,16340,15579,761,4.7
26035,2020-11-01,11467,10752,715,6.2
26037,2020-11-01,39365,38113,1252,3.2
26039,2020-11-01,5287,5001,286,5.4
26041,2020-11-01,17496,16703,793,4.5
26043,2020-11-01,12535,12051,484,3.9
26045,2020-11-01,54856,52787,2069,3.8
26047,2020-11-01,17588,16765,823,4.7
26049,2020-11-01,177968,168016,9952,5.6
26051,2020-11-01,9620,9121,499,5.2
26053,2020-11-01,6036,5776,260,4.3
26055,2020-11-01,51384,49524,1860,3.6
26057,2020-11-01,18168,17445,723,4
26059,2020-11-01,19740,18930,810,4.1
26061,2020-11-01,16783,16203,580,3.5
26063,2020-11-01,15567,15038,529,3.4
26065,2020-11-01,145349,139296,6053,4.2
26067,2020-11-01,29427,28359,1068,3.6
26069,2020-11-01,10011,9489,522,5.2
26071,2020-11-01,5226,5014,212,4.1
26073,2020-11-01,35417,34096,1321,3.7
26075,2020-11-01,72478,69117,3361,4.6
26077,2020-11-01,132511,127204,5307,4
26079,2020-11-01,8119,7710,409,5
26081,2020-11-01,355861,341868,13993,3.9
26083,2020-11-01,910,863,47,5.2
26085,2020-11-01,3723,3476,247,6.6
26087,2020-11-01,41449,38325,3124,7.5
26089,2020-11-01,10782,10408,374,3.5
26091,2020-11-01,45257,43463,1794,4
26093,2020-11-01,104460,98371,6089,5.8
26095,2020-11-01,2250,2136,114,5.1
26097,2020-11-01,4210,3904,306,7.3
26099,2020-11-01,459551,421523,38028,8.3
26101,2020-11-01,9904,9401,503,5.1
26103,2020-11-01,33149,31887,1262,3.8
26105,2020-11-01,13426,12782,644,4.8
26107,2020-11-01,18353,17494,859,4.7
26109,2020-11-01,10854,10496,358,3.3
26111,2020-11-01,38969,37470,1499,3.8
26113,2020-11-01,6998,6732,266,3.8
26115,2020-11-01,71272,68276,2996,4.2
26117,2020-11-01,27755,26569,1186,4.3
26119,2020-11-01,2906,2694,212,7.3
26121,2020-11-01,74465,69685,4780,6.4
26123,2020-11-01,22723,21723,1000,4.4
26125,2020-11-01,688176,641398,46778,6.8
26127,2020-11-01,11398,10747,651,5.7
26129,2020-11-01,7917,7501,416,5.3
26131,2020-11-01,2013,1903,110,5.5
26133,2020-11-01,11540,11083,457,4
26135,2020-11-01,2925,2765,160,5.5
26137,2020-11-01,11140,10552,588,5.3
26139,2020-11-01,158278,153153,5125,3.2
26141,2020-11-01,4762,4492,270,5.7
26143,2020-11-01,7366,6906,460,6.2
26145,2020-11-01,83435,78944,4491,5.4
26147,2020-11-01,76777,70816,5961,7.8
26149,2020-11-01,28116,26904,1212,4.3
26151,2020-11-01,19027,18255,772,4.1
26153,2020-11-01,3338,3179,159,4.8
26155,2020-11-01,33389,32035,1354,4.1
26157,2020-11-01,23679,22639,1040,4.4
26159,2020-11-01,34463,32938,1525,4.4
26161,2020-11-01,199710,192970,6740,3.4
26163,2020-11-01,836953,742486,94467,11.3
26165,2020-11-01,15163,14509,654,4.3
27001,2020-11-01,7190,6780,410,5.7
27003,2020-11-01,192710,184827,7883,4.1
27005,2020-11-01,18912,18174,738,3.9
27007,2020-11-01,24596,23513,1083,4.4
27009,2020-11-01,22121,21068,1053,4.8
27011,2020-11-01,2436,2373,63,2.6
27013,2020-11-01,40687,39352,1335,3.3
27015,2020-11-01,14522,14031,491,3.4
27017,2020-11-01,17011,16243,768,4.5
27019,2020-11-01,56988,55082,1906,3.3
27021,2020-11-01,14233,13398,835,5.9
27023,2020-11-01,6883,6672,211,3.1
27025,2020-11-01,29234,27911,1323,4.5
27027,2020-11-01,36125,35098,1027,2.8
27029,2020-11-01,4335,4044,291,6.7
27031,2020-11-01,3032,2875,157,5.2
27033,2020-11-01,6180,5947,233,3.8
27035,2020-11-01,32443,30815,1628,5
27037,2020-11-01,235216,226350,8866,3.8
27039,2020-11-01,11658,11237,421,3.6
27041,2020-11-01,21264,20562,702,3.3
27043,2020-11-01,7009,6682,327,4.7
27045,2020-11-01,11358,11017,341,3
27047,2020-11-01,16350,15778,572,3.5
27049,2020-11-01,26729,25811,918,3.4
27051,2020-11-01,3367,3253,114,3.4
27053,2020-11-01,691552,663002,28550,4.1
27055,2020-11-01,10095,9842,253,2.5
27057,2020-11-01,9838,9362,476,4.8
27059,2020-11-01,20741,19756,985,4.7
27061,2020-11-01,21178,19967,1211,5.7
27063,2020-11-01,5818,5637,181,3.1
27065,2020-11-01,9026,8474,552,6.1
27067,2020-11-01,24436,23609,827,3.4
27069,2020-11-01,2360,2286,74,3.1
27071,2020-11-01,5740,5435,305,5.3
27073,2020-11-01,3611,3497,114,3.2
27075,2020-11-01,5281,5064,217,4.1
27077,2020-11-01,2427,2290,137,5.6
27079,2020-11-01,15740,14988,752,4.8
27081,2020-11-01,3269,3175,94,2.9
27083,2020-11-01,14579,14137,442,3
27085,2020-11-01,19101,18353,748,3.9
27087,2020-11-01,2369,2209,160,6.8
27089,2020-11-01,5378,5112,266,4.9
27091,2020-11-01,10047,9728,319,3.2
27093,2020-11-01,13383,12859,524,3.9
27095,2020-11-01,12614,11847,767,6.1
27097,2020-11-01,17851,16828,1023,5.7
27099,2020-11-01,20769,20036,733,3.5
27101,2020-11-01,4740,4555,185,3.9
27103,2020-11-01,21013,20399,614,2.9
27105,2020-11-01,11511,11180,331,2.9
27107,2020-11-01,3270,3142,128,3.9
27109,2020-11-01,86843,83874,2969,3.4
27111,2020-11-01,31105,30035,1070,3.4
27113,2020-11-01,8497,8216,281,3.3
27115,2020-11-01,14760,13993,767,5.2
27117,2020-11-01,4802,4685,117,2.4
27119,2020-11-01,16673,16016,657,3.9
27121,2020-11-01,6582,6367,215,3.3
27123,2020-11-01,283516,271145,12371,4.4
27125,2020-11-01,2195,2109,86,3.9
27127,2020-11-01,7719,7453,266,3.4
27129,2020-11-01,8496,8188,308,3.6
27131,2020-11-01,37341,36053,1288,3.4
27133,2020-11-01,5699,5591,108,1.9
27135,2020-11-01,7894,7605,289,3.7
27137,2020-11-01,97626,93053,4573,4.7
27139,2020-11-01,81230,78391,2839,3.5
27141,2020-11-01,50955,48847,2108,4.1
27143,2020-11-01,8429,8096,333,4
27145,2020-11-01,90964,87382,3582,3.9
27147,2020-11-01,21482,20758,724,3.4
27149,2020-11-01,5427,5280,147,2.7
27151,2020-11-01,4924,4712,212,4.3
27153,2020-11-01,13882,13275,607,4.4
27155,2020-11-01,1801,1759,42,2.3
27157,2020-11-01,12136,11726,410,3.4
27159,2020-11-01,6074,5787,287,4.7
27161,2020-11-01,9051,8702,349,3.9
27163,2020-11-01,139136,134380,4756,3.4
27165,2020-11-01,6555,6364,191,2.9
27167,2020-11-01,3489,3379,110,3.2
27169,2020-11-01,28804,27974,830,2.9
27171,2020-11-01,73493,70814,2679,3.6
27173,2020-11-01,5378,5216,162,3
28001,2020-11-01,11426,10398,1028,9
28003,2020-11-01,16075,15351,724,4.5
28005,2020-11-01,4460,4114,346,7.8
28007,2020-11-01,7067,6598,469,6.6
28009,2020-11-01,3087,2895,192,6.2
28011,2020-11-01,11655,10820,835,7.2
28013,2020-11-01,5300,5021,279,5.3
28015,2020-11-01,3328,3123,205,6.2
28017,2020-11-01,6883,6398,485,7
28019,2020-11-01,3635,3442,193,5.3
28021,2020-11-01,3028,2661,367,12.1
28023,2020-11-01,5754,5363,391,6.8
28025,2020-11-01,7501,6825,676,9
28027,2020-11-01,8312,7541,771,9.3
28029,2020-11-01,11184,10421,763,6.8
28031,2020-11-01,8194,7691,503,6.1
28033,2020-11-01,92180,88256,3924,4.3
28035,2020-11-01,34958,32868,2090,6
28037,2020-11-01,2850,2651,199,7
28039,2020-11-01,8635,8022,613,7.1
28041,2020-11-01,4149,3844,305,7.4
28043,2020-11-01,9444,8931,513,5.4
28045,2020-11-01,19097,17890,1207,6.3
28047,2020-11-01,88721,83286,5435,6.1
28049,2020-11-01,108925,101527,7398,6.8
28051,2020-11-01,5567,4903,664,11.9
28053,2020-11-01,2152,1892,260,12.1
28055,2020-11-01,317,294,23,7.3
28057,2020-11-01,10532,10074,458,4.3
28059,2020-11-01,59841,56029,3812,6.4
28061,2020-11-01,5973,5519,454,7.6
28063,2020-11-01,1933,1613,320,16.6
28065,2020-11-01,4044,3714,330,8.2
28067,2020-11-01,25377,23871,1506,5.9
28069,2020-11-01,3402,3136,266,7.8
28071,2020-11-01,27808,26658,1150,4.1
28073,2020-11-01,32072,30695,1377,4.3
28075,2020-11-01,29798,28071,1727,5.8
28077,2020-11-01,4650,4304,346,7.4
28079,2020-11-01,7826,7376,450,5.8
28081,2020-11-01,41942,39770,2172,5.2
28083,2020-11-01,9831,8942,889,9
28085,2020-11-01,14643,13812,831,5.7
28087,2020-11-01,25013,23425,1588,6.3
28089,2020-11-01,53262,50946,2316,4.3
28091,2020-11-01,9783,9190,593,6.1
28093,2020-11-01,14602,13758,844,5.8
28095,2020-11-01,15409,14459,950,6.2
28097,2020-11-01,3978,3722,256,6.4
28099,2020-11-01,9732,9160,572,5.9
28101,2020-11-01,8523,8077,446,5.2
28103,2020-11-01,3564,3229,335,9.4
28105,2020-11-01,22561,21305,1256,5.6
28107,2020-11-01,12543,11544,999,8
28109,2020-11-01,23690,22237,1453,6.1
28111,2020-11-01,4441,4148,293,6.6
28113,2020-11-01,14908,13730,1178,7.9
28115,2020-11-01,14861,14180,681,4.6
28117,2020-11-01,11152,10611,541,4.9
28119,2020-11-01,2135,1931,204,9.6
28121,2020-11-01,75989,73227,2762,3.6
28123,2020-11-01,12734,12138,596,4.7
28125,2020-11-01,1493,1362,131,8.8
28127,2020-11-01,10736,10147,589,5.5
28129,2020-11-01,6514,6208,306,4.7
28131,2020-11-01,6809,6403,406,6
28133,2020-11-01,7579,6860,719,9.5
28135,2020-11-01,4754,4430,324,6.8
28137,2020-11-01,12481,11732,749,6
28139,2020-11-01,9250,8813,437,4.7
28141,2020-11-01,8592,8224,368,4.3
28143,2020-11-01,4645,4179,466,10
28145,2020-11-01,14271,13662,609,4.3
28147,2020-11-01,4916,4549,367,7.5
28149,2020-11-01,20202,18893,1309,6.5
28151,2020-11-01,16638,15144,1494,9
28153,2020-11-01,7308,6775,533,7.3
28155,2020-11-01,3901,3690,211,5.4
28157,2020-11-01,2816,2419,397,14.1
28159,2020-11-01,7273,6774,499,6.9
28161,2020-11-01,4812,4524,288,6
28163,2020-11-01,9391,8686,705,7.5
29001,2020-11-01,10147,9790,357,3.5
29003,2020-11-01,9486,9224,262,2.8
29005,2020-11-01,2693,2621,72,2.7
29007,2020-11-01,10423,10089,334,3.2
29009,2020-11-01,15589,14942,647,4.2
29011,2020-11-01,5185,5021,164,3.2
29013,2020-11-01,7635,7353,282,3.7
29015,2020-11-01,7235,6869,366,5.1
29017,2020-11-01,5117,4914,203,4
29019,2020-11-01,96278,93544,2734,2.8
29021,2020-11-01,43391,41843,1548,3.6
29023,2020-11-01,17993,17210,783,4.4
29025,2020-11-01,4252,4104,148,3.5
29027,2020-11-01,20651,20033,618,3
29029,2020-11-01,18541,17710,831,4.5
29031,2020-11-01,37803,36504,1299,3.4
29033,2020-11-01,4708,4458,250,5.3
29035,2020-11-01,2564,2451,113,4.4
29037,2020-11-01,53072,51129,1943,3.7
29039,2020-11-01,5802,5608,194,3.3
29041,2020-11-01,3715,3612,103,2.8
29043,2020-11-01,44077,42727,1350,3.1
29045,2020-11-01,3188,3046,142,4.5
29047,2020-11-01,131955,127122,4833,3.7
29049,2020-11-01,10373,10013,360,3.5
29051,2020-11-01,37780,36675,1105,2.9
29053,2020-11-01,7285,7038,247,3.4
29055,2020-11-01,10833,10371,462,4.3
29057,2020-11-01,3553,3451,102,2.9
29059,2020-11-01,6897,6625,272,3.9
29061,2020-11-01,4153,4030,123,3
29063,2020-11-01,4692,4559,133,2.8
29065,2020-11-01,6354,6112,242,3.8
29067,2020-11-01,5027,4811,216,4.3
29069,2020-11-01,11296,10724,572,5.1
29071,2020-11-01,50987,48987,2000,3.9
29073,2020-11-01,7631,7361,270,3.5
29075,2020-11-01,3475,3387,88,2.5
29077,2020-11-01,148565,143598,4967,3.3
29079,2020-11-01,4359,4241,118,2.7
29081,2020-11-01,3835,3730,105,2.7
29083,2020-11-01,9646,9263,383,4
29085,2020-11-01,3912,3760,152,3.9
29087,2020-11-01,2548,2490,58,2.3
29089,2020-11-01,4792,4659,133,2.8
29091,2020-11-01,16546,15743,803,4.9
29093,2020-11-01,3513,3344,169,4.8
29095,2020-11-01,353163,335506,17657,5
29097,2020-11-01,56438,54368,2070,3.7
29099,2020-11-01,113252,108837,4415,3.9
29101,2020-11-01,23445,22547,898,3.8
29103,2020-11-01,1780,1726,54,3
29105,2020-11-01,16766,16062,704,4.2
29107,2020-11-01,16297,15705,592,3.6
29109,2020-11-01,18038,17313,725,4
29111,2020-11-01,4927,4788,139,2.8
29113,2020-11-01,27162,26158,1004,3.7
29115,2020-11-01,5063,4861,202,4
29117,2020-11-01,7382,7184,198,2.7
29119,2020-11-01,10742,10351,391,3.6
29121,2020-11-01,7493,7268,225,3
29123,2020-11-01,5528,5307,221,4
29125,2020-11-01,3875,3727,148,3.8
29127,2020-11-01,14406,13965,441,3.1
29129,2020-11-01,1908,1862,46,2.4
29131,2020-11-01,12208,11753,455,3.7
29133,2020-11-01,5757,5514,243,4.2
29135,2020-11-01,7070,6880,190,2.7
29137,2020-11-01,3736,3602,134,3.6
29139,2020-11-01,5672,5497,175,3.1
29141,2020-11-01,7975,7652,323,4.1
29143,2020-11-01,8321,7982,339,4.1
29145,2020-11-01,26946,25956,990,3.7
29147,2020-11-01,11207,10900,307,2.7
29149,2020-11-01,4049,3851,198,4.9
29151,2020-11-01,6887,6733,154,2.2
29153,2020-11-01,3419,3253,166,4.9
29155,2020-11-01,6401,6009,392,6.1
29157,2020-11-01,9753,9476,277,2.8
29159,2020-11-01,20878,20099,779,3.7
29161,2020-11-01,19651,18944,707,3.6
29163,2020-11-01,7447,7179,268,3.6
29165,2020-11-01,56752,54830,1922,3.4
29167,2020-11-01,14320,13849,471,3.3
29169,2020-11-01,14543,13961,582,4
29171,2020-11-01,2220,2162,58,2.6
29173,2020-11-01,5599,5439,160,2.9
29175,2020-11-01,10276,9865,411,4
29177,2020-11-01,10599,10209,390,3.7
29179,2020-11-01,2968,2851,117,3.9
29181,2020-11-01,4991,4720,271,5.4
29183,2020-11-01,216861,209896,6965,3.2
29185,2020-11-01,3735,3578,157,4.2
29186,2020-11-01,9003,8711,292,3.2
29187,2020-11-01,26272,25145,1127,4.3
29189,2020-11-01,512963,490780,22183,4.3
29195,2020-11-01,10826,10506,320,3
29197,2020-11-01,1913,1852,61,3.2
29199,2020-11-01,2371,2320,51,2.2
29201,2020-11-01,19410,18657,753,3.9
29203,2020-11-01,3261,3094,167,5.1
29205,2020-11-01,3107,3018,89,2.9
29207,2020-11-01,13087,12572,515,3.9
29209,2020-11-01,13578,12961,617,4.5
29211,2020-11-01,2722,2623,99,3.6
29213,2020-11-01,26575,25208,1367,5.1
29215,2020-11-01,8872,8472,400,4.5
29217,2020-11-01,9446,9134,312,3.3
29219,2020-11-01,17244,16602,642,3.7
29221,2020-11-01,10090,9642,448,4.4
29223,2020-11-01,5062,4835,227,4.5
29225,2020-11-01,16890,16342,548,3.2
29227,2020-11-01,1168,1137,31,2.7
29229,2020-11-01,7349,7039,310,4.2
29510,2020-11-01,148610,139614,8996,6.1
30001,2020-11-01,5108,4946,162,3.2
30003,2020-11-01,4800,4528,272,5.7
30005,2020-11-01,2333,2234,99,4.2
30007,2020-11-01,2557,2425,132,5.2
30009,2020-11-01,5558,5306,252,4.5
30011,2020-11-01,721,703,18,2.5
30013,2020-11-01,37662,35930,1732,4.6
30015,2020-11-01,2598,2511,87,3.3
30017,2020-11-01,6172,5943,229,3.7
30019,2020-11-01,913,892,21,2.3
30021,2020-11-01,4674,4448,226,4.8
30023,2020-11-01,4896,4705,191,3.9
30025,2020-11-01,1707,1645,62,3.6
30027,2020-11-01,5813,5602,211,3.6
30029,2020-11-01,47556,44924,2632,5.5
30031,2020-11-01,69992,67400,2592,3.7
30033,2020-11-01,760,742,18,2.4
30035,2020-11-01,5658,5196,462,8.2
30037,2020-11-01,369,358,11,3
30039,2020-11-01,1552,1465,87,5.6
30041,2020-11-01,7530,7222,308,4.1
30043,2020-11-01,5672,5453,219,3.9
30045,2020-11-01,1076,1042,34,3.2
30047,2020-11-01,13355,12717,638,4.8
30049,2020-11-01,35594,34255,1339,3.8
30051,2020-11-01,1024,990,34,3.3
30053,2020-11-01,8002,7435,567,7.1
30055,2020-11-01,958,935,23,2.4
30057,2020-11-01,4384,4185,199,4.5
30059,2020-11-01,1008,965,43,4.3
30061,2020-11-01,1670,1559,111,6.6
30063,2020-11-01,65132,62382,2750,4.2
30065,2020-11-01,2368,2255,113,4.8
30067,2020-11-01,8909,8431,478,5.4
30069,2020-11-01,296,286,10,3.4
30071,2020-11-01,1936,1856,80,4.1
30073,2020-11-01,2691,2569,122,4.5
30075,2020-11-01,1006,982,24,2.4
30077,2020-11-01,2905,2811,94,3.2
30079,2020-11-01,482,449,33,6.8
30081,2020-11-01,20484,19565,919,4.5
30083,2020-11-01,5894,5577,317,5.4
30085,2020-11-01,4467,4248,219,4.9
30087,2020-11-01,3676,3502,174,4.7
30089,2020-11-01,5006,4710,296,5.9
30091,2020-11-01,1816,1729,87,4.8
30093,2020-11-01,16941,16130,811,4.8
30095,2020-11-01,5388,5187,201,3.7
30097,2020-11-01,1853,1802,51,2.8
30099,2020-11-01,2777,2673,104,3.7
30101,2020-11-01,2092,2004,88,4.2
30103,2020-11-01,348,336,12,3.4
30105,2020-11-01,4032,3886,146,3.6
30107,2020-11-01,822,776,46,5.6
30109,2020-11-01,464,440,24,5.2
30111,2020-11-01,82054,78728,3326,4.1
31001,2020-11-01,16139,15726,413,2.6
31003,2020-11-01,3898,3830,68,1.7
31005,2020-11-01,229,223,6,2.6
31007,2020-11-01,378,370,8,2.1
31009,2020-11-01,255,249,6,2.4
31011,2020-11-01,2921,2870,51,1.7
31013,2020-11-01,5236,5056,180,3.4
31015,2020-11-01,1050,1034,16,1.5
31017,2020-11-01,1372,1340,32,2.3
31019,2020-11-01,27324,26777,547,2
31021,2020-11-01,3479,3391,88,2.5
31023,2020-11-01,4496,4388,108,2.4
31025,2020-11-01,13489,13144,345,2.6
31027,2020-11-01,4446,4362,84,1.9
31029,2020-11-01,2253,2224,29,1.3
31031,2020-11-01,3290,3238,52,1.6
31033,2020-11-01,4166,4034,132,3.2
31035,2020-11-01,3190,3135,55,1.7
31037,2020-11-01,5508,5399,109,2
31039,2020-11-01,4788,4704,84,1.8
31041,2020-11-01,6193,6098,95,1.5
31043,2020-11-01,10643,10334,309,2.9
31045,2020-11-01,4908,4810,98,2
31047,2020-11-01,12985,12706,279,2.1
31049,2020-11-01,941,920,21,2.2
31051,2020-11-01,3011,2949,62,2.1
31053,2020-11-01,20131,19671,460,2.3
31055,2020-11-01,299609,290261,9348,3.1
31057,2020-11-01,1188,1163,25,2.1
31059,2020-11-01,3086,3026,60,1.9
31061,2020-11-01,1448,1409,39,2.7
31063,2020-11-01,1539,1513,26,1.7
31065,2020-11-01,2618,2567,51,1.9
31067,2020-11-01,10667,10418,249,2.3
31069,2020-11-01,1058,1036,22,2.1
31071,2020-11-01,1124,1108,16,1.4
31073,2020-11-01,1090,1073,17,1.6
31075,2020-11-01,422,416,6,1.4
31077,2020-11-01,1221,1195,26,2.1
31079,2020-11-01,31457,30127,1330,4.2
31081,2020-11-01,4675,4549,126,2.7
31083,2020-11-01,1707,1676,31,1.8
31085,2020-11-01,623,616,7,1.1
31087,2020-11-01,1288,1254,34,2.6
31089,2020-11-01,5711,5623,88,1.5
31091,2020-11-01,420,413,7,1.7
31093,2020-11-01,3338,3194,144,4.3
31095,2020-11-01,4136,4063,73,1.8
31097,2020-11-01,2043,1984,59,2.9
31099,2020-11-01,3665,3594,71,1.9
31101,2020-11-01,4398,4303,95,2.2
31103,2020-11-01,610,604,6,1
31105,2020-11-01,1931,1886,45,2.3
31107,2020-11-01,4593,4496,97,2.1
31109,2020-11-01,180478,175620,4858,2.7
31111,2020-11-01,17984,17586,398,2.2
31113,2020-11-01,470,465,5,1.1
31115,2020-11-01,397,390,7,1.8
31117,2020-11-01,443,435,8,1.8
31119,2020-11-01,19347,18762,585,3
31121,2020-11-01,3946,3824,122,3.1
31123,2020-11-01,2580,2520,60,2.3
31125,2020-11-01,1917,1875,42,2.2
31127,2020-11-01,3550,3473,77,2.2
31129,2020-11-01,2437,2396,41,1.7
31131,2020-11-01,8305,8112,193,2.3
31133,2020-11-01,1455,1431,24,1.6
31135,2020-11-01,1827,1802,25,1.4
31137,2020-11-01,4811,4731,80,1.7
31139,2020-11-01,4065,3937,128,3.1
31141,2020-11-01,17392,16996,396,2.3
31143,2020-11-01,2865,2813,52,1.8
31145,2020-11-01,5745,5607,138,2.4
31147,2020-11-01,4124,4037,87,2.1
31149,2020-11-01,872,860,12,1.4
31151,2020-11-01,7199,7047,152,2.1
31153,2020-11-01,96285,93978,2307,2.4
31155,2020-11-01,11127,10868,259,2.3
31157,2020-11-01,17844,17342,502,2.8
31159,2020-11-01,9106,8831,275,3
31161,2020-11-01,2616,2572,44,1.7
31163,2020-11-01,1643,1609,34,2.1
31165,2020-11-01,734,726,8,1.1
31167,2020-11-01,3492,3385,107,3.1
31169,2020-11-01,2736,2688,48,1.8
31171,2020-11-01,418,406,12,2.9
31173,2020-11-01,2848,2764,84,2.9
31175,2020-11-01,2073,2039,34,1.6
31177,2020-11-01,11225,10987,238,2.1
31179,2020-11-01,5607,5498,109,1.9
31181,2020-11-01,1602,1565,37,2.3
31183,2020-11-01,571,564,7,1.2
31185,2020-11-01,6973,6832,141,2
32001,2020-11-01,10759,10303,456,4.2
32003,2020-11-01,NA,968511,129421,11.8
32005,2020-11-01,22700,21348,1352,6
32007,2020-11-01,25939,24940,999,3.9
32009,2020-11-01,427,404,23,5.4
32011,2020-11-01,965,937,28,2.9
32013,2020-11-01,7802,7491,311,4
32015,2020-11-01,3099,2974,125,4
32017,2020-11-01,1993,1901,92,4.6
32019,2020-11-01,22417,20941,1476,6.6
32021,2020-11-01,1960,1872,88,4.5
32023,2020-11-01,17403,16047,1356,7.8
32027,2020-11-01,2360,2270,90,3.8
32029,2020-11-01,1985,1863,122,6.1
32031,2020-11-01,247968,234091,13877,5.6
32033,2020-11-01,4470,4322,148,3.3
32510,2020-11-01,24782,23262,1520,6.1
33001,2020-11-01,30725,29555,1170,3.8
33003,2020-11-01,22259,21304,955,4.3
33005,2020-11-01,40645,39234,1411,3.5
33007,2020-11-01,14076,13412,664,4.7
33009,2020-11-01,48603,47058,1545,3.2
33011,2020-11-01,238400,229229,9171,3.8
33013,2020-11-01,82446,79797,2649,3.2
33015,2020-11-01,180112,173176,6936,3.9
33017,2020-11-01,69078,66611,2467,3.6
33019,2020-11-01,23476,22714,762,3.2
34001,2020-11-01,120181,102152,18029,15
34003,2020-11-01,485948,441278,44670,9.2
34005,2020-11-01,233745,214207,19538,8.4
34007,2020-11-01,260181,233102,27079,10.4
34009,2020-11-01,42493,36697,5796,13.6
34011,2020-11-01,66916,59618,7298,10.9
34013,2020-11-01,374658,327149,47509,12.7
34015,2020-11-01,152453,138444,14009,9.2
34017,2020-11-01,367321,329073,38248,10.4
34019,2020-11-01,62971,58369,4602,7.3
34021,2020-11-01,208165,191231,16934,8.1
34023,2020-11-01,443539,403855,39684,8.9
34025,2020-11-01,331068,303023,28045,8.5
34027,2020-11-01,251791,231687,20104,8
34029,2020-11-01,277197,252261,24936,9
34031,2020-11-01,250612,218244,32368,12.9
34033,2020-11-01,29351,26361,2990,10.2
34035,2020-11-01,168112,154242,13870,8.3
34037,2020-11-01,72967,66433,6534,9
34039,2020-11-01,275605,246857,28748,10.4
34041,2020-11-01,57606,52942,4664,8.1
35001,2020-11-01,330114,309444,20670,6.3
35003,2020-11-01,1026,966,60,5.8
35005,2020-11-01,26568,24620,1948,7.3
35006,2020-11-01,8820,8077,743,8.4
35007,2020-11-01,5104,4804,300,5.9
35009,2020-11-01,20790,19776,1014,4.9
35011,2020-11-01,684,653,31,4.5
35013,2020-11-01,91758,85642,6116,6.7
35015,2020-11-01,34825,32604,2221,6.4
35017,2020-11-01,11902,10934,968,8.1
35019,2020-11-01,1502,1410,92,6.1
35021,2020-11-01,275,264,11,4
35023,2020-11-01,1944,1852,92,4.7
35025,2020-11-01,32430,29227,3203,9.9
35027,2020-11-01,8454,7846,608,7.2
35028,2020-11-01,8966,8702,264,2.9
35029,2020-11-01,9517,8167,1350,14.2
35031,2020-11-01,23712,21553,2159,9.1
35033,2020-11-01,1929,1804,125,6.5
35035,2020-11-01,24065,22413,1652,6.9
35037,2020-11-01,2998,2798,200,6.7
35039,2020-11-01,15809,14750,1059,6.7
35041,2020-11-01,7641,7234,407,5.3
35043,2020-11-01,65543,61171,4372,6.7
35045,2020-11-01,49764,45856,3908,7.9
35047,2020-11-01,10461,9776,685,6.5
35049,2020-11-01,69982,65629,4353,6.2
35051,2020-11-01,3690,3397,293,7.9
35053,2020-11-01,6027,5681,346,5.7
35055,2020-11-01,15075,13769,1306,8.7
35057,2020-11-01,5385,4973,412,7.7
35059,2020-11-01,1565,1502,63,4
35061,2020-11-01,30063,28045,2018,6.7
36001,2020-11-01,152004,144406,7598,5
36003,2020-11-01,18763,17798,965,5.1
36005,2020-11-01,581112,487946,93166,16
36007,2020-11-01,81331,76815,4516,5.6
36009,2020-11-01,32508,30707,1801,5.5
36011,2020-11-01,34660,32998,1662,4.8
36013,2020-11-01,51108,47909,3199,6.3
36015,2020-11-01,34991,32891,2100,6
36017,2020-11-01,21158,20186,972,4.6
36019,2020-11-01,35928,34258,1670,4.6
36021,2020-11-01,30050,28849,1201,4
36023,2020-11-01,22406,21259,1147,5.1
36025,2020-11-01,18199,17351,848,4.7
36027,2020-11-01,138043,131162,6881,5
36029,2020-11-01,431192,405637,25555,5.9
36031,2020-11-01,15552,14765,787,5.1
36033,2020-11-01,19073,18113,960,5
36035,2020-11-01,21209,19959,1250,5.9
36037,2020-11-01,28248,26967,1281,4.5
36039,2020-11-01,19768,18704,1064,5.4
36041,2020-11-01,2061,1944,117,5.7
36043,2020-11-01,26961,25307,1654,6.1
36045,2020-11-01,40793,38611,2182,5.3
36047,2020-11-01,NA,991374,136619,12.1
36049,2020-11-01,11098,10551,547,4.9
36051,2020-11-01,28939,27661,1278,4.4
36053,2020-11-01,30723,29284,1439,4.7
36055,2020-11-01,346377,325466,20911,6
36057,2020-11-01,20941,19658,1283,6.1
36059,2020-11-01,683558,646211,37347,5.5
36061,2020-11-01,836539,758649,77890,9.3
36063,2020-11-01,95852,90125,5727,6
36065,2020-11-01,97583,92319,5264,5.4
36067,2020-11-01,209965,198217,11748,5.6
36069,2020-11-01,52429,50012,2417,4.6
36071,2020-11-01,176482,166949,9533,5.4
36073,2020-11-01,16643,15749,894,5.4
36075,2020-11-01,49714,46851,2863,5.8
36077,2020-11-01,25921,24649,1272,4.9
36079,2020-11-01,48941,46605,2336,4.8
36081,2020-11-01,NA,948777,125406,11.7
36083,2020-11-01,77885,74256,3629,4.7
36085,2020-11-01,204611,184395,20216,9.9
36087,2020-11-01,148243,140331,7912,5.3
36089,2020-11-01,42972,40885,2087,4.9
36091,2020-11-01,114112,109306,4806,4.2
36093,2020-11-01,73791,69583,4208,5.7
36095,2020-11-01,13916,13267,649,4.7
36097,2020-11-01,7803,7381,422,5.4
36099,2020-11-01,15369,14618,751,4.9
36101,2020-11-01,40911,38768,2143,5.2
36103,2020-11-01,747884,708428,39456,5.3
36105,2020-11-01,35820,33752,2068,5.8
36107,2020-11-01,22047,21023,1024,4.6
36109,2020-11-01,49397,47435,1962,4
36111,2020-11-01,86567,82300,4267,4.9
36113,2020-11-01,29411,27820,1591,5.4
36115,2020-11-01,26085,24883,1202,4.6
36117,2020-11-01,41559,39569,1990,4.8
36119,2020-11-01,463516,436815,26701,5.8
36121,2020-11-01,17180,16366,814,4.7
36123,2020-11-01,11177,10717,460,4.1
37001,2020-11-01,81878,77061,4817,5.9
37003,2020-11-01,17267,16303,964,5.6
37005,2020-11-01,4600,4349,251,5.5
37007,2020-11-01,10822,10054,768,7.1
37009,2020-11-01,13595,12927,668,4.9
37011,2020-11-01,7804,7412,392,5
37013,2020-11-01,19440,18322,1118,5.8
37015,2020-11-01,7989,7519,470,5.9
37017,2020-11-01,15247,14305,942,6.2
37019,2020-11-01,50994,47428,3566,7
37021,2020-11-01,135293,127411,7882,5.8
37023,2020-11-01,39235,36984,2251,5.7
37025,2020-11-01,107888,101766,6122,5.7
37027,2020-11-01,35192,32871,2321,6.6
37029,2020-11-01,4656,4439,217,4.7
37031,2020-11-01,31839,30302,1537,4.8
37033,2020-11-01,9877,9227,650,6.6
37035,2020-11-01,75646,71010,4636,6.1
37037,2020-11-01,35088,33512,1576,4.5
37039,2020-11-01,11590,10908,682,5.9
37041,2020-11-01,5861,5549,312,5.3
37043,2020-11-01,4311,4050,261,6.1
37045,2020-11-01,50419,47172,3247,6.4
37047,2020-11-01,23427,21737,1690,7.2
37049,2020-11-01,40733,38371,2362,5.8
37051,2020-11-01,125239,114781,10458,8.4
37053,2020-11-01,13892,13245,647,4.7
37055,2020-11-01,17628,16514,1114,6.3
37057,2020-11-01,79244,74587,4657,5.9
37059,2020-11-01,20165,19094,1071,5.3
37061,2020-11-01,25619,24334,1285,5
37063,2020-11-01,168689,159258,9431,5.6
37065,2020-11-01,21189,19113,2076,9.8
37067,2020-11-01,184335,172766,11569,6.3
37069,2020-11-01,30912,29094,1818,5.9
37071,2020-11-01,110663,103286,7377,6.7
37073,2020-11-01,5267,5001,266,5.1
37075,2020-11-01,3384,3139,245,7.2
37077,2020-11-01,29913,28430,1483,5
37079,2020-11-01,9722,9229,493,5.1
37081,2020-11-01,256955,238604,18351,7.1
37083,2020-11-01,20524,18769,1755,8.6
37085,2020-11-01,53887,50469,3418,6.3
37087,2020-11-01,28652,27034,1618,5.6
37089,2020-11-01,52569,49861,2708,5.2
37091,2020-11-01,9452,8865,587,6.2
37093,2020-11-01,19726,18173,1553,7.9
37095,2020-11-01,1803,1683,120,6.7
37097,2020-11-01,88659,83546,5113,5.8
37099,2020-11-01,20768,19685,1083,5.2
37101,2020-11-01,97797,92596,5201,5.3
37103,2020-11-01,4299,4078,221,5.1
37105,2020-11-01,26020,24335,1685,6.5
37107,2020-11-01,28993,27320,1673,5.8
37109,2020-11-01,42996,40724,2272,5.3
37111,2020-11-01,20659,19499,1160,5.6
37113,2020-11-01,15825,15020,805,5.1
37115,2020-11-01,9682,9163,519,5.4
37117,2020-11-01,9039,8438,601,6.6
37119,2020-11-01,620068,580046,40022,6.5
37121,2020-11-01,6046,5671,375,6.2
37123,2020-11-01,11168,10538,630,5.6
37125,2020-11-01,42990,40674,2316,5.4
37127,2020-11-01,42483,39332,3151,7.4
37129,2020-11-01,120698,114062,6636,5.5
37131,2020-11-01,7715,7191,524,6.8
37133,2020-11-01,65861,61882,3979,6
37135,2020-11-01,77170,73737,3433,4.4
37137,2020-11-01,5202,4927,275,5.3
37139,2020-11-01,16901,15860,1041,6.2
37141,2020-11-01,28027,26537,1490,5.3
37143,2020-11-01,4993,4722,271,5.4
37145,2020-11-01,18126,17036,1090,6
37147,2020-11-01,86786,81449,5337,6.1
37149,2020-11-01,8946,8469,477,5.3
37151,2020-11-01,64276,60528,3748,5.8
37153,2020-11-01,17463,16028,1435,8.2
37155,2020-11-01,51864,47579,4285,8.3
37157,2020-11-01,39146,36453,2693,6.9
37159,2020-11-01,65728,61651,4077,6.2
37161,2020-11-01,25707,23805,1902,7.4
37163,2020-11-01,30151,28620,1531,5.1
37165,2020-11-01,12366,11078,1288,10.4
37167,2020-11-01,30846,29285,1561,5.1
37169,2020-11-01,21246,20086,1160,5.5
37171,2020-11-01,34083,32336,1747,5.1
37173,2020-11-01,7602,7222,380,5
37175,2020-11-01,14399,13704,695,4.8
37177,2020-11-01,1329,1224,105,7.9
37179,2020-11-01,122131,116032,6099,5
37181,2020-11-01,18231,16581,1650,9.1
37183,2020-11-01,587619,557156,30463,5.2
37185,2020-11-01,6775,6191,584,8.6
37187,2020-11-01,4417,4067,350,7.9
37189,2020-11-01,31643,30324,1319,4.2
37191,2020-11-01,49874,46847,3027,6.1
37193,2020-11-01,30354,28758,1596,5.3
37195,2020-11-01,34905,32228,2677,7.7
37197,2020-11-01,17320,16411,909,5.2
37199,2020-11-01,8330,7901,429,5.2
38001,2020-11-01,976,945,31,3.2
38003,2020-11-01,5058,4917,141,2.8
38005,2020-11-01,2193,2077,116,5.3
38007,2020-11-01,358,345,13,3.6
38009,2020-11-01,2956,2818,138,4.7
38011,2020-11-01,1581,1531,50,3.2
38013,2020-11-01,965,925,40,4.1
38015,2020-11-01,50073,48396,1677,3.3
38017,2020-11-01,106619,103303,3316,3.1
38019,2020-11-01,1925,1879,46,2.4
38021,2020-11-01,2230,2173,57,2.6
38023,2020-11-01,1336,1294,42,3.1
38025,2020-11-01,2769,2624,145,5.2
38027,2020-11-01,1169,1127,42,3.6
38029,2020-11-01,1444,1389,55,3.8
38031,2020-11-01,1523,1480,43,2.8
38033,2020-11-01,827,801,26,3.1
38035,2020-11-01,38573,37330,1243,3.2
38037,2020-11-01,1191,1157,34,2.9
38039,2020-11-01,987,957,30,3
38041,2020-11-01,1365,1313,52,3.8
38043,2020-11-01,1221,1161,60,4.9
38045,2020-11-01,1989,1945,44,2.2
38047,2020-11-01,851,834,17,2
38049,2020-11-01,3050,2885,165,5.4
38051,2020-11-01,1069,1038,31,2.9
38053,2020-11-01,7674,7020,654,8.5
38055,2020-11-01,4609,4430,179,3.9
38057,2020-11-01,3457,3273,184,5.3
38059,2020-11-01,16386,15767,619,3.8
38061,2020-11-01,6619,6278,341,5.2
38063,2020-11-01,1354,1302,52,3.8
38065,2020-11-01,862,829,33,3.8
38067,2020-11-01,3261,3136,125,3.8
38069,2020-11-01,1640,1579,61,3.7
38071,2020-11-01,5509,5325,184,3.3
38073,2020-11-01,2810,2728,82,2.9
38075,2020-11-01,1196,1146,50,4.2
38077,2020-11-01,8350,8110,240,2.9
38079,2020-11-01,4681,4182,499,10.7
38081,2020-11-01,2694,2613,81,3
38083,2020-11-01,675,637,38,5.6
38085,2020-11-01,1231,1193,38,3.1
38087,2020-11-01,380,370,10,2.6
38089,2020-11-01,16241,15072,1169,7.2
38091,2020-11-01,907,883,24,2.6
38093,2020-11-01,10354,10059,295,2.8
38095,2020-11-01,1115,1081,34,3
38097,2020-11-01,4397,4286,111,2.5
38099,2020-11-01,4979,4791,188,3.8
38101,2020-11-01,31010,29428,1582,5.1
38103,2020-11-01,1857,1792,65,3.5
38105,2020-11-01,19159,17073,2086,10.9
39001,2020-11-01,10747,10088,659,6.1
39003,2020-11-01,47259,44761,2498,5.3
39005,2020-11-01,26418,25285,1133,4.3
39007,2020-11-01,42171,39809,2362,5.6
39009,2020-11-01,29037,27721,1316,4.5
39011,2020-11-01,23355,22467,888,3.8
39013,2020-11-01,27931,26146,1785,6.4
39015,2020-11-01,19690,18624,1066,5.4
39017,2020-11-01,196401,187200,9201,4.7
39019,2020-11-01,12768,12031,737,5.8
39021,2020-11-01,19944,19129,815,4.1
39023,2020-11-01,64222,60982,3240,5
39025,2020-11-01,107244,102626,4618,4.3
39027,2020-11-01,17818,16869,949,5.3
39029,2020-11-01,45976,43222,2754,6
39031,2020-11-01,13604,12781,823,6
39033,2020-11-01,18106,17111,995,5.5
39035,2020-11-01,600198,561446,38752,6.5
39037,2020-11-01,25135,24147,988,3.9
39039,2020-11-01,17189,16387,802,4.7
39041,2020-11-01,109635,105722,3913,3.6
39043,2020-11-01,32643,30318,2325,7.1
39045,2020-11-01,77661,74321,3340,4.3
39047,2020-11-01,13885,13243,642,4.6
39049,2020-11-01,702453,665114,37339,5.3
39051,2020-11-01,22093,21159,934,4.2
39053,2020-11-01,12416,11790,626,5
39055,2020-11-01,47370,45633,1737,3.7
39057,2020-11-01,83381,79960,3421,4.1
39059,2020-11-01,17899,16810,1089,6.1
39061,2020-11-01,421697,399297,22400,5.3
39063,2020-11-01,41275,39616,1659,4
39065,2020-11-01,13791,13143,648,4.7
39067,2020-11-01,6582,6140,442,6.7
39069,2020-11-01,12874,12259,615,4.8
39071,2020-11-01,17308,16357,951,5.5
39073,2020-11-01,12919,12349,570,4.4
39075,2020-11-01,20915,20408,507,2.4
39077,2020-11-01,26064,24591,1473,5.7
39079,2020-11-01,12830,12137,693,5.4
39081,2020-11-01,27198,25312,1886,6.9
39083,2020-11-01,30954,29776,1178,3.8
39085,2020-11-01,122144,116404,5740,4.7
39087,2020-11-01,23801,22639,1162,4.9
39089,2020-11-01,90017,86289,3728,4.1
39091,2020-11-01,21770,20850,920,4.2
39093,2020-11-01,149041,140804,8237,5.5
39095,2020-11-01,209263,196225,13038,6.2
39097,2020-11-01,20698,19925,773,3.7
39099,2020-11-01,97902,91314,6588,6.7
39101,2020-11-01,27831,26400,1431,5.1
39103,2020-11-01,94034,90246,3788,4
39105,2020-11-01,9015,8440,575,6.4
39107,2020-11-01,22888,22188,700,3.1
39109,2020-11-01,54296,51998,2298,4.2
39111,2020-11-01,5793,5394,399,6.9
39113,2020-11-01,255915,241221,14694,5.7
39115,2020-11-01,6399,6004,395,6.2
39117,2020-11-01,16732,15975,757,4.5
39119,2020-11-01,40082,38086,1996,5
39121,2020-11-01,4521,4191,330,7.3
39123,2020-11-01,19528,18263,1265,6.5
39125,2020-11-01,8499,8134,365,4.3
39127,2020-11-01,15792,14932,860,5.4
39129,2020-11-01,26310,25163,1147,4.4
39131,2020-11-01,10399,9745,654,6.3
39133,2020-11-01,84665,80676,3989,4.7
39135,2020-11-01,20945,20097,848,4
39137,2020-11-01,18278,17695,583,3.2
39139,2020-11-01,52998,50097,2901,5.5
39141,2020-11-01,34237,32559,1678,4.9
39143,2020-11-01,28715,27225,1490,5.2
39145,2020-11-01,28878,27200,1678,5.8
39147,2020-11-01,26295,25015,1280,4.9
39149,2020-11-01,23358,22317,1041,4.5
39151,2020-11-01,182074,172675,9399,5.2
39153,2020-11-01,266081,251274,14807,5.6
39155,2020-11-01,82160,76567,5593,6.8
39157,2020-11-01,43344,41253,2091,4.8
39159,2020-11-01,28821,27827,994,3.4
39161,2020-11-01,14147,13569,578,4.1
39163,2020-11-01,5509,5180,329,6
39165,2020-11-01,119598,114724,4874,4.1
39167,2020-11-01,26648,25214,1434,5.4
39169,2020-11-01,59760,57591,2169,3.6
39171,2020-11-01,17945,17098,847,4.7
39173,2020-11-01,70016,67160,2856,4.1
39175,2020-11-01,12633,12172,461,3.6
40001,2020-11-01,8386,7931,455,5.4
40003,2020-11-01,2880,2780,100,3.5
40005,2020-11-01,5118,4724,394,7.7
40007,2020-11-01,2938,2868,70,2.4
40009,2020-11-01,9902,9093,809,8.2
40011,2020-11-01,4774,4502,272,5.7
40013,2020-11-01,21989,20870,1119,5.1
40015,2020-11-01,12318,11563,755,6.1
40017,2020-11-01,76088,72123,3965,5.2
40019,2020-11-01,21614,20219,1395,6.5
40021,2020-11-01,19319,18191,1128,5.8
40023,2020-11-01,5597,5141,456,8.1
40025,2020-11-01,1489,1458,31,2.1
40027,2020-11-01,145041,137975,7066,4.9
40029,2020-11-01,2483,2305,178,7.2
40031,2020-11-01,48500,45664,2836,5.8
40033,2020-11-01,2832,2666,166,5.9
40035,2020-11-01,5953,5643,310,5.2
40037,2020-11-01,31602,29462,2140,6.8
40039,2020-11-01,15963,15124,839,5.3
40041,2020-11-01,18714,17769,945,5
40043,2020-11-01,3095,2929,166,5.4
40045,2020-11-01,2210,2085,125,5.7
40047,2020-11-01,26266,24749,1517,5.8
40049,2020-11-01,12860,11994,866,6.7
40051,2020-11-01,27460,25807,1653,6
40053,2020-11-01,2790,2685,105,3.8
40055,2020-11-01,2011,1845,166,8.3
40057,2020-11-01,1277,1228,49,3.8
40059,2020-11-01,1896,1822,74,3.9
40061,2020-11-01,4353,3994,359,8.2
40063,2020-11-01,5670,5202,468,8.3
40065,2020-11-01,10998,10545,453,4.1
40067,2020-11-01,2633,2453,180,6.8
40069,2020-11-01,3382,3096,286,8.5
40071,2020-11-01,18372,17160,1212,6.6
40073,2020-11-01,9236,8825,411,4.4
40075,2020-11-01,3498,3313,185,5.3
40077,2020-11-01,3237,2875,362,11.2
40079,2020-11-01,19496,18096,1400,7.2
40081,2020-11-01,16157,15260,897,5.6
40083,2020-11-01,22639,21505,1134,5
40085,2020-11-01,6252,5997,255,4.1
40087,2020-11-01,20292,19248,1044,5.1
40089,2020-11-01,15428,14359,1069,6.9
40091,2020-11-01,7474,6822,652,8.7
40093,2020-11-01,3985,3767,218,5.5
40095,2020-11-01,7088,6680,408,5.8
40097,2020-11-01,19732,18642,1090,5.5
40099,2020-11-01,6526,6111,415,6.4
40101,2020-11-01,30186,28333,1853,6.1
40103,2020-11-01,5650,5439,211,3.7
40105,2020-11-01,4732,4459,273,5.8
40107,2020-11-01,4664,4339,325,7
40109,2020-11-01,394158,370529,23629,6
40111,2020-11-01,15809,14564,1245,7.9
40113,2020-11-01,20773,19412,1361,6.6
40115,2020-11-01,14770,14034,736,5
40117,2020-11-01,7417,6905,512,6.9
40119,2020-11-01,38675,36867,1808,4.7
40121,2020-11-01,17408,16081,1327,7.6
40123,2020-11-01,19445,18468,977,5
40125,2020-11-01,33057,31002,2055,6.2
40127,2020-11-01,4514,4168,346,7.7
40129,2020-11-01,1920,1828,92,4.8
40131,2020-11-01,44977,42351,2626,5.8
40133,2020-11-01,9717,8983,734,7.6
40135,2020-11-01,16496,15432,1064,6.5
40137,2020-11-01,19027,17521,1506,7.9
40139,2020-11-01,12377,12061,316,2.6
40141,2020-11-01,3121,2995,126,4
40143,2020-11-01,322970,302206,20764,6.4
40145,2020-11-01,37771,35582,2189,5.8
40147,2020-11-01,22274,20970,1304,5.9
40149,2020-11-01,5327,4947,380,7.1
40151,2020-11-01,4767,4614,153,3.2
40153,2020-11-01,9128,8435,693,7.6
41001,2020-11-01,7425,7026,399,5.4
41003,2020-11-01,47867,46038,1829,3.8
41005,2020-11-01,221015,209018,11997,5.4
41007,2020-11-01,19161,17998,1163,6.1
41009,2020-11-01,24398,22947,1451,5.9
41011,2020-11-01,26427,24796,1631,6.2
41013,2020-11-01,10289,9590,699,6.8
41015,2020-11-01,8908,8360,548,6.2
41017,2020-11-01,96286,91016,5270,5.5
41019,2020-11-01,47013,44422,2591,5.5
41021,2020-11-01,1010,963,47,4.7
41023,2020-11-01,3255,3060,195,6
41025,2020-11-01,3644,3479,165,4.5
41027,2020-11-01,13503,12877,626,4.6
41029,2020-11-01,105695,99956,5739,5.4
41031,2020-11-01,10170,9533,637,6.3
41033,2020-11-01,35061,33014,2047,5.8
41035,2020-11-01,29447,27655,1792,6.1
41037,2020-11-01,3694,3535,159,4.3
41039,2020-11-01,187643,177775,9868,5.3
41041,2020-11-01,19661,18232,1429,7.3
41043,2020-11-01,59942,56630,3312,5.5
41045,2020-11-01,12923,12449,474,3.7
41047,2020-11-01,159715,151275,8440,5.3
41049,2020-11-01,5744,5519,225,3.9
41051,2020-11-01,463047,433050,29997,6.5
41053,2020-11-01,39383,37458,1925,4.9
41055,2020-11-01,966,928,38,3.9
41057,2020-11-01,11554,10904,650,5.6
41059,2020-11-01,36997,35260,1737,4.7
41061,2020-11-01,12207,11592,615,5
41063,2020-11-01,3459,3283,176,5.1
41065,2020-11-01,12848,12191,657,5.1
41067,2020-11-01,325469,309860,15609,4.8
41069,2020-11-01,726,700,26,3.6
41071,2020-11-01,54684,52023,2661,4.9
42001,2020-11-01,54551,52391,2160,4
42003,2020-11-01,622911,583718,39193,6.3
42005,2020-11-01,30867,28825,2042,6.6
42007,2020-11-01,81067,75346,5721,7.1
42009,2020-11-01,22865,21645,1220,5.3
42011,2020-11-01,219669,206374,13295,6.1
42013,2020-11-01,57270,53969,3301,5.8
42015,2020-11-01,27955,26479,1476,5.3
42017,2020-11-01,328231,310204,18027,5.5
42019,2020-11-01,95050,90178,4872,5.1
42021,2020-11-01,55315,51836,3479,6.3
42023,2020-11-01,1950,1805,145,7.4
42025,2020-11-01,31237,29298,1939,6.2
42027,2020-11-01,75318,72459,2859,3.8
42029,2020-11-01,272439,260856,11583,4.3
42031,2020-11-01,16754,15856,898,5.4
42033,2020-11-01,34904,32795,2109,6
42035,2020-11-01,17729,16656,1073,6.1
42037,2020-11-01,33256,31556,1700,5.1
42039,2020-11-01,36947,34628,2319,6.3
42041,2020-11-01,130682,125033,5649,4.3
42043,2020-11-01,144551,135465,9086,6.3
42045,2020-11-01,294355,275407,18948,6.4
42047,2020-11-01,14557,13494,1063,7.3
42049,2020-11-01,121396,112638,8758,7.2
42051,2020-11-01,54993,50555,4438,8.1
42053,2020-11-01,1749,1619,130,7.4
42055,2020-11-01,75781,72116,3665,4.8
42057,2020-11-01,7703,7280,423,5.5
42059,2020-11-01,16284,15221,1063,6.5
42061,2020-11-01,19508,18174,1334,6.8
42063,2020-11-01,38321,36120,2201,5.7
42065,2020-11-01,20010,18872,1138,5.7
42067,2020-11-01,12269,11660,609,5
42069,2020-11-01,99497,92737,6760,6.8
42071,2020-11-01,284149,271061,13088,4.6
42073,2020-11-01,39076,36220,2856,7.3
42075,2020-11-01,71123,67304,3819,5.4
42077,2020-11-01,189613,177128,12485,6.6
42079,2020-11-01,149783,137858,11925,8
42081,2020-11-01,52200,48823,3377,6.5
42083,2020-11-01,16622,15571,1051,6.3
42085,2020-11-01,45728,42405,3323,7.3
42087,2020-11-01,20672,19346,1326,6.4
42089,2020-11-01,76813,70768,6045,7.9
42091,2020-11-01,433645,411168,22477,5.2
42093,2020-11-01,9062,8688,374,4.1
42095,2020-11-01,157493,148337,9156,5.8
42097,2020-11-01,41355,38681,2674,6.5
42099,2020-11-01,24194,23192,1002,4.1
42101,2020-11-01,712250,642946,69304,9.7
42103,2020-11-01,23587,21905,1682,7.1
42105,2020-11-01,6972,6533,439,6.3
42107,2020-11-01,65037,60869,4168,6.4
42109,2020-11-01,19635,18766,869,4.4
42111,2020-11-01,32275,30253,2022,6.3
42113,2020-11-01,2515,2365,150,6
42115,2020-11-01,19382,18419,963,5
42117,2020-11-01,18702,17548,1154,6.2
42119,2020-11-01,19172,18374,798,4.2
42121,2020-11-01,21920,20451,1469,6.7
42123,2020-11-01,18531,17483,1048,5.7
42125,2020-11-01,102854,96114,6740,6.6
42127,2020-11-01,20551,19272,1279,6.2
42129,2020-11-01,172951,162541,10410,6
42131,2020-11-01,12803,12071,732,5.7
42133,2020-11-01,231740,219839,11901,5.1
44001,2020-11-01,25425,23862,1563,6.1
44003,2020-11-01,88605,83066,5539,6.3
44005,2020-11-01,43168,40584,2584,6
44007,2020-11-01,320432,296003,24429,7.6
44009,2020-11-01,66571,62688,3883,5.8
45001,2020-11-01,9871,9457,414,4.2
45003,2020-11-01,71971,69504,2467,3.4
45005,2020-11-01,2552,2374,178,7
45007,2020-11-01,91646,88284,3362,3.7
45009,2020-11-01,4860,4530,330,6.8
45011,2020-11-01,7877,7439,438,5.6
45013,2020-11-01,77845,75339,2506,3.2
45015,2020-11-01,100326,96499,3827,3.8
45017,2020-11-01,6452,6162,290,4.5
45019,2020-11-01,204931,196644,8287,4
45021,2020-11-01,25225,23911,1314,5.2
45023,2020-11-01,13112,12294,818,6.2
45025,2020-11-01,21696,20759,937,4.3
45027,2020-11-01,12382,11779,603,4.9
45029,2020-11-01,16624,15851,773,4.6
45031,2020-11-01,30154,28757,1397,4.6
45033,2020-11-01,12995,12375,620,4.8
45035,2020-11-01,75429,72499,2930,3.9
45037,2020-11-01,10265,9906,359,3.5
45039,2020-11-01,9447,8918,529,5.6
45041,2020-11-01,66501,63797,2704,4.1
45043,2020-11-01,25439,24146,1293,5.1
45045,2020-11-01,256417,247505,8912,3.5
45047,2020-11-01,30957,29544,1413,4.6
45049,2020-11-01,8275,7965,310,3.7
45051,2020-11-01,137125,129986,7139,5.2
45053,2020-11-01,12683,12241,442,3.5
45055,2020-11-01,28644,27585,1059,3.7
45057,2020-11-01,39969,38150,1819,4.6
45059,2020-11-01,30353,29083,1270,4.2
45061,2020-11-01,6487,6127,360,5.5
45063,2020-11-01,147133,142579,4554,3.1
45065,2020-11-01,3298,3136,162,4.9
45067,2020-11-01,12761,11942,819,6.4
45069,2020-11-01,9146,8505,641,7
45071,2020-11-01,18512,17870,642,3.5
45073,2020-11-01,34696,33586,1110,3.2
45075,2020-11-01,34990,32677,2313,6.6
45077,2020-11-01,57445,55568,1877,3.3
45079,2020-11-01,197051,188478,8573,4.4
45081,2020-11-01,8535,8276,259,3
45083,2020-11-01,148440,142267,6173,4.2
45085,2020-11-01,41788,39737,2051,4.9
45087,2020-11-01,11401,10722,679,6
45089,2020-11-01,11871,11209,662,5.6
45091,2020-11-01,136036,130619,5417,4
46003,2020-11-01,1487,1450,37,2.5
46005,2020-11-01,9488,9188,300,3.2
46007,2020-11-01,1088,1041,47,4.3
46009,2020-11-01,2876,2770,106,3.7
46011,2020-11-01,19483,18814,669,3.4
46013,2020-11-01,20709,20089,620,3
46015,2020-11-01,2421,2352,69,2.9
46017,2020-11-01,640,606,34,5.3
46019,2020-11-01,5075,4888,187,3.7
46021,2020-11-01,773,749,24,3.1
46023,2020-11-01,3819,3630,189,4.9
46025,2020-11-01,1891,1835,56,3
46027,2020-11-01,7783,7530,253,3.3
46029,2020-11-01,15653,15087,566,3.6
46031,2020-11-01,1357,1303,54,4
46033,2020-11-01,3925,3736,189,4.8
46035,2020-11-01,11051,10719,332,3
46037,2020-11-01,2712,2606,106,3.9
46039,2020-11-01,2220,2124,96,4.3
46041,2020-11-01,2214,2088,126,5.7
46043,2020-11-01,1552,1517,35,2.3
46045,2020-11-01,2043,1991,52,2.5
46047,2020-11-01,2932,2777,155,5.3
46049,2020-11-01,1082,1052,30,2.8
46051,2020-11-01,4402,4286,116,2.6
46053,2020-11-01,2083,2026,57,2.7
46055,2020-11-01,1075,1050,25,2.3
46057,2020-11-01,3319,3235,84,2.5
46059,2020-11-01,1818,1778,40,2.2
46061,2020-11-01,1722,1663,59,3.4
46063,2020-11-01,744,720,24,3.2
46065,2020-11-01,9912,9681,231,2.3
46067,2020-11-01,3653,3543,110,3
46069,2020-11-01,691,669,22,3.2
46071,2020-11-01,1205,1154,51,4.2
46073,2020-11-01,1137,1113,24,2.1
46075,2020-11-01,541,526,15,2.8
46077,2020-11-01,2635,2559,76,2.9
46079,2020-11-01,6630,6433,197,3
46081,2020-11-01,13491,12990,501,3.7
46083,2020-11-01,34411,33524,887,2.6
46085,2020-11-01,1687,1626,61,3.6
46087,2020-11-01,3068,2994,74,2.4
46089,2020-11-01,1011,964,47,4.6
46091,2020-11-01,2392,2309,83,3.5
46093,2020-11-01,13565,13128,437,3.2
46095,2020-11-01,741,707,34,4.6
46097,2020-11-01,1205,1148,57,4.7
46099,2020-11-01,112691,109192,3499,3.1
46101,2020-11-01,4035,3919,116,2.9
46102,2020-11-01,3669,3248,421,11.5
46103,2020-11-01,54711,52635,2076,3.8
46105,2020-11-01,1451,1392,59,4.1
46107,2020-11-01,1019,994,25,2.5
46109,2020-11-01,4944,4735,209,4.2
46111,2020-11-01,1155,1123,32,2.8
46115,2020-11-01,3155,3064,91,2.9
46117,2020-11-01,1840,1791,49,2.7
46119,2020-11-01,800,783,17,2.1
46121,2020-11-01,3148,2979,169,5.4
46123,2020-11-01,3087,3013,74,2.4
46125,2020-11-01,4696,4571,125,2.7
46127,2020-11-01,8531,8194,337,4
46129,2020-11-01,2108,2004,104,4.9
46135,2020-11-01,11817,11426,391,3.3
46137,2020-11-01,940,898,42,4.5
47001,2020-11-01,36406,34716,1690,4.6
47003,2020-11-01,21846,20789,1057,4.8
47005,2020-11-01,7068,6664,404,5.7
47007,2020-11-01,4625,4339,286,6.2
47009,2020-11-01,66859,64056,2803,4.2
47011,2020-11-01,56047,53473,2574,4.6
47013,2020-11-01,15593,14750,843,5.4
47015,2020-11-01,6836,6555,281,4.1
47017,2020-11-01,12639,11949,690,5.5
47019,2020-11-01,24588,23319,1269,5.2
47021,2020-11-01,22685,21822,863,3.8
47023,2020-11-01,8828,8453,375,4.2
47025,2020-11-01,13543,12878,665,4.9
47027,2020-11-01,2851,2676,175,6.1
47029,2020-11-01,15277,14436,841,5.5
47031,2020-11-01,26365,25160,1205,4.6
47033,2020-11-01,7321,7005,316,4.3
47035,2020-11-01,24601,23248,1353,5.5
47037,2020-11-01,421595,401950,19645,4.7
47039,2020-11-01,4652,4369,283,6.1
47041,2020-11-01,7916,7461,455,5.7
47043,2020-11-01,27859,26806,1053,3.8
47045,2020-11-01,17303,16328,975,5.6
47047,2020-11-01,20088,19074,1014,5
47049,2020-11-01,7968,7521,447,5.6
47051,2020-11-01,21029,20110,919,4.4
47053,2020-11-01,23053,21835,1218,5.3
47055,2020-11-01,15273,14524,749,4.9
47057,2020-11-01,10067,9566,501,5
47059,2020-11-01,30447,28762,1685,5.5
47061,2020-11-01,5253,4937,316,6
47063,2020-11-01,29534,28181,1353,4.6
47065,2020-11-01,195425,186447,8978,4.6
47067,2020-11-01,2221,2084,137,6.2
47069,2020-11-01,9977,9287,690,6.9
47071,2020-11-01,10897,10277,620,5.7
47073,2020-11-01,24143,22865,1278,5.3
47075,2020-11-01,8146,7626,520,6.4
47077,2020-11-01,12737,12111,626,4.9
47079,2020-11-01,14573,13796,777,5.3
47081,2020-11-01,11862,11380,482,4.1
47083,2020-11-01,3435,3222,213,6.2
47085,2020-11-01,9179,8772,407,4.4
47087,2020-11-01,4906,4640,266,5.4
47089,2020-11-01,25856,24662,1194,4.6
47091,2020-11-01,8168,7761,407,5
47093,2020-11-01,256645,246309,10336,4
47095,2020-11-01,1840,1691,149,8.1
47097,2020-11-01,10227,9532,695,6.8
47099,2020-11-01,20162,19197,965,4.8
47101,2020-11-01,5403,5120,283,5.2
47103,2020-11-01,16460,15589,871,5.3
47105,2020-11-01,24818,23751,1067,4.3
47107,2020-11-01,24732,23513,1219,4.9
47109,2020-11-01,9046,8431,615,6.8
47111,2020-11-01,11897,11360,537,4.5
47113,2020-11-01,50863,48066,2797,5.5
47115,2020-11-01,13193,12536,657,5
47117,2020-11-01,16000,15240,760,4.8
47119,2020-11-01,51250,48968,2282,4.5
47121,2020-11-01,5469,5165,304,5.6
47123,2020-11-01,21229,20238,991,4.7
47125,2020-11-01,89904,85117,4787,5.3
47127,2020-11-01,3817,3685,132,3.5
47129,2020-11-01,8304,7895,409,4.9
47131,2020-11-01,13260,12498,762,5.7
47133,2020-11-01,10643,10198,445,4.2
47135,2020-11-01,3227,3027,200,6.2
47137,2020-11-01,2395,2281,114,4.8
47139,2020-11-01,8079,7693,386,4.8
47141,2020-11-01,37525,35817,1708,4.6
47143,2020-11-01,13948,13120,828,5.9
47145,2020-11-01,24611,23385,1226,5
47147,2020-11-01,39470,37918,1552,3.9
47149,2020-11-01,190449,183005,7444,3.9
47151,2020-11-01,8567,8049,518,6
47153,2020-11-01,6571,6239,332,5.1
47155,2020-11-01,54172,52092,2080,3.8
47157,2020-11-01,471058,436652,34406,7.3
47159,2020-11-01,9793,9421,372,3.8
47161,2020-11-01,5762,5465,297,5.2
47163,2020-11-01,71731,67899,3832,5.3
47165,2020-11-01,106116,101772,4344,4.1
47167,2020-11-01,29296,27763,1533,5.2
47169,2020-11-01,5629,5395,234,4.2
47171,2020-11-01,7363,6908,455,6.2
47173,2020-11-01,8022,7629,393,4.9
47175,2020-11-01,2115,1997,118,5.6
47177,2020-11-01,17038,16124,914,5.4
47179,2020-11-01,61825,58917,2908,4.7
47181,2020-11-01,6379,6023,356,5.6
47183,2020-11-01,16694,15923,771,4.6
47185,2020-11-01,12767,12183,584,4.6
47187,2020-11-01,132457,128126,4331,3.3
47189,2020-11-01,79309,76269,3040,3.8
48001,2020-11-01,23772,22201,1571,6.6
48003,2020-11-01,10025,9150,875,8.7
48005,2020-11-01,35872,32853,3019,8.4
48007,2020-11-01,9156,8291,865,9.4
48009,2020-11-01,4047,3812,235,5.8
48011,2020-11-01,889,847,42,4.7
48013,2020-11-01,22211,20108,2103,9.5
48015,2020-11-01,14004,12964,1040,7.4
48017,2020-11-01,2288,2157,131,5.7
48019,2020-11-01,9979,9350,629,6.3
48021,2020-11-01,43833,41163,2670,6.1
48023,2020-11-01,1771,1695,76,4.3
48025,2020-11-01,10074,8912,1162,11.5
48027,2020-11-01,145155,134276,10879,7.5
48029,2020-11-01,960069,887412,72657,7.6
48031,2020-11-01,6444,6184,260,4
48033,2020-11-01,407,389,18,4.4
48035,2020-11-01,8241,7750,491,6
48037,2020-11-01,40647,37677,2970,7.3
48039,2020-11-01,181453,164471,16982,9.4
48041,2020-11-01,122575,116018,6557,5.3
48043,2020-11-01,4148,3880,268,6.5
48045,2020-11-01,545,515,30,5.5
48047,2020-11-01,2710,2375,335,12.4
48049,2020-11-01,15354,14242,1112,7.2
48051,2020-11-01,8658,8069,589,6.8
48053,2020-11-01,23392,22166,1226,5.2
48055,2020-11-01,20126,18816,1310,6.5
48057,2020-11-01,12172,11394,778,6.4
48059,2020-11-01,6101,5742,359,5.9
48061,2020-11-01,167162,148440,18722,11.2
48063,2020-11-01,4992,4555,437,8.8
48065,2020-11-01,2887,2752,135,4.7
48067,2020-11-01,12630,11447,1183,9.4
48069,2020-11-01,3245,3102,143,4.4
48071,2020-11-01,19970,17790,2180,10.9
48073,2020-11-01,21037,19098,1939,9.2
48075,2020-11-01,2816,2695,121,4.3
48077,2020-11-01,4833,4526,307,6.4
48079,2020-11-01,1072,981,91,8.5
48081,2020-11-01,1426,1338,88,6.2
48083,2020-11-01,2835,2597,238,8.4
48085,2020-11-01,572542,536923,35619,6.2
48087,2020-11-01,1063,1003,60,5.6
48089,2020-11-01,9619,8985,634,6.6
48091,2020-11-01,73178,68519,4659,6.4
48093,2020-11-01,5559,5194,365,6.6
48095,2020-11-01,1275,1205,70,5.5
48097,2020-11-01,20235,18765,1470,7.3
48099,2020-11-01,24179,22475,1704,7
48101,2020-11-01,503,472,31,6.2
48103,2020-11-01,1628,1354,274,16.8
48105,2020-11-01,1646,1482,164,10
48107,2020-11-01,2409,2265,144,6
48109,2020-11-01,993,911,82,8.3
48111,2020-11-01,3637,3511,126,3.5
48113,2020-11-01,NA,NA,108891,7.8
48115,2020-11-01,4779,4297,482,10.1
48117,2020-11-01,8174,7778,396,4.8
48119,2020-11-01,2396,2244,152,6.3
48121,2020-11-01,504133,471968,32165,6.4
48123,2020-11-01,9808,9129,679,6.9
48125,2020-11-01,644,598,46,7.1
48127,2020-11-01,7247,6726,521,7.2
48129,2020-11-01,1301,1230,71,5.5
48131,2020-11-01,5120,4391,729,14.2
48133,2020-11-01,7603,7049,554,7.3
48135,2020-11-01,87183,75787,11396,13.1
48137,2020-11-01,1097,1033,64,5.8
48139,2020-11-01,94097,88182,5915,6.3
48141,2020-11-01,368889,334406,34483,9.3
48143,2020-11-01,20450,19166,1284,6.3
48145,2020-11-01,6729,6278,451,6.7
48147,2020-11-01,17568,16697,871,5
48149,2020-11-01,11867,11168,699,5.9
48151,2020-11-01,1559,1467,92,5.9
48153,2020-11-01,2446,2284,162,6.6
48155,2020-11-01,572,544,28,4.9
48157,2020-11-01,395310,361960,33350,8.4
48159,2020-11-01,4584,4273,311,6.8
48161,2020-11-01,6273,5675,598,9.5
48163,2020-11-01,10178,9554,624,6.1
48165,2020-11-01,9653,8961,692,7.2
48167,2020-11-01,167059,151755,15304,9.2
48169,2020-11-01,2147,1974,173,8.1
48171,2020-11-01,13194,12585,609,4.6
48173,2020-11-01,745,709,36,4.8
48175,2020-11-01,3242,2950,292,9
48177,2020-11-01,9466,8826,640,6.8
48179,2020-11-01,8191,7393,798,9.7
48181,2020-11-01,65118,61130,3988,6.1
48183,2020-11-01,57510,52299,5211,9.1
48185,2020-11-01,11434,10373,1061,9.3
48187,2020-11-01,81354,76308,5046,6.2
48189,2020-11-01,11670,10804,866,7.4
48191,2020-11-01,1006,938,68,6.8
48193,2020-11-01,3592,3385,207,5.8
48195,2020-11-01,2542,2426,116,4.6
48197,2020-11-01,1702,1610,92,5.4
48199,2020-11-01,24883,22493,2390,9.6
48201,2020-11-01,NA,NA,210859,9
48203,2020-11-01,29098,26397,2701,9.3
48205,2020-11-01,2601,2541,60,2.3
48207,2020-11-01,2182,2045,137,6.3
48209,2020-11-01,122908,115567,7341,6
48211,2020-11-01,1765,1659,106,6
48213,2020-11-01,36742,34138,2604,7.1
48215,2020-11-01,358745,313829,44916,12.5
48217,2020-11-01,16510,15384,1126,6.8
48219,2020-11-01,11193,10205,988,8.8
48221,2020-11-01,27804,25826,1978,7.1
48223,2020-11-01,17203,16206,997,5.8
48225,2020-11-01,10041,9377,664,6.6
48227,2020-11-01,14532,13209,1323,9.1
48229,2020-11-01,1833,1651,182,9.9
48231,2020-11-01,44087,41072,3015,6.8
48233,2020-11-01,8477,7790,687,8.1
48235,2020-11-01,735,683,52,7.1
48237,2020-11-01,3333,3058,275,8.3
48239,2020-11-01,7437,6956,481,6.5
48241,2020-11-01,12857,11277,1580,12.3
48243,2020-11-01,939,887,52,5.5
48245,2020-11-01,107255,93783,13472,12.6
48247,2020-11-01,1846,1608,238,12.9
48249,2020-11-01,17580,15035,2545,14.5
48251,2020-11-01,83199,77424,5775,6.9
48253,2020-11-01,5790,5314,476,8.2
48255,2020-11-01,7355,6791,564,7.7
48257,2020-11-01,66085,61433,4652,7
48259,2020-11-01,21787,20647,1140,5.2
48261,2020-11-01,185,170,15,8.1
48263,2020-11-01,456,440,16,3.5
48265,2020-11-01,22018,20759,1259,5.7
48267,2020-11-01,1790,1668,122,6.8
48269,2020-11-01,219,215,4,1.8
48271,2020-11-01,1341,1249,92,6.9
48273,2020-11-01,13443,12172,1271,9.5
48275,2020-11-01,1385,1285,100,7.2
48277,2020-11-01,24268,22583,1685,6.9
48279,2020-11-01,5130,4807,323,6.3
48281,2020-11-01,9162,8610,552,6
48283,2020-11-01,4208,3928,280,6.7
48285,2020-11-01,8154,7623,531,6.5
48287,2020-11-01,9943,9440,503,5.1
48289,2020-11-01,6334,5755,579,9.1
48291,2020-11-01,34295,30002,4293,12.5
48293,2020-11-01,8722,8005,717,8.2
48295,2020-11-01,1530,1454,76,5
48297,2020-11-01,5651,5139,512,9.1
48299,2020-11-01,8650,8090,560,6.5
48301,2020-11-01,698,695,3,0.4
48303,2020-11-01,157633,147877,9756,6.2
48305,2020-11-01,2719,2548,171,6.3
48307,2020-11-01,3247,2966,281,8.7
48309,2020-11-01,122936,114911,8025,6.5
48311,2020-11-01,847,823,24,2.8
48313,2020-11-01,4523,4123,400,8.8
48315,2020-11-01,4195,3795,400,9.5
48317,2020-11-01,2674,2488,186,7
48319,2020-11-01,1722,1596,126,7.3
48321,2020-11-01,17018,15081,1937,11.4
48323,2020-11-01,25059,20773,4286,17.1
48325,2020-11-01,21793,20318,1475,6.8
48327,2020-11-01,840,788,52,6.2
48329,2020-11-01,102925,93302,9623,9.3
48331,2020-11-01,9676,8881,795,8.2
48333,2020-11-01,1837,1737,100,5.4
48335,2020-11-01,2397,2144,253,10.6
48337,2020-11-01,9258,8599,659,7.1
48339,2020-11-01,285680,262095,23585,8.3
48341,2020-11-01,10459,9995,464,4.4
48343,2020-11-01,5085,4331,754,14.8
48345,2020-11-01,440,418,22,5
48347,2020-11-01,27547,25429,2118,7.7
48349,2020-11-01,23946,22428,1518,6.3
48351,2020-11-01,5097,4517,580,11.4
48353,2020-11-01,7241,6766,475,6.6
48355,2020-11-01,163677,147720,15957,9.7
48357,2020-11-01,4078,3791,287,7
48359,2020-11-01,872,833,39,4.5
48361,2020-11-01,36246,32143,4103,11.3
48363,2020-11-01,13706,12602,1104,8.1
48365,2020-11-01,10051,9116,935,9.3
48367,2020-11-01,67791,63547,4244,6.3
48369,2020-11-01,4588,4417,171,3.7
48371,2020-11-01,6356,5700,656,10.3
48373,2020-11-01,18308,16429,1879,10.3
48375,2020-11-01,54031,50775,3256,6
48377,2020-11-01,3206,2712,494,15.4
48379,2020-11-01,6069,5765,304,5
48381,2020-11-01,69944,66529,3415,4.9
48383,2020-11-01,1980,1754,226,11.4
48385,2020-11-01,970,884,86,8.9
48387,2020-11-01,5003,4627,376,7.5
48389,2020-11-01,12400,11580,820,6.6
48391,2020-11-01,3118,2825,293,9.4
48393,2020-11-01,400,379,21,5.3
48395,2020-11-01,7916,7340,576,7.3
48397,2020-11-01,52739,49574,3165,6
48399,2020-11-01,4459,4227,232,5.2
48401,2020-11-01,22638,20687,1951,8.6
48403,2020-11-01,3708,3236,472,12.7
48405,2020-11-01,3542,3179,363,10.2
48407,2020-11-01,11771,10656,1115,9.5
48409,2020-11-01,29346,25996,3350,11.4
48411,2020-11-01,2461,2336,125,5.1
48413,2020-11-01,1253,1144,109,8.7
48415,2020-11-01,6594,5984,610,9.3
48417,2020-11-01,1817,1707,110,6.1
48419,2020-11-01,11000,10112,888,8.1
48421,2020-11-01,1306,1252,54,4.1
48423,2020-11-01,108881,101150,7731,7.1
48425,2020-11-01,4382,4093,289,6.6
48427,2020-11-01,26224,21233,4991,19
48429,2020-11-01,3983,3666,317,8
48431,2020-11-01,553,511,42,7.6
48433,2020-11-01,542,508,34,6.3
48435,2020-11-01,1335,1173,162,12.1
48437,2020-11-01,2498,2348,150,6
48439,2020-11-01,NA,NA,82123,7.5
48441,2020-11-01,67219,63296,3923,5.8
48443,2020-11-01,356,338,18,5.1
48445,2020-11-01,4829,4399,430,8.9
48447,2020-11-01,606,566,40,6.6
48449,2020-11-01,12937,11961,976,7.5
48451,2020-11-01,52798,49008,3790,7.2
48453,2020-11-01,760508,715496,45012,5.9
48455,2020-11-01,5277,4776,501,9.5
48457,2020-11-01,7153,6333,820,11.5
48459,2020-11-01,17558,16039,1519,8.7
48461,2020-11-01,1660,1535,125,7.5
48463,2020-11-01,11147,10284,863,7.7
48465,2020-11-01,22321,20452,1869,8.4
48467,2020-11-01,26034,24278,1756,6.7
48469,2020-11-01,42437,38703,3734,8.8
48471,2020-11-01,24117,22102,2015,8.4
48473,2020-11-01,23665,21547,2118,8.9
48475,2020-11-01,8047,7309,738,9.2
48477,2020-11-01,15271,14255,1016,6.7
48479,2020-11-01,117221,106548,10673,9.1
48481,2020-11-01,21483,19833,1650,7.7
48483,2020-11-01,2243,2039,204,9.1
48485,2020-11-01,56110,51902,4208,7.5
48487,2020-11-01,4974,4593,381,7.7
48489,2020-11-01,6705,5878,827,12.3
48491,2020-11-01,321145,302905,18240,5.7
48493,2020-11-01,24777,23274,1503,6.1
48495,2020-11-01,4009,3555,454,11.3
48497,2020-11-01,32163,29970,2193,6.8
48499,2020-11-01,17623,16327,1296,7.4
48501,2020-11-01,3877,3405,472,12.2
48503,2020-11-01,7913,7431,482,6.1
48505,2020-11-01,4991,4248,743,14.9
48507,2020-11-01,3331,2742,589,17.7
49001,2020-11-01,2883,2780,103,3.6
49003,2020-11-01,26761,25950,811,3
49005,2020-11-01,66503,64798,1705,2.6
49007,2020-11-01,8647,8199,448,5.2
49009,2020-11-01,401,376,25,6.2
49011,2020-11-01,180379,174266,6113,3.4
49013,2020-11-01,7671,7073,598,7.8
49015,2020-11-01,4374,4189,185,4.2
49017,2020-11-01,2434,2229,205,8.4
49019,2020-11-01,5921,5568,353,6
49021,2020-11-01,25741,24768,973,3.8
49023,2020-11-01,5869,5731,138,2.4
49025,2020-11-01,3628,3475,153,4.2
49027,2020-11-01,6041,5871,170,2.8
49029,2020-11-01,5733,5576,157,2.7
49031,2020-11-01,482,452,30,6.2
49033,2020-11-01,1053,1023,30,2.8
49035,2020-11-01,649485,622397,27088,4.2
49037,2020-11-01,5316,4798,518,9.7
49039,2020-11-01,12832,12369,463,3.6
49041,2020-11-01,9906,9530,376,3.8
49043,2020-11-01,22547,21270,1277,5.7
49045,2020-11-01,34694,33262,1432,4.1
49047,2020-11-01,13291,12064,1227,9.2
49049,2020-11-01,318715,308228,10487,3.3
49051,2020-11-01,15880,15106,774,4.9
49053,2020-11-01,79199,75790,3409,4.3
49055,2020-11-01,1411,1328,83,5.9
49057,2020-11-01,132622,127375,5247,4
50001,2020-11-01,19834,19404,430,2.2
50003,2020-11-01,16633,16081,552,3.3
50005,2020-11-01,13866,13501,365,2.6
50007,2020-11-01,90494,88294,2200,2.4
50009,2020-11-01,2514,2445,69,2.7
50011,2020-11-01,25556,24858,698,2.7
50013,2020-11-01,3785,3659,126,3.3
50015,2020-11-01,12344,11867,477,3.9
50017,2020-11-01,15453,15113,340,2.2
50019,2020-11-01,11790,11352,438,3.7
50021,2020-11-01,28513,27490,1023,3.6
50023,2020-11-01,32311,31555,756,2.3
50025,2020-11-01,20643,19928,715,3.5
50027,2020-11-01,27589,26891,698,2.5
51001,2020-11-01,16158,15447,711,4.4
51003,2020-11-01,56725,54706,2019,3.6
51005,2020-11-01,6598,6320,278,4.2
51007,2020-11-01,6136,5875,261,4.3
51009,2020-11-01,14176,13587,589,4.2
51011,2020-11-01,6795,6481,314,4.6
51013,2020-11-01,150280,144594,5686,3.8
51015,2020-11-01,38037,36844,1193,3.1
51017,2020-11-01,2519,2417,102,4
51019,2020-11-01,36248,34874,1374,3.8
51021,2020-11-01,2746,2640,106,3.9
51023,2020-11-01,16770,16231,539,3.2
51025,2020-11-01,5738,5372,366,6.4
51027,2020-11-01,6330,5878,452,7.1
51029,2020-11-01,6415,6062,353,5.5
51031,2020-11-01,24511,23461,1050,4.3
51033,2020-11-01,14871,14119,752,5.1
51035,2020-11-01,12976,12397,579,4.5
51036,2020-11-01,3582,3413,169,4.7
51037,2020-11-01,5212,5002,210,4
51041,2020-11-01,181499,173914,7585,4.2
51043,2020-11-01,7425,7185,240,3.2
51045,2020-11-01,2211,2136,75,3.4
51047,2020-11-01,23907,23094,813,3.4
51049,2020-11-01,4515,4312,203,4.5
51051,2020-11-01,4629,4358,271,5.9
51053,2020-11-01,13353,12705,648,4.9
51057,2020-11-01,5380,5105,275,5.1
51059,2020-11-01,620668,593341,27327,4.4
51061,2020-11-01,36295,35101,1194,3.3
51063,2020-11-01,8108,7845,263,3.2
51065,2020-11-01,13773,13280,493,3.6
51067,2020-11-01,25627,24612,1015,4
51069,2020-11-01,45426,43987,1439,3.2
51071,2020-11-01,7691,7392,299,3.9
51073,2020-11-01,19021,18310,711,3.7
51075,2020-11-01,10837,10469,368,3.4
51077,2020-11-01,8111,7831,280,3.5
51079,2020-11-01,10391,10046,345,3.3
51081,2020-11-01,4234,3996,238,5.6
51083,2020-11-01,15308,14554,754,4.9
51085,2020-11-01,57165,55241,1924,3.4
51087,2020-11-01,176840,168604,8236,4.7
51089,2020-11-01,23832,22572,1260,5.3
51091,2020-11-01,1215,1186,29,2.4
51093,2020-11-01,18869,18158,711,3.8
51095,2020-11-01,35655,34069,1586,4.4
51097,2020-11-01,3823,3674,149,3.9
51099,2020-11-01,12916,12483,433,3.4
51101,2020-11-01,8886,8553,333,3.7
51103,2020-11-01,5505,5257,248,4.5
51105,2020-11-01,7969,7610,359,4.5
51107,2020-11-01,216144,207866,8278,3.8
51109,2020-11-01,19879,19179,700,3.5
51111,2020-11-01,5111,4891,220,4.3
51113,2020-11-01,7416,7221,195,2.6
51115,2020-11-01,3998,3853,145,3.6
51117,2020-11-01,12247,11639,608,5
51119,2020-11-01,5253,5072,181,3.4
51121,2020-11-01,48363,46860,1503,3.1
51125,2020-11-01,7455,7173,282,3.8
51127,2020-11-01,12047,11654,393,3.3
51131,2020-11-01,5347,5039,308,5.8
51133,2020-11-01,5634,5408,226,4
51135,2020-11-01,6933,6649,284,4.1
51137,2020-11-01,17316,16660,656,3.8
51139,2020-11-01,11794,11299,495,4.2
51141,2020-11-01,7065,6763,302,4.3
51143,2020-11-01,29476,28228,1248,4.2
51145,2020-11-01,13622,13178,444,3.3
51147,2020-11-01,10375,9926,449,4.3
51149,2020-11-01,14651,13912,739,5
51153,2020-11-01,240078,228589,11489,4.8
51155,2020-11-01,15654,14940,714,4.6
51157,2020-11-01,3632,3511,121,3.3
51159,2020-11-01,4005,3858,147,3.7
51161,2020-11-01,47515,45852,1663,3.5
51163,2020-11-01,11065,10547,518,4.7
51165,2020-11-01,40661,39440,1221,3
51167,2020-11-01,10863,10370,493,4.5
51169,2020-11-01,8676,8363,313,3.6
51171,2020-11-01,21893,21104,789,3.6
51173,2020-11-01,13207,12652,555,4.2
51175,2020-11-01,9007,8662,345,3.8
51177,2020-11-01,64985,62279,2706,4.2
51179,2020-11-01,69749,66870,2879,4.1
51181,2020-11-01,3627,3490,137,3.8
51183,2020-11-01,3846,3586,260,6.8
51185,2020-11-01,15157,14338,819,5.4
51187,2020-11-01,19827,19041,786,4
51191,2020-11-01,25342,24396,946,3.7
51193,2020-11-01,9335,8922,413,4.4
51195,2020-11-01,13290,12552,738,5.6
51197,2020-11-01,13391,12795,596,4.5
51199,2020-11-01,31576,30432,1144,3.6
51510,2020-11-01,99652,94742,4910,4.9
51520,2020-11-01,6908,6526,382,5.5
51530,2020-11-01,3693,3516,177,4.8
51540,2020-11-01,26244,25174,1070,4.1
51550,2020-11-01,118932,113695,5237,4.4
51570,2020-11-01,8574,8127,447,5.2
51580,2020-11-01,2318,2170,148,6.4
51590,2020-11-01,18995,17715,1280,6.7
51595,2020-11-01,2334,2129,205,8.8
51600,2020-11-01,13090,12584,506,3.9
51610,2020-11-01,8298,8049,249,3
51620,2020-11-01,3610,3346,264,7.3
51630,2020-11-01,13731,13043,688,5
51640,2020-11-01,2855,2729,126,4.4
51650,2020-11-01,63076,59070,4006,6.4
51660,2020-11-01,24001,23057,944,3.9
51670,2020-11-01,9640,8824,816,8.5
51678,2020-11-01,2072,1970,102,4.9
51680,2020-11-01,34359,32512,1847,5.4
51683,2020-11-01,21505,20533,972,4.5
51685,2020-11-01,9210,8748,462,5
51690,2020-11-01,5653,5194,459,8.1
51700,2020-11-01,87188,81709,5479,6.3
51710,2020-11-01,110034,102697,7337,6.7
51720,2020-11-01,1685,1598,87,5.2
51730,2020-11-01,13303,11719,1584,11.9
51735,2020-11-01,6157,5990,167,2.7
51740,2020-11-01,43996,40559,3437,7.8
51750,2020-11-01,8322,8000,322,3.9
51760,2020-11-01,116741,109136,7605,6.5
51770,2020-11-01,48076,45406,2670,5.6
51775,2020-11-01,12461,12000,461,3.7
51790,2020-11-01,12423,11922,501,4
51800,2020-11-01,43466,41299,2167,5
51810,2020-11-01,225809,216402,9407,4.2
51820,2020-11-01,10847,10380,467,4.3
51830,2020-11-01,6486,6134,352,5.4
51840,2020-11-01,14073,13532,541,3.8
53001,2020-11-01,9816,9291,525,5.3
53003,2020-11-01,9851,9475,376,3.8
53005,2020-11-01,104013,98124,5889,5.7
53007,2020-11-01,41613,39085,2528,6.1
53009,2020-11-01,28019,26011,2008,7.2
53011,2020-11-01,233558,218541,15017,6.4
53013,2020-11-01,1700,1605,95,5.6
53015,2020-11-01,47076,43838,3238,6.9
53017,2020-11-01,20210,18974,1236,6.1
53019,2020-11-01,2428,2245,183,7.5
53021,2020-11-01,44004,41092,2912,6.6
53023,2020-11-01,803,752,51,6.4
53025,2020-11-01,47398,44223,3175,6.7
53027,2020-11-01,28047,25537,2510,8.9
53029,2020-11-01,35488,33298,2190,6.2
53031,2020-11-01,11850,11012,838,7.1
53033,2020-11-01,NA,NA,55271,4.4
53035,2020-11-01,128673,121523,7150,5.6
53037,2020-11-01,20725,19397,1328,6.4
53039,2020-11-01,9711,9127,584,6
53041,2020-11-01,33855,31643,2212,6.5
53043,2020-11-01,4582,4359,223,4.9
53045,2020-11-01,24490,22581,1909,7.8
53047,2020-11-01,18199,16967,1232,6.8
53049,2020-11-01,7765,7100,665,8.6
53051,2020-11-01,4738,4350,388,8.2
53053,2020-11-01,437304,407056,30248,6.9
53055,2020-11-01,7449,7003,446,6
53057,2020-11-01,60716,56498,4218,6.9
53059,2020-11-01,5318,4938,380,7.1
53061,2020-11-01,429774,408513,21261,4.9
53063,2020-11-01,242944,227922,15022,6.2
53065,2020-11-01,17652,16487,1165,6.6
53067,2020-11-01,141232,133034,8198,5.8
53069,2020-11-01,1360,1268,92,6.8
53071,2020-11-01,29691,28152,1539,5.2
53073,2020-11-01,115185,107747,7438,6.5
53075,2020-11-01,21851,20840,1011,4.6
53077,2020-11-01,128102,118961,9141,7.1
54001,2020-11-01,6966,6538,428,6.1
54003,2020-11-01,56856,54482,2374,4.2
54005,2020-11-01,7307,6762,545,7.5
54007,2020-11-01,4599,4228,371,8.1
54009,2020-11-01,9626,8994,632,6.6
54011,2020-11-01,41319,39102,2217,5.4
54013,2020-11-01,2186,1896,290,13.3
54015,2020-11-01,3022,2769,253,8.4
54017,2020-11-01,3844,3672,172,4.5
54019,2020-11-01,15976,14856,1120,7
54021,2020-11-01,2362,2200,162,6.9
54023,2020-11-01,5758,5508,250,4.3
54025,2020-11-01,14756,13991,765,5.2
54027,2020-11-01,10407,9982,425,4.1
54029,2020-11-01,12608,11766,842,6.7
54031,2020-11-01,5760,5467,293,5.1
54033,2020-11-01,33943,32077,1866,5.5
54035,2020-11-01,12204,11450,754,6.2
54037,2020-11-01,29773,28577,1196,4
54039,2020-11-01,80640,75569,5071,6.3
54041,2020-11-01,6029,5524,505,8.4
54043,2020-11-01,7119,6617,502,7.1
54045,2020-11-01,9780,8841,939,9.6
54047,2020-11-01,4178,3750,428,10.2
54049,2020-11-01,25176,23773,1403,5.6
54051,2020-11-01,12847,11973,874,6.8
54053,2020-11-01,9384,8800,584,6.2
54055,2020-11-01,19689,18278,1411,7.2
54057,2020-11-01,11937,11313,624,5.2
54059,2020-11-01,5972,5303,669,11.2
54061,2020-11-01,55126,52887,2239,4.1
54063,2020-11-01,5664,5389,275,4.9
54065,2020-11-01,7824,7516,308,3.9
54067,2020-11-01,8376,7763,613,7.3
54069,2020-11-01,19435,18281,1154,5.9
54071,2020-11-01,3641,3527,114,3.1
54073,2020-11-01,2859,2648,211,7.4
54075,2020-11-01,4037,3795,242,6
54077,2020-11-01,15641,14900,741,4.7
54079,2020-11-01,26410,25162,1248,4.7
54081,2020-11-01,30000,28161,1839,6.1
54083,2020-11-01,11790,11037,753,6.4
54085,2020-11-01,4125,3865,260,6.3
54087,2020-11-01,4658,4210,448,9.6
54089,2020-11-01,3893,3643,250,6.4
54091,2020-11-01,7565,7184,381,5
54093,2020-11-01,3116,2942,174,5.6
54095,2020-11-01,2951,2698,253,8.6
54097,2020-11-01,8624,7958,666,7.7
54099,2020-11-01,15566,14699,867,5.6
54101,2020-11-01,2965,2756,209,7
54103,2020-11-01,6309,5819,490,7.8
54105,2020-11-01,2285,2107,178,7.8
54107,2020-11-01,36776,34622,2154,5.9
54109,2020-11-01,5818,5332,486,8.4
55001,2020-11-01,8109,7480,629,7.8
55003,2020-11-01,7754,7233,521,6.7
55005,2020-11-01,23726,22735,991,4.2
55007,2020-11-01,7468,6905,563,7.5
55009,2020-11-01,143031,136989,6042,4.2
55011,2020-11-01,6290,5998,292,4.6
55013,2020-11-01,6978,6506,472,6.8
55015,2020-11-01,27050,26147,903,3.3
55017,2020-11-01,33261,31732,1529,4.6
55019,2020-11-01,17297,16708,589,3.4
55021,2020-11-01,31761,30436,1325,4.2
55023,2020-11-01,7330,6977,353,4.8
55025,2020-11-01,325412,313515,11897,3.7
55027,2020-11-01,46836,45019,1817,3.9
55029,2020-11-01,13978,13210,768,5.5
55031,2020-11-01,22824,21573,1251,5.5
55033,2020-11-01,24057,23140,917,3.8
55035,2020-11-01,59311,56948,2363,4
55037,2020-11-01,2231,2098,133,6
55039,2020-11-01,59052,56784,2268,3.8
55041,2020-11-01,4102,3746,356,8.7
55043,2020-11-01,27516,26531,985,3.6
55045,2020-11-01,20970,20258,712,3.4
55047,2020-11-01,9135,8687,448,4.9
55049,2020-11-01,13709,13175,534,3.9
55051,2020-11-01,2576,2359,217,8.4
55053,2020-11-01,10201,9555,646,6.3
55055,2020-11-01,45729,43899,1830,4
55057,2020-11-01,13495,12778,717,5.3
55059,2020-11-01,88553,83881,4672,5.3
55061,2020-11-01,10885,10527,358,3.3
55063,2020-11-01,66521,64044,2477,3.7
55065,2020-11-01,9924,9630,294,3
55067,2020-11-01,9190,8715,475,5.2
55069,2020-11-01,14927,14319,608,4.1
55071,2020-11-01,40727,38980,1747,4.3
55073,2020-11-01,73432,70785,2647,3.6
55075,2020-11-01,19294,18184,1110,5.8
55077,2020-11-01,7709,7313,396,5.1
55078,2020-11-01,1622,1446,176,10.9
55079,2020-11-01,472194,439988,32206,6.8
55081,2020-11-01,23401,22407,994,4.2
55083,2020-11-01,20621,19700,921,4.5
55085,2020-11-01,17081,16172,909,5.3
55087,2020-11-01,101837,97963,3874,3.8
55089,2020-11-01,48771,46830,1941,4
55091,2020-11-01,4003,3838,165,4.1
55093,2020-11-01,25095,24091,1004,4
55095,2020-11-01,24413,23149,1264,5.2
55097,2020-11-01,38444,36922,1522,4
55099,2020-11-01,6371,6057,314,4.9
55101,2020-11-01,101373,95822,5551,5.5
55103,2020-11-01,9028,8693,335,3.7
55105,2020-11-01,84344,80137,4207,5
55107,2020-11-01,6581,6235,346,5.3
55109,2020-11-01,50253,48078,2175,4.3
55111,2020-11-01,35457,33730,1727,4.9
55113,2020-11-01,7738,7217,521,6.7
55115,2020-11-01,20721,19788,933,4.5
55117,2020-11-01,61414,58995,2419,3.9
55119,2020-11-01,10738,10319,419,3.9
55121,2020-11-01,15726,15009,717,4.6
55123,2020-11-01,15017,14465,552,3.7
55125,2020-11-01,9739,9178,561,5.8
55127,2020-11-01,57192,54741,2451,4.3
55129,2020-11-01,7728,7359,369,4.8
55131,2020-11-01,76520,73469,3051,4
55133,2020-11-01,223614,214319,9295,4.2
55135,2020-11-01,25507,24453,1054,4.1
55137,2020-11-01,11243,10741,502,4.5
55139,2020-11-01,92257,88730,3527,3.8
55141,2020-11-01,35116,33376,1740,5
56001,2020-11-01,21785,21121,664,3
56003,2020-11-01,5270,5067,203,3.9
56005,2020-11-01,23658,22283,1375,5.8
56007,2020-11-01,7743,7448,295,3.8
56009,2020-11-01,9146,8682,464,5.1
56011,2020-11-01,3736,3612,124,3.3
56013,2020-11-01,19111,18105,1006,5.3
56015,2020-11-01,6597,6336,261,4
56017,2020-11-01,2216,2119,97,4.4
56019,2020-11-01,4125,3943,182,4.4
56021,2020-11-01,49026,46955,2071,4.2
56023,2020-11-01,8845,8486,359,4.1
56025,2020-11-01,39959,37139,2820,7.1
56027,2020-11-01,1246,1204,42,3.4
56029,2020-11-01,14941,14266,675,4.5
56031,2020-11-01,4770,4579,191,4
56033,2020-11-01,15911,15264,647,4.1
56035,2020-11-01,4025,3807,218,5.4
56037,2020-11-01,21199,19920,1279,6
56039,2020-11-01,14220,13395,825,5.8
56041,2020-11-01,9006,8519,487,5.4
56043,2020-11-01,3884,3701,183,4.7
56045,2020-11-01,3832,3708,124,3.2
72001,2020-11-01,3881,3417,464,12
72003,2020-11-01,11026,9971,1055,9.6
72005,2020-11-01,13567,12155,1412,10.4
72007,2020-11-01,6052,5413,639,10.6
72009,2020-11-01,5889,5348,541,9.2
72011,2020-11-01,8213,7496,717,8.7
72013,2020-11-01,23385,21238,2147,9.2
72015,2020-11-01,4190,3758,432,10.3
72017,2020-11-01,5374,4787,587,10.9
72019,2020-11-01,6741,6044,697,10.3
72021,2020-11-01,61881,55886,5995,9.7
72023,2020-11-01,12808,11673,1135,8.9
72025,2020-11-01,44468,40589,3879,8.7
72027,2020-11-01,9256,8488,768,8.3
72029,2020-11-01,15109,13670,1439,9.5
72031,2020-11-01,58266,52734,5532,9.5
72033,2020-11-01,7427,6642,785,10.6
72035,2020-11-01,14833,13691,1142,7.7
72037,2020-11-01,3418,3054,364,10.6
72039,2020-11-01,3489,3027,462,13.2
72041,2020-11-01,14163,13204,959,6.8
72043,2020-11-01,9037,8064,973,10.8
72045,2020-11-01,4588,4071,517,11.3
72047,2020-11-01,8472,7393,1079,12.7
72049,2020-11-01,892,816,76,8.5
72051,2020-11-01,12333,11379,954,7.7
72053,2020-11-01,10145,8975,1170,11.5
72054,2020-11-01,3080,2692,388,12.6
72055,2020-11-01,3809,3354,455,11.9
72057,2020-11-01,9906,9032,874,8.8
72059,2020-11-01,4526,4011,515,11.4
72061,2020-11-01,35153,33031,2122,6
72063,2020-11-01,16624,15507,1117,6.7
72065,2020-11-01,12764,11687,1077,8.4
72067,2020-11-01,4969,4500,469,9.4
72069,2020-11-01,15785,14360,1425,9
72071,2020-11-01,10882,9890,992,9.1
72073,2020-11-01,3940,3516,424,10.8
72075,2020-11-01,14727,13488,1239,8.4
72077,2020-11-01,11407,10248,1159,10.2
72079,2020-11-01,4901,4336,565,11.5
72081,2020-11-01,6605,5813,792,12
72083,2020-11-01,2460,2200,260,10.6
72085,2020-11-01,10357,9388,969,9.4
72087,2020-11-01,7948,7081,867,10.9
72089,2020-11-01,5789,5124,665,11.5
72091,2020-11-01,10812,9854,958,8.9
72093,2020-11-01,1724,1583,141,8.2
72095,2020-11-01,2520,2277,243,9.6
72097,2020-11-01,19892,18022,1870,9.4
72099,2020-11-01,9715,8705,1010,10.4
72101,2020-11-01,7443,6600,843,11.3
72103,2020-11-01,7436,6797,639,8.6
72105,2020-11-01,6736,5850,886,13.2
72107,2020-11-01,4582,3992,590,12.9
72109,2020-11-01,3831,3385,446,11.6
72111,2020-11-01,5376,4746,630,11.7
72113,2020-11-01,42664,38717,3947,9.3
72115,2020-11-01,5853,5235,618,10.6
72117,2020-11-01,4270,3809,461,10.8
72119,2020-11-01,16010,14291,1719,10.7
72121,2020-11-01,5599,5049,550,9.8
72123,2020-11-01,6365,5624,741,11.6
72125,2020-11-01,9019,8122,897,9.9
72127,2020-11-01,127437,116185,11252,8.8
72129,2020-11-01,10680,9707,973,9.1
72131,2020-11-01,9491,8382,1109,11.7
72133,2020-11-01,8022,7299,723,9
72135,2020-11-01,25306,23275,2031,8
72137,2020-11-01,27442,25054,2388,8.7
72139,2020-11-01,25274,23473,1801,7.1
72141,2020-11-01,6097,5520,577,9.5
72143,2020-11-01,9157,8113,1044,11.4
72145,2020-11-01,12447,10911,1536,12.3
72147,2020-11-01,2445,2166,279,11.4
72149,2020-11-01,6613,5859,754,11.4
72151,2020-11-01,7907,7027,880,11.1
72153,2020-11-01,9202,8089,1113,12.1
01001,2020-12-01,25029,24237,792,3.2
01003,2020-12-01,91638,88526,3112,3.4
01005,2020-12-01,9629,9109,520,5.4
01007,2020-12-01,8539,8193,346,4.1
01009,2020-12-01,24585,24005,580,2.4
01011,2020-12-01,5104,4885,219,4.3
01013,2020-12-01,9628,9078,550,5.7
01015,2020-12-01,44289,42325,1964,4.4
01017,2020-12-01,16580,15921,659,4
01019,2020-12-01,12038,11737,301,2.5
01021,2020-12-01,19348,18792,556,2.9
01023,2020-12-01,5175,4964,211,4.1
01025,2020-12-01,8502,8003,499,5.9
01027,2020-12-01,6754,6580,174,2.6
01029,2020-12-01,6042,5901,141,2.3
01031,2020-12-01,23342,22747,595,2.5
01033,2020-12-01,22849,21994,855,3.7
01035,2020-12-01,4898,4672,226,4.6
01037,2020-12-01,4845,4697,148,3.1
01039,2020-12-01,16438,15966,472,2.9
01041,2020-12-01,6550,6341,209,3.2
01043,2020-12-01,41258,40390,868,2.1
01045,2020-12-01,22268,21555,713,3.2
01047,2020-12-01,15614,14491,1123,7.2
01049,2020-12-01,33976,33180,796,2.3
01051,2020-12-01,35891,34802,1089,3
01053,2020-12-01,16173,15579,594,3.7
01055,2020-12-01,40673,38965,1708,4.2
01057,2020-12-01,6961,6759,202,2.9
01059,2020-12-01,15453,15113,340,2.2
01061,2020-12-01,10839,10544,295,2.7
01063,2020-12-01,3170,2944,226,7.1
01065,2020-12-01,6117,5728,389,6.4
01067,2020-12-01,6793,6565,228,3.4
01069,2020-12-01,45617,43927,1690,3.7
01071,2020-12-01,23772,23099,673,2.8
01073,2020-12-01,314152,301073,13079,4.2
01075,2020-12-01,6260,6089,171,2.7
01077,2020-12-01,41025,39751,1274,3.1
01079,2020-12-01,13950,13515,435,3.1
01081,2020-12-01,75408,73110,2298,3
01083,2020-12-01,42894,41815,1079,2.5
01085,2020-12-01,3598,3231,367,10.2
01087,2020-12-01,8457,7921,536,6.3
01089,2020-12-01,181912,176626,5286,2.9
01091,2020-12-01,8518,8156,362,4.2
01093,2020-12-01,14810,14397,413,2.8
01095,2020-12-01,47633,46571,1062,2.2
01097,2020-12-01,184298,174213,10085,5.5
01099,2020-12-01,8104,7669,435,5.4
01101,2020-12-01,103411,97524,5887,5.7
01103,2020-12-01,56914,55309,1605,2.8
01105,2020-12-01,3740,3450,290,7.8
01107,2020-12-01,7743,7418,325,4.2
01109,2020-12-01,17504,16975,529,3
01111,2020-12-01,10284,10040,244,2.4
01113,2020-12-01,22835,22086,749,3.3
01115,2020-12-01,39477,38354,1123,2.8
01117,2020-12-01,112739,110261,2478,2.2
01119,2020-12-01,5102,4874,228,4.5
01121,2020-12-01,38428,36944,1484,3.9
01123,2020-12-01,19227,18420,807,4.2
01125,2020-12-01,102719,98702,4017,3.9
01127,2020-12-01,24746,23834,912,3.7
01129,2020-12-01,7232,6894,338,4.7
01131,2020-12-01,3104,2776,328,10.6
01133,2020-12-01,10514,10207,307,2.9
02013,2020-12-01,1165,1071,94,8.1
02016,2020-12-01,2718,2534,184,6.8
02020,2020-12-01,150509,142180,8329,5.5
02050,2020-12-01,7161,6495,666,9.3
02060,2020-12-01,271,249,22,8.1
02068,2020-12-01,533,458,75,14.1
02070,2020-12-01,1703,1600,103,6
02090,2020-12-01,44984,42930,2054,4.6
02100,2020-12-01,939,840,99,10.5
02105,2020-12-01,926,834,92,9.9
02110,2020-12-01,16149,15432,717,4.4
02122,2020-12-01,25076,23234,1842,7.3
02130,2020-12-01,6420,5993,427,6.7
02150,2020-12-01,5361,4824,537,10
02158,2020-12-01,2793,2436,357,12.8
02164,2020-12-01,630,584,46,7.3
02170,2020-12-01,47448,44578,2870,6
02180,2020-12-01,4152,3888,264,6.4
02185,2020-12-01,2898,2740,158,5.5
02188,2020-12-01,3002,2753,249,8.3
02195,2020-12-01,1302,1202,100,7.7
02198,2020-12-01,2716,2550,166,6.1
02220,2020-12-01,4013,3792,221,5.5
02230,2020-12-01,578,495,83,14.4
02240,2020-12-01,2799,2625,174,6.2
02261,2020-12-01,3899,3608,291,7.5
02275,2020-12-01,966,904,62,6.4
02282,2020-12-01,223,207,16,7.2
02290,2020-12-01,2419,2237,182,7.5
04001,2020-12-01,19726,17249,2477,12.6
04003,2020-12-01,51269,47992,3277,6.4
04005,2020-12-01,68305,61721,6584,9.6
04007,2020-12-01,20682,19130,1552,7.5
04009,2020-12-01,15737,14700,1037,6.6
04011,2020-12-01,4515,4243,272,6
04012,2020-12-01,9653,9039,614,6.4
04013,2020-12-01,NA,NA,161695,6.9
04015,2020-12-01,85783,78617,7166,8.4
04017,2020-12-01,39364,35598,3766,9.6
04019,2020-12-01,497081,460365,36716,7.4
04021,2020-12-01,190216,176718,13498,7.1
04023,2020-12-01,19363,17258,2105,10.9
04025,2020-12-01,107694,100692,7002,6.5
04027,2020-12-01,92162,80701,11461,12.4
05001,2020-12-01,9448,9167,281,3
05003,2020-12-01,7393,6921,472,6.4
05005,2020-12-01,16163,15537,626,3.9
05007,2020-12-01,138929,134851,4078,2.9
05009,2020-12-01,16001,15509,492,3.1
05011,2020-12-01,4472,4296,176,3.9
05013,2020-12-01,2428,2344,84,3.5
05015,2020-12-01,12766,12285,481,3.8
05017,2020-12-01,3167,2901,266,8.4
05019,2020-12-01,9627,9250,377,3.9
05021,2020-12-01,5539,5326,213,3.8
05023,2020-12-01,9013,8564,449,5
05025,2020-12-01,3108,2967,141,4.5
05027,2020-12-01,9450,8904,546,5.8
05029,2020-12-01,8174,7845,329,4
05031,2020-12-01,57412,55583,1829,3.2
05033,2020-12-01,26108,25170,938,3.6
05035,2020-12-01,21311,20207,1104,5.2
05037,2020-12-01,7395,7096,299,4
05039,2020-12-01,2732,2639,93,3.4
05041,2020-12-01,5319,5063,256,4.8
05043,2020-12-01,7726,7353,373,4.8
05045,2020-12-01,60172,58049,2123,3.5
05047,2020-12-01,7438,7157,281,3.8
05049,2020-12-01,5016,4829,187,3.7
05051,2020-12-01,41296,39199,2097,5.1
05053,2020-12-01,8099,7813,286,3.5
05055,2020-12-01,20022,19328,694,3.5
05057,2020-12-01,9727,9411,316,3.2
05059,2020-12-01,13873,13347,526,3.8
05061,2020-12-01,5548,5367,181,3.3
05063,2020-12-01,16702,16096,606,3.6
05065,2020-12-01,4790,4540,250,5.2
05067,2020-12-01,5599,5300,299,5.3
05069,2020-12-01,26768,25110,1658,6.2
05071,2020-12-01,10118,9693,425,4.2
05073,2020-12-01,2464,2315,149,6
05075,2020-12-01,6986,6692,294,4.2
05077,2020-12-01,2772,2616,156,5.6
05079,2020-12-01,3788,3625,163,4.3
05081,2020-12-01,5549,5307,242,4.4
05083,2020-12-01,8229,7874,355,4.3
05085,2020-12-01,33225,32017,1208,3.6
05087,2020-12-01,7500,7290,210,2.8
05089,2020-12-01,6586,6296,290,4.4
05091,2020-12-01,19874,19005,869,4.4
05093,2020-12-01,17276,16235,1041,6
05095,2020-12-01,2772,2623,149,5.4
05097,2020-12-01,2892,2743,149,5.2
05099,2020-12-01,3589,3454,135,3.8
05101,2020-12-01,3309,3208,101,3.1
05103,2020-12-01,9698,9329,369,3.8
05105,2020-12-01,4086,3932,154,3.8
05107,2020-12-01,6253,5819,434,6.9
05109,2020-12-01,4256,4070,186,4.4
05111,2020-12-01,10568,10186,382,3.6
05113,2020-12-01,8010,7652,358,4.5
05115,2020-12-01,28878,27782,1096,3.8
05117,2020-12-01,3559,3420,139,3.9
05119,2020-12-01,185504,176151,9353,5
05121,2020-12-01,7421,7104,317,4.3
05123,2020-12-01,8159,7705,454,5.6
05125,2020-12-01,56923,55062,1861,3.3
05127,2020-12-01,4360,4207,153,3.5
05129,2020-12-01,2826,2715,111,3.9
05131,2020-12-01,55144,52997,2147,3.9
05133,2020-12-01,5486,5243,243,4.4
05135,2020-12-01,5741,5444,297,5.2
05137,2020-12-01,4671,4422,249,5.3
05139,2020-12-01,15546,14687,859,5.5
05141,2020-12-01,5709,5394,315,5.5
05143,2020-12-01,126835,123001,3834,3
05145,2020-12-01,33442,32010,1432,4.3
05147,2020-12-01,2718,2594,124,4.6
05149,2020-12-01,8414,8123,291,3.5
06001,2020-12-01,819802,757149,62653,7.6
06003,2020-12-01,627,581,46,7.3
06005,2020-12-01,14288,13090,1198,8.4
06007,2020-12-01,93837,86142,7695,8.2
06009,2020-12-01,20406,18919,1487,7.3
06011,2020-12-01,9657,8157,1500,15.5
06013,2020-12-01,545832,502844,42988,7.9
06015,2020-12-01,9233,8386,847,9.2
06017,2020-12-01,90778,84438,6340,7
06019,2020-12-01,445484,399253,46231,10.4
06021,2020-12-01,12605,11637,968,7.7
06023,2020-12-01,60723,56188,4535,7.5
06025,2020-12-01,67125,55257,11868,17.7
06027,2020-12-01,8229,7659,570,6.9
06029,2020-12-01,377530,334904,42626,11.3
06031,2020-12-01,56006,49855,6151,11
06033,2020-12-01,28609,26047,2562,9
06035,2020-12-01,9287,8631,656,7.1
06037,2020-12-01,NA,NA,597356,12.3
06039,2020-12-01,61480,55405,6075,9.9
06041,2020-12-01,134147,126754,7393,5.5
06043,2020-12-01,7164,6424,740,10.3
06045,2020-12-01,36297,33373,2924,8.1
06047,2020-12-01,113559,100504,13055,11.5
06049,2020-12-01,3055,2784,271,8.9
06051,2020-12-01,8301,7566,735,8.9
06053,2020-12-01,188730,167218,21512,11.4
06055,2020-12-01,71100,65919,5181,7.3
06057,2020-12-01,47415,44182,3233,6.8
06059,2020-12-01,NA,NA,119074,7.4
06061,2020-12-01,184882,173352,11530,6.2
06063,2020-12-01,7306,6526,780,10.7
06065,2020-12-01,NA,NA,100365,9.1
06067,2020-12-01,714675,653583,61092,8.5
06069,2020-12-01,30800,28108,2692,8.7
06071,2020-12-01,977767,887739,90028,9.2
06073,2020-12-01,NA,NA,127414,8
06075,2020-12-01,566193,529919,36274,6.4
06077,2020-12-01,325459,290805,34654,10.6
06079,2020-12-01,131722,122842,8880,6.7
06081,2020-12-01,444330,418624,25706,5.8
06083,2020-12-01,211515,195460,16055,7.6
06085,2020-12-01,NA,978961,61925,5.9
06087,2020-12-01,127572,116738,10834,8.5
06089,2020-12-01,73407,67514,5893,8
06091,2020-12-01,1292,1202,90,7
06093,2020-12-01,15163,13543,1620,10.7
06095,2020-12-01,206099,187898,18201,8.8
06097,2020-12-01,250632,234440,16192,6.5
06099,2020-12-01,235114,211722,23392,9.9
06101,2020-12-01,41699,37169,4530,10.9
06103,2020-12-01,24042,21956,2086,8.7
06105,2020-12-01,4250,3895,355,8.4
06107,2020-12-01,194072,171210,22862,11.8
06109,2020-12-01,19677,17812,1865,9.5
06111,2020-12-01,413838,382718,31120,7.5
06113,2020-12-01,106549,99092,7457,7
06115,2020-12-01,28795,25792,3003,10.4
08001,2020-12-01,284360,258180,26180,9.2
08003,2020-12-01,8984,8231,753,8.4
08005,2020-12-01,379142,345764,33378,8.8
08007,2020-12-01,7093,6544,549,7.7
08009,2020-12-01,2299,2231,68,3
08011,2020-12-01,2072,1940,132,6.4
08013,2020-12-01,194238,180878,13360,6.9
08014,2020-12-01,41064,38111,2953,7.2
08015,2020-12-01,9208,8576,632,6.9
08017,2020-12-01,1218,1178,40,3.3
08019,2020-12-01,6365,5753,612,9.6
08021,2020-12-01,4249,3982,267,6.3
08023,2020-12-01,1885,1694,191,10.1
08025,2020-12-01,1532,1412,120,7.8
08027,2020-12-01,2145,2020,125,5.8
08029,2020-12-01,15005,13901,1104,7.4
08031,2020-12-01,436113,395349,40764,9.3
08033,2020-12-01,1234,1151,83,6.7
08035,2020-12-01,197177,184772,12405,6.3
08037,2020-12-01,34990,32403,2587,7.4
08039,2020-12-01,15469,14639,830,5.4
08041,2020-12-01,352383,321885,30498,8.7
08043,2020-12-01,15487,14022,1465,9.5
08045,2020-12-01,32029,29743,2286,7.1
08047,2020-12-01,4030,3601,429,10.6
08049,2020-12-01,9177,8473,704,7.7
08051,2020-12-01,11422,10785,637,5.6
08053,2020-12-01,398,376,22,5.5
08055,2020-12-01,2753,2449,304,11
08057,2020-12-01,968,919,49,5.1
08059,2020-12-01,345654,318453,27201,7.9
08061,2020-12-01,1066,1033,33,3.1
08063,2020-12-01,4585,4442,143,3.1
08065,2020-12-01,4823,4474,349,7.2
08067,2020-12-01,31807,28972,2835,8.9
08069,2020-12-01,205612,190294,15318,7.4
08071,2020-12-01,6638,6035,603,9.1
08073,2020-12-01,2474,2318,156,6.3
08075,2020-12-01,11473,10780,693,6
08077,2020-12-01,79880,73344,6536,8.2
08079,2020-12-01,422,397,25,5.9
08081,2020-12-01,7428,6940,488,6.6
08083,2020-12-01,12712,11688,1024,8.1
08085,2020-12-01,22108,20509,1599,7.2
08087,2020-12-01,16651,15481,1170,7
08089,2020-12-01,8712,7974,738,8.5
08091,2020-12-01,2260,2082,178,7.9
08093,2020-12-01,11307,10661,646,5.7
08095,2020-12-01,2688,2603,85,3.2
08097,2020-12-01,11219,10239,980,8.7
08099,2020-12-01,6799,6334,465,6.8
08101,2020-12-01,79911,70886,9025,11.3
08103,2020-12-01,3111,2908,203,6.5
08105,2020-12-01,5757,5270,487,8.5
08107,2020-12-01,16565,15285,1280,7.7
08109,2020-12-01,3733,3390,343,9.2
08111,2020-12-01,403,370,33,8.2
08113,2020-12-01,5285,4782,503,9.5
08115,2020-12-01,1147,1076,71,6.2
08117,2020-12-01,22144,20421,1723,7.8
08119,2020-12-01,13043,12056,987,7.6
08121,2020-12-01,3005,2883,122,4.1
08123,2020-12-01,174099,159598,14501,8.3
08125,2020-12-01,5616,5401,215,3.8
09001,2020-12-01,459903,426312,33591,7.3
09003,2020-12-01,479218,442214,37004,7.7
09005,2020-12-01,102286,95372,6914,6.8
09007,2020-12-01,92442,86762,5680,6.1
09009,2020-12-01,454357,418587,35770,7.9
09011,2020-12-01,132083,121125,10958,8.3
09013,2020-12-01,85413,80344,5069,5.9
09015,2020-12-01,63069,58153,4916,7.8
10001,2020-12-01,80706,76542,4164,5.2
10003,2020-12-01,293122,278877,14245,4.9
10005,2020-12-01,103873,99208,4665,4.5
11001,2020-12-01,413158,376699,36459,8.8
12001,2020-12-01,136264,130320,5944,4.4
12003,2020-12-01,11734,11211,523,4.5
12005,2020-12-01,80950,76898,4052,5
12007,2020-12-01,10982,10466,516,4.7
12009,2020-12-01,285234,271573,13661,4.8
12011,2020-12-01,NA,941123,66482,6.6
12013,2020-12-01,4630,4415,215,4.6
12015,2020-12-01,72881,69225,3656,5
12017,2020-12-01,45868,42841,3027,6.6
12019,2020-12-01,106043,101868,4175,3.9
12021,2020-12-01,181441,173723,7718,4.3
12023,2020-12-01,29837,28244,1593,5.3
12027,2020-12-01,15400,14793,607,3.9
12029,2020-12-01,5738,5461,277,4.8
12031,2020-12-01,490679,464433,26246,5.3
12033,2020-12-01,144460,136637,7823,5.4
12035,2020-12-01,46157,43598,2559,5.5
12037,2020-12-01,4354,4149,205,4.7
12039,2020-12-01,18326,17039,1287,7
12041,2020-12-01,6955,6644,311,4.5
12043,2020-12-01,5424,5198,226,4.2
12045,2020-12-01,5459,5216,243,4.5
12047,2020-12-01,4220,3923,297,7
12049,2020-12-01,8826,8363,463,5.2
12051,2020-12-01,15731,14791,940,6
12053,2020-12-01,70955,66800,4155,5.9
12055,2020-12-01,37423,35075,2348,6.3
12057,2020-12-01,745455,705886,39569,5.3
12059,2020-12-01,6863,6565,298,4.3
12061,2020-12-01,65492,62109,3383,5.2
12063,2020-12-01,17037,16142,895,5.3
12065,2020-12-01,5340,5075,265,5
12067,2020-12-01,2787,2660,127,4.6
12069,2020-12-01,149985,140934,9051,6
12071,2020-12-01,344421,327001,17420,5.1
12073,2020-12-01,147612,139863,7749,5.2
12075,2020-12-01,16581,15743,838,5.1
12077,2020-12-01,2553,2431,122,4.8
12079,2020-12-01,7582,7138,444,5.9
12081,2020-12-01,177242,168877,8365,4.7
12083,2020-12-01,142294,134309,7985,5.6
12085,2020-12-01,73700,70706,2994,4.1
12086,2020-12-01,NA,NA,103260,7.9
12087,2020-12-01,49581,47709,1872,3.8
12089,2020-12-01,40611,38979,1632,4
12091,2020-12-01,93409,89556,3853,4.1
12093,2020-12-01,17692,16908,784,4.4
12095,2020-12-01,728005,675329,52676,7.2
12097,2020-12-01,177970,162405,15565,8.7
12099,2020-12-01,707961,669299,38662,5.5
12101,2020-12-01,234916,222586,12330,5.2
12103,2020-12-01,488857,464567,24290,5
12105,2020-12-01,308560,287817,20743,6.7
12107,2020-12-01,26429,24529,1900,7.2
12109,2020-12-01,130381,125728,4653,3.6
12111,2020-12-01,145413,137050,8363,5.8
12113,2020-12-01,81115,77895,3220,4
12115,2020-12-01,185753,177064,8689,4.7
12117,2020-12-01,238666,226331,12335,5.2
12119,2020-12-01,32688,30763,1925,5.9
12121,2020-12-01,17847,16989,858,4.8
12123,2020-12-01,8269,7769,500,6
12125,2020-12-01,4469,4287,182,4.1
12127,2020-12-01,250590,236447,14143,5.6
12129,2020-12-01,13984,13479,505,3.6
12131,2020-12-01,30486,29156,1330,4.4
12133,2020-12-01,9361,8894,467,5
13001,2020-12-01,9387,8975,412,4.4
13003,2020-12-01,4257,4111,146,3.4
13005,2020-12-01,4719,4507,212,4.5
13007,2020-12-01,1128,1049,79,7
13009,2020-12-01,18331,17179,1152,6.3
13011,2020-12-01,9926,9579,347,3.5
13013,2020-12-01,40235,38615,1620,4
13015,2020-12-01,50496,48070,2426,4.8
13017,2020-12-01,5360,4976,384,7.2
13019,2020-12-01,7466,7112,354,4.7
13021,2020-12-01,68871,64223,4648,6.7
13023,2020-12-01,4477,4191,286,6.4
13025,2020-12-01,6478,6126,352,5.4
13027,2020-12-01,7042,6695,347,4.9
13029,2020-12-01,18159,17380,779,4.3
13031,2020-12-01,37440,35418,2022,5.4
13033,2020-12-01,8931,8316,615,6.9
13035,2020-12-01,10795,10207,588,5.4
13037,2020-12-01,2338,2225,113,4.8
13039,2020-12-01,20458,19562,896,4.4
13043,2020-12-01,5623,5375,248,4.4
13045,2020-12-01,55153,52340,2813,5.1
13047,2020-12-01,33325,32247,1078,3.2
13049,2020-12-01,4748,4555,193,4.1
13051,2020-12-01,141142,132519,8623,6.1
13053,2020-12-01,1943,1815,128,6.6
13055,2020-12-01,9797,9173,624,6.4
13057,2020-12-01,134623,129782,4841,3.6
13059,2020-12-01,58747,55706,3041,5.2
13061,2020-12-01,927,810,117,12.6
13063,2020-12-01,142577,129947,12630,8.9
13065,2020-12-01,2448,2340,108,4.4
13067,2020-12-01,424577,405535,19042,4.5
13069,2020-12-01,18958,17958,1000,5.3
13071,2020-12-01,21151,20184,967,4.6
13073,2020-12-01,72323,69723,2600,3.6
13075,2020-12-01,8226,7858,368,4.5
13077,2020-12-01,74723,71230,3493,4.7
13079,2020-12-01,5553,5300,253,4.6
13081,2020-12-01,9818,9019,799,8.1
13083,2020-12-01,8069,7784,285,3.5
13085,2020-12-01,12167,11708,459,3.8
13087,2020-12-01,11323,10754,569,5
13089,2020-12-01,405427,379452,25975,6.4
13091,2020-12-01,6788,6393,395,5.8
13093,2020-12-01,5119,4784,335,6.5
13095,2020-12-01,38336,35136,3200,8.3
13097,2020-12-01,73930,69471,4459,6
13099,2020-12-01,4453,4175,278,6.2
13101,2020-12-01,1930,1860,70,3.6
13103,2020-12-01,30781,29466,1315,4.3
13105,2020-12-01,7856,7347,509,6.5
13107,2020-12-01,8207,7600,607,7.4
13109,2020-12-01,4908,4658,250,5.1
13111,2020-12-01,12493,12049,444,3.6
13113,2020-12-01,57660,55369,2291,4
13115,2020-12-01,45111,42960,2151,4.8
13117,2020-12-01,120777,116715,4062,3.4
13119,2020-12-01,9956,9500,456,4.6
13121,2020-12-01,565196,528702,36494,6.5
13123,2020-12-01,11317,10828,489,4.3
13125,2020-12-01,1214,1168,46,3.8
13127,2020-12-01,35465,33458,2007,5.7
13129,2020-12-01,29240,28008,1232,4.2
13131,2020-12-01,10163,9725,438,4.3
13133,2020-12-01,7111,6717,394,5.5
13135,2020-12-01,489856,466466,23390,4.8
13137,2020-12-01,18761,17889,872,4.6
13139,2020-12-01,100505,96767,3738,3.7
13141,2020-12-01,2565,2348,217,8.5
13143,2020-12-01,12499,11912,587,4.7
13145,2020-12-01,15940,15341,599,3.8
13147,2020-12-01,10954,10396,558,5.1
13149,2020-12-01,5247,4977,270,5.1
13151,2020-12-01,116678,109851,6827,5.9
13153,2020-12-01,68693,65464,3229,4.7
13155,2020-12-01,3416,3225,191,5.6
13157,2020-12-01,38967,37633,1334,3.4
13159,2020-12-01,6900,6587,313,4.5
13161,2020-12-01,5822,5510,312,5.4
13163,2020-12-01,6594,6171,423,6.4
13165,2020-12-01,3123,2934,189,6.1
13167,2020-12-01,3993,3805,188,4.7
13169,2020-12-01,13558,13018,540,4
13171,2020-12-01,8224,7762,462,5.6
13173,2020-12-01,3855,3678,177,4.6
13175,2020-12-01,19018,17908,1110,5.8
13177,2020-12-01,14288,13723,565,4
13179,2020-12-01,26717,25251,1466,5.5
13181,2020-12-01,3431,3259,172,5
13183,2020-12-01,8149,7817,332,4.1
13185,2020-12-01,53683,50826,2857,5.3
13187,2020-12-01,16363,15760,603,3.7
13189,2020-12-01,8613,8053,560,6.5
13191,2020-12-01,5558,5243,315,5.7
13193,2020-12-01,4573,4253,320,7
13195,2020-12-01,13096,12539,557,4.3
13197,2020-12-01,3157,3002,155,4.9
13199,2020-12-01,8971,8328,643,7.2
13201,2020-12-01,2648,2549,99,3.7
13205,2020-12-01,8303,7762,541,6.5
13207,2020-12-01,12899,12319,580,4.5
13209,2020-12-01,3788,3587,201,5.3
13211,2020-12-01,9144,8725,419,4.6
13213,2020-12-01,14908,14033,875,5.9
13215,2020-12-01,75733,70442,5291,7
13217,2020-12-01,52528,49355,3173,6
13219,2020-12-01,19080,18516,564,3
13221,2020-12-01,6800,6526,274,4
13223,2020-12-01,85643,82082,3561,4.2
13225,2020-12-01,11595,10862,733,6.3
13227,2020-12-01,15156,14575,581,3.8
13229,2020-12-01,8476,8115,361,4.3
13231,2020-12-01,8812,8457,355,4
13233,2020-12-01,18401,17463,938,5.1
13235,2020-12-01,3909,3726,183,4.7
13237,2020-12-01,8132,7655,477,5.9
13239,2020-12-01,833,787,46,5.5
13241,2020-12-01,6895,6588,307,4.5
13243,2020-12-01,2620,2465,155,5.9
13245,2020-12-01,83709,77941,5768,6.9
13247,2020-12-01,45166,42348,2818,6.2
13249,2020-12-01,2262,2175,87,3.8
13251,2020-12-01,5100,4726,374,7.3
13253,2020-12-01,2973,2815,158,5.3
13255,2020-12-01,28967,27062,1905,6.6
13257,2020-12-01,10604,10019,585,5.5
13259,2020-12-01,2614,2483,131,5
13261,2020-12-01,13358,12437,921,6.9
13263,2020-12-01,2771,2593,178,6.4
13265,2020-12-01,574,536,38,6.6
13267,2020-12-01,9316,8924,392,4.2
13269,2020-12-01,2814,2620,194,6.9
13271,2020-12-01,3640,3275,365,10
13273,2020-12-01,3489,3200,289,8.3
13275,2020-12-01,16581,15568,1013,6.1
13277,2020-12-01,20484,19509,975,4.8
13279,2020-12-01,11682,10989,693,5.9
13281,2020-12-01,3502,3285,217,6.2
13283,2020-12-01,2555,2409,146,5.7
13285,2020-12-01,38471,36274,2197,5.7
13287,2020-12-01,3219,2956,263,8.2
13289,2020-12-01,2867,2688,179,6.2
13291,2020-12-01,10159,9762,397,3.9
13293,2020-12-01,11297,10639,658,5.8
13295,2020-12-01,31193,29967,1226,3.9
13297,2020-12-01,45841,43883,1958,4.3
13299,2020-12-01,15289,14505,784,5.1
13301,2020-12-01,2830,2674,156,5.5
13303,2020-12-01,6568,6107,461,7
13305,2020-12-01,10979,10379,600,5.5
13307,2020-12-01,1043,982,61,5.8
13309,2020-12-01,1568,1449,119,7.6
13311,2020-12-01,16526,15979,547,3.3
13313,2020-12-01,41939,39726,2213,5.3
13315,2020-12-01,2674,2518,156,5.8
13317,2020-12-01,3857,3617,240,6.2
13319,2020-12-01,4091,3879,212,5.2
13321,2020-12-01,8670,8205,465,5.4
15001,2020-12-01,89039,81154,7885,8.9
15003,2020-12-01,447861,411864,35997,8
15007,2020-12-01,34237,30016,4221,12.3
15009,2020-12-01,80577,70085,10492,13
16001,2020-12-01,255996,245208,10788,4.2
16003,2020-12-01,1881,1740,141,7.5
16005,2020-12-01,40604,38743,1861,4.6
16007,2020-12-01,3301,3176,125,3.8
16009,2020-12-01,4518,4262,256,5.7
16011,2020-12-01,25342,24473,869,3.4
16013,2020-12-01,13548,12917,631,4.7
16015,2020-12-01,3552,3324,228,6.4
16017,2020-12-01,23438,22123,1315,5.6
16019,2020-12-01,59688,57566,2122,3.6
16021,2020-12-01,5973,5647,326,5.5
16023,2020-12-01,1434,1374,60,4.2
16025,2020-12-01,722,692,30,4.2
16027,2020-12-01,104378,99051,5327,5.1
16029,2020-12-01,4363,4220,143,3.3
16031,2020-12-01,13511,13069,442,3.3
16033,2020-12-01,383,370,13,3.4
16035,2020-12-01,3258,3069,189,5.8
16037,2020-12-01,2232,2102,130,5.8
16039,2020-12-01,12921,12409,512,4
16041,2020-12-01,7019,6772,247,3.5
16043,2020-12-01,8961,8669,292,3.3
16045,2020-12-01,8345,7880,465,5.6
16047,2020-12-01,8802,8491,311,3.5
16049,2020-12-01,7163,6760,403,5.6
16051,2020-12-01,14461,14011,450,3.1
16053,2020-12-01,12289,11786,503,4.1
16055,2020-12-01,76616,71932,4684,6.1
16057,2020-12-01,21658,20841,817,3.8
16059,2020-12-01,3885,3642,243,6.3
16061,2020-12-01,1752,1642,110,6.3
16063,2020-12-01,2841,2706,135,4.8
16065,2020-12-01,25501,24944,557,2.2
16067,2020-12-01,12722,12250,472,3.7
16069,2020-12-01,19714,18825,889,4.5
16071,2020-12-01,2522,2443,79,3.1
16073,2020-12-01,5208,4888,320,6.1
16075,2020-12-01,12550,11956,594,4.7
16077,2020-12-01,4169,3959,210,5
16079,2020-12-01,6160,5748,412,6.7
16081,2020-12-01,6720,6451,269,4
16083,2020-12-01,41760,39936,1824,4.4
16085,2020-12-01,6232,5834,398,6.4
16087,2020-12-01,5109,4884,225,4.4
17001,2020-12-01,31029,29616,1413,4.6
17003,2020-12-01,1911,1777,134,7
17005,2020-12-01,7337,7008,329,4.5
17007,2020-12-01,24144,22518,1626,6.7
17009,2020-12-01,2803,2729,74,2.6
17011,2020-12-01,16159,15301,858,5.3
17013,2020-12-01,2191,2074,117,5.3
17015,2020-12-01,6909,6571,338,4.9
17017,2020-12-01,5815,5516,299,5.1
17019,2020-12-01,108425,102913,5512,5.1
17021,2020-12-01,13465,12696,769,5.7
17023,2020-12-01,7072,6718,354,5
17025,2020-12-01,5812,5475,337,5.8
17027,2020-12-01,19339,18619,720,3.7
17029,2020-12-01,23389,22129,1260,5.4
17031,2020-12-01,NA,NA,234603,9.3
17033,2020-12-01,8064,7638,426,5.3
17035,2020-12-01,5812,5559,253,4.4
17037,2020-12-01,51066,48089,2977,5.8
17039,2020-12-01,6987,6588,399,5.7
17041,2020-12-01,9847,9464,383,3.9
17043,2020-12-01,483711,451286,32425,6.7
17045,2020-12-01,8138,7784,354,4.3
17047,2020-12-01,2538,2408,130,5.1
17049,2020-12-01,18625,17841,784,4.2
17051,2020-12-01,9412,8934,478,5.1
17053,2020-12-01,6217,5928,289,4.6
17055,2020-12-01,15440,14457,983,6.4
17057,2020-12-01,14044,13202,842,6
17059,2020-12-01,2106,1991,115,5.5
17061,2020-12-01,5762,5480,282,4.9
17063,2020-12-01,23876,22189,1687,7.1
17065,2020-12-01,4120,3965,155,3.8
17067,2020-12-01,7877,7535,342,4.3
17069,2020-12-01,1331,1247,84,6.3
17071,2020-12-01,3415,3286,129,3.8
17073,2020-12-01,23449,22205,1244,5.3
17075,2020-12-01,13702,13064,638,4.7
17077,2020-12-01,27074,25630,1444,5.3
17079,2020-12-01,4617,4428,189,4.1
17081,2020-12-01,16614,15646,968,5.8
17083,2020-12-01,10457,9917,540,5.2
17085,2020-12-01,9822,9312,510,5.2
17087,2020-12-01,3917,3673,244,6.2
17089,2020-12-01,254578,237827,16751,6.6
17091,2020-12-01,53499,50085,3414,6.4
17093,2020-12-01,65103,60629,4474,6.9
17095,2020-12-01,20163,18779,1384,6.9
17097,2020-12-01,354017,331783,22234,6.3
17099,2020-12-01,51357,48098,3259,6.3
17101,2020-12-01,5496,5163,333,6.1
17103,2020-12-01,16648,15826,822,4.9
17105,2020-12-01,15614,14884,730,4.7
17107,2020-12-01,11942,11307,635,5.3
17109,2020-12-01,13034,12356,678,5.2
17111,2020-12-01,157250,146352,10898,6.9
17113,2020-12-01,83356,79045,4311,5.2
17115,2020-12-01,45798,42060,3738,8.2
17117,2020-12-01,21779,20712,1067,4.9
17119,2020-12-01,129118,122289,6829,5.3
17121,2020-12-01,16492,15523,969,5.9
17123,2020-12-01,4749,4468,281,5.9
17125,2020-12-01,5829,5491,338,5.8
17127,2020-12-01,5323,5005,318,6
17129,2020-12-01,6085,5787,298,4.9
17131,2020-12-01,7508,7137,371,4.9
17133,2020-12-01,17858,17234,624,3.5
17135,2020-12-01,10711,10076,635,5.9
17137,2020-12-01,15749,14909,840,5.3
17139,2020-12-01,7345,7063,282,3.8
17141,2020-12-01,23099,21757,1342,5.8
17143,2020-12-01,77825,71593,6232,8
17145,2020-12-01,7953,7525,428,5.4
17147,2020-12-01,8405,8048,357,4.2
17149,2020-12-01,6619,6336,283,4.3
17151,2020-12-01,1584,1505,79,5
17153,2020-12-01,1826,1679,147,8.1
17155,2020-12-01,2979,2827,152,5.1
17157,2020-12-01,13475,12862,613,4.5
17159,2020-12-01,6751,6437,314,4.7
17161,2020-12-01,67822,63772,4050,6
17163,2020-12-01,122278,114808,7470,6.1
17165,2020-12-01,9252,8644,608,6.6
17167,2020-12-01,96424,90232,6192,6.4
17169,2020-12-01,2957,2816,141,4.8
17171,2020-12-01,2465,2338,127,5.2
17173,2020-12-01,10028,9577,451,4.5
17175,2020-12-01,2227,2088,139,6.2
17177,2020-12-01,20815,19617,1198,5.8
17179,2020-12-01,57392,54041,3351,5.8
17181,2020-12-01,7108,6719,389,5.5
17183,2020-12-01,31966,29906,2060,6.4
17185,2020-12-01,5705,5453,252,4.4
17187,2020-12-01,8085,7688,397,4.9
17189,2020-12-01,8741,8459,282,3.2
17191,2020-12-01,6719,6414,305,4.5
17193,2020-12-01,6192,5928,264,4.3
17195,2020-12-01,26741,25375,1366,5.1
17197,2020-12-01,340828,314163,26665,7.8
17199,2020-12-01,30919,29250,1669,5.4
17201,2020-12-01,129665,120018,9647,7.4
17203,2020-12-01,16768,15970,798,4.8
18001,2020-12-01,16458,16040,418,2.5
18003,2020-12-01,188183,180541,7642,4.1
18005,2020-12-01,45555,44071,1484,3.3
18007,2020-12-01,4594,4457,137,3
18009,2020-12-01,4540,4343,197,4.3
18011,2020-12-01,37149,36251,898,2.4
18013,2020-12-01,7953,7677,276,3.5
18015,2020-12-01,10269,9966,303,3
18017,2020-12-01,16886,16233,653,3.9
18019,2020-12-01,61133,58735,2398,3.9
18021,2020-12-01,11879,11397,482,4.1
18023,2020-12-01,17046,16506,540,3.2
18025,2020-12-01,4762,4555,207,4.3
18027,2020-12-01,16811,16413,398,2.4
18029,2020-12-01,25607,24691,916,3.6
18031,2020-12-01,14301,13825,476,3.3
18033,2020-12-01,21613,20910,703,3.3
18035,2020-12-01,53057,50800,2257,4.3
18037,2020-12-01,22654,21981,673,3
18039,2020-12-01,109559,105882,3677,3.4
18041,2020-12-01,7956,7511,445,5.6
18043,2020-12-01,41143,39745,1398,3.4
18045,2020-12-01,7778,7514,264,3.4
18047,2020-12-01,11279,10928,351,3.1
18049,2020-12-01,9618,9241,377,3.9
18051,2020-12-01,19409,18856,553,2.8
18053,2020-12-01,31671,30465,1206,3.8
18055,2020-12-01,13269,12764,505,3.8
18057,2020-12-01,188082,183065,5017,2.7
18059,2020-12-01,41315,40039,1276,3.1
18061,2020-12-01,20046,19395,651,3.2
18063,2020-12-01,92073,89413,2660,2.9
18065,2020-12-01,21824,20996,828,3.8
18067,2020-12-01,37394,35530,1864,5
18069,2020-12-01,17489,16913,576,3.3
18071,2020-12-01,22060,21296,764,3.5
18073,2020-12-01,16072,15523,549,3.4
18075,2020-12-01,8805,8542,263,3
18077,2020-12-01,14661,14091,570,3.9
18079,2020-12-01,13477,12901,576,4.3
18081,2020-12-01,85114,82555,2559,3
18083,2020-12-01,18024,17412,612,3.4
18085,2020-12-01,41078,39712,1366,3.3
18087,2020-12-01,17114,16634,480,2.8
18089,2020-12-01,229787,215058,14729,6.4
18091,2020-12-01,48440,45567,2873,5.9
18093,2020-12-01,20574,19723,851,4.1
18095,2020-12-01,60986,58301,2685,4.4
18097,2020-12-01,510764,484745,26019,5.1
18099,2020-12-01,21626,20892,734,3.4
18101,2020-12-01,5495,5333,162,2.9
18103,2020-12-01,14789,14132,657,4.4
18105,2020-12-01,69205,66890,2315,3.3
18107,2020-12-01,18870,18296,574,3
18109,2020-12-01,37248,36071,1177,3.2
18111,2020-12-01,6901,6642,259,3.8
18113,2020-12-01,21425,20592,833,3.9
18115,2020-12-01,3164,3046,118,3.7
18117,2020-12-01,7512,7089,423,5.6
18119,2020-12-01,9311,8937,374,4
18121,2020-12-01,6895,6659,236,3.4
18123,2020-12-01,8714,8374,340,3.9
18125,2020-12-01,5907,5691,216,3.7
18127,2020-12-01,85689,82050,3639,4.2
18129,2020-12-01,13985,13605,380,2.7
18131,2020-12-01,6263,6041,222,3.5
18133,2020-12-01,17188,16609,579,3.4
18135,2020-12-01,11052,10638,414,3.7
18137,2020-12-01,14106,13670,436,3.1
18139,2020-12-01,8951,8658,293,3.3
18141,2020-12-01,130465,123986,6479,5
18143,2020-12-01,10472,10037,435,4.2
18145,2020-12-01,23797,23025,772,3.2
18147,2020-12-01,9595,9251,344,3.6
18149,2020-12-01,9424,8941,483,5.1
18151,2020-12-01,19007,18398,609,3.2
18153,2020-12-01,8235,7897,338,4.1
18155,2020-12-01,4544,4338,206,4.5
18157,2020-12-01,98611,95081,3530,3.6
18159,2020-12-01,8979,8716,263,2.9
18161,2020-12-01,3522,3427,95,2.7
18163,2020-12-01,97394,93685,3709,3.8
18165,2020-12-01,6823,6527,296,4.3
18167,2020-12-01,47236,45065,2171,4.6
18169,2020-12-01,14234,13713,521,3.7
18171,2020-12-01,4087,3967,120,2.9
18173,2020-12-01,33777,32848,929,2.8
18175,2020-12-01,13702,13210,492,3.6
18177,2020-12-01,29220,27991,1229,4.2
18179,2020-12-01,14592,14168,424,2.9
18181,2020-12-01,13147,12762,385,2.9
18183,2020-12-01,17866,17346,520,2.9
19001,2020-12-01,4034,3932,102,2.5
19003,2020-12-01,2067,2017,50,2.4
19005,2020-12-01,7051,6793,258,3.7
19007,2020-12-01,5548,5362,186,3.4
19009,2020-12-01,2984,2911,73,2.4
19011,2020-12-01,12661,12254,407,3.2
19013,2020-12-01,64748,62349,2399,3.7
19015,2020-12-01,14094,13748,346,2.5
19017,2020-12-01,13091,12771,320,2.4
19019,2020-12-01,10358,10020,338,3.3
19021,2020-12-01,12099,11819,280,2.3
19023,2020-12-01,7558,7324,234,3.1
19025,2020-12-01,4061,3951,110,2.7
19027,2020-12-01,10447,10191,256,2.5
19029,2020-12-01,6470,6290,180,2.8
19031,2020-12-01,10284,10007,277,2.7
19033,2020-12-01,21917,21162,755,3.4
19035,2020-12-01,6009,5849,160,2.7
19037,2020-12-01,6374,6204,170,2.7
19039,2020-12-01,4566,4413,153,3.4
19041,2020-12-01,8128,7913,215,2.6
19043,2020-12-01,9347,8950,397,4.2
19045,2020-12-01,21600,20753,847,3.9
19047,2020-12-01,7866,7511,355,4.5
19049,2020-12-01,46108,45028,1080,2.3
19051,2020-12-01,3977,3876,101,2.5
19053,2020-12-01,4168,4065,103,2.5
19055,2020-12-01,10033,9775,258,2.6
19057,2020-12-01,17478,16655,823,4.7
19059,2020-12-01,8196,7892,304,3.7
19061,2020-12-01,52367,50548,1819,3.5
19063,2020-12-01,4959,4814,145,2.9
19065,2020-12-01,10152,9764,388,3.8
19067,2020-12-01,8054,7760,294,3.7
19069,2020-12-01,5337,5181,156,2.9
19071,2020-12-01,3528,3446,82,2.3
19073,2020-12-01,5271,5133,138,2.6
19075,2020-12-01,6215,6052,163,2.6
19077,2020-12-01,5322,5162,160,3
19079,2020-12-01,6558,6366,192,2.9
19081,2020-12-01,5677,5534,143,2.5
19083,2020-12-01,7643,7403,240,3.1
19085,2020-12-01,7200,7003,197,2.7
19087,2020-12-01,9336,9049,287,3.1
19089,2020-12-01,5024,4870,154,3.1
19091,2020-12-01,4776,4643,133,2.8
19093,2020-12-01,4091,4004,87,2.1
19095,2020-12-01,10157,9888,269,2.6
19097,2020-12-01,10272,9880,392,3.8
19099,2020-12-01,18462,17857,605,3.3
19101,2020-12-01,10017,9702,315,3.1
19103,2020-12-01,81501,79189,2312,2.8
19105,2020-12-01,10062,9726,336,3.3
19107,2020-12-01,5006,4833,173,3.5
19109,2020-12-01,8166,7978,188,2.3
19111,2020-12-01,15407,14756,651,4.2
19113,2020-12-01,113635,109263,4372,3.8
19115,2020-12-01,5907,5713,194,3.3
19117,2020-12-01,4440,4325,115,2.6
19119,2020-12-01,6692,6569,123,1.8
19121,2020-12-01,7979,7713,266,3.3
19123,2020-12-01,11169,10838,331,3
19125,2020-12-01,17603,17184,419,2.4
19127,2020-12-01,16682,15714,968,5.8
19129,2020-12-01,7185,7008,177,2.5
19131,2020-12-01,6737,6606,131,1.9
19133,2020-12-01,4094,3957,137,3.3
19135,2020-12-01,3882,3761,121,3.1
19137,2020-12-01,4725,4576,149,3.2
19139,2020-12-01,20694,19928,766,3.7
19141,2020-12-01,7874,7692,182,2.3
19143,2020-12-01,3449,3378,71,2.1
19145,2020-12-01,6058,5880,178,2.9
19147,2020-12-01,4416,4301,115,2.6
19149,2020-12-01,14280,13953,327,2.3
19151,2020-12-01,4531,4433,98,2.2
19153,2020-12-01,250627,241593,9034,3.6
19155,2020-12-01,47080,45593,1487,3.2
19157,2020-12-01,9891,9605,286,2.9
19159,2020-12-01,2345,2295,50,2.1
19161,2020-12-01,5085,4950,135,2.7
19163,2020-12-01,82851,79206,3645,4.4
19165,2020-12-01,6340,6181,159,2.5
19167,2020-12-01,20216,19858,358,1.8
19169,2020-12-01,56853,55678,1175,2.1
19171,2020-12-01,8912,8510,402,4.5
19173,2020-12-01,3057,2987,70,2.3
19175,2020-12-01,6039,5830,209,3.5
19177,2020-12-01,3405,3311,94,2.8
19179,2020-12-01,16741,16102,639,3.8
19181,2020-12-01,26260,25501,759,2.9
19183,2020-12-01,11437,11130,307,2.7
19185,2020-12-01,2762,2684,78,2.8
19187,2020-12-01,18353,17729,624,3.4
19189,2020-12-01,4793,4630,163,3.4
19191,2020-12-01,10659,10296,363,3.4
19193,2020-12-01,53368,51577,1791,3.4
19195,2020-12-01,4009,3874,135,3.4
19197,2020-12-01,6700,6510,190,2.8
20001,2020-12-01,6544,6319,225,3.4
20003,2020-12-01,4372,4243,129,3
20005,2020-12-01,6891,6599,292,4.2
20007,2020-12-01,2390,2321,69,2.9
20009,2020-12-01,14221,13778,443,3.1
20011,2020-12-01,6754,6539,215,3.2
20013,2020-12-01,5324,5169,155,2.9
20015,2020-12-01,32441,31193,1248,3.8
20017,2020-12-01,1428,1384,44,3.1
20019,2020-12-01,1456,1401,55,3.8
20021,2020-12-01,10256,9991,265,2.6
20023,2020-12-01,1411,1387,24,1.7
20025,2020-12-01,1175,1159,16,1.4
20027,2020-12-01,3931,3803,128,3.3
20029,2020-12-01,3882,3762,120,3.1
20031,2020-12-01,3907,3779,128,3.3
20033,2020-12-01,898,875,23,2.6
20035,2020-12-01,16961,16362,599,3.5
20037,2020-12-01,19442,18756,686,3.5
20039,2020-12-01,1350,1313,37,2.7
20041,2020-12-01,9116,8827,289,3.2
20043,2020-12-01,4144,4055,89,2.1
20045,2020-12-01,64231,61743,2488,3.9
20047,2020-12-01,1711,1671,40,2.3
20049,2020-12-01,1211,1182,29,2.4
20051,2020-12-01,17666,17215,451,2.6
20053,2020-12-01,2835,2739,96,3.4
20055,2020-12-01,21688,21089,599,2.8
20057,2020-12-01,17622,17163,459,2.6
20059,2020-12-01,14572,14076,496,3.4
20061,2020-12-01,11638,11225,413,3.5
20063,2020-12-01,1533,1494,39,2.5
20065,2020-12-01,1160,1119,41,3.5
20067,2020-12-01,3194,3088,106,3.3
20069,2020-12-01,3435,3372,63,1.8
20071,2020-12-01,894,882,12,1.3
20073,2020-12-01,3271,3165,106,3.2
20075,2020-12-01,1721,1697,24,1.4
20077,2020-12-01,2805,2710,95,3.4
20079,2020-12-01,16950,16382,568,3.4
20081,2020-12-01,2282,2240,42,1.8
20083,2020-12-01,1073,1050,23,2.1
20085,2020-12-01,7151,6935,216,3
20087,2020-12-01,10099,9765,334,3.3
20089,2020-12-01,1299,1267,32,2.5
20091,2020-12-01,343194,331959,11235,3.3
20093,2020-12-01,2114,2068,46,2.2
20095,2020-12-01,3477,3342,135,3.9
20097,2020-12-01,1341,1309,32,2.4
20099,2020-12-01,9954,9595,359,3.6
20101,2020-12-01,815,793,22,2.7
20103,2020-12-01,36770,35515,1255,3.4
20105,2020-12-01,1729,1687,42,2.4
20107,2020-12-01,4376,4226,150,3.4
20109,2020-12-01,1719,1680,39,2.3
20111,2020-12-01,17189,16605,584,3.4
20113,2020-12-01,17725,17245,480,2.7
20115,2020-12-01,6084,5909,175,2.9
20117,2020-12-01,5763,5605,158,2.7
20119,2020-12-01,2231,2183,48,2.2
20121,2020-12-01,17603,17037,566,3.2
20123,2020-12-01,3608,3509,99,2.7
20125,2020-12-01,14743,14232,511,3.5
20127,2020-12-01,3103,3033,70,2.3
20129,2020-12-01,1197,1171,26,2.2
20131,2020-12-01,5884,5714,170,2.9
20133,2020-12-01,6351,6071,280,4.4
20135,2020-12-01,1379,1339,40,2.9
20137,2020-12-01,2735,2662,73,2.7
20139,2020-12-01,7953,7675,278,3.5
20141,2020-12-01,2060,2009,51,2.5
20143,2020-12-01,3032,2932,100,3.3
20145,2020-12-01,2982,2875,107,3.6
20147,2020-12-01,2715,2639,76,2.8
20149,2020-12-01,11832,11442,390,3.3
20151,2020-12-01,5112,4961,151,3
20153,2020-12-01,1629,1601,28,1.7
20155,2020-12-01,30612,29515,1097,3.6
20157,2020-12-01,2476,2411,65,2.6
20159,2020-12-01,5191,5046,145,2.8
20161,2020-12-01,33232,32149,1083,3.3
20163,2020-12-01,2571,2491,80,3.1
20165,2020-12-01,1610,1565,45,2.8
20167,2020-12-01,3399,3294,105,3.1
20169,2020-12-01,29955,28934,1021,3.4
20171,2020-12-01,2972,2893,79,2.7
20173,2020-12-01,251242,240154,11088,4.4
20175,2020-12-01,10142,9785,357,3.5
20177,2020-12-01,90583,86834,3749,4.1
20179,2020-12-01,1562,1536,26,1.7
20181,2020-12-01,3015,2919,96,3.2
20183,2020-12-01,2062,2026,36,1.7
20185,2020-12-01,2154,2098,56,2.6
20187,2020-12-01,1114,1093,21,1.9
20189,2020-12-01,2923,2854,69,2.4
20191,2020-12-01,10941,10495,446,4.1
20193,2020-12-01,4345,4224,121,2.8
20195,2020-12-01,1518,1474,44,2.9
20197,2020-12-01,3651,3546,105,2.9
20199,2020-12-01,849,830,19,2.2
20201,2020-12-01,3201,3139,62,1.9
20203,2020-12-01,1229,1200,29,2.4
20205,2020-12-01,3934,3777,157,4
20207,2020-12-01,1700,1643,57,3.4
20209,2020-12-01,77305,74503,2802,3.6
21001,2020-12-01,6835,6423,412,6
21003,2020-12-01,8540,8134,406,4.8
21005,2020-12-01,11710,11150,560,4.8
21007,2020-12-01,3283,3082,201,6.1
21009,2020-12-01,17749,16534,1215,6.8
21011,2020-12-01,4528,4215,313,6.9
21013,2020-12-01,8048,7483,565,7
21015,2020-12-01,69846,66472,3374,4.8
21017,2020-12-01,9832,9385,447,4.5
21019,2020-12-01,17790,16459,1331,7.5
21021,2020-12-01,11714,10921,793,6.8
21023,2020-12-01,3785,3563,222,5.9
21025,2020-12-01,3207,2932,275,8.6
21027,2020-12-01,7704,7211,493,6.4
21029,2020-12-01,41742,39724,2018,4.8
21031,2020-12-01,4817,4549,268,5.6
21033,2020-12-01,5339,5030,309,5.8
21035,2020-12-01,18335,17285,1050,5.7
21037,2020-12-01,50097,47550,2547,5.1
21039,2020-12-01,2210,2106,104,4.7
21041,2020-12-01,5145,4889,256,5
21043,2020-12-01,9557,8652,905,9.5
21045,2020-12-01,6492,6158,334,5.1
21047,2020-12-01,25165,23621,1544,6.1
21049,2020-12-01,17012,16069,943,5.5
21051,2020-12-01,5004,4595,409,8.2
21053,2020-12-01,3903,3727,176,4.5
21055,2020-12-01,3670,3496,174,4.7
21057,2020-12-01,3114,2983,131,4.2
21059,2020-12-01,45300,42825,2475,5.5
21061,2020-12-01,4513,4234,279,6.2
21063,2020-12-01,1983,1805,178,9
21065,2020-12-01,5166,4845,321,6.2
21067,2020-12-01,173151,164394,8757,5.1
21069,2020-12-01,6182,5820,362,5.9
21071,2020-12-01,10453,9559,894,8.6
21073,2020-12-01,24831,23371,1460,5.9
21075,2020-12-01,2064,1948,116,5.6
21077,2020-12-01,4048,3836,212,5.2
21079,2020-12-01,7328,6949,379,5.2
21081,2020-12-01,11603,10946,657,5.7
21083,2020-12-01,15265,14358,907,5.9
21085,2020-12-01,10816,10111,705,6.5
21087,2020-12-01,4884,4669,215,4.4
21089,2020-12-01,13340,12271,1069,8
21091,2020-12-01,3799,3595,204,5.4
21093,2020-12-01,46310,43668,2642,5.7
21095,2020-12-01,6221,5518,703,11.3
21097,2020-12-01,8631,8224,407,4.7
21099,2020-12-01,7713,7303,410,5.3
21101,2020-12-01,22438,21301,1137,5.1
21103,2020-12-01,8141,7763,378,4.6
21105,2020-12-01,1746,1661,85,4.9
21107,2020-12-01,16730,15620,1110,6.6
21109,2020-12-01,3869,3554,315,8.1
21111,2020-12-01,394489,371824,22665,5.7
21113,2020-12-01,26183,24878,1305,5
21115,2020-12-01,6446,5865,581,9
21117,2020-12-01,86766,82104,4662,5.4
21119,2020-12-01,4204,3845,359,8.5
21121,2020-12-01,9686,8958,728,7.5
21123,2020-12-01,5729,5388,341,6
21125,2020-12-01,23884,22488,1396,5.8
21127,2020-12-01,5144,4747,397,7.7
21129,2020-12-01,1998,1873,125,6.3
21131,2020-12-01,2534,2282,252,9.9
21133,2020-12-01,6015,5468,547,9.1
21135,2020-12-01,4448,4055,393,8.8
21137,2020-12-01,8758,8086,672,7.7
21139,2020-12-01,3442,3173,269,7.8
21141,2020-12-01,12006,11510,496,4.1
21143,2020-12-01,2900,2737,163,5.6
21145,2020-12-01,27411,25523,1888,6.9
21147,2020-12-01,4562,4230,332,7.3
21149,2020-12-01,4044,3841,203,5
21151,2020-12-01,44150,41816,2334,5.3
21153,2020-12-01,3192,2720,472,14.8
21155,2020-12-01,9310,8853,457,4.9
21157,2020-12-01,14599,13739,860,5.9
21159,2020-12-01,2709,2465,244,9
21161,2020-12-01,6800,6331,469,6.9
21163,2020-12-01,11598,10907,691,6
21165,2020-12-01,2267,2064,203,9
21167,2020-12-01,9472,8910,562,5.9
21169,2020-12-01,3921,3665,256,6.5
21171,2020-12-01,4534,4333,201,4.4
21173,2020-12-01,11325,10587,738,6.5
21175,2020-12-01,4475,4172,303,6.8
21177,2020-12-01,10038,9270,768,7.7
21179,2020-12-01,22839,21715,1124,4.9
21181,2020-12-01,3279,3113,166,5.1
21183,2020-12-01,9612,9027,585,6.1
21185,2020-12-01,32545,31271,1274,3.9
21187,2020-12-01,5032,4750,282,5.6
21189,2020-12-01,1113,1032,81,7.3
21191,2020-12-01,6887,6559,328,4.8
21193,2020-12-01,7764,7132,632,8.1
21195,2020-12-01,18258,16737,1521,8.3
21197,2020-12-01,4875,4571,304,6.2
21199,2020-12-01,25716,24100,1616,6.3
21201,2020-12-01,822,775,47,5.7
21203,2020-12-01,6243,5855,388,6.2
21205,2020-12-01,9909,9300,609,6.1
21207,2020-12-01,6024,5625,399,6.6
21209,2020-12-01,28666,27336,1330,4.6
21211,2020-12-01,25105,24033,1072,4.3
21213,2020-12-01,8643,8216,427,4.9
21215,2020-12-01,9973,9557,416,4.2
21217,2020-12-01,11907,11319,588,4.9
21219,2020-12-01,5341,5129,212,4
21221,2020-12-01,6136,5755,381,6.2
21223,2020-12-01,3834,3622,212,5.5
21225,2020-12-01,5796,5519,277,4.8
21227,2020-12-01,60626,57436,3190,5.3
21229,2020-12-01,6219,5956,263,4.2
21231,2020-12-01,7242,6811,431,6
21233,2020-12-01,5504,5219,285,5.2
21235,2020-12-01,13294,12435,859,6.5
21237,2020-12-01,1948,1802,146,7.5
21239,2020-12-01,14978,14356,622,4.2
22001,2020-12-01,23686,22288,1398,5.9
22003,2020-12-01,8660,8074,586,6.8
22005,2020-12-01,63324,59979,3345,5.3
22007,2020-12-01,9049,8301,748,8.3
22009,2020-12-01,15063,14132,931,6.2
22011,2020-12-01,14254,13560,694,4.9
22013,2020-12-01,5459,5080,379,6.9
22015,2020-12-01,57544,54810,2734,4.8
22017,2020-12-01,105396,97286,8110,7.7
22019,2020-12-01,95793,88262,7531,7.9
22021,2020-12-01,3734,3541,193,5.2
22023,2020-12-01,3441,3286,155,4.5
22025,2020-12-01,3436,3218,218,6.3
22027,2020-12-01,5704,5397,307,5.4
22029,2020-12-01,6999,6562,437,6.2
22031,2020-12-01,10771,10143,628,5.8
22033,2020-12-01,230387,215519,14868,6.5
22035,2020-12-01,1837,1644,193,10.5
22037,2020-12-01,7868,7439,429,5.5
22039,2020-12-01,11624,10892,732,6.3
22041,2020-12-01,7328,6851,477,6.5
22043,2020-12-01,8018,7614,404,5
22045,2020-12-01,28650,26227,2423,8.5
22047,2020-12-01,14185,12923,1262,8.9
22049,2020-12-01,6695,6406,289,4.3
22051,2020-12-01,211333,195229,16104,7.6
22053,2020-12-01,12673,11919,754,5.9
22055,2020-12-01,113579,107275,6304,5.6
22057,2020-12-01,41936,39763,2173,5.2
22059,2020-12-01,6742,6474,268,4
22061,2020-12-01,20553,19513,1040,5.1
22063,2020-12-01,67646,64472,3174,4.7
22065,2020-12-01,3467,3220,247,7.1
22067,2020-12-01,10029,9172,857,8.5
22069,2020-12-01,15742,14881,861,5.5
22071,2020-12-01,182736,162218,20518,11.2
22073,2020-12-01,73324,69121,4203,5.7
22075,2020-12-01,9667,9183,484,5
22077,2020-12-01,9768,9138,630,6.4
22079,2020-12-01,54447,51720,2727,5
22081,2020-12-01,3739,3549,190,5.1
22083,2020-12-01,8167,7674,493,6
22085,2020-12-01,9013,8622,391,4.3
22087,2020-12-01,19745,18019,1726,8.7
22089,2020-12-01,24466,22928,1538,6.3
22091,2020-12-01,4416,3926,490,11.1
22093,2020-12-01,9084,8269,815,9
22095,2020-12-01,19697,17674,2023,10.3
22097,2020-12-01,31973,29577,2396,7.5
22099,2020-12-01,22303,20795,1508,6.8
22101,2020-12-01,19717,18160,1557,7.9
22103,2020-12-01,114458,109045,5413,4.7
22105,2020-12-01,54729,50309,4420,8.1
22107,2020-12-01,1346,1258,88,6.5
22109,2020-12-01,46841,43754,3087,6.6
22111,2020-12-01,9445,8916,529,5.6
22113,2020-12-01,24065,22565,1500,6.2
22115,2020-12-01,15498,14670,828,5.3
22117,2020-12-01,16785,15596,1189,7.1
22119,2020-12-01,14445,13531,914,6.3
22121,2020-12-01,13576,12744,832,6.1
22123,2020-12-01,3488,3237,251,7.2
22125,2020-12-01,5291,5046,245,4.6
22127,2020-12-01,4752,4473,279,5.9
23001,2020-12-01,54323,51757,2566,4.7
23003,2020-12-01,29135,27576,1559,5.4
23005,2020-12-01,157962,151332,6630,4.2
23007,2020-12-01,14254,13515,739,5.2
23009,2020-12-01,26270,24749,1521,5.8
23011,2020-12-01,61573,58905,2668,4.3
23013,2020-12-01,18991,18170,821,4.3
23015,2020-12-01,15878,15126,752,4.7
23017,2020-12-01,25689,24164,1525,5.9
23019,2020-12-01,74829,71411,3418,4.6
23021,2020-12-01,7231,6818,413,5.7
23023,2020-12-01,19098,18377,721,3.8
23025,2020-12-01,21956,20583,1373,6.3
23027,2020-12-01,19769,18803,966,4.9
23029,2020-12-01,13619,12871,748,5.5
23031,2020-12-01,107359,102106,5253,4.9
24001,2020-12-01,29802,27762,2040,6.8
24003,2020-12-01,304458,289548,14910,4.9
24005,2020-12-01,440090,414313,25777,5.9
24009,2020-12-01,47652,45475,2177,4.6
24011,2020-12-01,16832,16016,816,4.8
24013,2020-12-01,91199,87534,3665,4
24015,2020-12-01,49302,46713,2589,5.3
24017,2020-12-01,84131,79123,5008,6
24019,2020-12-01,14625,13672,953,6.5
24021,2020-12-01,129790,123289,6501,5
24023,2020-12-01,14532,13711,821,5.6
24025,2020-12-01,135432,129121,6311,4.7
24027,2020-12-01,181044,172935,8109,4.5
24029,2020-12-01,9255,8716,539,5.8
24031,2020-12-01,546409,515259,31150,5.7
24033,2020-12-01,500279,460441,39838,8
24035,2020-12-01,26362,25208,1154,4.4
24037,2020-12-01,52949,50616,2333,4.4
24039,2020-12-01,8246,7581,665,8.1
24041,2020-12-01,17645,16716,929,5.3
24043,2020-12-01,70588,66702,3886,5.5
24045,2020-12-01,46967,43866,3101,6.6
24047,2020-12-01,23631,21175,2456,10.4
24510,2020-12-01,282198,259830,22368,7.9
25001,2020-12-01,104041,95293,8748,8.4
25003,2020-12-01,61509,56736,4773,7.8
25005,2020-12-01,293087,270750,22337,7.6
25007,2020-12-01,8651,7910,741,8.6
25009,2020-12-01,415116,382976,32140,7.7
25011,2020-12-01,39694,37079,2615,6.6
25013,2020-12-01,218816,199448,19368,8.9
25015,2020-12-01,85601,79871,5730,6.7
25017,2020-12-01,883862,831239,52623,6
25019,2020-12-01,6842,6110,732,10.7
25021,2020-12-01,375980,351945,24035,6.4
25023,2020-12-01,272431,252494,19937,7.3
25025,2020-12-01,442956,409719,33237,7.5
25027,2020-12-01,440005,409012,30993,7
26001,2020-12-01,3631,3412,219,6
26003,2020-12-01,2984,2757,227,7.6
26005,2020-12-01,59141,56621,2520,4.3
26007,2020-12-01,12597,11951,646,5.1
26009,2020-12-01,9768,9114,654,6.7
26011,2020-12-01,5514,5118,396,7.2
26013,2020-12-01,2943,2735,208,7.1
26015,2020-12-01,30229,28960,1269,4.2
26017,2020-12-01,45593,42991,2602,5.7
26019,2020-12-01,8318,7838,480,5.8
26021,2020-12-01,69374,65653,3721,5.4
26023,2020-12-01,18365,17521,844,4.6
26025,2020-12-01,58596,55205,3391,5.8
26027,2020-12-01,23189,22134,1055,4.5
26029,2020-12-01,12019,11302,717,6
26031,2020-12-01,8877,7942,935,10.5
26033,2020-12-01,15615,14685,930,6
26035,2020-12-01,10777,9975,802,7.4
26037,2020-12-01,37845,36472,1373,3.6
26039,2020-12-01,5033,4702,331,6.6
26041,2020-12-01,17028,16108,920,5.4
26043,2020-12-01,12163,11622,541,4.4
26045,2020-12-01,52841,50590,2251,4.3
26047,2020-12-01,16518,15417,1101,6.7
26049,2020-12-01,171106,160431,10675,6.2
26051,2020-12-01,9112,8539,573,6.3
26053,2020-12-01,5893,5600,293,5
26055,2020-12-01,47167,44752,2415,5.1
26057,2020-12-01,17485,16681,804,4.6
26059,2020-12-01,18964,18066,898,4.7
26061,2020-12-01,16122,15438,684,4.2
26063,2020-12-01,14661,13977,684,4.7
26065,2020-12-01,139976,133535,6441,4.6
26067,2020-12-01,28549,27393,1156,4
26069,2020-12-01,9405,8781,624,6.6
26071,2020-12-01,5005,4747,258,5.2
26073,2020-12-01,33782,32247,1535,4.5
26075,2020-12-01,69889,66239,3650,5.2
26077,2020-12-01,127305,121621,5684,4.5
26079,2020-12-01,7468,6968,500,6.7
26081,2020-12-01,346046,331126,14920,4.3
26083,2020-12-01,873,821,52,6
26085,2020-12-01,3493,3215,278,8
26087,2020-12-01,41060,36865,4195,10.2
26089,2020-12-01,9927,9406,521,5.2
26091,2020-12-01,44168,42108,2060,4.7
26093,2020-12-01,102019,94654,7365,7.2
26095,2020-12-01,2141,2003,138,6.4
26097,2020-12-01,3823,3340,483,12.6
26099,2020-12-01,449794,406152,43642,9.7
26101,2020-12-01,9182,8430,752,8.2
26103,2020-12-01,32463,30967,1496,4.6
26105,2020-12-01,12765,12020,745,5.8
26107,2020-12-01,17494,16503,991,5.7
26109,2020-12-01,10626,10216,410,3.9
26111,2020-12-01,37805,36119,1686,4.5
26113,2020-12-01,6622,6294,328,5
26115,2020-12-01,69051,65827,3224,4.7
26117,2020-12-01,27051,25703,1348,5
26119,2020-12-01,2746,2507,239,8.7
26121,2020-12-01,72617,67717,4900,6.7
26123,2020-12-01,21650,20505,1145,5.3
26125,2020-12-01,670276,617489,52787,7.9
26127,2020-12-01,10873,10111,762,7
26129,2020-12-01,7607,7050,557,7.3
26131,2020-12-01,1932,1808,124,6.4
26133,2020-12-01,11049,10524,525,4.8
26135,2020-12-01,2763,2559,204,7.4
26137,2020-12-01,10495,9804,691,6.6
26139,2020-12-01,153990,148243,5747,3.7
26141,2020-12-01,4423,4099,324,7.3
26143,2020-12-01,7095,6483,612,8.6
26145,2020-12-01,80519,75663,4856,6
26147,2020-12-01,75553,68140,7413,9.8
26149,2020-12-01,27260,25980,1280,4.7
26151,2020-12-01,18512,17584,928,5
26153,2020-12-01,3231,3014,217,6.7
26155,2020-12-01,31924,30439,1485,4.7
26157,2020-12-01,22959,21733,1226,5.3
26159,2020-12-01,33221,31423,1798,5.4
26161,2020-12-01,192221,185271,6950,3.6
26163,2020-12-01,818858,717077,101781,12.4
26165,2020-12-01,14368,13595,773,5.4
27001,2020-12-01,7234,6681,553,7.6
27003,2020-12-01,191964,182689,9275,4.8
27005,2020-12-01,18848,17920,928,4.9
27007,2020-12-01,24435,23205,1230,5
27009,2020-12-01,22136,20902,1234,5.6
27011,2020-12-01,2452,2347,105,4.3
27013,2020-12-01,40288,38709,1579,3.9
27015,2020-12-01,14461,13870,591,4.1
27017,2020-12-01,16947,16066,881,5.2
27019,2020-12-01,56643,54442,2201,3.9
27021,2020-12-01,14242,13190,1052,7.4
27023,2020-12-01,6865,6594,271,3.9
27025,2020-12-01,29198,27572,1626,5.6
27027,2020-12-01,36599,35500,1099,3
27029,2020-12-01,4307,3990,317,7.4
27031,2020-12-01,3035,2825,210,6.9
27033,2020-12-01,6149,5884,265,4.3
27035,2020-12-01,32588,30355,2233,6.9
27037,2020-12-01,233902,223746,10156,4.3
27039,2020-12-01,11647,11165,482,4.1
27041,2020-12-01,21637,20680,957,4.4
27043,2020-12-01,6937,6596,341,4.9
27045,2020-12-01,11388,10949,439,3.9
27047,2020-12-01,16248,15589,659,4.1
27049,2020-12-01,26605,25513,1092,4.1
27051,2020-12-01,3384,3222,162,4.8
27053,2020-12-01,684852,654954,29898,4.4
27055,2020-12-01,10258,9925,333,3.2
27057,2020-12-01,9826,9219,607,6.2
27059,2020-12-01,20751,19528,1223,5.9
27061,2020-12-01,21038,19693,1345,6.4
27063,2020-12-01,5787,5564,223,3.9
27065,2020-12-01,9049,8365,684,7.6
27067,2020-12-01,24386,23325,1061,4.4
27069,2020-12-01,2352,2269,83,3.5
27071,2020-12-01,5684,5358,326,5.7
27073,2020-12-01,3596,3459,137,3.8
27075,2020-12-01,5287,4996,291,5.5
27077,2020-12-01,2382,2261,121,5.1
27079,2020-12-01,15777,14814,963,6.1
27081,2020-12-01,3259,3139,120,3.7
27083,2020-12-01,14486,13981,505,3.5
27085,2020-12-01,19061,18128,933,4.9
27087,2020-12-01,2337,2182,155,6.6
27089,2020-12-01,5373,5068,305,5.7
27091,2020-12-01,9990,9605,385,3.9
27093,2020-12-01,13344,12705,639,4.8
27095,2020-12-01,12698,11707,991,7.8
27097,2020-12-01,17865,16647,1218,6.8
27099,2020-12-01,20641,19820,821,4
27101,2020-12-01,4740,4508,232,4.9
27103,2020-12-01,20783,20060,723,3.5
27105,2020-12-01,11408,11052,356,3.1
27107,2020-12-01,3284,3124,160,4.9
27109,2020-12-01,86605,83295,3310,3.8
27111,2020-12-01,31156,29638,1518,4.9
27113,2020-12-01,8514,8111,403,4.7
27115,2020-12-01,14831,13816,1015,6.8
27117,2020-12-01,4799,4629,170,3.5
27119,2020-12-01,16612,15944,668,4
27121,2020-12-01,6581,6315,266,4
27123,2020-12-01,281039,267916,13123,4.7
27125,2020-12-01,2194,2085,109,5
27127,2020-12-01,7680,7372,308,4
27129,2020-12-01,8489,8112,377,4.4
27131,2020-12-01,37169,35600,1569,4.2
27133,2020-12-01,5695,5556,139,2.4
27135,2020-12-01,7813,7512,301,3.9
27137,2020-12-01,97472,92067,5405,5.5
27139,2020-12-01,80958,77482,3476,4.3
27141,2020-12-01,50946,48292,2654,5.2
27143,2020-12-01,8391,8019,372,4.4
27145,2020-12-01,90826,86736,4090,4.5
27147,2020-12-01,21341,20503,838,3.9
27149,2020-12-01,5405,5223,182,3.4
27151,2020-12-01,4915,4650,265,5.4
27153,2020-12-01,13778,13121,657,4.8
27155,2020-12-01,1803,1742,61,3.4
27157,2020-12-01,12145,11648,497,4.1
27159,2020-12-01,6081,5701,380,6.2
27161,2020-12-01,9008,8586,422,4.7
27163,2020-12-01,138462,132856,5606,4
27165,2020-12-01,6520,6298,222,3.4
27167,2020-12-01,3501,3384,117,3.3
27169,2020-12-01,28616,27618,998,3.5
27171,2020-12-01,73196,69972,3224,4.4
27173,2020-12-01,5356,5153,203,3.8
28001,2020-12-01,11337,10299,1038,9.2
28003,2020-12-01,16202,15446,756,4.7
28005,2020-12-01,4505,4139,366,8.1
28007,2020-12-01,7096,6627,469,6.6
28009,2020-12-01,3081,2891,190,6.2
28011,2020-12-01,11665,10768,897,7.7
28013,2020-12-01,5369,5080,289,5.4
28015,2020-12-01,3334,3128,206,6.2
28017,2020-12-01,6900,6422,478,6.9
28019,2020-12-01,3642,3444,198,5.4
28021,2020-12-01,3001,2649,352,11.7
28023,2020-12-01,5740,5340,400,7
28025,2020-12-01,7391,6742,649,8.8
28027,2020-12-01,8327,7542,785,9.4
28029,2020-12-01,11140,10369,771,6.9
28031,2020-12-01,8137,7627,510,6.3
28033,2020-12-01,91772,87971,3801,4.1
28035,2020-12-01,34614,32557,2057,5.9
28037,2020-12-01,2824,2629,195,6.9
28039,2020-12-01,8675,8035,640,7.4
28041,2020-12-01,4237,3892,345,8.1
28043,2020-12-01,9429,8922,507,5.4
28045,2020-12-01,18999,17787,1212,6.4
28047,2020-12-01,88082,82843,5239,5.9
28049,2020-12-01,107712,100453,7259,6.7
28051,2020-12-01,5528,4855,673,12.2
28053,2020-12-01,2214,1927,287,13
28055,2020-12-01,332,302,30,9
28057,2020-12-01,10531,10064,467,4.4
28059,2020-12-01,59524,55740,3784,6.4
28061,2020-12-01,5971,5501,470,7.9
28063,2020-12-01,1966,1623,343,17.4
28065,2020-12-01,3982,3654,328,8.2
28067,2020-12-01,25195,23699,1496,5.9
28069,2020-12-01,3411,3152,259,7.6
28071,2020-12-01,26577,25408,1169,4.4
28073,2020-12-01,31700,30375,1325,4.2
28075,2020-12-01,29570,27844,1726,5.8
28077,2020-12-01,4629,4287,342,7.4
28079,2020-12-01,7934,7449,485,6.1
28081,2020-12-01,41667,39565,2102,5
28083,2020-12-01,9848,8927,921,9.4
28085,2020-12-01,14566,13723,843,5.8
28087,2020-12-01,24807,23212,1595,6.4
28089,2020-12-01,52729,50411,2318,4.4
28091,2020-12-01,9738,9147,591,6.1
28093,2020-12-01,14562,13729,833,5.7
28095,2020-12-01,15163,14242,921,6.1
28097,2020-12-01,3961,3701,260,6.6
28099,2020-12-01,9788,9221,567,5.8
28101,2020-12-01,8468,8013,455,5.4
28103,2020-12-01,3600,3283,317,8.8
28105,2020-12-01,22094,20852,1242,5.6
28107,2020-12-01,12534,11553,981,7.8
28109,2020-12-01,23458,21972,1486,6.3
28111,2020-12-01,4420,4121,299,6.8
28113,2020-12-01,14846,13696,1150,7.7
28115,2020-12-01,14807,14128,679,4.6
28117,2020-12-01,11014,10480,534,4.8
28119,2020-12-01,2200,1988,212,9.6
28121,2020-12-01,75268,72463,2805,3.7
28123,2020-12-01,12819,12207,612,4.8
28125,2020-12-01,1496,1347,149,10
28127,2020-12-01,10694,10086,608,5.7
28129,2020-12-01,6561,6243,318,4.8
28131,2020-12-01,6727,6326,401,6
28133,2020-12-01,7611,6869,742,9.7
28135,2020-12-01,4843,4516,327,6.8
28137,2020-12-01,12450,11750,700,5.6
28139,2020-12-01,9166,8730,436,4.8
28141,2020-12-01,8551,8178,373,4.4
28143,2020-12-01,4655,4213,442,9.5
28145,2020-12-01,14249,13639,610,4.3
28147,2020-12-01,4888,4520,368,7.5
28149,2020-12-01,20053,18747,1306,6.5
28151,2020-12-01,16758,15227,1531,9.1
28153,2020-12-01,7314,6784,530,7.2
28155,2020-12-01,3846,3628,218,5.7
28157,2020-12-01,2810,2413,397,14.1
28159,2020-12-01,7256,6750,506,7
28161,2020-12-01,4724,4417,307,6.5
28163,2020-12-01,9367,8690,677,7.2
29001,2020-12-01,10367,9780,587,5.7
29003,2020-12-01,9663,9252,411,4.3
29005,2020-12-01,2648,2542,106,4
29007,2020-12-01,10564,10033,531,5
29009,2020-12-01,15765,14809,956,6.1
29011,2020-12-01,5223,4965,258,4.9
29013,2020-12-01,7810,7358,452,5.8
29015,2020-12-01,7387,6841,546,7.4
29017,2020-12-01,5234,4931,303,5.8
29019,2020-12-01,97891,93768,4123,4.2
29021,2020-12-01,44565,42214,2351,5.3
29023,2020-12-01,18517,17253,1264,6.8
29025,2020-12-01,4340,4096,244,5.6
29027,2020-12-01,20933,19949,984,4.7
29029,2020-12-01,19173,17771,1402,7.3
29031,2020-12-01,39123,37101,2022,5.2
29033,2020-12-01,5058,4389,669,13.2
29035,2020-12-01,2639,2448,191,7.2
29037,2020-12-01,54703,51871,2832,5.2
29039,2020-12-01,5847,5553,294,5
29041,2020-12-01,3725,3550,175,4.7
29043,2020-12-01,45143,43079,2064,4.6
29045,2020-12-01,3196,3002,194,6.1
29047,2020-12-01,136324,129297,7027,5.2
29049,2020-12-01,10649,10105,544,5.1
29051,2020-12-01,38304,36623,1681,4.4
29053,2020-12-01,7401,7018,383,5.2
29055,2020-12-01,11044,10383,661,6
29057,2020-12-01,3562,3399,163,4.6
29059,2020-12-01,7038,6607,431,6.1
29061,2020-12-01,4119,3938,181,4.4
29063,2020-12-01,4752,4535,217,4.6
29065,2020-12-01,6502,6113,389,6
29067,2020-12-01,5129,4803,326,6.4
29069,2020-12-01,11437,10556,881,7.7
29071,2020-12-01,51965,49060,2905,5.6
29073,2020-12-01,7723,7328,395,5.1
29075,2020-12-01,3438,3307,131,3.8
29077,2020-12-01,152308,144896,7412,4.9
29079,2020-12-01,4361,4170,191,4.4
29081,2020-12-01,3823,3646,177,4.6
29083,2020-12-01,9856,9289,567,5.8
29085,2020-12-01,3978,3744,234,5.9
29087,2020-12-01,2517,2431,86,3.4
29089,2020-12-01,4849,4640,209,4.3
29091,2020-12-01,16949,15771,1178,7
29093,2020-12-01,3616,3348,268,7.4
29095,2020-12-01,366547,341422,25125,6.9
29097,2020-12-01,58271,55206,3065,5.3
29099,2020-12-01,116015,109252,6763,5.8
29101,2020-12-01,23986,22650,1336,5.6
29103,2020-12-01,1763,1677,86,4.9
29105,2020-12-01,17096,16046,1050,6.1
29107,2020-12-01,16714,15827,887,5.3
29109,2020-12-01,18207,17237,970,5.3
29111,2020-12-01,4966,4743,223,4.5
29113,2020-12-01,27648,26158,1490,5.4
29115,2020-12-01,5183,4835,348,6.7
29117,2020-12-01,7430,7115,315,4.2
29119,2020-12-01,10884,10329,555,5.1
29121,2020-12-01,7617,7222,395,5.2
29123,2020-12-01,5653,5313,340,6
29125,2020-12-01,3908,3700,208,5.3
29127,2020-12-01,14640,13957,683,4.7
29129,2020-12-01,1850,1775,75,4.1
29131,2020-12-01,12463,11753,710,5.7
29133,2020-12-01,5788,5436,352,6.1
29135,2020-12-01,7084,6773,311,4.4
29137,2020-12-01,3796,3573,223,5.9
29139,2020-12-01,5714,5443,271,4.7
29141,2020-12-01,8112,7591,521,6.4
29143,2020-12-01,8395,7864,531,6.3
29145,2020-12-01,27691,26247,1444,5.2
29147,2020-12-01,11301,10826,475,4.2
29149,2020-12-01,4114,3811,303,7.4
29151,2020-12-01,6904,6652,252,3.7
29153,2020-12-01,3489,3212,277,7.9
29155,2020-12-01,6553,5976,577,8.8
29157,2020-12-01,9895,9481,414,4.2
29159,2020-12-01,21084,20057,1027,4.9
29161,2020-12-01,20036,19006,1030,5.1
29163,2020-12-01,7548,7160,388,5.1
29165,2020-12-01,58542,55748,2794,4.8
29167,2020-12-01,14556,13833,723,5
29169,2020-12-01,14913,14018,895,6
29171,2020-12-01,2192,2086,106,4.8
29173,2020-12-01,5673,5410,263,4.6
29175,2020-12-01,10464,9875,589,5.6
29177,2020-12-01,10935,10346,589,5.4
29179,2020-12-01,3013,2845,168,5.6
29181,2020-12-01,5095,4704,391,7.7
29183,2020-12-01,220982,210536,10446,4.7
29185,2020-12-01,3770,3524,246,6.5
29186,2020-12-01,9155,8706,449,4.9
29187,2020-12-01,26990,25292,1698,6.3
29189,2020-12-01,525094,492544,32550,6.2
29195,2020-12-01,10946,10422,524,4.8
29197,2020-12-01,1910,1810,100,5.2
29199,2020-12-01,2346,2260,86,3.7
29201,2020-12-01,19803,18645,1158,5.8
29203,2020-12-01,3293,3035,258,7.8
29205,2020-12-01,3138,2957,181,5.8
29207,2020-12-01,13270,12447,823,6.2
29209,2020-12-01,13975,12988,987,7.1
29211,2020-12-01,2741,2572,169,6.2
29213,2020-12-01,27285,25318,1967,7.2
29215,2020-12-01,8985,8378,607,6.8
29217,2020-12-01,9476,9013,463,4.9
29219,2020-12-01,17536,16606,930,5.3
29221,2020-12-01,10359,9669,690,6.7
29223,2020-12-01,5197,4840,357,6.9
29225,2020-12-01,17192,16346,846,4.9
29227,2020-12-01,1147,1099,48,4.2
29229,2020-12-01,7357,6908,449,6.1
29510,2020-12-01,152954,140154,12800,8.4
30001,2020-12-01,5034,4859,175,3.5
30003,2020-12-01,4748,4437,311,6.6
30005,2020-12-01,2305,2197,108,4.7
30007,2020-12-01,2523,2384,139,5.5
30009,2020-12-01,5485,5252,233,4.2
30011,2020-12-01,687,670,17,2.5
30013,2020-12-01,37187,35567,1620,4.4
30015,2020-12-01,2549,2463,86,3.4
30017,2020-12-01,6131,5870,261,4.3
30019,2020-12-01,908,882,26,2.9
30021,2020-12-01,4642,4430,212,4.6
30023,2020-12-01,4861,4633,228,4.7
30025,2020-12-01,1697,1633,64,3.8
30027,2020-12-01,5720,5492,228,4
30029,2020-12-01,47602,44833,2769,5.8
30031,2020-12-01,69356,67069,2287,3.3
30033,2020-12-01,772,749,23,3
30035,2020-12-01,5542,5085,457,8.2
30037,2020-12-01,367,354,13,3.5
30039,2020-12-01,1589,1499,90,5.7
30041,2020-12-01,7394,7105,289,3.9
30043,2020-12-01,5615,5391,224,4
30045,2020-12-01,1061,1022,39,3.7
30047,2020-12-01,13232,12566,666,5
30049,2020-12-01,35277,33865,1412,4
30051,2020-12-01,1007,978,29,2.9
30053,2020-12-01,7816,7226,590,7.5
30055,2020-12-01,955,929,26,2.7
30057,2020-12-01,5177,4982,195,3.8
30059,2020-12-01,1021,985,36,3.5
30061,2020-12-01,1616,1497,119,7.4
30063,2020-12-01,64123,61256,2867,4.5
30065,2020-12-01,2353,2223,130,5.5
30067,2020-12-01,8764,8286,478,5.5
30069,2020-12-01,292,281,11,3.8
30071,2020-12-01,1933,1839,94,4.9
30073,2020-12-01,2643,2530,113,4.3
30075,2020-12-01,984,953,31,3.2
30077,2020-12-01,2879,2792,87,3
30079,2020-12-01,467,438,29,6.2
30081,2020-12-01,20160,19146,1014,5
30083,2020-12-01,5816,5519,297,5.1
30085,2020-12-01,4379,4177,202,4.6
30087,2020-12-01,3610,3432,178,4.9
30089,2020-12-01,4913,4575,338,6.9
30091,2020-12-01,1811,1713,98,5.4
30093,2020-12-01,16750,15922,828,4.9
30095,2020-12-01,5324,5116,208,3.9
30097,2020-12-01,1832,1776,56,3.1
30099,2020-12-01,2716,2614,102,3.8
30101,2020-12-01,2071,1991,80,3.9
30103,2020-12-01,331,321,10,3
30105,2020-12-01,3961,3810,151,3.8
30107,2020-12-01,824,766,58,7
30109,2020-12-01,465,443,22,4.7
30111,2020-12-01,81273,78049,3224,4
31001,2020-12-01,15937,15518,419,2.6
31003,2020-12-01,3890,3824,66,1.7
31005,2020-12-01,229,223,6,2.6
31007,2020-12-01,380,372,8,2.1
31009,2020-12-01,254,246,8,3.1
31011,2020-12-01,2911,2864,47,1.6
31013,2020-12-01,5202,5021,181,3.5
31015,2020-12-01,1048,1030,18,1.7
31017,2020-12-01,1356,1328,28,2.1
31019,2020-12-01,27158,26617,541,2
31021,2020-12-01,3474,3371,103,3
31023,2020-12-01,4488,4380,108,2.4
31025,2020-12-01,13557,13186,371,2.7
31027,2020-12-01,4460,4376,84,1.9
31029,2020-12-01,2234,2212,22,1
31031,2020-12-01,3251,3201,50,1.5
31033,2020-12-01,4152,4022,130,3.1
31035,2020-12-01,3159,3098,61,1.9
31037,2020-12-01,5470,5368,102,1.9
31039,2020-12-01,4764,4694,70,1.5
31041,2020-12-01,6194,6097,97,1.6
31043,2020-12-01,10635,10309,326,3.1
31045,2020-12-01,4781,4673,108,2.3
31047,2020-12-01,12947,12674,273,2.1
31049,2020-12-01,940,918,22,2.3
31051,2020-12-01,3009,2940,69,2.3
31053,2020-12-01,20094,19588,506,2.5
31055,2020-12-01,301181,291254,9927,3.3
31057,2020-12-01,1184,1161,23,1.9
31059,2020-12-01,3087,3028,59,1.9
31061,2020-12-01,1453,1410,43,3
31063,2020-12-01,1545,1520,25,1.6
31065,2020-12-01,2589,2539,50,1.9
31067,2020-12-01,10613,10344,269,2.5
31069,2020-12-01,1055,1023,32,3
31071,2020-12-01,1115,1103,12,1.1
31073,2020-12-01,1087,1072,15,1.4
31075,2020-12-01,422,416,6,1.4
31077,2020-12-01,1220,1201,19,1.6
31079,2020-12-01,31721,30206,1515,4.8
31081,2020-12-01,4685,4557,128,2.7
31083,2020-12-01,1684,1659,25,1.5
31085,2020-12-01,623,613,10,1.6
31087,2020-12-01,1286,1257,29,2.3
31089,2020-12-01,5725,5635,90,1.6
31091,2020-12-01,374,366,8,2.1
31093,2020-12-01,3370,3200,170,5
31095,2020-12-01,4123,4053,70,1.7
31097,2020-12-01,2043,1980,63,3.1
31099,2020-12-01,3633,3568,65,1.8
31101,2020-12-01,4385,4277,108,2.5
31103,2020-12-01,603,599,4,0.7
31105,2020-12-01,1912,1866,46,2.4
31107,2020-12-01,4578,4480,98,2.1
31109,2020-12-01,179677,174512,5165,2.9
31111,2020-12-01,17895,17480,415,2.3
31113,2020-12-01,468,462,6,1.3
31115,2020-12-01,398,391,7,1.8
31117,2020-12-01,436,430,6,1.4
31119,2020-12-01,19134,18494,640,3.3
31121,2020-12-01,3959,3831,128,3.2
31123,2020-12-01,2571,2508,63,2.5
31125,2020-12-01,1922,1878,44,2.3
31127,2020-12-01,3494,3421,73,2.1
31129,2020-12-01,2438,2391,47,1.9
31131,2020-12-01,8264,8069,195,2.4
31133,2020-12-01,1474,1445,29,2
31135,2020-12-01,1811,1792,19,1
31137,2020-12-01,4807,4727,80,1.7
31139,2020-12-01,4045,3896,149,3.7
31141,2020-12-01,17228,16880,348,2
31143,2020-12-01,2862,2811,51,1.8
31145,2020-12-01,5719,5593,126,2.2
31147,2020-12-01,4136,4031,105,2.5
31149,2020-12-01,865,855,10,1.2
31151,2020-12-01,7185,7004,181,2.5
31153,2020-12-01,96568,94290,2278,2.4
31155,2020-12-01,11175,10907,268,2.4
31157,2020-12-01,17633,17128,505,2.9
31159,2020-12-01,9068,8782,286,3.2
31161,2020-12-01,2597,2556,41,1.6
31163,2020-12-01,1635,1601,34,2.1
31165,2020-12-01,750,739,11,1.5
31167,2020-12-01,3467,3358,109,3.1
31169,2020-12-01,2745,2701,44,1.6
31171,2020-12-01,418,407,11,2.6
31173,2020-12-01,2846,2762,84,3
31175,2020-12-01,2079,2045,34,1.6
31177,2020-12-01,11271,11018,253,2.2
31179,2020-12-01,5619,5513,106,1.9
31181,2020-12-01,1591,1555,36,2.3
31183,2020-12-01,574,567,7,1.2
31185,2020-12-01,6956,6824,132,1.9
32001,2020-12-01,10644,10243,401,3.8
32003,2020-12-01,NA,971954,112990,10.4
32005,2020-12-01,22555,21327,1228,5.4
32007,2020-12-01,25864,24941,923,3.6
32009,2020-12-01,419,397,22,5.3
32011,2020-12-01,935,907,28,3
32013,2020-12-01,7713,7424,289,3.7
32015,2020-12-01,3085,2963,122,4
32017,2020-12-01,1964,1878,86,4.4
32019,2020-12-01,22319,20979,1340,6
32021,2020-12-01,1966,1878,88,4.5
32023,2020-12-01,17287,16042,1245,7.2
32027,2020-12-01,2340,2244,96,4.1
32029,2020-12-01,1999,1885,114,5.7
32031,2020-12-01,249523,237011,12512,5
32033,2020-12-01,4459,4321,138,3.1
32510,2020-12-01,24791,23369,1422,5.7
33001,2020-12-01,30603,29384,1219,4
33003,2020-12-01,22089,21135,954,4.3
33005,2020-12-01,40448,38958,1490,3.7
33007,2020-12-01,14051,13363,688,4.9
33009,2020-12-01,47996,46426,1570,3.3
33011,2020-12-01,236915,227661,9254,3.9
33013,2020-12-01,81921,79170,2751,3.4
33015,2020-12-01,179131,172308,6823,3.8
33017,2020-12-01,68639,66166,2473,3.6
33019,2020-12-01,23320,22573,747,3.2
34001,2020-12-01,114080,100343,13737,12
34003,2020-12-01,477210,444609,32601,6.8
34005,2020-12-01,229631,215236,14395,6.3
34007,2020-12-01,254406,234315,20091,7.9
34009,2020-12-01,41609,36780,4829,11.6
34011,2020-12-01,64970,59136,5834,9
34013,2020-12-01,364501,329716,34785,9.5
34015,2020-12-01,149608,139150,10458,7
34017,2020-12-01,359597,331650,27947,7.8
34019,2020-12-01,62142,58745,3397,5.5
34021,2020-12-01,205215,192807,12408,6
34023,2020-12-01,436536,407671,28865,6.6
34025,2020-12-01,326494,305631,20863,6.4
34027,2020-12-01,248235,233474,14761,5.9
34029,2020-12-01,273108,254460,18648,6.8
34031,2020-12-01,243959,219936,24023,9.8
34033,2020-12-01,28851,26503,2348,8.1
34035,2020-12-01,165472,155447,10025,6.1
34037,2020-12-01,71935,66893,5042,7
34039,2020-12-01,269949,248846,21103,7.8
34041,2020-12-01,57027,53417,3610,6.3
35001,2020-12-01,332948,308880,24068,7.2
35003,2020-12-01,1018,951,67,6.6
35005,2020-12-01,26585,24368,2217,8.3
35006,2020-12-01,8968,8001,967,10.8
35007,2020-12-01,5087,4749,338,6.6
35009,2020-12-01,20734,19536,1198,5.8
35011,2020-12-01,682,646,36,5.3
35013,2020-12-01,92700,85791,6909,7.5
35015,2020-12-01,34639,32246,2393,6.9
35017,2020-12-01,11787,10801,986,8.4
35019,2020-12-01,1503,1397,106,7.1
35021,2020-12-01,278,266,12,4.3
35023,2020-12-01,1910,1806,104,5.4
35025,2020-12-01,32189,28885,3304,10.3
35027,2020-12-01,8528,7751,777,9.1
35028,2020-12-01,8893,8596,297,3.3
35029,2020-12-01,9451,7987,1464,15.5
35031,2020-12-01,23717,21293,2424,10.2
35033,2020-12-01,1926,1795,131,6.8
35035,2020-12-01,24043,22219,1824,7.6
35037,2020-12-01,2987,2765,222,7.4
35039,2020-12-01,15825,14550,1275,8.1
35041,2020-12-01,7614,7159,455,6
35043,2020-12-01,66030,61055,4975,7.5
35045,2020-12-01,49733,45295,4438,8.9
35047,2020-12-01,10557,9751,806,7.6
35049,2020-12-01,70145,65088,5057,7.2
35051,2020-12-01,3634,3306,328,9
35053,2020-12-01,6029,5623,406,6.7
35055,2020-12-01,15195,13667,1528,10.1
35057,2020-12-01,5406,4961,445,8.2
35059,2020-12-01,1533,1467,66,4.3
35061,2020-12-01,30285,28001,2284,7.5
36001,2020-12-01,151312,143026,8286,5.5
36003,2020-12-01,19062,17877,1185,6.2
36005,2020-12-01,574858,488301,86557,15.1
36007,2020-12-01,81894,76643,5251,6.4
36009,2020-12-01,32978,30851,2127,6.4
36011,2020-12-01,34911,32927,1984,5.7
36013,2020-12-01,51977,47939,4038,7.8
36015,2020-12-01,34908,32565,2343,6.7
36017,2020-12-01,21533,20336,1197,5.6
36019,2020-12-01,36111,34031,2080,5.8
36021,2020-12-01,30165,28797,1368,4.5
36023,2020-12-01,22476,21061,1415,6.3
36025,2020-12-01,18302,17273,1029,5.6
36027,2020-12-01,137442,130080,7362,5.4
36029,2020-12-01,435361,402271,33090,7.6
36031,2020-12-01,16174,15225,949,5.9
36033,2020-12-01,19209,18114,1095,5.7
36035,2020-12-01,21238,19806,1432,6.7
36037,2020-12-01,28451,26914,1537,5.4
36039,2020-12-01,20017,18811,1206,6
36041,2020-12-01,2034,1909,125,6.1
36043,2020-12-01,27068,25076,1992,7.4
36045,2020-12-01,41107,38511,2596,6.3
36047,2020-12-01,NA,992255,126316,11.3
36049,2020-12-01,11245,10567,678,6
36051,2020-12-01,28979,27394,1585,5.5
36053,2020-12-01,30839,29058,1781,5.8
36055,2020-12-01,345748,321721,24027,6.9
36057,2020-12-01,20999,19521,1478,7
36059,2020-12-01,684719,646725,37994,5.5
36061,2020-12-01,831271,759361,71910,8.7
36063,2020-12-01,96452,89403,7049,7.3
36065,2020-12-01,97440,91402,6038,6.2
36067,2020-12-01,209887,196399,13488,6.4
36069,2020-12-01,52348,49489,2859,5.5
36071,2020-12-01,176235,165886,10349,5.9
36073,2020-12-01,16670,15601,1069,6.4
36075,2020-12-01,49870,46443,3427,6.9
36077,2020-12-01,25786,24299,1487,5.8
36079,2020-12-01,48661,46208,2453,5
36081,2020-12-01,NA,949575,113961,10.7
36083,2020-12-01,77657,73568,4089,5.3
36085,2020-12-01,203688,184465,19223,9.4
36087,2020-12-01,147573,139463,8110,5.5
36089,2020-12-01,43184,40644,2540,5.9
36091,2020-12-01,113597,108326,5271,4.6
36093,2020-12-01,73475,68924,4551,6.2
36095,2020-12-01,13955,13169,786,5.6
36097,2020-12-01,7797,7269,528,6.8
36099,2020-12-01,15415,14530,885,5.7
36101,2020-12-01,41344,38821,2523,6.1
36103,2020-12-01,750212,708964,41248,5.5
36105,2020-12-01,35540,33329,2211,6.2
36107,2020-12-01,22158,20978,1180,5.3
36109,2020-12-01,49471,47338,2133,4.3
36111,2020-12-01,86439,81740,4699,5.4
36113,2020-12-01,29655,27766,1889,6.4
36115,2020-12-01,26272,24867,1405,5.3
36117,2020-12-01,41469,39171,2298,5.5
36119,2020-12-01,462009,434219,27790,6
36121,2020-12-01,17424,16369,1055,6.1
36123,2020-12-01,11215,10650,565,5
37001,2020-12-01,82048,77229,4819,5.9
37003,2020-12-01,17286,16345,941,5.4
37005,2020-12-01,4525,4255,270,6
37007,2020-12-01,10718,9956,762,7.1
37009,2020-12-01,13399,12751,648,4.8
37011,2020-12-01,7872,7470,402,5.1
37013,2020-12-01,19466,18321,1145,5.9
37015,2020-12-01,8004,7527,477,6
37017,2020-12-01,15311,14333,978,6.4
37019,2020-12-01,50650,46937,3713,7.3
37021,2020-12-01,134907,127370,7537,5.6
37023,2020-12-01,39346,37050,2296,5.8
37025,2020-12-01,107789,101783,6006,5.6
37027,2020-12-01,35241,32926,2315,6.6
37029,2020-12-01,4641,4411,230,5
37031,2020-12-01,31632,30007,1625,5.1
37033,2020-12-01,9855,9216,639,6.5
37035,2020-12-01,75707,71196,4511,6
37037,2020-12-01,35000,33387,1613,4.6
37039,2020-12-01,11444,10751,693,6.1
37041,2020-12-01,5875,5533,342,5.8
37043,2020-12-01,4235,3977,258,6.1
37045,2020-12-01,50206,47011,3195,6.4
37047,2020-12-01,23402,21681,1721,7.4
37049,2020-12-01,40674,38220,2454,6
37051,2020-12-01,125852,115470,10382,8.2
37053,2020-12-01,13879,13185,694,5
37055,2020-12-01,16882,15596,1286,7.6
37057,2020-12-01,79573,74960,4613,5.8
37059,2020-12-01,20252,19196,1056,5.2
37061,2020-12-01,25547,24229,1318,5.2
37063,2020-12-01,168358,159084,9274,5.5
37065,2020-12-01,21160,19160,2000,9.5
37067,2020-12-01,185060,173713,11347,6.1
37069,2020-12-01,30954,29101,1853,6
37071,2020-12-01,110453,103304,7149,6.5
37073,2020-12-01,5261,4985,276,5.2
37075,2020-12-01,3326,3067,259,7.8
37077,2020-12-01,29941,28485,1456,4.9
37079,2020-12-01,9690,9192,498,5.1
37081,2020-12-01,256701,239057,17644,6.9
37083,2020-12-01,20613,18892,1721,8.3
37085,2020-12-01,53183,49723,3460,6.5
37087,2020-12-01,28647,27037,1610,5.6
37089,2020-12-01,52606,49856,2750,5.2
37091,2020-12-01,9457,8821,636,6.7
37093,2020-12-01,19796,18269,1527,7.7
37095,2020-12-01,1719,1598,121,7
37097,2020-12-01,88604,83541,5063,5.7
37099,2020-12-01,20104,19014,1090,5.4
37101,2020-12-01,97802,92605,5197,5.3
37103,2020-12-01,4292,4065,227,5.3
37105,2020-12-01,25924,24262,1662,6.4
37107,2020-12-01,28852,27195,1657,5.7
37109,2020-12-01,42926,40688,2238,5.2
37111,2020-12-01,20584,19405,1179,5.7
37113,2020-12-01,15849,15018,831,5.2
37115,2020-12-01,9694,9165,529,5.5
37117,2020-12-01,8980,8382,598,6.7
37119,2020-12-01,617825,579953,37872,6.1
37121,2020-12-01,5974,5583,391,6.5
37123,2020-12-01,11114,10441,673,6.1
37125,2020-12-01,42538,40216,2322,5.5
37127,2020-12-01,42464,39409,3055,7.2
37129,2020-12-01,120145,113583,6562,5.5
37131,2020-12-01,7783,7234,549,7.1
37133,2020-12-01,66027,61926,4101,6.2
37135,2020-12-01,77072,73566,3506,4.5
37137,2020-12-01,5190,4911,279,5.4
37139,2020-12-01,16864,15753,1111,6.6
37141,2020-12-01,27970,26428,1542,5.5
37143,2020-12-01,4983,4686,297,6
37145,2020-12-01,18105,17021,1084,6
37147,2020-12-01,87494,82075,5419,6.2
37149,2020-12-01,8912,8420,492,5.5
37151,2020-12-01,64429,60637,3792,5.9
37153,2020-12-01,17481,16029,1452,8.3
37155,2020-12-01,51852,47523,4329,8.3
37157,2020-12-01,39162,36507,2655,6.8
37159,2020-12-01,65682,61620,4062,6.2
37161,2020-12-01,25590,23678,1912,7.5
37163,2020-12-01,29939,28363,1576,5.3
37165,2020-12-01,12294,11035,1259,10.2
37167,2020-12-01,30717,29141,1576,5.1
37169,2020-12-01,21342,20171,1171,5.5
37171,2020-12-01,34071,32300,1771,5.2
37173,2020-12-01,7440,7063,377,5.1
37175,2020-12-01,14361,13628,733,5.1
37177,2020-12-01,1274,1167,107,8.4
37179,2020-12-01,122035,115955,6080,5
37181,2020-12-01,18159,16579,1580,8.7
37183,2020-12-01,587226,557276,29950,5.1
37185,2020-12-01,6695,6119,576,8.6
37187,2020-12-01,4292,3949,343,8
37189,2020-12-01,31777,30414,1363,4.3
37191,2020-12-01,49900,46794,3106,6.2
37193,2020-12-01,30231,28605,1626,5.4
37195,2020-12-01,34878,32301,2577,7.4
37197,2020-12-01,17431,16499,932,5.3
37199,2020-12-01,8245,7808,437,5.3
38001,2020-12-01,991,959,32,3.2
38003,2020-12-01,5111,4952,159,3.1
38005,2020-12-01,2186,2069,117,5.4
38007,2020-12-01,360,347,13,3.6
38009,2020-12-01,2912,2777,135,4.6
38011,2020-12-01,1590,1545,45,2.8
38013,2020-12-01,974,929,45,4.6
38015,2020-12-01,50443,48707,1736,3.4
38017,2020-12-01,107086,103701,3385,3.2
38019,2020-12-01,1932,1884,48,2.5
38021,2020-12-01,2260,2192,68,3
38023,2020-12-01,1332,1298,34,2.6
38025,2020-12-01,2706,2580,126,4.7
38027,2020-12-01,1197,1149,48,4
38029,2020-12-01,1456,1397,59,4.1
38031,2020-12-01,1557,1508,49,3.1
38033,2020-12-01,825,803,22,2.7
38035,2020-12-01,38162,36854,1308,3.4
38037,2020-12-01,1215,1170,45,3.7
38039,2020-12-01,997,966,31,3.1
38041,2020-12-01,1359,1311,48,3.5
38043,2020-12-01,1240,1174,66,5.3
38045,2020-12-01,1984,1936,48,2.4
38047,2020-12-01,865,840,25,2.9
38049,2020-12-01,3039,2904,135,4.4
38051,2020-12-01,1095,1052,43,3.9
38053,2020-12-01,7405,6810,595,8
38055,2020-12-01,4629,4448,181,3.9
38057,2020-12-01,3420,3234,186,5.4
38059,2020-12-01,16538,15893,645,3.9
38061,2020-12-01,6555,6253,302,4.6
38063,2020-12-01,1366,1302,64,4.7
38065,2020-12-01,867,833,34,3.9
38067,2020-12-01,3267,3142,125,3.8
38069,2020-12-01,1638,1585,53,3.2
38071,2020-12-01,5500,5303,197,3.6
38073,2020-12-01,2802,2734,68,2.4
38075,2020-12-01,1200,1156,44,3.7
38077,2020-12-01,8395,8158,237,2.8
38079,2020-12-01,4676,4190,486,10.4
38081,2020-12-01,2713,2630,83,3.1
38083,2020-12-01,697,657,40,5.7
38085,2020-12-01,1235,1198,37,3
38087,2020-12-01,381,372,9,2.4
38089,2020-12-01,15884,14851,1033,6.5
38091,2020-12-01,913,894,19,2.1
38093,2020-12-01,10397,10076,321,3.1
38095,2020-12-01,1106,1067,39,3.5
38097,2020-12-01,4402,4285,117,2.7
38099,2020-12-01,4990,4795,195,3.9
38101,2020-12-01,30808,29290,1518,4.9
38103,2020-12-01,1882,1803,79,4.2
38105,2020-12-01,18455,16708,1747,9.5
39001,2020-12-01,10584,9889,695,6.6
39003,2020-12-01,47083,44649,2434,5.2
39005,2020-12-01,25980,24767,1213,4.7
39007,2020-12-01,41459,38939,2520,6.1
39009,2020-12-01,27505,26141,1364,5
39011,2020-12-01,23325,22454,871,3.7
39013,2020-12-01,27727,25932,1795,6.5
39015,2020-12-01,19568,18489,1079,5.5
39017,2020-12-01,194744,186105,8639,4.4
39019,2020-12-01,12708,11973,735,5.8
39021,2020-12-01,19677,18875,802,4.1
39023,2020-12-01,63424,60262,3162,5
39025,2020-12-01,106533,101969,4564,4.3
39027,2020-12-01,17654,16697,957,5.4
39029,2020-12-01,45285,42497,2788,6.2
39031,2020-12-01,13442,12633,809,6
39033,2020-12-01,17906,16933,973,5.4
39035,2020-12-01,574713,535833,38880,6.8
39037,2020-12-01,24808,23770,1038,4.2
39039,2020-12-01,17087,16255,832,4.9
39041,2020-12-01,108543,104643,3900,3.6
39043,2020-12-01,32090,29713,2377,7.4
39045,2020-12-01,76919,73604,3315,4.3
39047,2020-12-01,13742,13111,631,4.6
39049,2020-12-01,692825,658535,34290,4.9
39051,2020-12-01,21935,20890,1045,4.8
39053,2020-12-01,12294,11619,675,5.5
39055,2020-12-01,45538,43493,2045,4.5
39057,2020-12-01,82465,79009,3456,4.2
39059,2020-12-01,17602,16515,1087,6.2
39061,2020-12-01,417860,396786,21074,5
39063,2020-12-01,40951,39292,1659,4.1
39065,2020-12-01,13616,12927,689,5.1
39067,2020-12-01,6467,6037,430,6.6
39069,2020-12-01,12679,11971,708,5.6
39071,2020-12-01,17073,16099,974,5.7
39073,2020-12-01,12878,12219,659,5.1
39075,2020-12-01,20796,20232,564,2.7
39077,2020-12-01,25800,23971,1829,7.1
39079,2020-12-01,12672,11889,783,6.2
39081,2020-12-01,26790,24945,1845,6.9
39083,2020-12-01,30616,29321,1295,4.2
39085,2020-12-01,117519,111113,6406,5.5
39087,2020-12-01,23759,22570,1189,5
39089,2020-12-01,89134,85414,3720,4.2
39091,2020-12-01,21663,20724,939,4.3
39093,2020-12-01,143225,134430,8795,6.1
39095,2020-12-01,205895,193587,12308,6
39097,2020-12-01,20559,19746,813,4
39099,2020-12-01,96239,89845,6394,6.6
39101,2020-12-01,27495,26122,1373,5
39103,2020-12-01,90305,86139,4166,4.6
39105,2020-12-01,8727,8148,579,6.6
39107,2020-12-01,22751,22063,688,3
39109,2020-12-01,53733,51401,2332,4.3
39111,2020-12-01,5724,5305,419,7.3
39113,2020-12-01,252018,238318,13700,5.4
39115,2020-12-01,6289,5864,425,6.8
39117,2020-12-01,16606,15808,798,4.8
39119,2020-12-01,39510,37321,2189,5.5
39121,2020-12-01,4457,4115,342,7.7
39123,2020-12-01,19116,17769,1347,7
39125,2020-12-01,8446,8071,375,4.4
39127,2020-12-01,15696,14791,905,5.8
39129,2020-12-01,26104,24922,1182,4.5
39131,2020-12-01,10271,9607,664,6.5
39133,2020-12-01,84072,79981,4091,4.9
39135,2020-12-01,20683,19809,874,4.2
39137,2020-12-01,18214,17592,622,3.4
39139,2020-12-01,52483,49542,2941,5.6
39141,2020-12-01,33911,32276,1635,4.8
39143,2020-12-01,28376,26907,1469,5.2
39145,2020-12-01,28495,26777,1718,6
39147,2020-12-01,26009,24716,1293,5
39149,2020-12-01,23221,22214,1007,4.3
39151,2020-12-01,181373,171901,9472,5.2
39153,2020-12-01,263664,249155,14509,5.5
39155,2020-12-01,80855,75315,5540,6.9
39157,2020-12-01,42843,40693,2150,5
39159,2020-12-01,28565,27550,1015,3.6
39161,2020-12-01,14043,13484,559,4
39163,2020-12-01,5431,5063,368,6.8
39165,2020-12-01,118761,114016,4745,4
39167,2020-12-01,26288,24747,1541,5.9
39169,2020-12-01,59287,57058,2229,3.8
39171,2020-12-01,17788,16949,839,4.7
39173,2020-12-01,69153,66272,2881,4.2
39175,2020-12-01,12566,12081,485,3.9
40001,2020-12-01,8086,7698,388,4.8
40003,2020-12-01,2723,2630,93,3.4
40005,2020-12-01,4995,4651,344,6.9
40007,2020-12-01,2802,2746,56,2
40009,2020-12-01,9645,8972,673,7
40011,2020-12-01,4607,4402,205,4.4
40013,2020-12-01,21699,20705,994,4.6
40015,2020-12-01,11863,11228,635,5.4
40017,2020-12-01,74984,71666,3318,4.4
40019,2020-12-01,21183,19994,1189,5.6
40021,2020-12-01,18902,17876,1026,5.4
40023,2020-12-01,5452,5054,398,7.3
40025,2020-12-01,1350,1322,28,2.1
40027,2020-12-01,143759,137716,6043,4.2
40029,2020-12-01,2426,2269,157,6.5
40031,2020-12-01,48192,45782,2410,5
40033,2020-12-01,2752,2613,139,5.1
40035,2020-12-01,5765,5504,261,4.5
40037,2020-12-01,31100,29273,1827,5.9
40039,2020-12-01,15648,14927,721,4.6
40041,2020-12-01,18353,17519,834,4.5
40043,2020-12-01,2952,2823,129,4.4
40045,2020-12-01,2099,1991,108,5.1
40047,2020-12-01,25585,24275,1310,5.1
40049,2020-12-01,12512,11800,712,5.7
40051,2020-12-01,26891,25519,1372,5.1
40053,2020-12-01,2612,2516,96,3.7
40055,2020-12-01,1869,1732,137,7.3
40057,2020-12-01,1201,1159,42,3.5
40059,2020-12-01,1761,1692,69,3.9
40061,2020-12-01,4243,3927,316,7.4
40063,2020-12-01,5435,5040,395,7.3
40065,2020-12-01,10721,10342,379,3.5
40067,2020-12-01,2530,2370,160,6.3
40069,2020-12-01,3258,3028,230,7.1
40071,2020-12-01,17967,16919,1048,5.8
40073,2020-12-01,8918,8565,353,4
40075,2020-12-01,3370,3209,161,4.8
40077,2020-12-01,3153,2835,318,10.1
40079,2020-12-01,18932,17736,1196,6.3
40081,2020-12-01,15876,15123,753,4.7
40083,2020-12-01,22270,21318,952,4.3
40085,2020-12-01,6094,5874,220,3.6
40087,2020-12-01,19852,18996,856,4.3
40089,2020-12-01,15003,13993,1010,6.7
40091,2020-12-01,7303,6734,569,7.8
40093,2020-12-01,3785,3613,172,4.5
40095,2020-12-01,6948,6585,363,5.2
40097,2020-12-01,19413,18453,960,4.9
40099,2020-12-01,6378,6040,338,5.3
40101,2020-12-01,29856,28200,1656,5.5
40103,2020-12-01,5543,5358,185,3.3
40105,2020-12-01,4619,4380,239,5.2
40107,2020-12-01,4540,4256,284,6.3
40109,2020-12-01,389840,369761,20079,5.2
40111,2020-12-01,15473,14389,1084,7
40113,2020-12-01,20341,19179,1162,5.7
40115,2020-12-01,14454,13819,635,4.4
40117,2020-12-01,7259,6817,442,6.1
40119,2020-12-01,38093,36487,1606,4.2
40121,2020-12-01,17022,15904,1118,6.6
40123,2020-12-01,19181,18312,869,4.5
40125,2020-12-01,32566,30810,1756,5.4
40127,2020-12-01,4310,4007,303,7
40129,2020-12-01,1813,1737,76,4.2
40131,2020-12-01,44298,42040,2258,5.1
40133,2020-12-01,9556,8904,652,6.8
40135,2020-12-01,16033,15149,884,5.5
40137,2020-12-01,18672,17424,1248,6.7
40139,2020-12-01,11841,11542,299,2.5
40141,2020-12-01,2981,2869,112,3.8
40143,2020-12-01,318641,300862,17779,5.6
40145,2020-12-01,37296,35356,1940,5.2
40147,2020-12-01,21985,20859,1126,5.1
40149,2020-12-01,5094,4770,324,6.4
40151,2020-12-01,4619,4482,137,3
40153,2020-12-01,8818,8266,552,6.3
41001,2020-12-01,7471,7015,456,6.1
41003,2020-12-01,47824,45890,1934,4
41005,2020-12-01,219618,206939,12679,5.8
41007,2020-12-01,18664,17344,1320,7.1
41009,2020-12-01,24338,22763,1575,6.5
41011,2020-12-01,26481,24855,1626,6.1
41013,2020-12-01,10290,9464,826,8
41015,2020-12-01,8871,8282,589,6.6
41017,2020-12-01,96841,90278,6563,6.8
41019,2020-12-01,47261,44335,2926,6.2
41021,2020-12-01,997,951,46,4.6
41023,2020-12-01,3222,2957,265,8.2
41025,2020-12-01,3619,3434,185,5.1
41027,2020-12-01,12986,12292,694,5.3
41029,2020-12-01,105596,99321,6275,5.9
41031,2020-12-01,10263,9494,769,7.5
41033,2020-12-01,35388,33019,2369,6.7
41035,2020-12-01,29629,27430,2199,7.4
41037,2020-12-01,3711,3537,174,4.7
41039,2020-12-01,187094,176376,10718,5.7
41041,2020-12-01,19402,17895,1507,7.8
41043,2020-12-01,60096,56511,3585,6
41045,2020-12-01,12812,12243,569,4.4
41047,2020-12-01,158890,149550,9340,5.9
41049,2020-12-01,5626,5366,260,4.6
41051,2020-12-01,460112,429692,30420,6.6
41053,2020-12-01,39070,36943,2127,5.4
41055,2020-12-01,969,928,41,4.2
41057,2020-12-01,11510,10836,674,5.9
41059,2020-12-01,36651,34442,2209,6
41061,2020-12-01,12160,11394,766,6.3
41063,2020-12-01,3440,3243,197,5.7
41065,2020-12-01,12467,11666,801,6.4
41067,2020-12-01,323255,306982,16273,5
41069,2020-12-01,714,684,30,4.2
41071,2020-12-01,54555,51655,2900,5.3
42001,2020-12-01,54131,51845,2286,4.2
42003,2020-12-01,619355,580061,39294,6.3
42005,2020-12-01,30986,28668,2318,7.5
42007,2020-12-01,80847,74885,5962,7.4
42009,2020-12-01,23103,21590,1513,6.5
42011,2020-12-01,218689,205601,13088,6
42013,2020-12-01,57188,53574,3614,6.3
42015,2020-12-01,27815,26280,1535,5.5
42017,2020-12-01,325300,307999,17301,5.3
42019,2020-12-01,95121,89651,5470,5.8
42021,2020-12-01,54681,50715,3966,7.3
42023,2020-12-01,1963,1805,158,8
42025,2020-12-01,31357,29305,2052,6.5
42027,2020-12-01,74297,71034,3263,4.4
42029,2020-12-01,270770,259384,11386,4.2
42031,2020-12-01,16728,15671,1057,6.3
42033,2020-12-01,35049,32604,2445,7
42035,2020-12-01,17666,16430,1236,7
42037,2020-12-01,32719,30795,1924,5.9
42039,2020-12-01,36987,34438,2549,6.9
42041,2020-12-01,129589,123766,5823,4.5
42043,2020-12-01,142796,134025,8771,6.1
42045,2020-12-01,289970,272220,17750,6.1
42047,2020-12-01,14497,13455,1042,7.2
42049,2020-12-01,120891,111448,9443,7.8
42051,2020-12-01,55120,50260,4860,8.8
42053,2020-12-01,1742,1596,146,8.4
42055,2020-12-01,76473,72658,3815,5
42057,2020-12-01,7756,7277,479,6.2
42059,2020-12-01,16210,15075,1135,7
42061,2020-12-01,19518,17975,1543,7.9
42063,2020-12-01,38302,35835,2467,6.4
42065,2020-12-01,20133,18824,1309,6.5
42067,2020-12-01,12342,11653,689,5.6
42069,2020-12-01,99144,92332,6812,6.9
42071,2020-12-01,280787,267578,13209,4.7
42073,2020-12-01,39178,36070,3108,7.9
42075,2020-12-01,70542,66694,3848,5.5
42077,2020-12-01,189281,177139,12142,6.4
42079,2020-12-01,149612,137260,12352,8.3
42081,2020-12-01,51787,48062,3725,7.2
42083,2020-12-01,16654,15488,1166,7
42085,2020-12-01,45547,42025,3522,7.7
42087,2020-12-01,20848,19377,1471,7.1
42089,2020-12-01,76318,70346,5972,7.8
42091,2020-12-01,429996,408178,21818,5.1
42093,2020-12-01,8909,8477,432,4.8
42095,2020-12-01,157324,148347,8977,5.7
42097,2020-12-01,41267,38415,2852,6.9
42099,2020-12-01,24051,22990,1061,4.4
42101,2020-12-01,699455,634633,64822,9.3
42103,2020-12-01,23569,21875,1694,7.2
42105,2020-12-01,7023,6506,517,7.4
42107,2020-12-01,65132,60846,4286,6.6
42109,2020-12-01,19700,18722,978,5
42111,2020-12-01,32404,30018,2386,7.4
42113,2020-12-01,2522,2349,173,6.9
42115,2020-12-01,19282,18263,1019,5.3
42117,2020-12-01,18577,17306,1271,6.8
42119,2020-12-01,19067,18124,943,4.9
42121,2020-12-01,21905,20371,1534,7
42123,2020-12-01,18582,17400,1182,6.4
42125,2020-12-01,102628,95539,7089,6.9
42127,2020-12-01,20498,19096,1402,6.8
42129,2020-12-01,172951,161576,11375,6.6
42131,2020-12-01,12850,12033,817,6.4
42133,2020-12-01,232397,220415,11982,5.2
44001,2020-12-01,25491,23591,1900,7.5
44003,2020-12-01,88359,82122,6237,7.1
44005,2020-12-01,43381,40123,3258,7.5
44007,2020-12-01,318557,292643,25914,8.1
44009,2020-12-01,66938,62223,4715,7
45001,2020-12-01,9894,9424,470,4.8
45003,2020-12-01,72073,69323,2750,3.8
45005,2020-12-01,2582,2360,222,8.6
45007,2020-12-01,91253,87470,3783,4.1
45009,2020-12-01,4889,4507,382,7.8
45011,2020-12-01,7938,7410,528,6.7
45013,2020-12-01,77404,74516,2888,3.7
45015,2020-12-01,100616,96334,4282,4.3
45017,2020-12-01,6441,6115,326,5.1
45019,2020-12-01,205453,196433,9020,4.4
45021,2020-12-01,25310,23855,1455,5.7
45023,2020-12-01,13133,12233,900,6.9
45025,2020-12-01,21754,20685,1069,4.9
45027,2020-12-01,12438,11749,689,5.5
45029,2020-12-01,16681,15816,865,5.2
45031,2020-12-01,30249,28704,1545,5.1
45033,2020-12-01,13022,12318,704,5.4
45035,2020-12-01,75597,72377,3220,4.3
45037,2020-12-01,10271,9880,391,3.8
45039,2020-12-01,9412,8849,563,6
45041,2020-12-01,66808,63732,3076,4.6
45043,2020-12-01,25465,24012,1453,5.7
45045,2020-12-01,255179,245227,9952,3.9
45047,2020-12-01,30983,29413,1570,5.1
45049,2020-12-01,8246,7902,344,4.2
45051,2020-12-01,136755,128404,8351,6.1
45053,2020-12-01,12631,12138,493,3.9
45055,2020-12-01,28580,27372,1208,4.2
45057,2020-12-01,40009,37977,2032,5.1
45059,2020-12-01,30265,28819,1446,4.8
45061,2020-12-01,6491,6101,390,6
45063,2020-12-01,146692,141518,5174,3.5
45065,2020-12-01,3312,3129,183,5.5
45067,2020-12-01,12804,11882,922,7.2
45069,2020-12-01,9155,8468,687,7.5
45071,2020-12-01,18490,17761,729,3.9
45073,2020-12-01,34730,33420,1310,3.8
45075,2020-12-01,35100,32535,2565,7.3
45077,2020-12-01,57195,55075,2120,3.7
45079,2020-12-01,196493,187032,9461,4.8
45081,2020-12-01,8508,8203,305,3.6
45083,2020-12-01,149145,142340,6805,4.6
45085,2020-12-01,42151,39869,2282,5.4
45087,2020-12-01,11517,10730,787,6.8
45089,2020-12-01,11926,11165,761,6.4
45091,2020-12-01,135978,130058,5920,4.4
46003,2020-12-01,1499,1466,33,2.2
46005,2020-12-01,9409,9139,270,2.9
46007,2020-12-01,1078,1035,43,4
46009,2020-12-01,2892,2797,95,3.3
46011,2020-12-01,19356,18681,675,3.5
46013,2020-12-01,20629,20020,609,3
46015,2020-12-01,2440,2374,66,2.7
46017,2020-12-01,643,614,29,4.5
46019,2020-12-01,5011,4828,183,3.7
46021,2020-12-01,792,771,21,2.7
46023,2020-12-01,3765,3614,151,4
46025,2020-12-01,1898,1831,67,3.5
46027,2020-12-01,7457,7218,239,3.2
46029,2020-12-01,15601,15102,499,3.2
46031,2020-12-01,1358,1306,52,3.8
46033,2020-12-01,3929,3747,182,4.6
46035,2020-12-01,10974,10648,326,3
46037,2020-12-01,2702,2588,114,4.2
46039,2020-12-01,2140,2048,92,4.3
46041,2020-12-01,2183,2084,99,4.5
46043,2020-12-01,1555,1514,41,2.6
46045,2020-12-01,2047,1988,59,2.9
46047,2020-12-01,2934,2794,140,4.8
46049,2020-12-01,1087,1058,29,2.7
46051,2020-12-01,4435,4289,146,3.3
46053,2020-12-01,2077,2009,68,3.3
46055,2020-12-01,1060,1036,24,2.3
46057,2020-12-01,3345,3250,95,2.8
46059,2020-12-01,1803,1764,39,2.2
46061,2020-12-01,1726,1656,70,4.1
46063,2020-12-01,738,721,17,2.3
46065,2020-12-01,9816,9579,237,2.4
46067,2020-12-01,3683,3560,123,3.3
46069,2020-12-01,694,679,15,2.2
46071,2020-12-01,1193,1140,53,4.4
46073,2020-12-01,1148,1120,28,2.4
46075,2020-12-01,527,514,13,2.5
46077,2020-12-01,2664,2590,74,2.8
46079,2020-12-01,6613,6406,207,3.1
46081,2020-12-01,13466,13014,452,3.4
46083,2020-12-01,34173,33353,820,2.4
46085,2020-12-01,1679,1619,60,3.6
46087,2020-12-01,3071,2985,86,2.8
46089,2020-12-01,1013,974,39,3.8
46091,2020-12-01,2416,2329,87,3.6
46093,2020-12-01,13578,13155,423,3.1
46095,2020-12-01,735,707,28,3.8
46097,2020-12-01,1191,1140,51,4.3
46099,2020-12-01,111892,108629,3263,2.9
46101,2020-12-01,4012,3906,106,2.6
46102,2020-12-01,3564,3216,348,9.8
46103,2020-12-01,54621,52755,1866,3.4
46105,2020-12-01,1451,1398,53,3.7
46107,2020-12-01,1031,1002,29,2.8
46109,2020-12-01,4934,4693,241,4.9
46111,2020-12-01,1177,1140,37,3.1
46115,2020-12-01,3163,3067,96,3
46117,2020-12-01,1828,1777,51,2.8
46119,2020-12-01,797,782,15,1.9
46121,2020-12-01,3096,2945,151,4.9
46123,2020-12-01,3102,3032,70,2.3
46125,2020-12-01,4677,4554,123,2.6
46127,2020-12-01,8492,8184,308,3.6
46129,2020-12-01,2155,2047,108,5
46135,2020-12-01,11722,11354,368,3.1
46137,2020-12-01,937,898,39,4.2
47001,2020-12-01,36308,34176,2132,5.9
47003,2020-12-01,21491,20156,1335,6.2
47005,2020-12-01,7021,6485,536,7.6
47007,2020-12-01,4556,4154,402,8.8
47009,2020-12-01,66515,62889,3626,5.5
47011,2020-12-01,55584,52242,3342,6
47013,2020-12-01,15581,14471,1110,7.1
47015,2020-12-01,6788,6430,358,5.3
47017,2020-12-01,12520,11656,864,6.9
47019,2020-12-01,24251,22586,1665,6.9
47021,2020-12-01,22507,21397,1110,4.9
47023,2020-12-01,8757,8275,482,5.5
47025,2020-12-01,13495,12546,949,7
47027,2020-12-01,2840,2606,234,8.2
47029,2020-12-01,15221,14135,1086,7.1
47031,2020-12-01,26163,24632,1531,5.9
47033,2020-12-01,7172,6751,421,5.9
47035,2020-12-01,24496,22587,1909,7.8
47037,2020-12-01,420401,396582,23819,5.7
47039,2020-12-01,4677,4277,400,8.6
47041,2020-12-01,7755,7190,565,7.3
47043,2020-12-01,27798,26400,1398,5
47045,2020-12-01,17048,15921,1127,6.6
47047,2020-12-01,19853,18626,1227,6.2
47049,2020-12-01,7769,7207,562,7.2
47051,2020-12-01,20619,19507,1112,5.4
47053,2020-12-01,22867,21349,1518,6.6
47055,2020-12-01,15076,14138,938,6.2
47057,2020-12-01,9997,9317,680,6.8
47059,2020-12-01,30154,28011,2143,7.1
47061,2020-12-01,5121,4711,410,8
47063,2020-12-01,29435,27720,1715,5.8
47065,2020-12-01,193473,182067,11406,5.9
47067,2020-12-01,2181,2001,180,8.3
47069,2020-12-01,9800,9001,799,8.2
47071,2020-12-01,10815,10031,784,7.2
47073,2020-12-01,24067,22426,1641,6.8
47075,2020-12-01,8016,7395,621,7.7
47077,2020-12-01,12636,11826,810,6.4
47079,2020-12-01,14374,13367,1007,7
47081,2020-12-01,11766,11136,630,5.4
47083,2020-12-01,3337,3083,254,7.6
47085,2020-12-01,9026,8494,532,5.9
47087,2020-12-01,4888,4519,369,7.5
47089,2020-12-01,25795,24251,1544,6
47091,2020-12-01,8056,7539,517,6.4
47093,2020-12-01,255750,242457,13293,5.2
47095,2020-12-01,1805,1614,191,10.6
47097,2020-12-01,10106,9296,810,8
47099,2020-12-01,19937,18721,1216,6.1
47101,2020-12-01,5268,4921,347,6.6
47103,2020-12-01,16178,15114,1064,6.6
47105,2020-12-01,24574,23182,1392,5.7
47107,2020-12-01,24560,22927,1633,6.6
47109,2020-12-01,8957,8184,773,8.6
47111,2020-12-01,11645,10970,675,5.8
47113,2020-12-01,50696,47354,3342,6.6
47115,2020-12-01,13114,12226,888,6.8
47117,2020-12-01,15845,14924,921,5.8
47119,2020-12-01,51206,48216,2990,5.8
47121,2020-12-01,5464,5069,395,7.2
47123,2020-12-01,20952,19708,1244,5.9
47125,2020-12-01,89215,83112,6103,6.8
47127,2020-12-01,3714,3545,169,4.6
47129,2020-12-01,8325,7745,580,7
47131,2020-12-01,13055,12104,951,7.3
47133,2020-12-01,10474,9890,584,5.6
47135,2020-12-01,3232,2924,308,9.5
47137,2020-12-01,2357,2203,154,6.5
47139,2020-12-01,8015,7492,523,6.5
47141,2020-12-01,37043,34872,2171,5.9
47143,2020-12-01,13925,12800,1125,8.1
47145,2020-12-01,24633,22987,1646,6.7
47147,2020-12-01,39155,37153,2002,5.1
47149,2020-12-01,189980,180711,9269,4.9
47151,2020-12-01,8556,7842,714,8.3
47153,2020-12-01,6479,6056,423,6.5
47155,2020-12-01,53514,50687,2827,5.3
47157,2020-12-01,471469,432051,39418,8.4
47159,2020-12-01,9690,9221,469,4.8
47161,2020-12-01,5691,5305,386,6.8
47163,2020-12-01,71522,66626,4896,6.8
47165,2020-12-01,105565,100239,5326,5
47167,2020-12-01,29229,27355,1874,6.4
47169,2020-12-01,5625,5293,332,5.9
47171,2020-12-01,7225,6621,604,8.4
47173,2020-12-01,7983,7464,519,6.5
47175,2020-12-01,2092,1923,169,8.1
47177,2020-12-01,16768,15602,1166,7
47179,2020-12-01,60980,57228,3752,6.2
47181,2020-12-01,6300,5835,465,7.4
47183,2020-12-01,16172,15234,938,5.8
47185,2020-12-01,12532,11796,736,5.9
47187,2020-12-01,131513,125976,5537,4.2
47189,2020-12-01,78996,75096,3900,4.9
48001,2020-12-01,23751,22323,1428,6
48003,2020-12-01,9957,9203,754,7.6
48005,2020-12-01,35790,33038,2752,7.7
48007,2020-12-01,9130,8331,799,8.8
48009,2020-12-01,4059,3844,215,5.3
48011,2020-12-01,896,855,41,4.6
48013,2020-12-01,22105,20298,1807,8.2
48015,2020-12-01,13980,13039,941,6.7
48017,2020-12-01,2300,2167,133,5.8
48019,2020-12-01,10007,9442,565,5.6
48021,2020-12-01,43790,41452,2338,5.3
48023,2020-12-01,1778,1714,64,3.6
48025,2020-12-01,9985,8968,1017,10.2
48027,2020-12-01,144350,134511,9839,6.8
48029,2020-12-01,958667,895338,63329,6.6
48031,2020-12-01,6480,6237,243,3.8
48033,2020-12-01,408,393,15,3.7
48035,2020-12-01,8265,7796,469,5.7
48037,2020-12-01,40519,37888,2631,6.5
48039,2020-12-01,180918,165285,15633,8.6
48041,2020-12-01,121520,115598,5922,4.9
48043,2020-12-01,4158,3903,255,6.1
48045,2020-12-01,552,518,34,6.2
48047,2020-12-01,2679,2386,293,10.9
48049,2020-12-01,15321,14344,977,6.4
48051,2020-12-01,8573,8049,524,6.1
48053,2020-12-01,23427,22332,1095,4.7
48055,2020-12-01,20111,18947,1164,5.8
48057,2020-12-01,12192,11453,739,6.1
48059,2020-12-01,6100,5781,319,5.2
48061,2020-12-01,166224,149088,17136,10.3
48063,2020-12-01,4981,4585,396,8
48065,2020-12-01,2901,2774,127,4.4
48067,2020-12-01,12595,11517,1078,8.6
48069,2020-12-01,3250,3117,133,4.1
48071,2020-12-01,19940,17881,2059,10.3
48073,2020-12-01,20923,19240,1683,8
48075,2020-12-01,2821,2702,119,4.2
48077,2020-12-01,4870,4563,307,6.3
48079,2020-12-01,1057,985,72,6.8
48081,2020-12-01,1428,1349,79,5.5
48083,2020-12-01,2845,2622,223,7.8
48085,2020-12-01,574378,542849,31529,5.5
48087,2020-12-01,1059,1007,52,4.9
48089,2020-12-01,9624,9038,586,6.1
48091,2020-12-01,73271,69169,4102,5.6
48093,2020-12-01,5573,5237,336,6
48095,2020-12-01,1286,1216,70,5.4
48097,2020-12-01,20245,18965,1280,6.3
48099,2020-12-01,24036,22518,1518,6.3
48101,2020-12-01,512,478,34,6.6
48103,2020-12-01,1592,1363,229,14.4
48105,2020-12-01,1627,1490,137,8.4
48107,2020-12-01,2409,2269,140,5.8
48109,2020-12-01,985,918,67,6.8
48111,2020-12-01,3628,3523,105,2.9
48113,2020-12-01,NA,NA,95815,6.8
48115,2020-12-01,4761,4329,432,9.1
48117,2020-12-01,8181,7804,377,4.6
48119,2020-12-01,2393,2263,130,5.4
48121,2020-12-01,505807,477127,28680,5.7
48123,2020-12-01,9772,9183,589,6
48125,2020-12-01,646,600,46,7.1
48127,2020-12-01,7216,6759,457,6.3
48129,2020-12-01,1305,1235,70,5.4
48131,2020-12-01,5050,4415,635,12.6
48133,2020-12-01,7620,7092,528,6.9
48135,2020-12-01,86333,76411,9922,11.5
48137,2020-12-01,1102,1041,61,5.5
48139,2020-12-01,94522,89169,5353,5.7
48141,2020-12-01,364379,335061,29318,8
48143,2020-12-01,20520,19362,1158,5.6
48145,2020-12-01,6685,6282,403,6
48147,2020-12-01,17670,16868,802,4.5
48149,2020-12-01,11880,11249,631,5.3
48151,2020-12-01,1565,1478,87,5.6
48153,2020-12-01,2457,2292,165,6.7
48155,2020-12-01,573,549,24,4.2
48157,2020-12-01,393065,363849,29216,7.4
48159,2020-12-01,4590,4300,290,6.3
48161,2020-12-01,6245,5714,531,8.5
48163,2020-12-01,10186,9607,579,5.7
48165,2020-12-01,9631,9023,608,6.3
48167,2020-12-01,166370,152548,13822,8.3
48169,2020-12-01,2125,1986,139,6.5
48171,2020-12-01,13230,12685,545,4.1
48173,2020-12-01,745,714,31,4.2
48175,2020-12-01,3249,2988,261,8
48177,2020-12-01,9426,8892,534,5.7
48179,2020-12-01,8142,7414,728,8.9
48181,2020-12-01,65406,61851,3555,5.4
48183,2020-12-01,57129,52548,4581,8
48185,2020-12-01,11363,10415,948,8.3
48187,2020-12-01,81368,76976,4392,5.4
48189,2020-12-01,11692,10840,852,7.3
48191,2020-12-01,1005,942,63,6.3
48193,2020-12-01,3595,3407,188,5.2
48195,2020-12-01,2536,2440,96,3.8
48197,2020-12-01,1723,1627,96,5.6
48199,2020-12-01,24789,22536,2253,9.1
48201,2020-12-01,NA,NA,187784,8.1
48203,2020-12-01,28928,26540,2388,8.3
48205,2020-12-01,2599,2549,50,1.9
48207,2020-12-01,2191,2060,131,6
48209,2020-12-01,122718,116350,6368,5.2
48211,2020-12-01,1763,1670,93,5.3
48213,2020-12-01,36779,34429,2350,6.4
48215,2020-12-01,358574,316535,42039,11.7
48217,2020-12-01,16508,15476,1032,6.3
48219,2020-12-01,11105,10247,858,7.7
48221,2020-12-01,27883,26055,1828,6.6
48223,2020-12-01,17232,16319,913,5.3
48225,2020-12-01,10090,9438,652,6.5
48227,2020-12-01,14474,13298,1176,8.1
48229,2020-12-01,1825,1657,168,9.2
48231,2020-12-01,44280,41534,2746,6.2
48233,2020-12-01,8469,7831,638,7.5
48235,2020-12-01,746,691,55,7.4
48237,2020-12-01,3313,3078,235,7.1
48239,2020-12-01,7447,7003,444,6
48241,2020-12-01,12844,11335,1509,11.7
48243,2020-12-01,947,894,53,5.6
48245,2020-12-01,106406,93978,12428,11.7
48247,2020-12-01,1825,1619,206,11.3
48249,2020-12-01,17289,15111,2178,12.6
48251,2020-12-01,83236,78051,5185,6.2
48253,2020-12-01,5786,5345,441,7.6
48255,2020-12-01,7309,6828,481,6.6
48257,2020-12-01,66286,62103,4183,6.3
48259,2020-12-01,21873,20853,1020,4.7
48261,2020-12-01,182,171,11,6
48263,2020-12-01,455,443,12,2.6
48265,2020-12-01,22041,20917,1124,5.1
48267,2020-12-01,1791,1681,110,6.1
48269,2020-12-01,220,215,5,2.3
48271,2020-12-01,1343,1256,87,6.5
48273,2020-12-01,13340,12233,1107,8.3
48275,2020-12-01,1381,1294,87,6.3
48277,2020-12-01,24283,22712,1571,6.5
48279,2020-12-01,5130,4823,307,6
48281,2020-12-01,9149,8633,516,5.6
48283,2020-12-01,4189,3948,241,5.8
48285,2020-12-01,8160,7677,483,5.9
48287,2020-12-01,9955,9503,452,4.5
48289,2020-12-01,6366,5799,567,8.9
48291,2020-12-01,34190,30164,4026,11.8
48293,2020-12-01,8720,8062,658,7.5
48295,2020-12-01,1533,1460,73,4.8
48297,2020-12-01,5611,5165,446,7.9
48299,2020-12-01,8675,8157,518,6
48301,2020-12-01,703,700,3,0.4
48303,2020-12-01,156375,147673,8702,5.6
48305,2020-12-01,2699,2551,148,5.5
48307,2020-12-01,3279,2995,284,8.7
48309,2020-12-01,122217,114962,7255,5.9
48311,2020-12-01,848,828,20,2.4
48313,2020-12-01,4514,4147,367,8.1
48315,2020-12-01,4166,3818,348,8.4
48317,2020-12-01,2675,2516,159,5.9
48319,2020-12-01,1723,1613,110,6.4
48321,2020-12-01,16922,15167,1755,10.4
48323,2020-12-01,24928,20864,4064,16.3
48325,2020-12-01,21816,20506,1310,6
48327,2020-12-01,844,795,49,5.8
48329,2020-12-01,102582,94317,8265,8.1
48331,2020-12-01,9657,8948,709,7.3
48333,2020-12-01,1849,1751,98,5.3
48335,2020-12-01,2369,2158,211,8.9
48337,2020-12-01,9254,8657,597,6.5
48339,2020-12-01,284591,263555,21036,7.4
48341,2020-12-01,10461,10024,437,4.2
48343,2020-12-01,5034,4356,678,13.5
48345,2020-12-01,439,421,18,4.1
48347,2020-12-01,27487,25586,1901,6.9
48349,2020-12-01,24055,22661,1394,5.8
48351,2020-12-01,5088,4526,562,11
48353,2020-12-01,7254,6816,438,6
48355,2020-12-01,162456,148246,14210,8.7
48357,2020-12-01,4063,3814,249,6.1
48359,2020-12-01,886,840,46,5.2
48361,2020-12-01,36005,32215,3790,10.5
48363,2020-12-01,13701,12722,979,7.1
48365,2020-12-01,10008,9171,837,8.4
48367,2020-12-01,67924,64077,3847,5.7
48369,2020-12-01,4589,4433,156,3.4
48371,2020-12-01,6336,5728,608,9.6
48373,2020-12-01,18277,16536,1741,9.5
48375,2020-12-01,54076,51139,2937,5.4
48377,2020-12-01,3182,2725,457,14.4
48379,2020-12-01,6091,5818,273,4.5
48381,2020-12-01,70078,66972,3106,4.4
48383,2020-12-01,1959,1764,195,10
48385,2020-12-01,971,890,81,8.3
48387,2020-12-01,5014,4657,357,7.1
48389,2020-12-01,12343,11633,710,5.8
48391,2020-12-01,3110,2843,267,8.6
48393,2020-12-01,398,380,18,4.5
48395,2020-12-01,7837,7321,516,6.6
48397,2020-12-01,52980,50129,2851,5.4
48399,2020-12-01,4477,4259,218,4.9
48401,2020-12-01,22557,20796,1761,7.8
48403,2020-12-01,3723,3254,469,12.6
48405,2020-12-01,3517,3196,321,9.1
48407,2020-12-01,11784,10724,1060,9
48409,2020-12-01,29166,26080,3086,10.6
48411,2020-12-01,2473,2354,119,4.8
48413,2020-12-01,1250,1152,98,7.8
48415,2020-12-01,6571,6021,550,8.4
48417,2020-12-01,1818,1719,99,5.4
48419,2020-12-01,10960,10178,782,7.1
48421,2020-12-01,1307,1257,50,3.8
48423,2020-12-01,109268,102320,6948,6.4
48425,2020-12-01,4405,4129,276,6.3
48427,2020-12-01,26209,21354,4855,18.5
48429,2020-12-01,3955,3689,266,6.7
48431,2020-12-01,560,516,44,7.9
48433,2020-12-01,544,512,32,5.9
48435,2020-12-01,1322,1180,142,10.7
48437,2020-12-01,2501,2361,140,5.6
48439,2020-12-01,NA,NA,72485,6.6
48441,2020-12-01,67133,63645,3488,5.2
48443,2020-12-01,354,339,15,4.2
48445,2020-12-01,4780,4412,368,7.7
48447,2020-12-01,608,570,38,6.3
48449,2020-12-01,12946,12037,909,7
48451,2020-12-01,52776,49403,3373,6.4
48453,2020-12-01,759594,720478,39116,5.1
48455,2020-12-01,5279,4807,472,8.9
48457,2020-12-01,7159,6368,791,11
48459,2020-12-01,17520,16124,1396,8
48461,2020-12-01,1649,1544,105,6.4
48463,2020-12-01,11122,10340,782,7
48465,2020-12-01,22214,20536,1678,7.6
48467,2020-12-01,26054,24496,1558,6
48469,2020-12-01,42507,39178,3329,7.8
48471,2020-12-01,24037,22218,1819,7.6
48473,2020-12-01,23552,21664,1888,8
48475,2020-12-01,7963,7345,618,7.8
48477,2020-12-01,15283,14355,928,6.1
48479,2020-12-01,116769,107316,9453,8.1
48481,2020-12-01,21457,19948,1509,7
48483,2020-12-01,2241,2053,188,8.4
48485,2020-12-01,56212,52321,3891,6.9
48487,2020-12-01,5006,4641,365,7.3
48489,2020-12-01,6701,5905,796,11.9
48491,2020-12-01,320937,304876,16061,5
48493,2020-12-01,24821,23488,1333,5.4
48495,2020-12-01,3984,3576,408,10.2
48497,2020-12-01,32193,30223,1970,6.1
48499,2020-12-01,17621,16453,1168,6.6
48501,2020-12-01,3812,3427,385,10.1
48503,2020-12-01,7937,7511,426,5.4
48505,2020-12-01,4957,4282,675,13.6
48507,2020-12-01,3282,2755,527,16.1
49001,2020-12-01,2799,2704,95,3.4
49003,2020-12-01,26824,26102,722,2.7
49005,2020-12-01,66219,64706,1513,2.3
49007,2020-12-01,8495,8109,386,4.5
49009,2020-12-01,374,351,23,6.1
49011,2020-12-01,181002,175785,5217,2.9
49013,2020-12-01,7466,6975,491,6.6
49015,2020-12-01,4342,4158,184,4.2
49017,2020-12-01,2287,2018,269,11.8
49019,2020-12-01,5541,5057,484,8.7
49021,2020-12-01,25502,24620,882,3.5
49023,2020-12-01,5908,5776,132,2.2
49025,2020-12-01,3496,3341,155,4.4
49027,2020-12-01,5933,5774,159,2.7
49029,2020-12-01,5763,5617,146,2.5
49031,2020-12-01,469,439,30,6.4
49033,2020-12-01,1033,1000,33,3.2
49035,2020-12-01,652235,629751,22484,3.4
49037,2020-12-01,5130,4645,485,9.5
49039,2020-12-01,12616,12211,405,3.2
49041,2020-12-01,9759,9390,369,3.8
49043,2020-12-01,24422,23513,909,3.7
49045,2020-12-01,34933,33704,1229,3.5
49047,2020-12-01,12975,11996,979,7.5
49049,2020-12-01,319335,310363,8972,2.8
49051,2020-12-01,16035,15456,579,3.6
49053,2020-12-01,78190,75187,3003,3.8
49055,2020-12-01,1303,1208,95,7.3
49057,2020-12-01,133157,128571,4586,3.4
50001,2020-12-01,19592,19146,446,2.3
50003,2020-12-01,16654,16104,550,3.3
50005,2020-12-01,13729,13343,386,2.8
50007,2020-12-01,89573,87324,2249,2.5
50009,2020-12-01,2462,2389,73,3
50011,2020-12-01,25398,24633,765,3
50013,2020-12-01,3743,3620,123,3.3
50015,2020-12-01,12374,11886,488,3.9
50017,2020-12-01,15293,14943,350,2.3
50019,2020-12-01,11797,11326,471,4
50021,2020-12-01,28629,27622,1007,3.5
50023,2020-12-01,32473,31674,799,2.5
50025,2020-12-01,20740,20059,681,3.3
50027,2020-12-01,27780,27133,647,2.3
51001,2020-12-01,16071,15277,794,4.9
51003,2020-12-01,56877,54725,2152,3.8
51005,2020-12-01,6528,6234,294,4.5
51007,2020-12-01,6121,5859,262,4.3
51009,2020-12-01,14107,13485,622,4.4
51011,2020-12-01,6771,6432,339,5
51013,2020-12-01,149607,143909,5698,3.8
51015,2020-12-01,38015,36748,1267,3.3
51017,2020-12-01,2503,2386,117,4.7
51019,2020-12-01,36099,34600,1499,4.2
51021,2020-12-01,2726,2623,103,3.8
51023,2020-12-01,16761,16194,567,3.4
51025,2020-12-01,5746,5341,405,7
51027,2020-12-01,6381,5874,507,7.9
51029,2020-12-01,6454,6063,391,6.1
51031,2020-12-01,24428,23282,1146,4.7
51033,2020-12-01,14828,14092,736,5
51035,2020-12-01,12935,12307,628,4.9
51036,2020-12-01,3592,3407,185,5.2
51037,2020-12-01,5215,4992,223,4.3
51041,2020-12-01,181431,173612,7819,4.3
51043,2020-12-01,7402,7144,258,3.5
51045,2020-12-01,2209,2130,79,3.6
51047,2020-12-01,23825,22965,860,3.6
51049,2020-12-01,4474,4269,205,4.6
51051,2020-12-01,4622,4330,292,6.3
51053,2020-12-01,13386,12671,715,5.3
51057,2020-12-01,5395,5094,301,5.6
51059,2020-12-01,617688,590375,27313,4.4
51061,2020-12-01,36164,34916,1248,3.5
51063,2020-12-01,7997,7701,296,3.7
51065,2020-12-01,13811,13286,525,3.8
51067,2020-12-01,25612,24543,1069,4.2
51069,2020-12-01,45624,44085,1539,3.4
51071,2020-12-01,7560,7252,308,4.1
51073,2020-12-01,19035,18289,746,3.9
51075,2020-12-01,10841,10440,401,3.7
51077,2020-12-01,7974,7668,306,3.8
51079,2020-12-01,10402,10048,354,3.4
51081,2020-12-01,4234,3996,238,5.6
51083,2020-12-01,15200,14423,777,5.1
51085,2020-12-01,57114,55139,1975,3.5
51087,2020-12-01,176683,168330,8353,4.7
51089,2020-12-01,23788,22517,1271,5.3
51091,2020-12-01,1232,1191,41,3.3
51093,2020-12-01,18887,18134,753,4
51095,2020-12-01,35685,34036,1649,4.6
51097,2020-12-01,3870,3712,158,4.1
51099,2020-12-01,12695,12220,475,3.7
51101,2020-12-01,8894,8528,366,4.1
51103,2020-12-01,5404,5141,263,4.9
51105,2020-12-01,7896,7504,392,5
51107,2020-12-01,215277,206893,8384,3.9
51109,2020-12-01,19689,18949,740,3.8
51111,2020-12-01,5077,4840,237,4.7
51113,2020-12-01,7356,7148,208,2.8
51115,2020-12-01,4011,3849,162,4
51117,2020-12-01,12224,11580,644,5.3
51119,2020-12-01,5150,4957,193,3.7
51121,2020-12-01,47587,45971,1616,3.4
51125,2020-12-01,7453,7161,292,3.9
51127,2020-12-01,12030,11630,400,3.3
51131,2020-12-01,5277,4943,334,6.3
51133,2020-12-01,5613,5346,267,4.8
51135,2020-12-01,6884,6575,309,4.5
51137,2020-12-01,17235,16530,705,4.1
51139,2020-12-01,11647,10999,648,5.6
51141,2020-12-01,7050,6719,331,4.7
51143,2020-12-01,29299,27951,1348,4.6
51145,2020-12-01,13606,13148,458,3.4
51147,2020-12-01,10188,9672,516,5.1
51149,2020-12-01,14668,13891,777,5.3
51153,2020-12-01,239006,227521,11485,4.8
51155,2020-12-01,15452,14655,797,5.2
51157,2020-12-01,3611,3486,125,3.5
51159,2020-12-01,3977,3805,172,4.3
51161,2020-12-01,47527,45750,1777,3.7
51163,2020-12-01,10804,10321,483,4.5
51165,2020-12-01,40595,39259,1336,3.3
51167,2020-12-01,10873,10309,564,5.2
51169,2020-12-01,8733,8384,349,4
51171,2020-12-01,22017,21150,867,3.9
51173,2020-12-01,13150,12541,609,4.6
51175,2020-12-01,8924,8571,353,4
51177,2020-12-01,64808,61980,2828,4.4
51179,2020-12-01,69610,66573,3037,4.4
51181,2020-12-01,3552,3395,157,4.4
51183,2020-12-01,3836,3576,260,6.8
51185,2020-12-01,15213,14308,905,5.9
51187,2020-12-01,19785,18941,844,4.3
51191,2020-12-01,25496,24459,1037,4.1
51193,2020-12-01,9205,8728,477,5.2
51195,2020-12-01,13194,12404,790,6
51197,2020-12-01,13373,12714,659,4.9
51199,2020-12-01,31638,30416,1222,3.9
51510,2020-12-01,99065,94288,4777,4.8
51520,2020-12-01,6934,6538,396,5.7
51530,2020-12-01,3646,3508,138,3.8
51540,2020-12-01,26292,25200,1092,4.2
51550,2020-12-01,119108,113649,5459,4.6
51570,2020-12-01,8583,8112,471,5.5
51580,2020-12-01,2294,2150,144,6.3
51590,2020-12-01,18893,17517,1376,7.3
51595,2020-12-01,2334,2133,201,8.6
51600,2020-12-01,13032,12519,513,3.9
51610,2020-12-01,8275,8009,266,3.2
51620,2020-12-01,3587,3314,273,7.6
51630,2020-12-01,13719,12985,734,5.4
51640,2020-12-01,2834,2706,128,4.5
51650,2020-12-01,63175,59048,4127,6.5
51660,2020-12-01,24012,22964,1048,4.4
51670,2020-12-01,9654,8813,841,8.7
51678,2020-12-01,2036,1913,123,6
51680,2020-12-01,34256,32274,1982,5.8
51683,2020-12-01,21406,20435,971,4.5
51685,2020-12-01,9151,8703,448,4.9
51690,2020-12-01,5640,5162,478,8.5
51700,2020-12-01,87257,81685,5572,6.4
51710,2020-12-01,110096,102666,7430,6.7
51720,2020-12-01,1672,1583,89,5.3
51730,2020-12-01,13278,11700,1578,11.9
51735,2020-12-01,6169,5984,185,3
51740,2020-12-01,44035,40542,3493,7.9
51750,2020-12-01,8231,7849,382,4.6
51760,2020-12-01,116571,108936,7635,6.5
51770,2020-12-01,48017,45307,2710,5.6
51775,2020-12-01,12487,11977,510,4.1
51790,2020-12-01,12413,11895,518,4.2
51800,2020-12-01,43595,41286,2309,5.3
51810,2020-12-01,226000,216261,9739,4.3
51820,2020-12-01,10845,10358,487,4.5
51830,2020-12-01,6486,6130,356,5.5
51840,2020-12-01,14124,13559,565,4
53001,2020-12-01,10458,9797,661,6.3
53003,2020-12-01,9790,9343,447,4.6
53005,2020-12-01,107504,100622,6882,6.4
53007,2020-12-01,44934,41845,3089,6.9
53009,2020-12-01,27817,25469,2348,8.4
53011,2020-12-01,229137,213092,16045,7
53013,2020-12-01,1696,1589,107,6.3
53015,2020-12-01,47317,43656,3661,7.7
53017,2020-12-01,21852,20317,1535,7
53019,2020-12-01,2398,2155,243,10.1
53021,2020-12-01,46272,42827,3445,7.4
53023,2020-12-01,785,725,60,7.6
53025,2020-12-01,49899,45935,3964,7.9
53027,2020-12-01,28003,25179,2824,10.1
53029,2020-12-01,35048,32593,2455,7
53031,2020-12-01,11720,10755,965,8.2
53033,2020-12-01,NA,NA,86588,6.8
53035,2020-12-01,128001,119914,8087,6.3
53037,2020-12-01,19979,18288,1691,8.5
53039,2020-12-01,10136,9448,688,6.8
53041,2020-12-01,34025,31499,2526,7.4
53043,2020-12-01,4492,4228,264,5.9
53045,2020-12-01,24273,22188,2085,8.6
53047,2020-12-01,18873,17363,1510,8
53049,2020-12-01,7642,6821,821,10.7
53051,2020-12-01,4706,4259,447,9.5
53053,2020-12-01,431281,398510,32771,7.6
53055,2020-12-01,7358,6800,558,7.6
53057,2020-12-01,61071,56259,4812,7.9
53059,2020-12-01,5265,4817,448,8.5
53061,2020-12-01,437537,403429,34108,7.8
53063,2020-12-01,240915,223152,17763,7.4
53065,2020-12-01,17589,16144,1445,8.2
53067,2020-12-01,140555,131385,9170,6.5
53069,2020-12-01,1356,1248,108,8
53071,2020-12-01,30101,28155,1946,6.5
53073,2020-12-01,115221,106952,8269,7.2
53075,2020-12-01,21473,20355,1118,5.2
53077,2020-12-01,138639,127657,10982,7.9
54001,2020-12-01,6942,6479,463,6.7
54003,2020-12-01,56702,54283,2419,4.3
54005,2020-12-01,7248,6703,545,7.5
54007,2020-12-01,4604,4201,403,8.8
54009,2020-12-01,9603,8921,682,7.1
54011,2020-12-01,41589,39263,2326,5.6
54013,2020-12-01,2225,1882,343,15.4
54015,2020-12-01,3007,2740,267,8.9
54017,2020-12-01,3812,3628,184,4.8
54019,2020-12-01,15904,14724,1180,7.4
54021,2020-12-01,2359,2149,210,8.9
54023,2020-12-01,5758,5418,340,5.9
54025,2020-12-01,14744,13914,830,5.6
54027,2020-12-01,10450,9972,478,4.6
54029,2020-12-01,12572,11678,894,7.1
54031,2020-12-01,5742,5393,349,6.1
54033,2020-12-01,33843,31932,1911,5.6
54035,2020-12-01,12098,11300,798,6.6
54037,2020-12-01,29854,28658,1196,4
54039,2020-12-01,79871,74898,4973,6.2
54041,2020-12-01,5926,5432,494,8.3
54043,2020-12-01,7179,6646,533,7.4
54045,2020-12-01,9725,8833,892,9.2
54047,2020-12-01,4198,3734,464,11.1
54049,2020-12-01,24931,23435,1496,6
54051,2020-12-01,12887,11957,930,7.2
54053,2020-12-01,9283,8653,630,6.8
54055,2020-12-01,19509,18062,1447,7.4
54057,2020-12-01,11971,11241,730,6.1
54059,2020-12-01,5981,5320,661,11.1
54061,2020-12-01,54590,52195,2395,4.4
54063,2020-12-01,5607,5317,290,5.2
54065,2020-12-01,7797,7456,341,4.4
54067,2020-12-01,8368,7724,644,7.7
54069,2020-12-01,19460,18255,1205,6.2
54071,2020-12-01,3571,3441,130,3.6
54073,2020-12-01,2849,2632,217,7.6
54075,2020-12-01,4006,3770,236,5.9
54077,2020-12-01,15509,14683,826,5.3
54079,2020-12-01,26542,25253,1289,4.9
54081,2020-12-01,29768,27910,1858,6.2
54083,2020-12-01,11733,10932,801,6.8
54085,2020-12-01,4086,3801,285,7
54087,2020-12-01,4688,4191,497,10.6
54089,2020-12-01,3855,3604,251,6.5
54091,2020-12-01,7507,7106,401,5.3
54093,2020-12-01,3164,2969,195,6.2
54095,2020-12-01,2935,2675,260,8.9
54097,2020-12-01,8474,7823,651,7.7
54099,2020-12-01,15702,14759,943,6
54101,2020-12-01,2932,2718,214,7.3
54103,2020-12-01,6279,5744,535,8.5
54105,2020-12-01,2281,2075,206,9
54107,2020-12-01,36415,34145,2270,6.2
54109,2020-12-01,5839,5326,513,8.8
55001,2020-12-01,8226,7449,777,9.4
55003,2020-12-01,7821,7206,615,7.9
55005,2020-12-01,24202,22693,1509,6.2
55007,2020-12-01,7564,6894,670,8.9
55009,2020-12-01,142176,135669,6507,4.6
55011,2020-12-01,6406,6018,388,6.1
55013,2020-12-01,7069,6462,607,8.6
55015,2020-12-01,27113,26097,1016,3.7
55017,2020-12-01,33644,31596,2048,6.1
55019,2020-12-01,17651,16834,817,4.6
55021,2020-12-01,31755,30197,1558,4.9
55023,2020-12-01,7476,6990,486,6.5
55025,2020-12-01,322809,310007,12802,4
55027,2020-12-01,46881,44787,2094,4.5
55029,2020-12-01,14210,13147,1063,7.5
55031,2020-12-01,22471,20973,1498,6.7
55033,2020-12-01,24095,22855,1240,5.1
55035,2020-12-01,59237,56509,2728,4.6
55037,2020-12-01,2243,2074,169,7.5
55039,2020-12-01,59028,56512,2516,4.3
55041,2020-12-01,4109,3745,364,8.9
55043,2020-12-01,27482,26401,1081,3.9
55045,2020-12-01,21039,20177,862,4.1
55047,2020-12-01,9227,8677,550,6
55049,2020-12-01,13793,13171,622,4.5
55051,2020-12-01,2602,2341,261,10
55053,2020-12-01,10341,9567,774,7.5
55055,2020-12-01,45681,43552,2129,4.7
55057,2020-12-01,13581,12724,857,6.3
55059,2020-12-01,87713,82608,5105,5.8
55061,2020-12-01,10969,10538,431,3.9
55063,2020-12-01,66435,63563,2872,4.3
55065,2020-12-01,10029,9683,346,3.4
55067,2020-12-01,9261,8709,552,6
55069,2020-12-01,15046,14247,799,5.3
55071,2020-12-01,40754,38762,1992,4.9
55073,2020-12-01,73628,70619,3009,4.1
55075,2020-12-01,19324,18080,1244,6.4
55077,2020-12-01,7790,7282,508,6.5
55078,2020-12-01,1630,1449,181,11.1
55079,2020-12-01,467167,433773,33394,7.1
55081,2020-12-01,23482,22349,1133,4.8
55083,2020-12-01,20702,19606,1096,5.3
55085,2020-12-01,17320,16065,1255,7.2
55087,2020-12-01,101825,97416,4409,4.3
55089,2020-12-01,48308,46260,2048,4.2
55091,2020-12-01,4062,3845,217,5.3
55093,2020-12-01,24803,23519,1284,5.2
55095,2020-12-01,24677,22882,1795,7.3
55097,2020-12-01,38353,36504,1849,4.8
55099,2020-12-01,6430,6057,373,5.8
55101,2020-12-01,101015,94829,6186,6.1
55103,2020-12-01,9123,8707,416,4.6
55105,2020-12-01,84075,79527,4548,5.4
55107,2020-12-01,6684,6239,445,6.7
55109,2020-12-01,49531,46801,2730,5.5
55111,2020-12-01,35562,33570,1992,5.6
55113,2020-12-01,7835,7196,639,8.2
55115,2020-12-01,20861,19808,1053,5
55117,2020-12-01,61141,58565,2576,4.2
55119,2020-12-01,10994,10355,639,5.8
55121,2020-12-01,15911,15017,894,5.6
55123,2020-12-01,15217,14512,705,4.6
55125,2020-12-01,9884,9132,752,7.6
55127,2020-12-01,56944,54097,2847,5
55129,2020-12-01,7836,7340,496,6.3
55131,2020-12-01,75787,72546,3241,4.3
55133,2020-12-01,221180,211328,9852,4.5
55135,2020-12-01,25680,24385,1295,5
55137,2020-12-01,11376,10741,635,5.6
55139,2020-12-01,92440,88479,3961,4.3
55141,2020-12-01,35422,33236,2186,6.2
56001,2020-12-01,21722,21072,650,3
56003,2020-12-01,5253,5037,216,4.1
56005,2020-12-01,23455,22228,1227,5.2
56007,2020-12-01,7726,7409,317,4.1
56009,2020-12-01,9054,8643,411,4.5
56011,2020-12-01,3690,3574,116,3.1
56013,2020-12-01,18969,18052,917,4.8
56015,2020-12-01,6523,6283,240,3.7
56017,2020-12-01,2198,2112,86,3.9
56019,2020-12-01,4091,3918,173,4.2
56021,2020-12-01,48588,46596,1992,4.1
56023,2020-12-01,8806,8464,342,3.9
56025,2020-12-01,39317,36748,2569,6.5
56027,2020-12-01,1233,1191,42,3.4
56029,2020-12-01,14859,14194,665,4.5
56031,2020-12-01,4737,4544,193,4.1
56033,2020-12-01,15857,15198,659,4.2
56035,2020-12-01,4004,3774,230,5.7
56037,2020-12-01,21104,19880,1224,5.8
56039,2020-12-01,13891,13353,538,3.9
56041,2020-12-01,8941,8498,443,5
56043,2020-12-01,3847,3685,162,4.2
56045,2020-12-01,3810,3695,115,3
72001,2020-12-01,3977,3351,626,15.7
72003,2020-12-01,11008,9819,1189,10.8
72005,2020-12-01,13574,11947,1627,12
72007,2020-12-01,6045,5345,700,11.6
72009,2020-12-01,5886,5229,657,11.2
72011,2020-12-01,8170,7379,791,9.7
72013,2020-12-01,23210,20794,2416,10.4
72015,2020-12-01,4238,3708,530,12.5
72017,2020-12-01,5364,4704,660,12.3
72019,2020-12-01,6705,5923,782,11.7
72021,2020-12-01,61584,55140,6444,10.5
72023,2020-12-01,12891,11615,1276,9.9
72025,2020-12-01,44287,40007,4280,9.7
72027,2020-12-01,9168,8325,843,9.2
72029,2020-12-01,15035,13475,1560,10.4
72031,2020-12-01,57962,51983,5979,10.3
72033,2020-12-01,7407,6560,847,11.4
72035,2020-12-01,14765,13509,1256,8.5
72037,2020-12-01,3407,3018,389,11.4
72039,2020-12-01,3505,2971,534,15.2
72041,2020-12-01,14063,13003,1060,7.5
72043,2020-12-01,9116,8005,1111,12.2
72045,2020-12-01,4581,4004,577,12.6
72047,2020-12-01,8475,7255,1220,14.4
72049,2020-12-01,878,795,83,9.5
72051,2020-12-01,12275,11216,1059,8.6
72053,2020-12-01,10086,8852,1234,12.2
72054,2020-12-01,3063,2645,418,13.6
72055,2020-12-01,3816,3280,536,14
72057,2020-12-01,9896,8912,984,9.9
72059,2020-12-01,4519,3942,577,12.8
72061,2020-12-01,34949,32653,2296,6.6
72063,2020-12-01,16513,15273,1240,7.5
72065,2020-12-01,12724,11437,1287,10.1
72067,2020-12-01,4977,4440,537,10.8
72069,2020-12-01,15805,14169,1636,10.4
72071,2020-12-01,10843,9723,1120,10.3
72073,2020-12-01,3956,3448,508,12.8
72075,2020-12-01,14563,13180,1383,9.5
72077,2020-12-01,11365,10069,1296,11.4
72079,2020-12-01,4937,4278,659,13.3
72081,2020-12-01,6483,5625,858,13.2
72083,2020-12-01,2458,2170,288,11.7
72085,2020-12-01,10334,9243,1091,10.6
72087,2020-12-01,7928,6969,959,12.1
72089,2020-12-01,5782,5056,726,12.6
72091,2020-12-01,10758,9658,1100,10.2
72093,2020-12-01,1721,1538,183,10.6
72095,2020-12-01,2566,2244,322,12.5
72097,2020-12-01,19911,17761,2150,10.8
72099,2020-12-01,9656,8556,1100,11.4
72101,2020-12-01,7436,6481,955,12.8
72103,2020-12-01,7420,6707,713,9.6
72105,2020-12-01,6730,5749,981,14.6
72107,2020-12-01,4609,3925,684,14.8
72109,2020-12-01,3875,3334,541,14
72111,2020-12-01,5401,4692,709,13.1
72113,2020-12-01,42734,38331,4403,10.3
72115,2020-12-01,5856,5148,708,12.1
72117,2020-12-01,4285,3751,534,12.5
72119,2020-12-01,15934,14068,1866,11.7
72121,2020-12-01,5621,4980,641,11.4
72123,2020-12-01,6436,5573,863,13.4
72125,2020-12-01,9115,8078,1037,11.4
72127,2020-12-01,127052,114959,12093,9.5
72129,2020-12-01,10657,9551,1106,10.4
72131,2020-12-01,9461,8187,1274,13.5
72133,2020-12-01,7871,7049,822,10.4
72135,2020-12-01,25162,22929,2233,8.9
72137,2020-12-01,27266,24678,2588,9.5
72139,2020-12-01,25121,23154,1967,7.8
72141,2020-12-01,6044,5387,657,10.9
72143,2020-12-01,9138,7978,1160,12.7
72145,2020-12-01,12389,10695,1694,13.7
72147,2020-12-01,2510,2195,315,12.5
72149,2020-12-01,6754,5799,955,14.1
72151,2020-12-01,7920,6917,1003,12.7
72153,2020-12-01,9284,7939,1345,14.5
01001,2021-01-01,25757,24904,853,3.3
01003,2021-01-01,95885,92512,3373,3.5
01005,2021-01-01,8391,7826,565,6.7
01007,2021-01-01,8622,8270,352,4.1
01009,2021-01-01,24792,24190,602,2.4
01011,2021-01-01,4781,4554,227,4.7
01013,2021-01-01,8821,8232,589,6.7
01015,2021-01-01,46374,44284,2090,4.5
01017,2021-01-01,15904,15163,741,4.7
01019,2021-01-01,11453,11136,317,2.8
01021,2021-01-01,19641,19021,620,3.2
01023,2021-01-01,4566,4342,224,4.9
01025,2021-01-01,7615,7095,520,6.8
01027,2021-01-01,6044,5857,187,3.1
01029,2021-01-01,5628,5475,153,2.7
01031,2021-01-01,21109,20493,616,2.9
01033,2021-01-01,23362,22407,955,4.1
01035,2021-01-01,4393,4160,233,5.3
01037,2021-01-01,4286,4128,158,3.7
01039,2021-01-01,14916,14424,492,3.3
01041,2021-01-01,6028,5804,224,3.7
01043,2021-01-01,38178,37233,945,2.5
01045,2021-01-01,20609,19840,769,3.7
01047,2021-01-01,14147,12912,1235,8.7
01049,2021-01-01,30052,29213,839,2.8
01051,2021-01-01,36537,35350,1187,3.2
01053,2021-01-01,14108,13451,657,4.7
01055,2021-01-01,40101,38264,1837,4.6
01057,2021-01-01,6477,6259,218,3.4
01059,2021-01-01,14198,13829,369,2.6
01061,2021-01-01,10787,10478,309,2.9
01063,2021-01-01,2927,2680,247,8.4
01065,2021-01-01,5938,5509,429,7.2
01067,2021-01-01,6832,6582,250,3.7
01069,2021-01-01,46553,44689,1864,4
01071,2021-01-01,22539,21844,695,3.1
01073,2021-01-01,318691,304351,14340,4.5
01075,2021-01-01,5663,5477,186,3.3
01077,2021-01-01,41726,40342,1384,3.3
01079,2021-01-01,14449,14002,447,3.1
01081,2021-01-01,76610,74164,2446,3.2
01083,2021-01-01,45174,44035,1139,2.5
01085,2021-01-01,3639,3200,439,12.1
01087,2021-01-01,7953,7343,610,7.7
01089,2021-01-01,190168,184420,5748,3
01091,2021-01-01,7645,7259,386,5
01093,2021-01-01,12965,12543,422,3.3
01095,2021-01-01,44081,42908,1173,2.7
01097,2021-01-01,189933,178528,11405,6
01099,2021-01-01,7393,6883,510,6.9
01101,2021-01-01,106922,100178,6744,6.3
01103,2021-01-01,59574,57846,1728,2.9
01105,2021-01-01,3321,3006,315,9.5
01107,2021-01-01,7579,7232,347,4.6
01109,2021-01-01,15495,14918,577,3.7
01111,2021-01-01,9178,8924,254,2.8
01113,2021-01-01,23246,22462,784,3.4
01115,2021-01-01,40337,39147,1190,3
01117,2021-01-01,115236,112621,2615,2.3
01119,2021-01-01,4657,4418,239,5.1
01121,2021-01-01,35750,34142,1608,4.5
01123,2021-01-01,17370,16465,905,5.2
01125,2021-01-01,101494,97147,4347,4.3
01127,2021-01-01,25018,24039,979,3.9
01129,2021-01-01,6551,6196,355,5.4
01131,2021-01-01,2792,2445,347,12.4
01133,2021-01-01,9762,9447,315,3.2
02013,2021-01-01,2944,2876,68,2.3
02016,2021-01-01,4751,4545,206,4.3
02020,2021-01-01,150995,141545,9450,6.3
02050,2021-01-01,6722,5919,803,11.9
02060,2021-01-01,212,182,30,14.2
02068,2021-01-01,581,493,88,15.1
02070,2021-01-01,1497,1370,127,8.5
02090,2021-01-01,44218,41784,2434,5.5
02100,2021-01-01,918,788,130,14.2
02105,2021-01-01,962,844,118,12.3
02110,2021-01-01,16567,15665,902,5.4
02122,2021-01-01,25387,23167,2220,8.7
02130,2021-01-01,6324,5812,512,8.1
02150,2021-01-01,6176,5744,432,7
02158,2021-01-01,2125,1695,430,20.2
02164,2021-01-01,510,455,55,10.8
02170,2021-01-01,48616,45184,3432,7.1
02180,2021-01-01,4087,3768,319,7.8
02185,2021-01-01,3011,2825,186,6.2
02188,2021-01-01,3147,2839,308,9.8
02195,2021-01-01,1386,1263,123,8.9
02198,2021-01-01,2658,2432,226,8.5
02220,2021-01-01,3997,3726,271,6.8
02230,2021-01-01,547,435,112,20.5
02240,2021-01-01,3005,2791,214,7.1
02261,2021-01-01,3962,3600,362,9.1
02275,2021-01-01,980,906,74,7.6
02282,2021-01-01,253,230,23,9.1
02290,2021-01-01,2328,2108,220,9.5
04001,2021-01-01,19885,17585,2300,11.6
04003,2021-01-01,51649,48636,3013,5.8
04005,2021-01-01,73845,67415,6430,8.7
04007,2021-01-01,20782,19339,1443,6.9
04009,2021-01-01,16151,15171,980,6.1
04011,2021-01-01,4455,4197,258,5.8
04012,2021-01-01,9171,8620,551,6
04013,2021-01-01,NA,NA,152479,6.5
04015,2021-01-01,87086,80511,6575,7.6
04017,2021-01-01,39602,36049,3553,9
04019,2021-01-01,496225,461244,34981,7
04021,2021-01-01,192575,179808,12767,6.6
04023,2021-01-01,19672,17644,2028,10.3
04025,2021-01-01,107294,100955,6339,5.9
04027,2021-01-01,94419,83921,10498,11.1
05001,2021-01-01,9372,9015,357,3.8
05003,2021-01-01,7122,6465,657,9.2
05005,2021-01-01,16430,15635,795,4.8
05007,2021-01-01,141136,136083,5053,3.6
05009,2021-01-01,15609,14995,614,3.9
05011,2021-01-01,4376,4137,239,5.5
05013,2021-01-01,2436,2324,112,4.6
05015,2021-01-01,12270,11610,660,5.4
05017,2021-01-01,3240,2880,360,11.1
05019,2021-01-01,9217,8732,485,5.3
05021,2021-01-01,5465,5173,292,5.3
05023,2021-01-01,8969,8395,574,6.4
05025,2021-01-01,3205,3034,171,5.3
05027,2021-01-01,9113,8457,656,7.2
05029,2021-01-01,8422,7995,427,5.1
05031,2021-01-01,55555,53223,2332,4.2
05033,2021-01-01,26424,25241,1183,4.5
05035,2021-01-01,20976,19591,1385,6.6
05037,2021-01-01,7193,6789,404,5.6
05039,2021-01-01,2874,2748,126,4.4
05041,2021-01-01,5223,4877,346,6.6
05043,2021-01-01,7739,7242,497,6.4
05045,2021-01-01,61353,58606,2747,4.5
05047,2021-01-01,7444,7108,336,4.5
05049,2021-01-01,4873,4624,249,5.1
05051,2021-01-01,41156,38457,2699,6.6
05053,2021-01-01,8188,7846,342,4.2
05055,2021-01-01,19118,18238,880,4.6
05057,2021-01-01,9435,9043,392,4.2
05059,2021-01-01,14139,13462,677,4.8
05061,2021-01-01,5537,5312,225,4.1
05063,2021-01-01,16617,15792,825,5
05065,2021-01-01,4436,4112,324,7.3
05067,2021-01-01,5890,5496,394,6.7
05069,2021-01-01,27502,25372,2130,7.7
05071,2021-01-01,10211,9644,567,5.6
05073,2021-01-01,2434,2244,190,7.8
05075,2021-01-01,6821,6467,354,5.2
05077,2021-01-01,2791,2600,191,6.8
05079,2021-01-01,3841,3637,204,5.3
05081,2021-01-01,5389,5074,315,5.8
05083,2021-01-01,8668,8231,437,5
05085,2021-01-01,33339,31883,1456,4.4
05087,2021-01-01,7542,7261,281,3.7
05089,2021-01-01,6025,5666,359,6
05091,2021-01-01,19311,18166,1145,5.9
05093,2021-01-01,16799,15444,1355,8.1
05095,2021-01-01,2740,2558,182,6.6
05097,2021-01-01,2964,2788,176,5.9
05099,2021-01-01,3475,3316,159,4.6
05101,2021-01-01,3230,3099,131,4.1
05103,2021-01-01,9763,9299,464,4.8
05105,2021-01-01,4184,3977,207,4.9
05107,2021-01-01,6443,5879,564,8.8
05109,2021-01-01,4296,4072,224,5.2
05111,2021-01-01,9966,9470,496,5
05113,2021-01-01,7967,7512,455,5.7
05115,2021-01-01,27383,25987,1396,5.1
05117,2021-01-01,3631,3455,176,4.8
05119,2021-01-01,187357,175717,11640,6.2
05121,2021-01-01,7538,7146,392,5.2
05123,2021-01-01,7905,7315,590,7.5
05125,2021-01-01,57826,55501,2325,4
05127,2021-01-01,4393,4207,186,4.2
05129,2021-01-01,2763,2609,154,5.6
05131,2021-01-01,55989,53287,2702,4.8
05133,2021-01-01,5469,5159,310,5.7
05135,2021-01-01,5669,5295,374,6.6
05137,2021-01-01,4543,4217,326,7.2
05139,2021-01-01,15395,14285,1110,7.2
05141,2021-01-01,5743,5356,387,6.7
05143,2021-01-01,127077,122384,4693,3.7
05145,2021-01-01,33896,32087,1809,5.3
05147,2021-01-01,2839,2662,177,6.2
05149,2021-01-01,7973,7576,397,5
06001,2021-01-01,802122,743826,58296,7.3
06003,2021-01-01,624,581,43,6.9
06005,2021-01-01,14325,13139,1186,8.3
06007,2021-01-01,89106,81716,7390,8.3
06009,2021-01-01,21135,19673,1462,6.9
06011,2021-01-01,10212,8615,1597,15.6
06013,2021-01-01,534596,494348,40248,7.5
06015,2021-01-01,9294,8462,832,9
06017,2021-01-01,91135,84804,6331,6.9
06019,2021-01-01,444676,400255,44421,10
06021,2021-01-01,12175,11214,961,7.9
06023,2021-01-01,58693,54380,4313,7.3
06025,2021-01-01,65042,54280,10762,16.5
06027,2021-01-01,8262,7694,568,6.9
06029,2021-01-01,381232,340201,41031,10.8
06031,2021-01-01,55802,49848,5954,10.7
06033,2021-01-01,28596,26068,2528,8.8
06035,2021-01-01,9438,8785,653,6.9
06037,2021-01-01,NA,NA,626370,12.7
06039,2021-01-01,62802,56757,6045,9.6
06041,2021-01-01,129033,122048,6985,5.4
06043,2021-01-01,6760,5944,816,12.1
06045,2021-01-01,36140,33375,2765,7.7
06047,2021-01-01,113874,100842,13032,11.4
06049,2021-01-01,3120,2825,295,9.5
06051,2021-01-01,8567,7803,764,8.9
06053,2021-01-01,202761,180028,22733,11.2
06055,2021-01-01,67504,61695,5809,8.6
06057,2021-01-01,46782,43635,3147,6.7
06059,2021-01-01,NA,NA,111961,7.4
06061,2021-01-01,185569,174486,11083,6
06063,2021-01-01,7075,6236,839,11.9
06065,2021-01-01,NA,NA,95228,8.6
06067,2021-01-01,711206,653275,57931,8.1
06069,2021-01-01,30743,28014,2729,8.9
06071,2021-01-01,969393,885577,83816,8.6
06073,2021-01-01,NA,NA,122263,8.1
06075,2021-01-01,535350,501868,33482,6.3
06077,2021-01-01,330115,297150,32965,10
06079,2021-01-01,131091,122258,8833,6.7
06081,2021-01-01,419962,395990,23972,5.7
06083,2021-01-01,210552,194307,16245,7.7
06085,2021-01-01,NA,947300,57353,5.7
06087,2021-01-01,128542,117537,11005,8.6
06089,2021-01-01,73867,68063,5804,7.9
06091,2021-01-01,1257,1164,93,7.4
06093,2021-01-01,16452,14853,1599,9.7
06095,2021-01-01,201208,183854,17354,8.6
06097,2021-01-01,233999,217342,16657,7.1
06099,2021-01-01,238573,216274,22299,9.3
06101,2021-01-01,43340,38907,4433,10.2
06103,2021-01-01,25214,23187,2027,8
06105,2021-01-01,4396,4056,340,7.7
06107,2021-01-01,194739,172669,22070,11.3
06109,2021-01-01,19753,17962,1791,9.1
06111,2021-01-01,401900,371972,29928,7.4
06113,2021-01-01,105534,98185,7349,7
06115,2021-01-01,29181,26244,2937,10.1
08001,2021-01-01,278529,257038,21491,7.7
08003,2021-01-01,8461,7857,604,7.1
08005,2021-01-01,370563,343973,26590,7.2
08007,2021-01-01,7198,6731,467,6.5
08009,2021-01-01,2278,2213,65,2.9
08011,2021-01-01,1976,1825,151,7.6
08013,2021-01-01,193590,182103,11487,5.9
08014,2021-01-01,40664,38216,2448,6
08015,2021-01-01,9947,9389,558,5.6
08017,2021-01-01,1143,1111,32,2.8
08019,2021-01-01,6172,5732,440,7.1
08021,2021-01-01,4121,3863,258,6.3
08023,2021-01-01,1849,1704,145,7.8
08025,2021-01-01,1566,1463,103,6.6
08027,2021-01-01,2126,2011,115,5.4
08029,2021-01-01,14504,13503,1001,6.9
08031,2021-01-01,428499,395862,32637,7.6
08033,2021-01-01,1138,1075,63,5.5
08035,2021-01-01,197257,186681,10576,5.4
08037,2021-01-01,37667,35627,2040,5.4
08039,2021-01-01,15262,14568,694,4.5
08041,2021-01-01,348918,323717,25201,7.2
08043,2021-01-01,15696,14420,1276,8.1
08045,2021-01-01,33396,31395,2001,6
08047,2021-01-01,3944,3626,318,8.1
08049,2021-01-01,10009,9477,532,5.3
08051,2021-01-01,11606,11058,548,4.7
08053,2021-01-01,384,364,20,5.2
08055,2021-01-01,2735,2466,269,9.8
08057,2021-01-01,915,876,39,4.3
08059,2021-01-01,338060,315644,22416,6.6
08061,2021-01-01,1025,988,37,3.6
08063,2021-01-01,4438,4302,136,3.1
08065,2021-01-01,5146,4864,282,5.5
08067,2021-01-01,32067,29609,2458,7.7
08069,2021-01-01,206895,193886,13009,6.3
08071,2021-01-01,6644,6121,523,7.9
08073,2021-01-01,2462,2333,129,5.2
08075,2021-01-01,11301,10682,619,5.5
08077,2021-01-01,76281,70285,5996,7.9
08079,2021-01-01,548,525,23,4.2
08081,2021-01-01,7547,7090,457,6.1
08083,2021-01-01,12703,11722,981,7.7
08085,2021-01-01,21995,20554,1441,6.6
08087,2021-01-01,16691,15732,959,5.7
08089,2021-01-01,8461,7850,611,7.2
08091,2021-01-01,2497,2336,161,6.4
08093,2021-01-01,11266,10687,579,5.1
08095,2021-01-01,2543,2457,86,3.4
08097,2021-01-01,11422,10677,745,6.5
08099,2021-01-01,6362,5994,368,5.8
08101,2021-01-01,78837,71483,7354,9.3
08103,2021-01-01,3005,2799,206,6.9
08105,2021-01-01,5596,5169,427,7.6
08107,2021-01-01,17367,16485,882,5.1
08109,2021-01-01,3467,3213,254,7.3
08111,2021-01-01,465,439,26,5.6
08113,2021-01-01,5614,5273,341,6.1
08115,2021-01-01,1186,1143,43,3.6
08117,2021-01-01,25286,24030,1256,5
08119,2021-01-01,13038,12195,843,6.5
08121,2021-01-01,3069,2969,100,3.3
08123,2021-01-01,169323,157221,12102,7.1
08125,2021-01-01,5736,5548,188,3.3
09001,2021-01-01,452128,413742,38386,8.5
09003,2021-01-01,463591,423503,40088,8.6
09005,2021-01-01,100099,92122,7977,8
09007,2021-01-01,90219,83706,6513,7.2
09009,2021-01-01,446990,408338,38652,8.6
09011,2021-01-01,126797,114860,11937,9.4
09013,2021-01-01,82601,76887,5714,6.9
09015,2021-01-01,60805,55594,5211,8.6
10001,2021-01-01,80182,74499,5683,7.1
10003,2021-01-01,300981,281973,19008,6.3
10005,2021-01-01,106589,99992,6597,6.2
11001,2021-01-01,407132,374864,32268,7.9
12001,2021-01-01,138072,132098,5974,4.3
12003,2021-01-01,12043,11518,525,4.4
12005,2021-01-01,82988,79224,3764,4.5
12007,2021-01-01,10969,10478,491,4.5
12009,2021-01-01,283296,270510,12786,4.5
12011,2021-01-01,NA,953568,53023,5.3
12013,2021-01-01,4870,4652,218,4.5
12015,2021-01-01,72115,68623,3492,4.8
12017,2021-01-01,46770,43846,2924,6.3
12019,2021-01-01,107253,102964,4289,4
12021,2021-01-01,185870,178585,7285,3.9
12023,2021-01-01,30236,28729,1507,5
12027,2021-01-01,15355,14739,616,4
12029,2021-01-01,6153,5856,297,4.8
12031,2021-01-01,489583,466446,23137,4.7
12033,2021-01-01,147019,139657,7362,5
12035,2021-01-01,46743,44348,2395,5.1
12037,2021-01-01,4797,4593,204,4.3
12039,2021-01-01,18858,17712,1146,6.1
12041,2021-01-01,7238,6896,342,4.7
12043,2021-01-01,5473,5231,242,4.4
12045,2021-01-01,5041,4816,225,4.5
12047,2021-01-01,4186,3905,281,6.7
12049,2021-01-01,8950,8481,469,5.2
12051,2021-01-01,16628,15729,899,5.4
12053,2021-01-01,72075,68025,4050,5.6
12055,2021-01-01,35389,33162,2227,6.3
12057,2021-01-01,761099,726131,34968,4.6
12059,2021-01-01,6948,6622,326,4.7
12061,2021-01-01,64843,61595,3248,5
12063,2021-01-01,17582,16713,869,4.9
12065,2021-01-01,5478,5195,283,5.2
12067,2021-01-01,2876,2741,135,4.7
12069,2021-01-01,147696,139767,7929,5.4
12071,2021-01-01,347082,331026,16056,4.6
12073,2021-01-01,153143,145732,7411,4.8
12075,2021-01-01,17041,16243,798,4.7
12077,2021-01-01,2649,2523,126,4.8
12079,2021-01-01,7783,7372,411,5.3
12081,2021-01-01,179288,171382,7906,4.4
12083,2021-01-01,141221,133750,7471,5.3
12085,2021-01-01,73002,70050,2952,4
12086,2021-01-01,NA,NA,104856,8.1
12087,2021-01-01,45468,43882,1586,3.5
12089,2021-01-01,41861,40185,1676,4
12091,2021-01-01,96969,93145,3824,3.9
12093,2021-01-01,17641,16862,779,4.4
12095,2021-01-01,696216,655018,41198,5.9
12097,2021-01-01,171547,159605,11942,7
12099,2021-01-01,725005,690486,34519,4.8
12101,2021-01-01,240170,228437,11733,4.9
12103,2021-01-01,486703,465434,21269,4.4
12105,2021-01-01,317417,299422,17995,5.7
12107,2021-01-01,26961,25183,1778,6.6
12109,2021-01-01,135470,130684,4786,3.5
12111,2021-01-01,145671,138065,7606,5.2
12113,2021-01-01,84218,80931,3287,3.9
12115,2021-01-01,186995,178915,8080,4.3
12117,2021-01-01,230522,219570,10952,4.8
12119,2021-01-01,32032,30116,1916,6
12121,2021-01-01,17854,16991,863,4.8
12123,2021-01-01,8136,7692,444,5.5
12125,2021-01-01,4586,4389,197,4.3
12127,2021-01-01,250485,237674,12811,5.1
12129,2021-01-01,15176,14613,563,3.7
12131,2021-01-01,32333,30989,1344,4.2
12133,2021-01-01,9545,9094,451,4.7
13001,2021-01-01,9550,9159,391,4.1
13003,2021-01-01,4767,4616,151,3.2
13005,2021-01-01,4795,4600,195,4.1
13007,2021-01-01,1222,1156,66,5.4
13009,2021-01-01,17684,16581,1103,6.2
13011,2021-01-01,10211,9905,306,3
13013,2021-01-01,40350,38883,1467,3.6
13015,2021-01-01,50078,47680,2398,4.8
13017,2021-01-01,5508,5116,392,7.1
13019,2021-01-01,7735,7399,336,4.3
13021,2021-01-01,68123,63645,4478,6.6
13023,2021-01-01,4562,4294,268,5.9
13025,2021-01-01,7203,6889,314,4.4
13027,2021-01-01,7241,6914,327,4.5
13029,2021-01-01,19053,18363,690,3.6
13031,2021-01-01,37758,35777,1981,5.2
13033,2021-01-01,9299,8701,598,6.4
13035,2021-01-01,10891,10311,580,5.3
13037,2021-01-01,2431,2324,107,4.4
13039,2021-01-01,21518,20749,769,3.6
13043,2021-01-01,5809,5577,232,4
13045,2021-01-01,54826,52151,2675,4.9
13047,2021-01-01,32748,31788,960,2.9
13049,2021-01-01,4989,4828,161,3.2
13051,2021-01-01,142496,134409,8087,5.7
13053,2021-01-01,2013,1908,105,5.2
13055,2021-01-01,9772,9124,648,6.6
13057,2021-01-01,133487,129096,4391,3.3
13059,2021-01-01,58461,55585,2876,4.9
13061,2021-01-01,929,822,107,11.5
13063,2021-01-01,140119,128014,12105,8.6
13065,2021-01-01,3086,2992,94,3
13067,2021-01-01,415318,397645,17673,4.3
13069,2021-01-01,19311,18308,1003,5.2
13071,2021-01-01,22970,22095,875,3.8
13073,2021-01-01,75423,73121,2302,3.1
13075,2021-01-01,8360,8016,344,4.1
13077,2021-01-01,74031,70881,3150,4.3
13079,2021-01-01,5623,5369,254,4.5
13081,2021-01-01,9750,9015,735,7.5
13083,2021-01-01,7928,7678,250,3.2
13085,2021-01-01,12413,12004,409,3.3
13087,2021-01-01,11686,11197,489,4.2
13089,2021-01-01,395535,371395,24140,6.1
13091,2021-01-01,6998,6639,359,5.1
13093,2021-01-01,5042,4717,325,6.4
13095,2021-01-01,37560,34577,2983,7.9
13097,2021-01-01,72347,68255,4092,5.7
13099,2021-01-01,4587,4323,264,5.8
13101,2021-01-01,2042,1982,60,2.9
13103,2021-01-01,32112,30899,1213,3.8
13105,2021-01-01,8030,7565,465,5.8
13107,2021-01-01,8806,8215,591,6.7
13109,2021-01-01,5177,4945,232,4.5
13111,2021-01-01,11247,10869,378,3.4
13113,2021-01-01,56539,54484,2055,3.6
13115,2021-01-01,44274,42186,2088,4.7
13117,2021-01-01,121476,117807,3669,3
13119,2021-01-01,10094,9661,433,4.3
13121,2021-01-01,557275,523095,34180,6.1
13123,2021-01-01,12058,11629,429,3.6
13125,2021-01-01,1272,1237,35,2.8
13127,2021-01-01,38538,36675,1863,4.8
13129,2021-01-01,28998,27788,1210,4.2
13131,2021-01-01,11069,10667,402,3.6
13133,2021-01-01,7085,6733,352,5
13135,2021-01-01,481409,459811,21598,4.5
13137,2021-01-01,18663,17811,852,4.6
13139,2021-01-01,103248,99831,3417,3.3
13141,2021-01-01,2625,2413,212,8.1
13143,2021-01-01,12301,11757,544,4.4
13145,2021-01-01,16578,16017,561,3.4
13147,2021-01-01,11682,11151,531,4.5
13149,2021-01-01,5177,4920,257,5
13151,2021-01-01,115517,109087,6430,5.6
13153,2021-01-01,71236,68217,3019,4.2
13155,2021-01-01,3617,3441,176,4.9
13157,2021-01-01,41427,40187,1240,3
13159,2021-01-01,6892,6594,298,4.3
13161,2021-01-01,6280,5983,297,4.7
13163,2021-01-01,6813,6402,411,6
13165,2021-01-01,3282,3097,185,5.6
13167,2021-01-01,4204,4025,179,4.3
13169,2021-01-01,13560,13057,503,3.7
13171,2021-01-01,8049,7622,427,5.3
13173,2021-01-01,3836,3669,167,4.4
13175,2021-01-01,20026,18966,1060,5.3
13177,2021-01-01,14686,14141,545,3.7
13179,2021-01-01,26018,24680,1338,5.1
13181,2021-01-01,3629,3454,175,4.8
13183,2021-01-01,8337,8052,285,3.4
13185,2021-01-01,52917,50215,2702,5.1
13187,2021-01-01,16434,15859,575,3.5
13189,2021-01-01,8821,8241,580,6.6
13191,2021-01-01,6138,5871,267,4.3
13193,2021-01-01,4826,4505,321,6.7
13195,2021-01-01,13065,12566,499,3.8
13197,2021-01-01,3227,3084,143,4.4
13199,2021-01-01,8903,8275,628,7.1
13201,2021-01-01,2889,2785,104,3.6
13205,2021-01-01,8530,8018,512,6
13207,2021-01-01,12878,12351,527,4.1
13209,2021-01-01,4036,3840,196,4.9
13211,2021-01-01,9310,8919,391,4.2
13213,2021-01-01,15661,14742,919,5.9
13215,2021-01-01,77015,71989,5026,6.5
13217,2021-01-01,52202,49273,2929,5.6
13219,2021-01-01,19391,18882,509,2.6
13221,2021-01-01,6926,6677,249,3.6
13223,2021-01-01,85798,82458,3340,3.9
13225,2021-01-01,12151,11442,709,5.8
13227,2021-01-01,15036,14502,534,3.6
13229,2021-01-01,8728,8409,319,3.7
13231,2021-01-01,8779,8468,311,3.5
13233,2021-01-01,18562,17695,867,4.7
13235,2021-01-01,4103,3930,173,4.2
13237,2021-01-01,8258,7815,443,5.4
13239,2021-01-01,805,758,47,5.8
13241,2021-01-01,7093,6797,296,4.2
13243,2021-01-01,2542,2399,143,5.6
13245,2021-01-01,86210,80714,5496,6.4
13247,2021-01-01,44121,41478,2643,6
13249,2021-01-01,2183,2086,97,4.4
13251,2021-01-01,5186,4819,367,7.1
13253,2021-01-01,3171,3036,135,4.3
13255,2021-01-01,28601,26730,1871,6.5
13257,2021-01-01,10439,9909,530,5.1
13259,2021-01-01,2590,2464,126,4.9
13261,2021-01-01,12757,11834,923,7.2
13263,2021-01-01,2782,2617,165,5.9
13265,2021-01-01,537,501,36,6.7
13267,2021-01-01,9955,9567,388,3.9
13269,2021-01-01,2772,2591,181,6.5
13271,2021-01-01,3874,3527,347,9
13273,2021-01-01,3536,3266,270,7.6
13275,2021-01-01,17103,16184,919,5.4
13277,2021-01-01,21352,20441,911,4.3
13279,2021-01-01,12448,11757,691,5.6
13281,2021-01-01,3729,3545,184,4.9
13283,2021-01-01,2830,2694,136,4.8
13285,2021-01-01,37993,35787,2206,5.8
13287,2021-01-01,3426,3179,247,7.2
13289,2021-01-01,2827,2650,177,6.3
13291,2021-01-01,10623,10279,344,3.2
13293,2021-01-01,11469,10857,612,5.3
13295,2021-01-01,30847,29737,1110,3.6
13297,2021-01-01,45180,43397,1783,3.9
13299,2021-01-01,15645,14929,716,4.6
13301,2021-01-01,2737,2563,174,6.4
13303,2021-01-01,6948,6532,416,6
13305,2021-01-01,11780,11222,558,4.7
13307,2021-01-01,1040,981,59,5.7
13309,2021-01-01,1671,1562,109,6.5
13311,2021-01-01,16393,15837,556,3.4
13313,2021-01-01,43953,41550,2403,5.5
13315,2021-01-01,2868,2714,154,5.4
13317,2021-01-01,3791,3556,235,6.2
13319,2021-01-01,3881,3678,203,5.2
13321,2021-01-01,8952,8509,443,4.9
15001,2021-01-01,89285,80780,8505,9.5
15003,2021-01-01,450070,410622,39448,8.8
15007,2021-01-01,33696,28822,4874,14.5
15009,2021-01-01,81563,70336,11227,13.8
16001,2021-01-01,259959,249818,10141,3.9
16003,2021-01-01,1718,1580,138,8
16005,2021-01-01,43055,41257,1798,4.2
16007,2021-01-01,3078,2960,118,3.8
16009,2021-01-01,4137,3875,262,6.3
16011,2021-01-01,23521,22646,875,3.7
16013,2021-01-01,12887,12355,532,4.1
16015,2021-01-01,3634,3398,236,6.5
16017,2021-01-01,21665,20349,1316,6.1
16019,2021-01-01,59578,57502,2076,3.5
16021,2021-01-01,5436,5116,320,5.9
16023,2021-01-01,1406,1347,59,4.2
16025,2021-01-01,685,655,30,4.4
16027,2021-01-01,106514,101223,5291,5
16029,2021-01-01,4075,3913,162,4
16031,2021-01-01,12325,11907,418,3.4
16033,2021-01-01,355,342,13,3.7
16035,2021-01-01,2996,2784,212,7.1
16037,2021-01-01,2072,1926,146,7
16039,2021-01-01,12048,11521,527,4.4
16041,2021-01-01,7005,6784,221,3.2
16043,2021-01-01,8008,7707,301,3.8
16045,2021-01-01,8450,8006,444,5.3
16047,2021-01-01,8325,7981,344,4.1
16049,2021-01-01,6670,6267,403,6
16051,2021-01-01,14323,13847,476,3.3
16053,2021-01-01,12186,11680,506,4.2
16055,2021-01-01,81438,76874,4564,5.6
16057,2021-01-01,19767,18972,795,4
16059,2021-01-01,3545,3314,231,6.5
16061,2021-01-01,1605,1491,114,7.1
16063,2021-01-01,2749,2583,166,6
16065,2021-01-01,23183,22589,594,2.6
16067,2021-01-01,11588,11122,466,4
16069,2021-01-01,20643,19807,836,4
16071,2021-01-01,2316,2233,83,3.6
16073,2021-01-01,5254,4938,316,6
16075,2021-01-01,11921,11336,585,4.9
16077,2021-01-01,3953,3747,206,5.2
16079,2021-01-01,5718,5284,434,7.6
16081,2021-01-01,6359,6113,246,3.9
16083,2021-01-01,41187,39448,1739,4.2
16085,2021-01-01,5859,5499,360,6.1
16087,2021-01-01,4756,4533,223,4.7
17001,2021-01-01,30652,28994,1658,5.4
17003,2021-01-01,1900,1716,184,9.7
17005,2021-01-01,7288,6851,437,6
17007,2021-01-01,24948,21977,2971,11.9
17009,2021-01-01,2915,2823,92,3.2
17011,2021-01-01,15691,14544,1147,7.3
17013,2021-01-01,2165,2025,140,6.5
17015,2021-01-01,6985,6542,443,6.3
17017,2021-01-01,5610,5255,355,6.3
17019,2021-01-01,104959,98264,6695,6.4
17021,2021-01-01,13141,12172,969,7.4
17023,2021-01-01,7081,6589,492,6.9
17025,2021-01-01,5805,5381,424,7.3
17027,2021-01-01,19310,18415,895,4.6
17029,2021-01-01,22897,21397,1500,6.6
17031,2021-01-01,NA,NA,243261,9.8
17033,2021-01-01,8339,7786,553,6.6
17035,2021-01-01,5840,5516,324,5.5
17037,2021-01-01,51473,47562,3911,7.6
17039,2021-01-01,6890,6409,481,7
17041,2021-01-01,9691,9224,467,4.8
17043,2021-01-01,473595,441419,32176,6.8
17045,2021-01-01,8523,8094,429,5
17047,2021-01-01,2601,2441,160,6.2
17049,2021-01-01,19235,18236,999,5.2
17051,2021-01-01,9564,8888,676,7.1
17053,2021-01-01,5885,5511,374,6.4
17055,2021-01-01,15286,14086,1200,7.9
17057,2021-01-01,14025,12895,1130,8.1
17059,2021-01-01,1912,1765,147,7.7
17061,2021-01-01,5731,5373,358,6.2
17063,2021-01-01,23844,21859,1985,8.3
17065,2021-01-01,4083,3861,222,5.4
17067,2021-01-01,7645,7176,469,6.1
17069,2021-01-01,1286,1183,103,8
17071,2021-01-01,3388,3190,198,5.8
17073,2021-01-01,23238,21629,1609,6.9
17075,2021-01-01,12809,11954,855,6.7
17077,2021-01-01,26287,24479,1808,6.9
17079,2021-01-01,4612,4344,268,5.8
17081,2021-01-01,16557,15323,1234,7.5
17083,2021-01-01,10424,9800,624,6
17085,2021-01-01,9941,9265,676,6.8
17087,2021-01-01,4016,3706,310,7.7
17089,2021-01-01,254019,232973,21046,8.3
17091,2021-01-01,52010,47496,4514,8.7
17093,2021-01-01,64824,60202,4622,7.1
17095,2021-01-01,20326,18545,1781,8.8
17097,2021-01-01,357043,329898,27145,7.6
17099,2021-01-01,51680,47266,4414,8.5
17101,2021-01-01,5744,5306,438,7.6
17103,2021-01-01,16847,15790,1057,6.3
17105,2021-01-01,15190,14166,1024,6.7
17107,2021-01-01,11861,11099,762,6.4
17109,2021-01-01,12479,11639,840,6.7
17111,2021-01-01,155068,143597,11471,7.4
17113,2021-01-01,82405,77242,5163,6.3
17115,2021-01-01,46256,41658,4598,9.9
17117,2021-01-01,21687,20345,1342,6.2
17119,2021-01-01,128972,120812,8160,6.3
17121,2021-01-01,16501,15319,1182,7.2
17123,2021-01-01,4931,4529,402,8.2
17125,2021-01-01,5664,5233,431,7.6
17127,2021-01-01,5291,4863,428,8.1
17129,2021-01-01,5915,5555,360,6.1
17131,2021-01-01,7436,6891,545,7.3
17133,2021-01-01,18016,17267,749,4.2
17135,2021-01-01,11004,10173,831,7.6
17137,2021-01-01,15437,14387,1050,6.8
17139,2021-01-01,7178,6821,357,5
17141,2021-01-01,23505,21621,1884,8
17143,2021-01-01,81004,73267,7737,9.6
17145,2021-01-01,7763,7234,529,6.8
17147,2021-01-01,8105,7653,452,5.6
17149,2021-01-01,6381,6029,352,5.5
17151,2021-01-01,1628,1518,110,6.8
17153,2021-01-01,1734,1532,202,11.6
17155,2021-01-01,2905,2697,208,7.2
17157,2021-01-01,13435,12677,758,5.6
17159,2021-01-01,7104,6718,386,5.4
17161,2021-01-01,67015,61792,5223,7.8
17163,2021-01-01,122858,113474,9384,7.6
17165,2021-01-01,9205,8467,738,8
17167,2021-01-01,94360,87083,7277,7.7
17169,2021-01-01,2967,2796,171,5.8
17171,2021-01-01,2276,2101,175,7.7
17173,2021-01-01,9882,9320,562,5.7
17175,2021-01-01,2275,2096,179,7.9
17177,2021-01-01,20374,18832,1542,7.6
17179,2021-01-01,59642,55469,4173,7
17181,2021-01-01,6887,6364,523,7.6
17183,2021-01-01,31971,29423,2548,8
17185,2021-01-01,5435,5117,318,5.9
17187,2021-01-01,7725,7255,470,6.1
17189,2021-01-01,9522,9138,384,4
17191,2021-01-01,6363,5986,377,5.9
17193,2021-01-01,5870,5531,339,5.8
17195,2021-01-01,27095,25334,1761,6.5
17197,2021-01-01,337156,308660,28496,8.5
17199,2021-01-01,30173,28087,2086,6.9
17201,2021-01-01,131079,116671,14408,11
17203,2021-01-01,17408,16424,984,5.7
18001,2021-01-01,17040,16583,457,2.7
18003,2021-01-01,187871,179170,8701,4.6
18005,2021-01-01,43903,42262,1641,3.7
18007,2021-01-01,4373,4204,169,3.9
18009,2021-01-01,4841,4617,224,4.6
18011,2021-01-01,36329,35320,1009,2.8
18013,2021-01-01,7699,7338,361,4.7
18015,2021-01-01,9759,9404,355,3.6
18017,2021-01-01,17500,16727,773,4.4
18019,2021-01-01,61125,58513,2612,4.3
18021,2021-01-01,11552,10937,615,5.3
18023,2021-01-01,17116,16470,646,3.8
18025,2021-01-01,4903,4639,264,5.4
18027,2021-01-01,16945,16449,496,2.9
18029,2021-01-01,25123,24062,1061,4.2
18031,2021-01-01,15099,14534,565,3.7
18033,2021-01-01,22214,21451,763,3.4
18035,2021-01-01,53176,50516,2660,5
18037,2021-01-01,22891,22056,835,3.6
18039,2021-01-01,114053,110043,4010,3.5
18041,2021-01-01,8366,7883,483,5.8
18043,2021-01-01,41207,39637,1570,3.8
18045,2021-01-01,7785,7481,304,3.9
18047,2021-01-01,11369,10962,407,3.6
18049,2021-01-01,9605,9147,458,4.8
18051,2021-01-01,19868,19229,639,3.2
18053,2021-01-01,30671,29251,1420,4.6
18055,2021-01-01,13432,12788,644,4.8
18057,2021-01-01,185804,180478,5326,2.9
18059,2021-01-01,40850,39440,1410,3.5
18061,2021-01-01,19943,19233,710,3.6
18063,2021-01-01,90752,87767,2985,3.3
18065,2021-01-01,21911,20938,973,4.4
18067,2021-01-01,35071,32938,2133,6.1
18069,2021-01-01,18131,17487,644,3.6
18071,2021-01-01,23670,22808,862,3.6
18073,2021-01-01,15556,14832,724,4.7
18075,2021-01-01,8765,8443,322,3.7
18077,2021-01-01,15339,14692,647,4.2
18079,2021-01-01,13708,13017,691,5
18081,2021-01-01,83288,80419,2869,3.4
18083,2021-01-01,18411,17708,703,3.8
18085,2021-01-01,41163,39677,1486,3.6
18087,2021-01-01,19415,18898,517,2.7
18089,2021-01-01,222214,205795,16419,7.4
18091,2021-01-01,47461,44228,3233,6.8
18093,2021-01-01,20516,19545,971,4.7
18095,2021-01-01,59316,56052,3264,5.5
18097,2021-01-01,501585,471756,29829,5.9
18099,2021-01-01,22669,21804,865,3.8
18101,2021-01-01,5576,5387,189,3.4
18103,2021-01-01,14793,14056,737,5
18105,2021-01-01,67340,64626,2714,4
18107,2021-01-01,18579,17912,667,3.6
18109,2021-01-01,36281,34915,1366,3.8
18111,2021-01-01,6620,6303,317,4.8
18113,2021-01-01,22474,21519,955,4.2
18115,2021-01-01,3110,2993,117,3.8
18117,2021-01-01,8591,8086,505,5.9
18119,2021-01-01,8985,8516,469,5.2
18121,2021-01-01,6854,6581,273,4
18123,2021-01-01,9234,8810,424,4.6
18125,2021-01-01,6393,6099,294,4.6
18127,2021-01-01,82878,78712,4166,5
18129,2021-01-01,12845,12417,428,3.3
18131,2021-01-01,6477,6227,250,3.9
18133,2021-01-01,16624,15881,743,4.5
18135,2021-01-01,11123,10632,491,4.4
18137,2021-01-01,13827,13328,499,3.6
18139,2021-01-01,8824,8484,340,3.9
18141,2021-01-01,132469,125080,7389,5.6
18143,2021-01-01,10415,9909,506,4.9
18145,2021-01-01,23120,22214,906,3.9
18147,2021-01-01,10050,9619,431,4.3
18149,2021-01-01,9730,9162,568,5.8
18151,2021-01-01,19966,19255,711,3.6
18153,2021-01-01,7915,7530,385,4.9
18155,2021-01-01,4692,4455,237,5.1
18157,2021-01-01,94664,90683,3981,4.2
18159,2021-01-01,9065,8776,289,3.2
18161,2021-01-01,3455,3342,113,3.3
18163,2021-01-01,90408,86117,4291,4.7
18165,2021-01-01,6602,6247,355,5.4
18167,2021-01-01,45638,43082,2556,5.6
18169,2021-01-01,14412,13867,545,3.8
18171,2021-01-01,4029,3896,133,3.3
18173,2021-01-01,31487,30363,1124,3.6
18175,2021-01-01,13592,13007,585,4.3
18177,2021-01-01,29959,28589,1370,4.6
18179,2021-01-01,14379,13896,483,3.4
18181,2021-01-01,13388,12930,458,3.4
18183,2021-01-01,17546,16942,604,3.4
19001,2021-01-01,4210,4070,140,3.3
19003,2021-01-01,2016,1947,69,3.4
19005,2021-01-01,7098,6656,442,6.2
19007,2021-01-01,5950,5682,268,4.5
19009,2021-01-01,3091,2987,104,3.4
19011,2021-01-01,12695,12070,625,4.9
19013,2021-01-01,64045,60829,3216,5
19015,2021-01-01,14100,13600,500,3.5
19017,2021-01-01,13100,12641,459,3.5
19019,2021-01-01,10915,10445,470,4.3
19021,2021-01-01,11707,11324,383,3.3
19023,2021-01-01,7617,7269,348,4.6
19025,2021-01-01,4120,3958,162,3.9
19027,2021-01-01,10476,10153,323,3.1
19029,2021-01-01,6777,6489,288,4.2
19031,2021-01-01,10236,9771,465,4.5
19033,2021-01-01,22490,21507,983,4.4
19035,2021-01-01,6277,6059,218,3.5
19037,2021-01-01,6269,6008,261,4.2
19039,2021-01-01,4816,4564,252,5.2
19041,2021-01-01,8216,7900,316,3.8
19043,2021-01-01,9616,8927,689,7.2
19045,2021-01-01,21207,20002,1205,5.7
19047,2021-01-01,7991,7501,490,6.1
19049,2021-01-01,48510,47006,1504,3.1
19051,2021-01-01,4107,3953,154,3.7
19053,2021-01-01,4339,4201,138,3.2
19055,2021-01-01,10391,9988,403,3.9
19057,2021-01-01,17849,16731,1118,6.3
19059,2021-01-01,9078,8574,504,5.6
19061,2021-01-01,53312,50622,2690,5
19063,2021-01-01,4901,4673,228,4.7
19065,2021-01-01,10348,9760,588,5.7
19067,2021-01-01,8213,7823,390,4.7
19069,2021-01-01,5606,5382,224,4
19071,2021-01-01,3710,3608,102,2.7
19073,2021-01-01,5347,5180,167,3.1
19075,2021-01-01,6189,5945,244,3.9
19077,2021-01-01,5460,5194,266,4.9
19079,2021-01-01,6692,6405,287,4.3
19081,2021-01-01,5741,5537,204,3.6
19083,2021-01-01,7729,7348,381,4.9
19085,2021-01-01,7080,6779,301,4.3
19087,2021-01-01,9500,9088,412,4.3
19089,2021-01-01,5094,4838,256,5
19091,2021-01-01,4895,4717,178,3.6
19093,2021-01-01,3984,3834,150,3.8
19095,2021-01-01,9817,9404,413,4.2
19097,2021-01-01,10385,9738,647,6.2
19099,2021-01-01,18657,17784,873,4.7
19101,2021-01-01,9340,8928,412,4.4
19103,2021-01-01,80205,77164,3041,3.8
19105,2021-01-01,10126,9571,555,5.5
19107,2021-01-01,5153,4896,257,5
19109,2021-01-01,8054,7789,265,3.3
19111,2021-01-01,15255,14324,931,6.1
19113,2021-01-01,113898,107960,5938,5.2
19115,2021-01-01,5970,5673,297,5
19117,2021-01-01,4718,4555,163,3.5
19119,2021-01-01,6901,6719,182,2.6
19121,2021-01-01,8259,7818,441,5.3
19123,2021-01-01,11604,11144,460,4
19125,2021-01-01,17504,16892,612,3.5
19127,2021-01-01,17293,15873,1420,8.2
19129,2021-01-01,7077,6829,248,3.5
19131,2021-01-01,5940,5749,191,3.2
19133,2021-01-01,4373,4147,226,5.2
19135,2021-01-01,3902,3727,175,4.5
19137,2021-01-01,4841,4646,195,4
19139,2021-01-01,20179,19001,1178,5.8
19141,2021-01-01,8020,7762,258,3.2
19143,2021-01-01,3578,3484,94,2.6
19145,2021-01-01,6154,5911,243,3.9
19147,2021-01-01,4439,4276,163,3.7
19149,2021-01-01,14098,13648,450,3.2
19151,2021-01-01,4107,3967,140,3.4
19153,2021-01-01,257205,244837,12368,4.8
19155,2021-01-01,46209,44086,2123,4.6
19157,2021-01-01,9203,8754,449,4.9
19159,2021-01-01,2420,2339,81,3.3
19161,2021-01-01,5205,5011,194,3.7
19163,2021-01-01,83268,78310,4958,6
19165,2021-01-01,6223,6012,211,3.4
19167,2021-01-01,21103,20489,614,2.9
19169,2021-01-01,54188,52584,1604,3
19171,2021-01-01,9128,8589,539,5.9
19173,2021-01-01,3081,2984,97,3.1
19175,2021-01-01,6106,5782,324,5.3
19177,2021-01-01,3641,3478,163,4.5
19179,2021-01-01,16997,16110,887,5.2
19181,2021-01-01,27053,25924,1129,4.2
19183,2021-01-01,11341,10826,515,4.5
19185,2021-01-01,2838,2720,118,4.2
19187,2021-01-01,18066,17217,849,4.7
19189,2021-01-01,4884,4680,204,4.2
19191,2021-01-01,10862,10251,611,5.6
19193,2021-01-01,52718,50265,2453,4.7
19195,2021-01-01,4022,3834,188,4.7
19197,2021-01-01,6847,6567,280,4.1
20001,2021-01-01,6387,6101,286,4.5
20003,2021-01-01,4295,4162,133,3.1
20005,2021-01-01,6876,6450,426,6.2
20007,2021-01-01,2383,2264,119,5
20009,2021-01-01,13552,12950,602,4.4
20011,2021-01-01,6791,6457,334,4.9
20013,2021-01-01,5268,5050,218,4.1
20015,2021-01-01,32859,30914,1945,5.9
20017,2021-01-01,1433,1368,65,4.5
20019,2021-01-01,1501,1421,80,5.3
20021,2021-01-01,10051,9726,325,3.2
20023,2021-01-01,1360,1330,30,2.2
20025,2021-01-01,1197,1167,30,2.5
20027,2021-01-01,3886,3708,178,4.6
20029,2021-01-01,3990,3785,205,5.1
20031,2021-01-01,3874,3708,166,4.3
20033,2021-01-01,857,824,33,3.9
20035,2021-01-01,16506,15741,765,4.6
20037,2021-01-01,19077,18196,881,4.6
20039,2021-01-01,1248,1194,54,4.3
20041,2021-01-01,8907,8484,423,4.7
20043,2021-01-01,4156,4024,132,3.2
20045,2021-01-01,64703,60742,3961,6.1
20047,2021-01-01,1639,1543,96,5.9
20049,2021-01-01,1174,1133,41,3.5
20051,2021-01-01,17002,16376,626,3.7
20053,2021-01-01,2809,2712,97,3.5
20055,2021-01-01,21391,20525,866,4
20057,2021-01-01,17424,16678,746,4.3
20059,2021-01-01,14553,13772,781,5.4
20061,2021-01-01,11420,10879,541,4.7
20063,2021-01-01,1502,1461,41,2.7
20065,2021-01-01,1072,1022,50,4.7
20067,2021-01-01,3002,2878,124,4.1
20069,2021-01-01,3344,3263,81,2.4
20071,2021-01-01,837,822,15,1.8
20073,2021-01-01,3123,2984,139,4.5
20075,2021-01-01,1674,1642,32,1.9
20077,2021-01-01,2970,2766,204,6.9
20079,2021-01-01,17072,16301,771,4.5
20081,2021-01-01,2289,2245,44,1.9
20083,2021-01-01,1009,983,26,2.6
20085,2021-01-01,7289,6988,301,4.1
20087,2021-01-01,10405,9952,453,4.4
20089,2021-01-01,1264,1229,35,2.8
20091,2021-01-01,352728,335242,17486,5
20093,2021-01-01,2065,2000,65,3.1
20095,2021-01-01,3408,3220,188,5.5
20097,2021-01-01,1270,1224,46,3.6
20099,2021-01-01,9596,9136,460,4.8
20101,2021-01-01,758,730,28,3.7
20103,2021-01-01,37430,35730,1700,4.5
20105,2021-01-01,1828,1751,77,4.2
20107,2021-01-01,4431,4205,226,5.1
20109,2021-01-01,1640,1599,41,2.5
20111,2021-01-01,16920,15968,952,5.6
20113,2021-01-01,17548,16874,674,3.8
20115,2021-01-01,5838,5592,246,4.2
20117,2021-01-01,5606,5354,252,4.5
20119,2021-01-01,2151,2088,63,2.9
20121,2021-01-01,18095,17340,755,4.2
20123,2021-01-01,3572,3403,169,4.7
20125,2021-01-01,14387,13663,724,5
20127,2021-01-01,3165,3049,116,3.7
20129,2021-01-01,1146,1097,49,4.3
20131,2021-01-01,5726,5482,244,4.3
20133,2021-01-01,6347,5964,383,6
20135,2021-01-01,1332,1288,44,3.3
20137,2021-01-01,2671,2573,98,3.7
20139,2021-01-01,8158,7799,359,4.4
20141,2021-01-01,1984,1907,77,3.9
20143,2021-01-01,3015,2899,116,3.8
20145,2021-01-01,2904,2758,146,5
20147,2021-01-01,2693,2599,94,3.5
20149,2021-01-01,11689,11160,529,4.5
20151,2021-01-01,5010,4793,217,4.3
20153,2021-01-01,1586,1540,46,2.9
20155,2021-01-01,29399,27969,1430,4.9
20157,2021-01-01,2286,2202,84,3.7
20159,2021-01-01,5121,4907,214,4.2
20161,2021-01-01,33561,31421,2140,6.4
20163,2021-01-01,2546,2419,127,5
20165,2021-01-01,1546,1489,57,3.7
20167,2021-01-01,3335,3212,123,3.7
20169,2021-01-01,29523,28170,1353,4.6
20171,2021-01-01,2893,2770,123,4.3
20173,2021-01-01,256932,238765,18167,7.1
20175,2021-01-01,10090,9512,578,5.7
20177,2021-01-01,94524,88094,6430,6.8
20179,2021-01-01,1490,1454,36,2.4
20181,2021-01-01,2944,2833,111,3.8
20183,2021-01-01,2050,1997,53,2.6
20185,2021-01-01,2080,2006,74,3.6
20187,2021-01-01,1145,1096,49,4.3
20189,2021-01-01,2855,2768,87,3
20191,2021-01-01,10945,10285,660,6
20193,2021-01-01,4337,4165,172,4
20195,2021-01-01,1490,1437,53,3.6
20197,2021-01-01,3728,3599,129,3.5
20199,2021-01-01,824,801,23,2.8
20201,2021-01-01,3139,3046,93,3
20203,2021-01-01,1244,1211,33,2.7
20205,2021-01-01,3875,3662,213,5.5
20207,2021-01-01,1514,1438,76,5
20209,2021-01-01,79271,74636,4635,5.8
21001,2021-01-01,6752,6382,370,5.5
21003,2021-01-01,8683,8321,362,4.2
21005,2021-01-01,11274,10752,522,4.6
21007,2021-01-01,3238,3064,174,5.4
21009,2021-01-01,17767,16728,1039,5.8
21011,2021-01-01,4466,4174,292,6.5
21013,2021-01-01,8157,7669,488,6
21015,2021-01-01,67956,64960,2996,4.4
21017,2021-01-01,9472,9084,388,4.1
21019,2021-01-01,17120,15947,1173,6.9
21021,2021-01-01,12422,11709,713,5.7
21023,2021-01-01,3698,3483,215,5.8
21025,2021-01-01,3183,2933,250,7.9
21027,2021-01-01,7695,7232,463,6
21029,2021-01-01,41367,38947,2420,5.9
21031,2021-01-01,4907,4659,248,5.1
21033,2021-01-01,5513,5238,275,5
21035,2021-01-01,16857,15973,884,5.2
21037,2021-01-01,48345,46000,2345,4.9
21039,2021-01-01,2119,2026,93,4.4
21041,2021-01-01,5053,4814,239,4.7
21043,2021-01-01,9420,8602,818,8.7
21045,2021-01-01,6634,6320,314,4.7
21047,2021-01-01,24099,22767,1332,5.5
21049,2021-01-01,16529,15705,824,5
21051,2021-01-01,5074,4699,375,7.4
21053,2021-01-01,3972,3809,163,4.1
21055,2021-01-01,3557,3388,169,4.8
21057,2021-01-01,3184,3057,127,4
21059,2021-01-01,44342,42151,2191,4.9
21061,2021-01-01,4487,4237,250,5.6
21063,2021-01-01,1923,1741,182,9.5
21065,2021-01-01,4929,4636,293,5.9
21067,2021-01-01,167397,159988,7409,4.4
21069,2021-01-01,6041,5713,328,5.4
21071,2021-01-01,10279,9507,772,7.5
21073,2021-01-01,23830,22545,1285,5.4
21075,2021-01-01,1929,1833,96,5
21077,2021-01-01,3926,3726,200,5.1
21079,2021-01-01,7336,6985,351,4.8
21081,2021-01-01,11132,10543,589,5.3
21083,2021-01-01,15386,14588,798,5.2
21085,2021-01-01,10401,9751,650,6.2
21087,2021-01-01,4991,4793,198,4
21089,2021-01-01,12948,11970,978,7.6
21091,2021-01-01,3697,3510,187,5.1
21093,2021-01-01,45781,43392,2389,5.2
21095,2021-01-01,6251,5634,617,9.9
21097,2021-01-01,8479,8110,369,4.4
21099,2021-01-01,7544,7179,365,4.8
21101,2021-01-01,20242,19207,1035,5.1
21103,2021-01-01,7972,7615,357,4.5
21105,2021-01-01,1692,1613,79,4.7
21107,2021-01-01,17899,16956,943,5.3
21109,2021-01-01,3873,3599,274,7.1
21111,2021-01-01,381910,360305,21605,5.7
21113,2021-01-01,25548,24384,1164,4.6
21115,2021-01-01,6378,5858,520,8.2
21117,2021-01-01,83616,79447,4169,5
21119,2021-01-01,4289,3961,328,7.6
21121,2021-01-01,9823,9167,656,6.7
21123,2021-01-01,5720,5401,319,5.6
21125,2021-01-01,24399,23182,1217,5
21127,2021-01-01,5011,4634,377,7.5
21129,2021-01-01,1962,1852,110,5.6
21131,2021-01-01,2571,2339,232,9
21133,2021-01-01,5914,5428,486,8.2
21135,2021-01-01,4604,4192,412,8.9
21137,2021-01-01,9241,8643,598,6.5
21139,2021-01-01,3422,3161,261,7.6
21141,2021-01-01,11824,11388,436,3.7
21143,2021-01-01,3023,2866,157,5.2
21145,2021-01-01,27280,25625,1655,6.1
21147,2021-01-01,4828,4540,288,6
21149,2021-01-01,3957,3764,193,4.9
21151,2021-01-01,44238,42212,2026,4.6
21153,2021-01-01,3150,2700,450,14.3
21155,2021-01-01,9072,8637,435,4.8
21157,2021-01-01,14195,13408,787,5.5
21159,2021-01-01,2364,2150,214,9.1
21161,2021-01-01,6833,6416,417,6.1
21163,2021-01-01,11422,10731,691,6
21165,2021-01-01,2212,2015,197,8.9
21167,2021-01-01,9520,9040,480,5
21169,2021-01-01,3962,3732,230,5.8
21171,2021-01-01,4460,4276,184,4.1
21173,2021-01-01,10956,10278,678,6.2
21175,2021-01-01,4237,3945,292,6.9
21177,2021-01-01,9541,8842,699,7.3
21179,2021-01-01,22247,21132,1115,5
21181,2021-01-01,3203,3055,148,4.6
21183,2021-01-01,8942,8367,575,6.4
21185,2021-01-01,31855,30648,1207,3.8
21187,2021-01-01,4953,4721,232,4.7
21189,2021-01-01,1046,969,77,7.4
21191,2021-01-01,6682,6375,307,4.6
21193,2021-01-01,7966,7416,550,6.9
21195,2021-01-01,18480,17189,1291,7
21197,2021-01-01,4887,4616,271,5.5
21199,2021-01-01,25040,23663,1377,5.5
21201,2021-01-01,780,742,38,4.9
21203,2021-01-01,6197,5853,344,5.6
21205,2021-01-01,9188,8652,536,5.8
21207,2021-01-01,5955,5608,347,5.8
21209,2021-01-01,28262,27124,1138,4
21211,2021-01-01,24852,23734,1118,4.5
21213,2021-01-01,8568,8193,375,4.4
21215,2021-01-01,10108,9597,511,5.1
21217,2021-01-01,12393,11893,500,4
21219,2021-01-01,5304,5115,189,3.6
21221,2021-01-01,5985,5656,329,5.5
21223,2021-01-01,3721,3523,198,5.3
21225,2021-01-01,5949,5698,251,4.2
21227,2021-01-01,61480,58692,2788,4.5
21229,2021-01-01,6015,5781,234,3.9
21231,2021-01-01,7340,6952,388,5.3
21233,2021-01-01,5250,4994,256,4.9
21235,2021-01-01,13539,12783,756,5.6
21237,2021-01-01,2047,1911,136,6.6
21239,2021-01-01,14829,14272,557,3.8
22001,2021-01-01,23040,21515,1525,6.6
22003,2021-01-01,8130,7517,613,7.5
22005,2021-01-01,64068,60409,3659,5.7
22007,2021-01-01,8734,7909,825,9.4
22009,2021-01-01,14793,13779,1014,6.9
22011,2021-01-01,13869,13108,761,5.5
22013,2021-01-01,5384,4971,413,7.7
22015,2021-01-01,55380,52416,2964,5.4
22017,2021-01-01,100747,92066,8681,8.6
22019,2021-01-01,91780,84190,7590,8.3
22021,2021-01-01,3610,3391,219,6.1
22023,2021-01-01,3293,3134,159,4.8
22025,2021-01-01,3481,3240,241,6.9
22027,2021-01-01,5667,5321,346,6.1
22029,2021-01-01,6844,6341,503,7.3
22031,2021-01-01,10416,9731,685,6.6
22033,2021-01-01,229744,213292,16452,7.2
22035,2021-01-01,1835,1606,229,12.5
22037,2021-01-01,7786,7313,473,6.1
22039,2021-01-01,11698,10871,827,7.1
22041,2021-01-01,7303,6773,530,7.3
22043,2021-01-01,8120,7691,429,5.3
22045,2021-01-01,27591,24939,2652,9.6
22047,2021-01-01,14123,12762,1361,9.6
22049,2021-01-01,6650,6341,309,4.6
22051,2021-01-01,208519,190672,17847,8.6
22053,2021-01-01,12410,11625,785,6.3
22055,2021-01-01,111104,104085,7019,6.3
22057,2021-01-01,40761,38358,2403,5.9
22059,2021-01-01,6925,6641,284,4.1
22061,2021-01-01,20406,19266,1140,5.6
22063,2021-01-01,67953,64496,3457,5.1
22065,2021-01-01,3565,3286,279,7.8
22067,2021-01-01,10085,9149,936,9.3
22069,2021-01-01,15736,14776,960,6.1
22071,2021-01-01,181091,158592,22499,12.4
22073,2021-01-01,69657,65024,4633,6.7
22075,2021-01-01,9495,8952,543,5.7
22077,2021-01-01,9714,8996,718,7.4
22079,2021-01-01,55043,52157,2886,5.2
22081,2021-01-01,3565,3349,216,6.1
22083,2021-01-01,8001,7467,534,6.7
22085,2021-01-01,9141,8723,418,4.6
22087,2021-01-01,19809,17864,1945,9.8
22089,2021-01-01,24252,22571,1681,6.9
22091,2021-01-01,4376,3846,530,12.1
22093,2021-01-01,9030,8143,887,9.8
22095,2021-01-01,19399,17192,2207,11.4
22097,2021-01-01,32189,29521,2668,8.3
22099,2021-01-01,21689,20018,1671,7.7
22101,2021-01-01,18884,17177,1707,9
22103,2021-01-01,113718,107784,5934,5.2
22105,2021-01-01,56334,51459,4875,8.7
22107,2021-01-01,1330,1231,99,7.4
22109,2021-01-01,45668,42263,3405,7.5
22111,2021-01-01,8972,8409,563,6.3
22113,2021-01-01,23302,21663,1639,7
22115,2021-01-01,15718,14769,949,6
22117,2021-01-01,16649,15370,1279,7.7
22119,2021-01-01,13788,12804,984,7.1
22121,2021-01-01,13559,12655,904,6.7
22123,2021-01-01,3501,3212,289,8.3
22125,2021-01-01,5306,5046,260,4.9
22127,2021-01-01,4611,4319,292,6.3
23001,2021-01-01,54047,50770,3277,6.1
23003,2021-01-01,29207,27199,2008,6.9
23005,2021-01-01,156926,148356,8570,5.5
23007,2021-01-01,14065,13146,919,6.5
23009,2021-01-01,25627,23489,2138,8.3
23011,2021-01-01,60817,57377,3440,5.7
23013,2021-01-01,18758,17574,1184,6.3
23015,2021-01-01,15630,14604,1026,6.6
23017,2021-01-01,26077,24060,2017,7.7
23019,2021-01-01,73585,68977,4608,6.3
23021,2021-01-01,7141,6671,470,6.6
23023,2021-01-01,18850,17887,963,5.1
23025,2021-01-01,21877,20090,1787,8.2
23027,2021-01-01,19442,18149,1293,6.7
23029,2021-01-01,13356,12232,1124,8.4
23031,2021-01-01,109256,101759,7497,6.9
24001,2021-01-01,29627,27412,2215,7.5
24003,2021-01-01,302164,286466,15698,5.2
24005,2021-01-01,434169,406931,27238,6.3
24009,2021-01-01,46778,44542,2236,4.8
24011,2021-01-01,16956,16011,945,5.6
24013,2021-01-01,90799,86734,4065,4.5
24015,2021-01-01,51061,48257,2804,5.5
24017,2021-01-01,82871,77782,5089,6.1
24019,2021-01-01,14793,13733,1060,7.2
24021,2021-01-01,127972,121184,6788,5.3
24023,2021-01-01,14627,13677,950,6.5
24025,2021-01-01,134696,127834,6862,5.1
24027,2021-01-01,179778,171371,8407,4.7
24029,2021-01-01,9664,9004,660,6.8
24031,2021-01-01,527420,496786,30634,5.8
24033,2021-01-01,486249,448210,38039,7.8
24035,2021-01-01,26608,25310,1298,4.9
24037,2021-01-01,56421,53929,2492,4.4
24039,2021-01-01,8575,7840,735,8.6
24041,2021-01-01,17862,16730,1132,6.3
24043,2021-01-01,70412,66167,4245,6
24045,2021-01-01,47846,44354,3492,7.3
24047,2021-01-01,24642,21624,3018,12.2
24510,2021-01-01,274773,251371,23402,8.5
25001,2021-01-01,107016,96177,10839,10.1
25003,2021-01-01,61747,56318,5429,8.8
25005,2021-01-01,297129,271762,25367,8.5
25007,2021-01-01,8347,7400,947,11.3
25009,2021-01-01,420958,386058,34900,8.3
25011,2021-01-01,39612,36911,2701,6.8
25013,2021-01-01,221446,200531,20915,9.4
25015,2021-01-01,86334,80715,5619,6.5
25017,2021-01-01,895320,841027,54293,6.1
25019,2021-01-01,6294,5225,1069,17
25021,2021-01-01,382506,357683,24823,6.5
25023,2021-01-01,279301,257067,22234,8
25025,2021-01-01,448719,414151,34568,7.7
25027,2021-01-01,439034,406055,32979,7.5
26001,2021-01-01,3783,3462,321,8.5
26003,2021-01-01,3037,2690,347,11.4
26005,2021-01-01,60944,57434,3510,5.8
26007,2021-01-01,13159,12258,901,6.8
26009,2021-01-01,9854,8894,960,9.7
26011,2021-01-01,5607,4997,610,10.9
26013,2021-01-01,3120,2822,298,9.6
26015,2021-01-01,30734,28988,1746,5.7
26017,2021-01-01,48689,44897,3792,7.8
26019,2021-01-01,8304,7586,718,8.6
26021,2021-01-01,71064,65936,5128,7.2
26023,2021-01-01,19384,18228,1156,6
26025,2021-01-01,60659,55980,4679,7.7
26027,2021-01-01,23777,22315,1462,6.1
26029,2021-01-01,12211,11211,1000,8.2
26031,2021-01-01,9724,8205,1519,15.6
26033,2021-01-01,15889,14448,1441,9.1
26035,2021-01-01,11614,10457,1157,10
26037,2021-01-01,38763,36890,1873,4.8
26039,2021-01-01,5509,5036,473,8.6
26041,2021-01-01,17098,15793,1305,7.6
26043,2021-01-01,12239,11508,731,6
26045,2021-01-01,54338,51258,3080,5.7
26047,2021-01-01,16486,14899,1587,9.6
26049,2021-01-01,176977,161895,15082,8.5
26051,2021-01-01,9567,8721,846,8.8
26053,2021-01-01,5909,5534,375,6.3
26055,2021-01-01,46924,43522,3402,7.3
26057,2021-01-01,17467,16366,1101,6.3
26059,2021-01-01,19582,18347,1235,6.3
26061,2021-01-01,15700,14764,936,6
26063,2021-01-01,14990,13991,999,6.7
26065,2021-01-01,143200,134632,8568,6
26067,2021-01-01,29978,28325,1653,5.5
26069,2021-01-01,9814,8888,926,9.4
26071,2021-01-01,4878,4497,381,7.8
26073,2021-01-01,32563,30499,2064,6.3
26075,2021-01-01,72341,67269,5072,7
26077,2021-01-01,128732,121176,7556,5.9
26079,2021-01-01,7592,6821,771,10.2
26081,2021-01-01,351198,331219,19979,5.7
26083,2021-01-01,875,797,78,8.9
26085,2021-01-01,3853,3466,387,10
26087,2021-01-01,38437,36170,2267,5.9
26089,2021-01-01,9820,9095,725,7.4
26091,2021-01-01,44519,41645,2874,6.5
26093,2021-01-01,97425,93715,3710,3.8
26095,2021-01-01,2163,1976,187,8.6
26097,2021-01-01,4054,3265,789,19.5
26099,2021-01-01,421965,400485,21480,5.1
26101,2021-01-01,10035,9080,955,9.5
26103,2021-01-01,31977,29830,2147,6.7
26105,2021-01-01,12990,11902,1088,8.4
26107,2021-01-01,17927,16487,1440,8
26109,2021-01-01,10651,10113,538,5.1
26111,2021-01-01,39326,36950,2376,6
26113,2021-01-01,6710,6211,499,7.4
26115,2021-01-01,72275,67500,4775,6.6
26117,2021-01-01,27456,25545,1911,7
26119,2021-01-01,2901,2543,358,12.3
26121,2021-01-01,75359,68647,6712,8.9
26123,2021-01-01,22763,21174,1589,7
26125,2021-01-01,634075,608326,25749,4.1
26127,2021-01-01,11492,10370,1122,9.8
26129,2021-01-01,7912,7056,856,10.8
26131,2021-01-01,2012,1838,174,8.6
26133,2021-01-01,11489,10697,792,6.9
26135,2021-01-01,2797,2499,298,10.7
26137,2021-01-01,11265,10274,991,8.8
26139,2021-01-01,155745,148215,7530,4.8
26141,2021-01-01,4819,4299,520,10.8
26143,2021-01-01,7614,6703,911,12
26145,2021-01-01,84181,77349,6832,8.1
26147,2021-01-01,71024,67106,3918,5.5
26149,2021-01-01,28520,26851,1669,5.9
26151,2021-01-01,19088,17612,1476,7.7
26153,2021-01-01,3213,2885,328,10.2
26155,2021-01-01,31973,29838,2135,6.7
26157,2021-01-01,23308,21520,1788,7.7
26159,2021-01-01,34089,31348,2741,8
26161,2021-01-01,190057,181008,9049,4.8
26163,2021-01-01,765287,714077,51210,6.7
26165,2021-01-01,14604,13495,1109,7.6
27001,2021-01-01,7396,6777,619,8.4
27003,2021-01-01,191246,181721,9525,5
27005,2021-01-01,18184,17061,1123,6.2
27007,2021-01-01,24197,22844,1353,5.6
27009,2021-01-01,21609,20121,1488,6.9
27011,2021-01-01,2399,2240,159,6.6
27013,2021-01-01,39590,37827,1763,4.5
27015,2021-01-01,13726,12993,733,5.3
27017,2021-01-01,17225,16229,996,5.8
27019,2021-01-01,56624,54307,2317,4.1
27021,2021-01-01,12656,11425,1231,9.7
27023,2021-01-01,6574,6252,322,4.9
27025,2021-01-01,29276,27446,1830,6.3
27027,2021-01-01,35845,34394,1451,4
27029,2021-01-01,4391,3948,443,10.1
27031,2021-01-01,2569,2343,226,8.8
27033,2021-01-01,6369,6087,282,4.4
27035,2021-01-01,31171,28892,2279,7.3
27037,2021-01-01,233273,222513,10760,4.6
27039,2021-01-01,11695,11088,607,5.2
27041,2021-01-01,20842,19857,985,4.7
27043,2021-01-01,6708,6284,424,6.3
27045,2021-01-01,11273,10686,587,5.2
27047,2021-01-01,15885,15081,804,5.1
27049,2021-01-01,25842,24513,1329,5.1
27051,2021-01-01,3235,3036,199,6.2
27053,2021-01-01,680573,649588,30985,4.6
27055,2021-01-01,10040,9575,465,4.6
27057,2021-01-01,9318,8628,690,7.4
27059,2021-01-01,20945,19518,1427,6.8
27061,2021-01-01,21354,19913,1441,6.7
27063,2021-01-01,5596,5312,284,5.1
27065,2021-01-01,9110,8216,894,9.8
27067,2021-01-01,23988,22713,1275,5.3
27069,2021-01-01,2306,2213,93,4
27071,2021-01-01,5475,5132,343,6.3
27073,2021-01-01,3374,3198,176,5.2
27075,2021-01-01,4917,4592,325,6.6
27077,2021-01-01,2481,2372,109,4.4
27079,2021-01-01,15919,14675,1244,7.8
27081,2021-01-01,2945,2767,178,6
27083,2021-01-01,13580,12958,622,4.6
27085,2021-01-01,18702,17636,1066,5.7
27087,2021-01-01,2049,1852,197,9.6
27089,2021-01-01,5254,4860,394,7.5
27091,2021-01-01,9584,9140,444,4.6
27093,2021-01-01,12912,12133,779,6
27095,2021-01-01,12739,11557,1182,9.3
27097,2021-01-01,17611,16159,1452,8.2
27099,2021-01-01,20521,19566,955,4.7
27101,2021-01-01,4719,4368,351,7.4
27103,2021-01-01,20375,19522,853,4.2
27105,2021-01-01,11338,10891,447,3.9
27107,2021-01-01,3122,2931,191,6.1
27109,2021-01-01,88183,84484,3699,4.2
27111,2021-01-01,30298,28402,1896,6.3
27113,2021-01-01,8541,8013,528,6.2
27115,2021-01-01,14144,12888,1256,8.9
27117,2021-01-01,4377,4123,254,5.8
27119,2021-01-01,15811,14978,833,5.3
27121,2021-01-01,6285,5957,328,5.2
27123,2021-01-01,278399,264320,14079,5.1
27125,2021-01-01,2188,2045,143,6.5
27127,2021-01-01,7442,7045,397,5.3
27129,2021-01-01,8277,7787,490,5.9
27131,2021-01-01,36199,34467,1732,4.8
27133,2021-01-01,5723,5562,161,2.8
27135,2021-01-01,7641,7310,331,4.3
27137,2021-01-01,98250,92783,5467,5.6
27139,2021-01-01,80867,77233,3634,4.5
27141,2021-01-01,51168,48148,3020,5.9
27143,2021-01-01,8038,7586,452,5.6
27145,2021-01-01,88231,83571,4660,5.3
27147,2021-01-01,19295,18359,936,4.9
27149,2021-01-01,5163,4960,203,3.9
27151,2021-01-01,4628,4332,296,6.4
27153,2021-01-01,13443,12655,788,5.9
27155,2021-01-01,1676,1590,86,5.1
27157,2021-01-01,12015,11396,619,5.2
27159,2021-01-01,5899,5436,463,7.8
27161,2021-01-01,8623,8085,538,6.2
27163,2021-01-01,138516,132556,5960,4.3
27165,2021-01-01,6554,6257,297,4.5
27167,2021-01-01,3286,3142,144,4.4
27169,2021-01-01,27222,26118,1104,4.1
27171,2021-01-01,73586,69855,3731,5.1
27173,2021-01-01,5128,4847,281,5.5
28001,2021-01-01,10428,9352,1076,10.3
28003,2021-01-01,15449,14694,755,4.9
28005,2021-01-01,4517,4169,348,7.7
28007,2021-01-01,6850,6395,455,6.6
28009,2021-01-01,3004,2810,194,6.5
28011,2021-01-01,11421,10494,927,8.1
28013,2021-01-01,5415,5102,313,5.8
28015,2021-01-01,3409,3189,220,6.5
28017,2021-01-01,6891,6402,489,7.1
28019,2021-01-01,3549,3359,190,5.4
28021,2021-01-01,3065,2650,415,13.5
28023,2021-01-01,5847,5454,393,6.7
28025,2021-01-01,7856,7143,713,9.1
28027,2021-01-01,8111,7221,890,11
28029,2021-01-01,10816,10043,773,7.1
28031,2021-01-01,8491,7974,517,6.1
28033,2021-01-01,91054,87041,4013,4.4
28035,2021-01-01,33941,31726,2215,6.5
28037,2021-01-01,2765,2564,201,7.3
28039,2021-01-01,9000,8349,651,7.2
28041,2021-01-01,4369,4033,336,7.7
28043,2021-01-01,9368,8818,550,5.9
28045,2021-01-01,18949,17682,1267,6.7
28047,2021-01-01,87739,82244,5495,6.3
28049,2021-01-01,104277,96719,7558,7.2
28051,2021-01-01,5167,4486,681,13.2
28053,2021-01-01,2160,1862,298,13.8
28055,2021-01-01,329,291,38,11.6
28057,2021-01-01,10362,9886,476,4.6
28059,2021-01-01,58979,55047,3932,6.7
28061,2021-01-01,5985,5522,463,7.7
28063,2021-01-01,1974,1639,335,17
28065,2021-01-01,4019,3665,354,8.8
28067,2021-01-01,25254,23731,1523,6
28069,2021-01-01,3384,3138,246,7.3
28071,2021-01-01,26258,25066,1192,4.5
28073,2021-01-01,31470,30073,1397,4.4
28075,2021-01-01,29880,28110,1770,5.9
28077,2021-01-01,4687,4332,355,7.6
28079,2021-01-01,7989,7529,460,5.8
28081,2021-01-01,41363,39172,2191,5.3
28083,2021-01-01,9841,8837,1004,10.2
28085,2021-01-01,14607,13771,836,5.7
28087,2021-01-01,25261,23638,1623,6.4
28089,2021-01-01,52347,49957,2390,4.6
28091,2021-01-01,10453,9829,624,6
28093,2021-01-01,14226,13325,901,6.3
28095,2021-01-01,15531,14612,919,5.9
28097,2021-01-01,3919,3633,286,7.3
28099,2021-01-01,10015,9432,583,5.8
28101,2021-01-01,7837,7391,446,5.7
28103,2021-01-01,3931,3547,384,9.8
28105,2021-01-01,22466,21166,1300,5.8
28107,2021-01-01,12659,11607,1052,8.3
28109,2021-01-01,23384,21879,1505,6.4
28111,2021-01-01,4319,4040,279,6.5
28113,2021-01-01,14886,13732,1154,7.8
28115,2021-01-01,14815,14118,697,4.7
28117,2021-01-01,11164,10623,541,4.8
28119,2021-01-01,2314,2081,233,10.1
28121,2021-01-01,74778,71978,2800,3.7
28123,2021-01-01,12997,12374,623,4.8
28125,2021-01-01,1450,1286,164,11.3
28127,2021-01-01,10507,9902,605,5.8
28129,2021-01-01,6686,6386,300,4.5
28131,2021-01-01,7043,6653,390,5.5
28133,2021-01-01,7402,6578,824,11.1
28135,2021-01-01,5098,4747,351,6.9
28137,2021-01-01,12011,11279,732,6.1
28139,2021-01-01,9500,9037,463,4.9
28141,2021-01-01,8265,7878,387,4.7
28143,2021-01-01,4449,3973,476,10.7
28145,2021-01-01,14041,13444,597,4.3
28147,2021-01-01,5012,4619,393,7.8
28149,2021-01-01,19878,18462,1416,7.1
28151,2021-01-01,16013,14414,1599,10
28153,2021-01-01,7333,6773,560,7.6
28155,2021-01-01,3970,3739,231,5.8
28157,2021-01-01,2837,2444,393,13.9
28159,2021-01-01,7112,6615,497,7
28161,2021-01-01,4907,4589,318,6.5
28163,2021-01-01,9787,9010,777,7.9
29001,2021-01-01,10047,9543,504,5
29003,2021-01-01,9725,9352,373,3.8
29005,2021-01-01,2738,2638,100,3.7
29007,2021-01-01,10258,9811,447,4.4
29009,2021-01-01,15727,14763,964,6.1
29011,2021-01-01,5296,5087,209,3.9
29013,2021-01-01,7776,7376,400,5.1
29015,2021-01-01,7316,6791,525,7.2
29017,2021-01-01,5403,5135,268,5
29019,2021-01-01,95630,92019,3611,3.8
29021,2021-01-01,43511,41523,1988,4.6
29023,2021-01-01,18287,17242,1045,5.7
29025,2021-01-01,4321,4117,204,4.7
29027,2021-01-01,21451,20570,881,4.1
29029,2021-01-01,18137,16765,1372,7.6
29031,2021-01-01,40088,38352,1736,4.3
29033,2021-01-01,4793,4539,254,5.3
29035,2021-01-01,2521,2345,176,7
29037,2021-01-01,54529,51967,2562,4.7
29039,2021-01-01,5864,5598,266,4.5
29041,2021-01-01,3875,3704,171,4.4
29043,2021-01-01,45834,43951,1883,4.1
29045,2021-01-01,3155,2990,165,5.2
29047,2021-01-01,136017,129987,6030,4.4
29049,2021-01-01,10589,10078,511,4.8
29051,2021-01-01,39263,37734,1529,3.9
29053,2021-01-01,7153,6819,334,4.7
29055,2021-01-01,10843,10212,631,5.8
29057,2021-01-01,3601,3449,152,4.2
29059,2021-01-01,7126,6761,365,5.1
29061,2021-01-01,4147,3968,179,4.3
29063,2021-01-01,4778,4577,201,4.2
29065,2021-01-01,6442,6123,319,5
29067,2021-01-01,5226,4942,284,5.4
29069,2021-01-01,11667,10844,823,7.1
29071,2021-01-01,52221,49568,2653,5.1
29073,2021-01-01,7509,7153,356,4.7
29075,2021-01-01,3415,3310,105,3.1
29077,2021-01-01,152003,145614,6389,4.2
29079,2021-01-01,4368,4184,184,4.2
29081,2021-01-01,3847,3678,169,4.4
29083,2021-01-01,9760,9257,503,5.2
29085,2021-01-01,3854,3656,198,5.1
29087,2021-01-01,2564,2480,84,3.3
29089,2021-01-01,4893,4695,198,4
29091,2021-01-01,16202,15233,969,6
29093,2021-01-01,3530,3284,246,7
29095,2021-01-01,360667,339354,21313,5.9
29097,2021-01-01,57175,54550,2625,4.6
29099,2021-01-01,116037,110078,5959,5.1
29101,2021-01-01,23079,21951,1128,4.9
29103,2021-01-01,1752,1682,70,4
29105,2021-01-01,16515,15575,940,5.7
29107,2021-01-01,16717,15930,787,4.7
29109,2021-01-01,17651,16644,1007,5.7
29111,2021-01-01,4956,4742,214,4.3
29113,2021-01-01,28432,27014,1418,5
29115,2021-01-01,5222,4841,381,7.3
29117,2021-01-01,7441,7150,291,3.9
29119,2021-01-01,10752,10302,450,4.2
29121,2021-01-01,7532,7170,362,4.8
29123,2021-01-01,5483,5187,296,5.4
29125,2021-01-01,3971,3786,185,4.7
29127,2021-01-01,14180,13574,606,4.3
29129,2021-01-01,1920,1843,77,4
29131,2021-01-01,12239,11533,706,5.8
29133,2021-01-01,5744,5422,322,5.6
29135,2021-01-01,7410,7111,299,4
29137,2021-01-01,3738,3519,219,5.9
29139,2021-01-01,5729,5495,234,4.1
29141,2021-01-01,8292,7730,562,6.8
29143,2021-01-01,8688,8227,461,5.3
29145,2021-01-01,27171,25923,1248,4.6
29147,2021-01-01,10522,10110,412,3.9
29149,2021-01-01,3999,3733,266,6.7
29151,2021-01-01,7120,6891,229,3.2
29153,2021-01-01,3399,3165,234,6.9
29155,2021-01-01,6240,5763,477,7.6
29157,2021-01-01,9873,9473,400,4.1
29159,2021-01-01,20431,19291,1140,5.6
29161,2021-01-01,19993,19066,927,4.6
29163,2021-01-01,7448,7103,345,4.6
29165,2021-01-01,58398,56040,2358,4
29167,2021-01-01,14625,13994,631,4.3
29169,2021-01-01,14570,13781,789,5.4
29171,2021-01-01,2290,2191,99,4.3
29173,2021-01-01,5611,5366,245,4.4
29175,2021-01-01,10109,9571,538,5.3
29177,2021-01-01,10875,10360,515,4.7
29179,2021-01-01,2851,2703,148,5.2
29181,2021-01-01,4943,4610,333,6.7
29183,2021-01-01,222129,213224,8905,4
29185,2021-01-01,3846,3639,207,5.4
29186,2021-01-01,9278,8871,407,4.4
29187,2021-01-01,26254,24715,1539,5.9
29189,2021-01-01,520362,493491,26871,5.2
29195,2021-01-01,10726,10267,459,4.3
29197,2021-01-01,1953,1854,99,5.1
29199,2021-01-01,2427,2346,81,3.3
29201,2021-01-01,19954,18975,979,4.9
29203,2021-01-01,3375,3143,232,6.9
29205,2021-01-01,3090,2938,152,4.9
29207,2021-01-01,13338,12621,717,5.4
29209,2021-01-01,12305,10946,1359,11
29211,2021-01-01,2886,2723,163,5.6
29213,2021-01-01,24019,20974,3045,12.7
29215,2021-01-01,9122,8637,485,5.3
29217,2021-01-01,9626,9228,398,4.1
29219,2021-01-01,18056,17211,845,4.7
29221,2021-01-01,10155,9491,664,6.5
29223,2021-01-01,5054,4757,297,5.9
29225,2021-01-01,17477,16749,728,4.2
29227,2021-01-01,1173,1135,38,3.2
29229,2021-01-01,7341,6952,389,5.3
29510,2021-01-01,150347,139719,10628,7.1
30001,2021-01-01,4993,4795,198,4
30003,2021-01-01,4860,4420,440,9.1
30005,2021-01-01,2243,2126,117,5.2
30007,2021-01-01,2541,2390,151,5.9
30009,2021-01-01,5380,5101,279,5.2
30011,2021-01-01,667,647,20,3
30013,2021-01-01,36717,34955,1762,4.8
30015,2021-01-01,2440,2346,94,3.9
30017,2021-01-01,6108,5807,301,4.9
30019,2021-01-01,905,883,22,2.4
30021,2021-01-01,4616,4392,224,4.9
30023,2021-01-01,4899,4663,236,4.8
30025,2021-01-01,1624,1559,65,4
30027,2021-01-01,5727,5451,276,4.8
30029,2021-01-01,47727,44604,3123,6.5
30031,2021-01-01,69198,66843,2355,3.4
30033,2021-01-01,779,755,24,3.1
30035,2021-01-01,5056,4541,515,10.2
30037,2021-01-01,353,342,11,3.1
30039,2021-01-01,1628,1519,109,6.7
30041,2021-01-01,7325,7032,293,4
30043,2021-01-01,5704,5464,240,4.2
30045,2021-01-01,981,948,33,3.4
30047,2021-01-01,13240,12506,734,5.5
30049,2021-01-01,35993,34390,1603,4.5
30051,2021-01-01,983,956,27,2.7
30053,2021-01-01,7676,6970,706,9.2
30055,2021-01-01,976,954,22,2.3
30057,2021-01-01,5280,5064,216,4.1
30059,2021-01-01,1038,1000,38,3.7
30061,2021-01-01,1668,1540,128,7.7
30063,2021-01-01,61378,58207,3171,5.2
30065,2021-01-01,2326,2191,135,5.8
30067,2021-01-01,8361,7860,501,6
30069,2021-01-01,270,262,8,3
30071,2021-01-01,1900,1792,108,5.7
30073,2021-01-01,2669,2543,126,4.7
30075,2021-01-01,1002,968,34,3.4
30077,2021-01-01,2816,2705,111,3.9
30079,2021-01-01,469,442,27,5.8
30081,2021-01-01,20325,19168,1157,5.7
30083,2021-01-01,5740,5438,302,5.3
30085,2021-01-01,4435,4183,252,5.7
30087,2021-01-01,3555,3377,178,5
30089,2021-01-01,4916,4525,391,8
30091,2021-01-01,1799,1700,99,5.5
30093,2021-01-01,16884,15952,932,5.5
30095,2021-01-01,5245,5029,216,4.1
30097,2021-01-01,1844,1787,57,3.1
30099,2021-01-01,2715,2593,122,4.5
30101,2021-01-01,2119,2044,75,3.5
30103,2021-01-01,342,328,14,4.1
30105,2021-01-01,3987,3808,179,4.5
30107,2021-01-01,751,689,62,8.3
30109,2021-01-01,452,429,23,5.1
30111,2021-01-01,79787,76274,3513,4.4
31001,2021-01-01,16448,16006,442,2.7
31003,2021-01-01,3929,3854,75,1.9
31005,2021-01-01,240,233,7,2.9
31007,2021-01-01,388,382,6,1.5
31009,2021-01-01,264,254,10,3.8
31011,2021-01-01,2949,2896,53,1.8
31013,2021-01-01,5358,5178,180,3.4
31015,2021-01-01,1068,1046,22,2.1
31017,2021-01-01,1410,1378,32,2.3
31019,2021-01-01,26885,26221,664,2.5
31021,2021-01-01,3545,3442,103,2.9
31023,2021-01-01,4591,4465,126,2.7
31025,2021-01-01,13132,12711,421,3.2
31027,2021-01-01,4451,4361,90,2
31029,2021-01-01,2336,2299,37,1.6
31031,2021-01-01,3309,3250,59,1.8
31033,2021-01-01,4116,3967,149,3.6
31035,2021-01-01,3228,3155,73,2.3
31037,2021-01-01,5587,5472,115,2.1
31039,2021-01-01,4788,4711,77,1.6
31041,2021-01-01,6365,6250,115,1.8
31043,2021-01-01,10138,9837,301,3
31045,2021-01-01,4841,4741,100,2.1
31047,2021-01-01,13219,12887,332,2.5
31049,2021-01-01,955,932,23,2.4
31051,2021-01-01,2909,2838,71,2.4
31053,2021-01-01,20233,19668,565,2.8
31055,2021-01-01,291724,280388,11336,3.9
31057,2021-01-01,1178,1158,20,1.7
31059,2021-01-01,3126,3059,67,2.1
31061,2021-01-01,1496,1452,44,2.9
31063,2021-01-01,1525,1495,30,2
31065,2021-01-01,2606,2549,57,2.2
31067,2021-01-01,10632,10296,336,3.2
31069,2021-01-01,1063,1035,28,2.6
31071,2021-01-01,1164,1143,21,1.8
31073,2021-01-01,1075,1058,17,1.6
31075,2021-01-01,425,420,5,1.2
31077,2021-01-01,1234,1213,21,1.7
31079,2021-01-01,31178,29946,1232,4
31081,2021-01-01,4720,4607,113,2.4
31083,2021-01-01,1697,1659,38,2.2
31085,2021-01-01,638,630,8,1.3
31087,2021-01-01,1285,1254,31,2.4
31089,2021-01-01,5792,5686,106,1.8
31091,2021-01-01,376,370,6,1.6
31093,2021-01-01,3297,3203,94,2.9
31095,2021-01-01,4202,4114,88,2.1
31097,2021-01-01,2047,1976,71,3.5
31099,2021-01-01,3724,3649,75,2
31101,2021-01-01,4473,4353,120,2.7
31103,2021-01-01,630,622,8,1.3
31105,2021-01-01,1946,1894,52,2.7
31107,2021-01-01,4686,4569,117,2.5
31109,2021-01-01,171287,165703,5584,3.3
31111,2021-01-01,17872,17410,462,2.6
31113,2021-01-01,477,470,7,1.5
31115,2021-01-01,424,415,9,2.1
31117,2021-01-01,442,434,8,1.8
31119,2021-01-01,19244,18580,664,3.5
31121,2021-01-01,3970,3861,109,2.7
31123,2021-01-01,2597,2520,77,3
31125,2021-01-01,1932,1891,41,2.1
31127,2021-01-01,3495,3413,82,2.3
31129,2021-01-01,2491,2435,56,2.2
31131,2021-01-01,8271,8045,226,2.7
31133,2021-01-01,1502,1472,30,2
31135,2021-01-01,1846,1825,21,1.1
31137,2021-01-01,4922,4831,91,1.8
31139,2021-01-01,4087,3940,147,3.6
31141,2021-01-01,17524,17122,402,2.3
31143,2021-01-01,2923,2864,59,2
31145,2021-01-01,5841,5702,139,2.4
31147,2021-01-01,4094,3980,114,2.8
31149,2021-01-01,898,887,11,1.2
31151,2021-01-01,7193,6986,207,2.9
31153,2021-01-01,93946,91332,2614,2.8
31155,2021-01-01,10993,10685,308,2.8
31157,2021-01-01,17799,17210,589,3.3
31159,2021-01-01,8686,8414,272,3.1
31161,2021-01-01,2727,2675,52,1.9
31163,2021-01-01,1670,1636,34,2
31165,2021-01-01,759,747,12,1.6
31167,2021-01-01,3506,3400,106,3
31169,2021-01-01,2808,2763,45,1.6
31171,2021-01-01,431,414,17,3.9
31173,2021-01-01,3006,2919,87,2.9
31175,2021-01-01,2113,2066,47,2.2
31177,2021-01-01,10896,10613,283,2.6
31179,2021-01-01,5532,5429,103,1.9
31181,2021-01-01,1667,1629,38,2.3
31183,2021-01-01,579,572,7,1.2
31185,2021-01-01,7147,6990,157,2.2
32001,2021-01-01,11638,11202,436,3.7
32003,2021-01-01,NA,998676,109974,9.9
32005,2021-01-01,22706,21456,1250,5.5
32007,2021-01-01,27675,26641,1034,3.7
32009,2021-01-01,417,401,16,3.8
32011,2021-01-01,1137,1102,35,3.1
32013,2021-01-01,8372,8059,313,3.7
32015,2021-01-01,3302,3168,134,4.1
32017,2021-01-01,2123,2032,91,4.3
32019,2021-01-01,23764,22354,1410,5.9
32021,2021-01-01,2109,2020,89,4.2
32023,2021-01-01,18129,16928,1201,6.6
32027,2021-01-01,2642,2544,98,3.7
32029,2021-01-01,2142,2023,119,5.6
32031,2021-01-01,265191,252304,12887,4.9
32033,2021-01-01,4688,4536,152,3.2
32510,2021-01-01,26767,25262,1505,5.6
33001,2021-01-01,31081,29686,1395,4.5
33003,2021-01-01,22832,21829,1003,4.4
33005,2021-01-01,39586,37928,1658,4.2
33007,2021-01-01,14353,13593,760,5.3
33009,2021-01-01,47879,46163,1716,3.6
33011,2021-01-01,238511,228415,10096,4.2
33013,2021-01-01,82335,79282,3053,3.7
33015,2021-01-01,183667,176266,7401,4
33017,2021-01-01,72178,69419,2759,3.8
33019,2021-01-01,23145,22302,843,3.6
34001,2021-01-01,115049,100709,14340,12.5
34003,2021-01-01,461445,426341,35104,7.6
34005,2021-01-01,225537,210681,14856,6.6
34007,2021-01-01,249733,229229,20504,8.2
34009,2021-01-01,44653,39046,5607,12.6
34011,2021-01-01,64242,58005,6237,9.7
34013,2021-01-01,362294,326411,35883,9.9
34015,2021-01-01,147445,136373,11072,7.5
34017,2021-01-01,348276,317844,30432,8.7
34019,2021-01-01,61558,57934,3624,5.9
34021,2021-01-01,202566,189800,12766,6.3
34023,2021-01-01,427677,397677,30000,7
34025,2021-01-01,320462,298382,22080,6.9
34027,2021-01-01,245688,230203,15485,6.3
34029,2021-01-01,272073,251802,20271,7.5
34031,2021-01-01,235796,211259,24537,10.4
34033,2021-01-01,29124,26626,2498,8.6
34035,2021-01-01,163316,152980,10336,6.3
34037,2021-01-01,71488,66052,5436,7.6
34039,2021-01-01,267870,245884,21986,8.2
34041,2021-01-01,55261,51359,3902,7.1
35001,2021-01-01,333644,305475,28169,8.4
35003,2021-01-01,1211,1113,98,8.1
35005,2021-01-01,29126,26554,2572,8.8
35006,2021-01-01,9784,8616,1168,11.9
35007,2021-01-01,5435,5033,402,7.4
35009,2021-01-01,23109,21667,1442,6.2
35011,2021-01-01,718,676,42,5.8
35013,2021-01-01,97607,89215,8392,8.6
35015,2021-01-01,33366,30603,2763,8.3
35017,2021-01-01,11751,10648,1103,9.4
35019,2021-01-01,1592,1456,136,8.5
35021,2021-01-01,275,262,13,4.7
35023,2021-01-01,1983,1861,122,6.2
35025,2021-01-01,29017,25254,3763,13
35027,2021-01-01,9358,8418,940,10
35028,2021-01-01,10334,9966,368,3.6
35029,2021-01-01,10136,8337,1799,17.7
35031,2021-01-01,24972,21969,3003,12
35033,2021-01-01,2043,1874,169,8.3
35035,2021-01-01,26076,23941,2135,8.2
35037,2021-01-01,3159,2886,273,8.6
35039,2021-01-01,17264,15716,1548,9
35041,2021-01-01,8113,7557,556,6.9
35043,2021-01-01,67008,60890,6118,9.1
35045,2021-01-01,49929,44482,5447,10.9
35047,2021-01-01,10688,9693,995,9.3
35049,2021-01-01,70668,64623,6045,8.6
35051,2021-01-01,4250,3826,424,10
35053,2021-01-01,6404,5909,495,7.7
35055,2021-01-01,15022,13236,1786,11.9
35057,2021-01-01,5318,4787,531,10
35059,2021-01-01,1617,1535,82,5.1
35061,2021-01-01,30520,27794,2726,8.9
36001,2021-01-01,156871,147393,9478,6
36003,2021-01-01,19440,18034,1406,7.2
36005,2021-01-01,585782,482225,103557,17.7
36007,2021-01-01,81244,75117,6127,7.5
36009,2021-01-01,33756,31221,2535,7.5
36011,2021-01-01,35587,33118,2469,6.9
36013,2021-01-01,53334,48217,5117,9.6
36015,2021-01-01,35019,32466,2553,7.3
36017,2021-01-01,22016,20625,1391,6.3
36019,2021-01-01,35737,33119,2618,7.3
36021,2021-01-01,30145,28484,1661,5.5
36023,2021-01-01,22517,20854,1663,7.4
36025,2021-01-01,18690,17455,1235,6.6
36027,2021-01-01,140592,131966,8626,6.1
36029,2021-01-01,437859,403391,34468,7.9
36031,2021-01-01,16900,15753,1147,6.8
36033,2021-01-01,19419,18157,1262,6.5
36035,2021-01-01,22478,20794,1684,7.5
36037,2021-01-01,29011,27206,1805,6.2
36039,2021-01-01,20820,19430,1390,6.7
36041,2021-01-01,2048,1906,142,6.9
36043,2021-01-01,27621,25277,2344,8.5
36045,2021-01-01,43035,39959,3076,7.1
36047,2021-01-01,NA,980945,152741,13.5
36049,2021-01-01,11770,10879,891,7.6
36051,2021-01-01,30231,28349,1882,6.2
36053,2021-01-01,32156,29998,2158,6.7
36055,2021-01-01,360751,334365,26386,7.3
36057,2021-01-01,21922,20209,1713,7.8
36059,2021-01-01,687595,644240,43355,6.3
36061,2021-01-01,842454,757477,84977,10.1
36063,2021-01-01,97095,89282,7813,8
36065,2021-01-01,99818,92497,7321,7.3
36067,2021-01-01,217090,201734,15356,7.1
36069,2021-01-01,54783,51433,3350,6.1
36071,2021-01-01,181847,169866,11981,6.6
36073,2021-01-01,17388,16122,1266,7.3
36075,2021-01-01,51638,47526,4112,8
36077,2021-01-01,26059,24313,1746,6.7
36079,2021-01-01,49371,46519,2852,5.8
36081,2021-01-01,NA,936691,138198,12.9
36083,2021-01-01,80635,75864,4771,5.9
36085,2021-01-01,207467,183876,23591,11.4
36087,2021-01-01,150998,141765,9233,6.1
36089,2021-01-01,42900,39891,3009,7
36091,2021-01-01,118394,112070,6324,5.3
36093,2021-01-01,76555,71380,5175,6.8
36095,2021-01-01,14549,13600,949,6.5
36097,2021-01-01,7914,7332,582,7.4
36099,2021-01-01,15177,14136,1041,6.9
36101,2021-01-01,42219,39277,2942,7
36103,2021-01-01,753139,704752,48387,6.4
36105,2021-01-01,35542,33073,2469,6.9
36107,2021-01-01,21910,20536,1374,6.3
36109,2021-01-01,47774,45233,2541,5.3
36111,2021-01-01,85164,79458,5706,6.7
36113,2021-01-01,30955,28727,2228,7.2
36115,2021-01-01,27591,25854,1737,6.3
36117,2021-01-01,43367,40676,2691,6.2
36119,2021-01-01,472778,441284,31494,6.7
36121,2021-01-01,17990,16765,1225,6.8
36123,2021-01-01,11755,11102,653,5.6
37001,2021-01-01,81143,76363,4780,5.9
37003,2021-01-01,17804,16885,919,5.2
37005,2021-01-01,4125,3871,254,6.2
37007,2021-01-01,10576,9764,812,7.7
37009,2021-01-01,12704,12021,683,5.4
37011,2021-01-01,7500,7101,399,5.3
37013,2021-01-01,19592,18423,1169,6
37015,2021-01-01,7712,7222,490,6.4
37017,2021-01-01,14744,13732,1012,6.9
37019,2021-01-01,51412,47428,3984,7.7
37021,2021-01-01,135833,128183,7650,5.6
37023,2021-01-01,40479,38164,2315,5.7
37025,2021-01-01,108937,102914,6023,5.5
37027,2021-01-01,36218,33950,2268,6.3
37029,2021-01-01,4590,4369,221,4.8
37031,2021-01-01,31201,29533,1668,5.3
37033,2021-01-01,9663,9036,627,6.5
37035,2021-01-01,78415,73847,4568,5.8
37037,2021-01-01,35573,34021,1552,4.4
37039,2021-01-01,10628,9964,664,6.2
37041,2021-01-01,5571,5229,342,6.1
37043,2021-01-01,4042,3802,240,5.9
37045,2021-01-01,48345,45197,3148,6.5
37047,2021-01-01,22283,20506,1777,8
37049,2021-01-01,41166,38733,2433,5.9
37051,2021-01-01,125685,115270,10415,8.3
37053,2021-01-01,13943,13156,787,5.6
37055,2021-01-01,18363,16480,1883,10.3
37057,2021-01-01,79061,74501,4560,5.8
37059,2021-01-01,20033,19014,1019,5.1
37061,2021-01-01,24912,23592,1320,5.3
37063,2021-01-01,171404,162434,8970,5.2
37065,2021-01-01,21021,18968,2053,9.8
37067,2021-01-01,184324,173182,11142,6
37069,2021-01-01,31571,29722,1849,5.9
37071,2021-01-01,109818,102777,7041,6.4
37073,2021-01-01,5105,4846,259,5.1
37075,2021-01-01,2969,2696,273,9.2
37077,2021-01-01,29789,28360,1429,4.8
37079,2021-01-01,9718,9240,478,4.9
37081,2021-01-01,256209,238645,17564,6.9
37083,2021-01-01,20313,18544,1769,8.7
37085,2021-01-01,53278,49844,3434,6.4
37087,2021-01-01,28762,27152,1610,5.6
37089,2021-01-01,52797,50039,2758,5.2
37091,2021-01-01,8995,8378,617,6.9
37093,2021-01-01,19733,18200,1533,7.8
37095,2021-01-01,1726,1559,167,9.7
37097,2021-01-01,89079,84008,5071,5.7
37099,2021-01-01,18444,17348,1096,5.9
37101,2021-01-01,99841,94653,5188,5.2
37103,2021-01-01,4250,4027,223,5.2
37105,2021-01-01,26153,24489,1664,6.4
37107,2021-01-01,27710,26067,1643,5.9
37109,2021-01-01,43438,41239,2199,5.1
37111,2021-01-01,20383,19206,1177,5.8
37113,2021-01-01,15486,14614,872,5.6
37115,2021-01-01,9682,9145,537,5.5
37117,2021-01-01,9107,8494,613,6.7
37119,2021-01-01,618686,581129,37557,6.1
37121,2021-01-01,5756,5360,396,6.9
37123,2021-01-01,11871,11230,641,5.4
37125,2021-01-01,40799,38561,2238,5.5
37127,2021-01-01,42669,39540,3129,7.3
37129,2021-01-01,121068,114459,6609,5.5
37131,2021-01-01,7669,7099,570,7.4
37133,2021-01-01,64455,60423,4032,6.3
37135,2021-01-01,78493,75103,3390,4.3
37137,2021-01-01,5293,5028,265,5
37139,2021-01-01,16606,15458,1148,6.9
37141,2021-01-01,28265,26722,1543,5.5
37143,2021-01-01,4886,4575,311,6.4
37145,2021-01-01,18204,17100,1104,6.1
37147,2021-01-01,89834,84528,5306,5.9
37149,2021-01-01,8958,8463,495,5.5
37151,2021-01-01,63970,60222,3748,5.9
37153,2021-01-01,16827,15383,1444,8.6
37155,2021-01-01,50572,46092,4480,8.9
37157,2021-01-01,39012,36299,2713,7
37159,2021-01-01,65137,61133,4004,6.1
37161,2021-01-01,24732,22773,1959,7.9
37163,2021-01-01,28773,27223,1550,5.4
37165,2021-01-01,11524,10212,1312,11.4
37167,2021-01-01,29878,28312,1566,5.2
37169,2021-01-01,21122,19961,1161,5.5
37171,2021-01-01,32479,30696,1783,5.5
37173,2021-01-01,6595,6168,427,6.5
37175,2021-01-01,14003,13290,713,5.1
37177,2021-01-01,1286,1170,116,9
37179,2021-01-01,122141,116261,5880,4.8
37181,2021-01-01,17005,15433,1572,9.2
37183,2021-01-01,591129,561838,29291,5
37185,2021-01-01,6508,5917,591,9.1
37187,2021-01-01,4478,4095,383,8.6
37189,2021-01-01,28229,26935,1294,4.6
37191,2021-01-01,50668,47501,3167,6.3
37193,2021-01-01,28499,26895,1604,5.6
37195,2021-01-01,34348,31747,2601,7.6
37197,2021-01-01,17250,16342,908,5.3
37199,2021-01-01,8226,7772,454,5.5
38001,2021-01-01,958,920,38,4
38003,2021-01-01,5140,4934,206,4
38005,2021-01-01,2335,2184,151,6.5
38007,2021-01-01,374,359,15,4
38009,2021-01-01,2890,2678,212,7.3
38011,2021-01-01,1586,1535,51,3.2
38013,2021-01-01,1006,948,58,5.8
38015,2021-01-01,50801,48576,2225,4.4
38017,2021-01-01,104131,99954,4177,4
38019,2021-01-01,1873,1800,73,3.9
38021,2021-01-01,2261,2184,77,3.4
38023,2021-01-01,1351,1309,42,3.1
38025,2021-01-01,2797,2655,142,5.1
38027,2021-01-01,1172,1100,72,6.1
38029,2021-01-01,1493,1392,101,6.8
38031,2021-01-01,1529,1469,60,3.9
38033,2021-01-01,827,803,24,2.9
38035,2021-01-01,35977,34408,1569,4.4
38037,2021-01-01,1190,1140,50,4.2
38039,2021-01-01,995,956,39,3.9
38041,2021-01-01,1360,1290,70,5.1
38043,2021-01-01,1300,1200,100,7.7
38045,2021-01-01,1988,1931,57,2.9
38047,2021-01-01,851,817,34,4
38049,2021-01-01,3026,2831,195,6.4
38051,2021-01-01,1085,1032,53,4.9
38053,2021-01-01,8283,7612,671,8.1
38055,2021-01-01,4657,4400,257,5.5
38057,2021-01-01,3444,3207,237,6.9
38059,2021-01-01,16838,15941,897,5.3
38061,2021-01-01,6407,6093,314,4.9
38063,2021-01-01,1367,1295,72,5.3
38065,2021-01-01,875,829,46,5.3
38067,2021-01-01,3277,3070,207,6.3
38069,2021-01-01,1697,1613,84,4.9
38071,2021-01-01,5537,5294,243,4.4
38073,2021-01-01,2820,2729,91,3.2
38075,2021-01-01,1211,1149,62,5.1
38077,2021-01-01,8394,8094,300,3.6
38079,2021-01-01,4562,3964,598,13.1
38081,2021-01-01,2791,2711,80,2.9
38083,2021-01-01,667,610,57,8.5
38085,2021-01-01,1193,1151,42,3.5
38087,2021-01-01,380,365,15,3.9
38089,2021-01-01,17451,16268,1183,6.8
38091,2021-01-01,911,883,28,3.1
38093,2021-01-01,10379,9958,421,4.1
38095,2021-01-01,1116,1067,49,4.4
38097,2021-01-01,4451,4305,146,3.3
38099,2021-01-01,5018,4724,294,5.9
38101,2021-01-01,30997,29128,1869,6
38103,2021-01-01,1897,1781,116,6.1
38105,2021-01-01,20594,18764,1830,8.9
39001,2021-01-01,10701,9861,840,7.8
39003,2021-01-01,47913,45084,2829,5.9
39005,2021-01-01,26363,24975,1388,5.3
39007,2021-01-01,42359,39446,2913,6.9
39009,2021-01-01,26746,25093,1653,6.2
39011,2021-01-01,24151,23185,966,4
39013,2021-01-01,28208,26107,2101,7.4
39015,2021-01-01,19117,17883,1234,6.5
39017,2021-01-01,191279,181283,9996,5.2
39019,2021-01-01,12783,11924,859,6.7
39021,2021-01-01,19442,18522,920,4.7
39023,2021-01-01,62178,58584,3594,5.8
39025,2021-01-01,104990,99600,5390,5.1
39027,2021-01-01,17439,16311,1128,6.5
39029,2021-01-01,45929,42900,3029,6.6
39031,2021-01-01,13471,12567,904,6.7
39033,2021-01-01,18125,16982,1143,6.3
39035,2021-01-01,595869,548435,47434,8
39037,2021-01-01,25298,24116,1182,4.7
39039,2021-01-01,17426,16524,902,5.2
39041,2021-01-01,112118,107511,4607,4.1
39043,2021-01-01,34120,31351,2769,8.1
39045,2021-01-01,78734,74828,3906,5
39047,2021-01-01,13655,12870,785,5.7
39049,2021-01-01,705868,666289,39579,5.6
39051,2021-01-01,21475,20273,1202,5.6
39053,2021-01-01,11972,11189,783,6.5
39055,2021-01-01,47031,44522,2509,5.3
39057,2021-01-01,81821,77913,3908,4.8
39059,2021-01-01,17651,16382,1269,7.2
39061,2021-01-01,410256,386267,23989,5.8
39063,2021-01-01,41039,39223,1816,4.4
39065,2021-01-01,13774,13003,771,5.6
39067,2021-01-01,6426,5945,481,7.5
39069,2021-01-01,12683,11884,799,6.3
39071,2021-01-01,17181,16062,1119,6.5
39073,2021-01-01,12999,12243,756,5.8
39075,2021-01-01,20618,19976,642,3.1
39077,2021-01-01,26502,24389,2113,8
39079,2021-01-01,12909,11980,929,7.2
39081,2021-01-01,26908,24903,2005,7.5
39083,2021-01-01,30484,29004,1480,4.9
39085,2021-01-01,122144,114287,7857,6.4
39087,2021-01-01,23380,22125,1255,5.4
39089,2021-01-01,90721,86360,4361,4.8
39091,2021-01-01,22189,21085,1104,5
39093,2021-01-01,149573,138590,10983,7.3
39095,2021-01-01,202875,188569,14306,7.1
39097,2021-01-01,20858,19917,941,4.5
39099,2021-01-01,99098,91823,7275,7.3
39101,2021-01-01,27727,26209,1518,5.5
39103,2021-01-01,94125,88970,5155,5.5
39105,2021-01-01,8743,8048,695,7.9
39107,2021-01-01,22873,22094,779,3.4
39109,2021-01-01,53408,50757,2651,5
39111,2021-01-01,5479,5018,461,8.4
39113,2021-01-01,249350,233656,15694,6.3
39115,2021-01-01,6525,5996,529,8.1
39117,2021-01-01,16891,15972,919,5.4
39119,2021-01-01,39843,37285,2558,6.4
39121,2021-01-01,4522,4137,385,8.5
39123,2021-01-01,19176,17563,1613,8.4
39125,2021-01-01,8560,8131,429,5
39127,2021-01-01,15979,14899,1080,6.8
39129,2021-01-01,26554,25172,1382,5.2
39131,2021-01-01,10643,9836,807,7.6
39133,2021-01-01,84646,79923,4723,5.6
39135,2021-01-01,20838,19860,978,4.7
39137,2021-01-01,18353,17649,704,3.8
39139,2021-01-01,51894,48588,3306,6.4
39141,2021-01-01,34653,32663,1990,5.7
39143,2021-01-01,29425,27717,1708,5.8
39145,2021-01-01,28619,26581,2038,7.1
39147,2021-01-01,26517,25060,1457,5.5
39149,2021-01-01,23593,22413,1180,5
39151,2021-01-01,183233,172332,10901,5.9
39153,2021-01-01,266158,249420,16738,6.3
39155,2021-01-01,83364,77034,6330,7.6
39157,2021-01-01,43390,40944,2446,5.6
39159,2021-01-01,29281,28149,1132,3.9
39161,2021-01-01,14449,13784,665,4.6
39163,2021-01-01,5504,5086,418,7.6
39165,2021-01-01,117454,112004,5450,4.6
39167,2021-01-01,26040,24351,1689,6.5
39169,2021-01-01,58655,56107,2548,4.3
39171,2021-01-01,18409,17504,905,4.9
39173,2021-01-01,68108,64799,3309,4.9
39175,2021-01-01,12756,12224,532,4.2
40001,2021-01-01,8526,8133,393,4.6
40003,2021-01-01,2818,2730,88,3.1
40005,2021-01-01,5360,5021,339,6.3
40007,2021-01-01,2556,2498,58,2.3
40009,2021-01-01,10007,9380,627,6.3
40011,2021-01-01,4263,4066,197,4.6
40013,2021-01-01,23262,22286,976,4.2
40015,2021-01-01,12240,11649,591,4.8
40017,2021-01-01,76198,73003,3195,4.2
40019,2021-01-01,21956,20772,1184,5.4
40021,2021-01-01,20346,19346,1000,4.9
40023,2021-01-01,5744,5335,409,7.1
40025,2021-01-01,1498,1470,28,1.9
40027,2021-01-01,143402,137545,5857,4.1
40029,2021-01-01,2454,2305,149,6.1
40031,2021-01-01,48328,45970,2358,4.9
40033,2021-01-01,2733,2602,131,4.8
40035,2021-01-01,5831,5571,260,4.5
40037,2021-01-01,31554,29780,1774,5.6
40039,2021-01-01,15045,14361,684,4.5
40041,2021-01-01,18727,17881,846,4.5
40043,2021-01-01,2704,2586,118,4.4
40045,2021-01-01,2188,2097,91,4.2
40047,2021-01-01,26919,25635,1284,4.8
40049,2021-01-01,13088,12410,678,5.2
40051,2021-01-01,26891,25578,1313,4.9
40053,2021-01-01,2826,2732,94,3.3
40055,2021-01-01,1934,1800,134,6.9
40057,2021-01-01,1216,1178,38,3.1
40059,2021-01-01,1851,1791,60,3.2
40061,2021-01-01,4419,4108,311,7
40063,2021-01-01,5502,5134,368,6.7
40065,2021-01-01,11054,10681,373,3.4
40067,2021-01-01,2640,2507,133,5
40069,2021-01-01,3659,3437,222,6.1
40071,2021-01-01,18165,17152,1013,5.6
40073,2021-01-01,8822,8482,340,3.9
40075,2021-01-01,3673,3517,156,4.2
40077,2021-01-01,3163,2870,293,9.3
40079,2021-01-01,19624,18475,1149,5.9
40081,2021-01-01,15818,15085,733,4.6
40083,2021-01-01,22489,21533,956,4.3
40085,2021-01-01,6693,6486,207,3.1
40087,2021-01-01,20055,19222,833,4.2
40089,2021-01-01,15685,14708,977,6.2
40091,2021-01-01,7229,6661,568,7.9
40093,2021-01-01,3779,3618,161,4.3
40095,2021-01-01,6943,6576,367,5.3
40097,2021-01-01,19868,18887,981,4.9
40099,2021-01-01,6068,5726,342,5.6
40101,2021-01-01,29923,28266,1657,5.5
40103,2021-01-01,5630,5450,180,3.2
40105,2021-01-01,4736,4509,227,4.8
40107,2021-01-01,4540,4244,296,6.5
40109,2021-01-01,388423,368845,19578,5
40111,2021-01-01,15787,14725,1062,6.7
40113,2021-01-01,20651,19517,1134,5.5
40115,2021-01-01,14390,13772,618,4.3
40117,2021-01-01,7388,6966,422,5.7
40119,2021-01-01,38130,36493,1637,4.3
40121,2021-01-01,16789,15692,1097,6.5
40123,2021-01-01,19819,18993,826,4.2
40125,2021-01-01,32744,31090,1654,5.1
40127,2021-01-01,4640,4336,304,6.6
40129,2021-01-01,1871,1802,69,3.7
40131,2021-01-01,45185,42923,2262,5
40133,2021-01-01,9381,8758,623,6.6
40135,2021-01-01,16894,15980,914,5.4
40137,2021-01-01,18664,17526,1138,6.1
40139,2021-01-01,11715,11420,295,2.5
40141,2021-01-01,3110,2984,126,4.1
40143,2021-01-01,324808,307566,17242,5.3
40145,2021-01-01,38372,36496,1876,4.9
40147,2021-01-01,22483,21383,1100,4.9
40149,2021-01-01,5134,4836,298,5.8
40151,2021-01-01,4685,4552,133,2.8
40153,2021-01-01,8792,8255,537,6.1
41001,2021-01-01,7366,6820,546,7.4
41003,2021-01-01,46824,44389,2435,5.2
41005,2021-01-01,220067,205582,14485,6.6
41007,2021-01-01,19098,17337,1761,9.2
41009,2021-01-01,24360,22522,1838,7.5
41011,2021-01-01,27448,25364,2084,7.6
41013,2021-01-01,10601,9576,1025,9.7
41015,2021-01-01,9101,8299,802,8.8
41017,2021-01-01,100329,92435,7894,7.9
41019,2021-01-01,48330,45046,3284,6.8
41021,2021-01-01,1002,949,53,5.3
41023,2021-01-01,3212,2878,334,10.4
41025,2021-01-01,3702,3431,271,7.3
41027,2021-01-01,13449,12614,835,6.2
41029,2021-01-01,107339,99639,7700,7.2
41031,2021-01-01,10556,9577,979,9.3
41033,2021-01-01,37169,34241,2928,7.9
41035,2021-01-01,29623,26946,2677,9
41037,2021-01-01,3646,3410,236,6.5
41039,2021-01-01,180036,167014,13022,7.2
41041,2021-01-01,20492,18576,1916,9.3
41043,2021-01-01,59441,54983,4458,7.5
41045,2021-01-01,12725,12013,712,5.6
41047,2021-01-01,164372,153213,11159,6.8
41049,2021-01-01,5790,5430,360,6.2
41051,2021-01-01,459625,425413,34212,7.4
41053,2021-01-01,40700,38141,2559,6.3
41055,2021-01-01,978,925,53,5.4
41057,2021-01-01,11725,10771,954,8.1
41059,2021-01-01,37447,34717,2730,7.3
41061,2021-01-01,12179,11233,946,7.8
41063,2021-01-01,3508,3250,258,7.4
41065,2021-01-01,12662,11676,986,7.8
41067,2021-01-01,323770,304922,18848,5.8
41069,2021-01-01,706,670,36,5.1
41071,2021-01-01,54621,51162,3459,6.3
42001,2021-01-01,53571,50507,3064,5.7
42003,2021-01-01,620673,571150,49523,8
42005,2021-01-01,31040,27972,3068,9.9
42007,2021-01-01,81088,73480,7608,9.4
42009,2021-01-01,22858,20946,1912,8.4
42011,2021-01-01,205273,188565,16708,8.1
42013,2021-01-01,58507,53748,4759,8.1
42015,2021-01-01,27757,25802,1955,7
42017,2021-01-01,330202,308437,21765,6.6
42019,2021-01-01,95331,88293,7038,7.4
42021,2021-01-01,54557,49568,4989,9.1
42023,2021-01-01,2049,1839,210,10.2
42025,2021-01-01,31361,28608,2753,8.8
42027,2021-01-01,71455,67072,4383,6.1
42029,2021-01-01,274000,259746,14254,5.2
42031,2021-01-01,16545,15182,1363,8.2
42033,2021-01-01,35401,32071,3330,9.4
42035,2021-01-01,17424,15890,1534,8.8
42037,2021-01-01,32607,30001,2606,8
42039,2021-01-01,37768,34448,3320,8.8
42041,2021-01-01,128021,120756,7265,5.7
42043,2021-01-01,141794,130499,11295,8
42045,2021-01-01,287873,265795,22078,7.7
42047,2021-01-01,14666,13338,1328,9.1
42049,2021-01-01,124873,112611,12262,9.8
42051,2021-01-01,55397,49063,6334,11.4
42053,2021-01-01,1782,1596,186,10.4
42055,2021-01-01,75567,70663,4904,6.5
42057,2021-01-01,7611,6969,642,8.4
42059,2021-01-01,15755,14347,1408,8.9
42061,2021-01-01,19185,17091,2094,10.9
42063,2021-01-01,36146,32895,3251,9
42065,2021-01-01,19740,18056,1684,8.5
42067,2021-01-01,12546,11675,871,6.9
42069,2021-01-01,101559,92563,8996,8.9
42071,2021-01-01,276138,258771,17367,6.3
42073,2021-01-01,39710,35574,4136,10.4
42075,2021-01-01,70250,65272,4978,7.1
42077,2021-01-01,189363,173724,15639,8.3
42079,2021-01-01,154145,138213,15932,10.3
42081,2021-01-01,54983,50209,4774,8.7
42083,2021-01-01,16763,15318,1445,8.6
42085,2021-01-01,47451,42913,4538,9.6
42087,2021-01-01,21034,19311,1723,8.2
42089,2021-01-01,79735,72298,7437,9.3
42091,2021-01-01,437358,410152,27206,6.2
42093,2021-01-01,8854,8318,536,6.1
42095,2021-01-01,156629,145237,11392,7.3
42097,2021-01-01,41047,37380,3667,8.9
42099,2021-01-01,23660,22231,1429,6
42101,2021-01-01,698661,620100,78561,11.2
42103,2021-01-01,23853,21708,2145,9
42105,2021-01-01,7152,6484,668,9.3
42107,2021-01-01,65078,59524,5554,8.5
42109,2021-01-01,18932,17611,1321,7
42111,2021-01-01,33097,30049,3048,9.2
42113,2021-01-01,2620,2380,240,9.2
42115,2021-01-01,19526,18156,1370,7
42117,2021-01-01,18503,16853,1650,8.9
42119,2021-01-01,18689,17475,1214,6.5
42121,2021-01-01,21722,19790,1932,8.9
42123,2021-01-01,18405,16840,1565,8.5
42125,2021-01-01,103035,93935,9100,8.8
42127,2021-01-01,21980,20000,1980,9
42129,2021-01-01,173155,158431,14724,8.5
42131,2021-01-01,13074,11944,1130,8.6
42133,2021-01-01,230896,215334,15562,6.7
44001,2021-01-01,25334,23206,2128,8.4
44003,2021-01-01,88296,81287,7009,7.9
44005,2021-01-01,43120,39389,3731,8.7
44007,2021-01-01,317923,290236,27687,8.7
44009,2021-01-01,65993,60968,5025,7.6
45001,2021-01-01,9954,9395,559,5.6
45003,2021-01-01,74671,71359,3312,4.4
45005,2021-01-01,2563,2336,227,8.9
45007,2021-01-01,89538,85020,4518,5
45009,2021-01-01,4706,4258,448,9.5
45011,2021-01-01,7823,7244,579,7.4
45013,2021-01-01,75808,72313,3495,4.6
45015,2021-01-01,103743,98661,5082,4.9
45017,2021-01-01,6374,6024,350,5.5
45019,2021-01-01,208743,198008,10735,5.1
45021,2021-01-01,24831,23106,1725,6.9
45023,2021-01-01,13396,12348,1048,7.8
45025,2021-01-01,21548,20154,1394,6.5
45027,2021-01-01,12483,11654,829,6.6
45029,2021-01-01,16437,15448,989,6
45031,2021-01-01,30075,28234,1841,6.1
45033,2021-01-01,13248,12351,897,6.8
45035,2021-01-01,76719,72887,3832,5
45037,2021-01-01,10636,10154,482,4.5
45039,2021-01-01,9349,8667,682,7.3
45041,2021-01-01,66495,62987,3508,5.3
45043,2021-01-01,25280,23591,1689,6.7
45045,2021-01-01,251983,240169,11814,4.7
45047,2021-01-01,31197,29347,1850,5.9
45049,2021-01-01,8014,7622,392,4.9
45051,2021-01-01,141397,131153,10244,7.2
45053,2021-01-01,12685,12080,605,4.8
45055,2021-01-01,28696,27274,1422,5
45057,2021-01-01,42045,39421,2624,6.2
45059,2021-01-01,29673,27955,1718,5.8
45061,2021-01-01,6684,6213,471,7
45063,2021-01-01,146777,140750,6027,4.1
45065,2021-01-01,3328,3104,224,6.7
45067,2021-01-01,13173,12132,1041,7.9
45069,2021-01-01,9257,8374,883,9.5
45071,2021-01-01,18872,18020,852,4.5
45073,2021-01-01,34274,32703,1571,4.6
45075,2021-01-01,34290,31341,2949,8.6
45077,2021-01-01,56352,53838,2514,4.5
45079,2021-01-01,194959,184102,10857,5.6
45081,2021-01-01,8384,8033,351,4.2
45083,2021-01-01,155589,147509,8080,5.2
45085,2021-01-01,43695,41016,2679,6.1
45087,2021-01-01,11798,10878,920,7.8
45089,2021-01-01,11620,10772,848,7.3
45091,2021-01-01,142314,134696,7618,5.4
46003,2021-01-01,1468,1434,34,2.3
46005,2021-01-01,9268,8992,276,3
46007,2021-01-01,1057,1016,41,3.9
46009,2021-01-01,2824,2730,94,3.3
46011,2021-01-01,18110,17497,613,3.4
46013,2021-01-01,20584,19950,634,3.1
46015,2021-01-01,2393,2328,65,2.7
46017,2021-01-01,721,698,23,3.2
46019,2021-01-01,4925,4749,176,3.6
46021,2021-01-01,777,755,22,2.8
46023,2021-01-01,3685,3531,154,4.2
46025,2021-01-01,2364,2277,87,3.7
46027,2021-01-01,7296,7078,218,3
46029,2021-01-01,15305,14801,504,3.3
46031,2021-01-01,1347,1300,47,3.5
46033,2021-01-01,4013,3841,172,4.3
46035,2021-01-01,10947,10630,317,2.9
46037,2021-01-01,2669,2526,143,5.4
46039,2021-01-01,2404,2291,113,4.7
46041,2021-01-01,2211,2117,94,4.3
46043,2021-01-01,1547,1508,39,2.5
46045,2021-01-01,2019,1956,63,3.1
46047,2021-01-01,2935,2790,145,4.9
46049,2021-01-01,1025,1000,25,2.4
46051,2021-01-01,4369,4182,187,4.3
46053,2021-01-01,1980,1915,65,3.3
46055,2021-01-01,1087,1057,30,2.8
46057,2021-01-01,3320,3225,95,2.9
46059,2021-01-01,1784,1743,41,2.3
46061,2021-01-01,1760,1680,80,4.5
46063,2021-01-01,702,687,15,2.1
46065,2021-01-01,10006,9732,274,2.7
46067,2021-01-01,3644,3513,131,3.6
46069,2021-01-01,684,667,17,2.5
46071,2021-01-01,1114,1053,61,5.5
46073,2021-01-01,1211,1185,26,2.1
46075,2021-01-01,461,449,12,2.6
46077,2021-01-01,2659,2580,79,3
46079,2021-01-01,6397,6204,193,3
46081,2021-01-01,13404,12981,423,3.2
46083,2021-01-01,35969,35073,896,2.5
46085,2021-01-01,1583,1514,69,4.4
46087,2021-01-01,3101,3009,92,3
46089,2021-01-01,1013,968,45,4.4
46091,2021-01-01,2404,2308,96,4
46093,2021-01-01,13693,13269,424,3.1
46095,2021-01-01,707,679,28,4
46097,2021-01-01,1108,1068,40,3.6
46099,2021-01-01,113745,110118,3627,3.2
46101,2021-01-01,3925,3811,114,2.9
46102,2021-01-01,3735,3396,339,9.1
46103,2021-01-01,56158,54247,1911,3.4
46105,2021-01-01,1375,1328,47,3.4
46107,2021-01-01,973,947,26,2.7
46109,2021-01-01,4749,4489,260,5.5
46111,2021-01-01,1170,1129,41,3.5
46115,2021-01-01,3070,2969,101,3.3
46117,2021-01-01,1909,1844,65,3.4
46119,2021-01-01,792,775,17,2.1
46121,2021-01-01,3015,2876,139,4.6
46123,2021-01-01,2998,2925,73,2.4
46125,2021-01-01,4662,4532,130,2.8
46127,2021-01-01,8466,8145,321,3.8
46129,2021-01-01,2104,1979,125,5.9
46135,2021-01-01,11615,11288,327,2.8
46137,2021-01-01,947,915,32,3.4
47001,2021-01-01,34738,32997,1741,5
47003,2021-01-01,20860,19746,1114,5.3
47005,2021-01-01,6706,6267,439,6.5
47007,2021-01-01,4277,3951,326,7.6
47009,2021-01-01,64148,61161,2987,4.7
47011,2021-01-01,53084,50342,2742,5.2
47013,2021-01-01,14928,13985,943,6.3
47015,2021-01-01,6570,6288,282,4.3
47017,2021-01-01,12134,11382,752,6.2
47019,2021-01-01,23560,22235,1325,5.6
47021,2021-01-01,21591,20745,846,3.9
47023,2021-01-01,8414,8029,385,4.6
47025,2021-01-01,12977,12252,725,5.6
47027,2021-01-01,2767,2570,197,7.1
47029,2021-01-01,14587,13341,1246,8.5
47031,2021-01-01,25619,24409,1210,4.7
47033,2021-01-01,6850,6514,336,4.9
47035,2021-01-01,22800,21195,1605,7
47037,2021-01-01,402128,382548,19580,4.9
47039,2021-01-01,4403,4092,311,7.1
47041,2021-01-01,7659,7243,416,5.4
47043,2021-01-01,26742,25653,1089,4.1
47045,2021-01-01,15776,14812,964,6.1
47047,2021-01-01,19181,18186,995,5.2
47049,2021-01-01,7585,7169,416,5.5
47051,2021-01-01,19461,18566,895,4.6
47053,2021-01-01,21884,20705,1179,5.4
47055,2021-01-01,14585,13826,759,5.2
47057,2021-01-01,9606,9027,579,6
47059,2021-01-01,28715,26968,1747,6.1
47061,2021-01-01,5064,4723,341,6.7
47063,2021-01-01,28088,26694,1394,5
47065,2021-01-01,182757,173431,9326,5.1
47067,2021-01-01,2150,2016,134,6.2
47069,2021-01-01,9316,8589,727,7.8
47071,2021-01-01,10393,9772,621,6
47073,2021-01-01,23496,22093,1403,6
47075,2021-01-01,7821,7261,560,7.2
47077,2021-01-01,12054,11339,715,5.9
47079,2021-01-01,13426,12611,815,6.1
47081,2021-01-01,11259,10787,472,4.2
47083,2021-01-01,3237,3007,230,7.1
47085,2021-01-01,8738,8282,456,5.2
47087,2021-01-01,4873,4583,290,6
47089,2021-01-01,24827,23435,1392,5.6
47091,2021-01-01,7933,7500,433,5.5
47093,2021-01-01,245486,235085,10401,4.2
47095,2021-01-01,1715,1571,144,8.4
47097,2021-01-01,9860,9181,679,6.9
47099,2021-01-01,19233,18223,1010,5.3
47101,2021-01-01,5318,5046,272,5.1
47103,2021-01-01,16018,15180,838,5.2
47105,2021-01-01,23728,22696,1032,4.3
47107,2021-01-01,23319,22107,1212,5.2
47109,2021-01-01,8409,7761,648,7.7
47111,2021-01-01,11330,10743,587,5.2
47113,2021-01-01,48702,46035,2667,5.5
47115,2021-01-01,12370,11676,694,5.6
47117,2021-01-01,15231,14476,755,5
47119,2021-01-01,50219,47427,2792,5.6
47121,2021-01-01,5270,4911,359,6.8
47123,2021-01-01,20320,19294,1026,5
47125,2021-01-01,87064,82073,4991,5.7
47127,2021-01-01,3523,3389,134,3.8
47129,2021-01-01,7860,7369,491,6.2
47131,2021-01-01,12350,11547,803,6.5
47133,2021-01-01,9853,9349,504,5.1
47135,2021-01-01,3055,2821,234,7.7
47137,2021-01-01,2212,2095,117,5.3
47139,2021-01-01,7495,7106,389,5.2
47141,2021-01-01,35406,33675,1731,4.9
47143,2021-01-01,13106,12163,943,7.2
47145,2021-01-01,23511,22152,1359,5.8
47147,2021-01-01,37743,36196,1547,4.1
47149,2021-01-01,185529,177814,7715,4.2
47151,2021-01-01,8229,7694,535,6.5
47153,2021-01-01,6148,5786,362,5.9
47155,2021-01-01,52567,48752,3815,7.3
47157,2021-01-01,449707,414958,34749,7.7
47159,2021-01-01,9365,8983,382,4.1
47161,2021-01-01,5502,5178,324,5.9
47163,2021-01-01,69567,65625,3942,5.7
47165,2021-01-01,102948,98646,4302,4.2
47167,2021-01-01,27704,26260,1444,5.2
47169,2021-01-01,5484,5225,259,4.7
47171,2021-01-01,7096,6565,531,7.5
47173,2021-01-01,7688,7276,412,5.4
47175,2021-01-01,2011,1883,128,6.4
47177,2021-01-01,17124,16104,1020,6
47179,2021-01-01,59459,56608,2851,4.8
47181,2021-01-01,6505,6120,385,5.9
47183,2021-01-01,15545,14813,732,4.7
47185,2021-01-01,12089,11512,577,4.8
47187,2021-01-01,128934,124852,4082,3.2
47189,2021-01-01,77433,74363,3070,4
48001,2021-01-01,23229,21777,1452,6.3
48003,2021-01-01,9028,8290,738,8.2
48005,2021-01-01,35323,32412,2911,8.2
48007,2021-01-01,9018,8203,815,9
48009,2021-01-01,3906,3689,217,5.6
48011,2021-01-01,924,880,44,4.8
48013,2021-01-01,22003,20252,1751,8
48015,2021-01-01,13619,12672,947,7
48017,2021-01-01,2476,2329,147,5.9
48019,2021-01-01,9982,9384,598,6
48021,2021-01-01,43366,40868,2498,5.8
48023,2021-01-01,1829,1762,67,3.7
48025,2021-01-01,9844,8827,1017,10.3
48027,2021-01-01,145315,134988,10327,7.1
48029,2021-01-01,947934,883288,64646,6.8
48031,2021-01-01,6702,6442,260,3.9
48033,2021-01-01,492,478,14,2.8
48035,2021-01-01,8477,7991,486,5.7
48037,2021-01-01,38911,36168,2743,7
48039,2021-01-01,177305,161467,15838,8.9
48041,2021-01-01,116514,110227,6287,5.4
48043,2021-01-01,4129,3882,247,6
48045,2021-01-01,571,541,30,5.3
48047,2021-01-01,2659,2343,316,11.9
48049,2021-01-01,15344,14330,1014,6.6
48051,2021-01-01,8198,7654,544,6.6
48053,2021-01-01,24103,22972,1131,4.7
48055,2021-01-01,19707,18483,1224,6.2
48057,2021-01-01,12523,11760,763,6.1
48059,2021-01-01,6020,5670,350,5.8
48061,2021-01-01,169901,152028,17873,10.5
48063,2021-01-01,5072,4664,408,8
48065,2021-01-01,2963,2829,134,4.5
48067,2021-01-01,12333,11266,1067,8.7
48069,2021-01-01,3354,3208,146,4.4
48071,2021-01-01,19969,17835,2134,10.7
48073,2021-01-01,21461,19736,1725,8
48075,2021-01-01,3075,2932,143,4.7
48077,2021-01-01,4826,4510,316,6.5
48079,2021-01-01,1119,1043,76,6.8
48081,2021-01-01,1335,1251,84,6.3
48083,2021-01-01,2930,2697,233,8
48085,2021-01-01,577511,544536,32975,5.7
48087,2021-01-01,1055,998,57,5.4
48089,2021-01-01,9654,9060,594,6.2
48091,2021-01-01,75650,71273,4377,5.8
48093,2021-01-01,5709,5368,341,6
48095,2021-01-01,1331,1262,69,5.2
48097,2021-01-01,19132,17850,1282,6.7
48099,2021-01-01,24121,22490,1631,6.8
48101,2021-01-01,584,545,39,6.7
48103,2021-01-01,1577,1364,213,13.5
48105,2021-01-01,1492,1356,136,9.1
48107,2021-01-01,2454,2287,167,6.8
48109,2021-01-01,1200,1133,67,5.6
48111,2021-01-01,3682,3562,120,3.3
48113,2021-01-01,NA,NA,97208,7.1
48115,2021-01-01,4653,4216,437,9.4
48117,2021-01-01,8658,8281,377,4.4
48119,2021-01-01,2440,2300,140,5.7
48121,2021-01-01,509500,480096,29404,5.8
48123,2021-01-01,9133,8535,598,6.5
48125,2021-01-01,668,625,43,6.4
48127,2021-01-01,6111,5678,433,7.1
48129,2021-01-01,1458,1379,79,5.4
48131,2021-01-01,4798,4191,607,12.7
48133,2021-01-01,7225,6681,544,7.5
48135,2021-01-01,79707,70314,9393,11.8
48137,2021-01-01,1383,1319,64,4.6
48139,2021-01-01,95104,89551,5553,5.8
48141,2021-01-01,367572,338059,29513,8
48143,2021-01-01,19853,18623,1230,6.2
48145,2021-01-01,6641,6244,397,6
48147,2021-01-01,16988,16158,830,4.9
48149,2021-01-01,11724,11096,628,5.4
48151,2021-01-01,1626,1536,90,5.5
48153,2021-01-01,2540,2349,191,7.5
48155,2021-01-01,584,558,26,4.5
48157,2021-01-01,392406,362249,30157,7.7
48159,2021-01-01,4952,4662,290,5.9
48161,2021-01-01,6300,5740,560,8.9
48163,2021-01-01,9273,8683,590,6.4
48165,2021-01-01,9845,9204,641,6.5
48167,2021-01-01,163566,149334,14232,8.7
48169,2021-01-01,2010,1876,134,6.7
48171,2021-01-01,13293,12709,584,4.4
48173,2021-01-01,783,756,27,3.4
48175,2021-01-01,3190,2909,281,8.8
48177,2021-01-01,9757,9213,544,5.6
48179,2021-01-01,7618,6925,693,9.1
48181,2021-01-01,64765,61075,3690,5.7
48183,2021-01-01,56384,51768,4616,8.2
48185,2021-01-01,11086,10115,971,8.8
48187,2021-01-01,81337,76751,4586,5.6
48189,2021-01-01,11900,11002,898,7.5
48191,2021-01-01,1081,1010,71,6.6
48193,2021-01-01,3872,3675,197,5.1
48195,2021-01-01,2473,2370,103,4.2
48197,2021-01-01,1740,1649,91,5.2
48199,2021-01-01,25040,22655,2385,9.5
48201,2021-01-01,NA,NA,187359,8.3
48203,2021-01-01,28817,26439,2378,8.3
48205,2021-01-01,2592,2532,60,2.3
48207,2021-01-01,2832,2699,133,4.7
48209,2021-01-01,122802,116094,6708,5.5
48211,2021-01-01,1712,1621,91,5.3
48213,2021-01-01,37599,35167,2432,6.5
48215,2021-01-01,364596,321271,43325,11.9
48217,2021-01-01,16187,15130,1057,6.5
48219,2021-01-01,10463,9618,845,8.1
48221,2021-01-01,28009,26071,1938,6.9
48223,2021-01-01,17728,16775,953,5.4
48225,2021-01-01,9839,9183,656,6.7
48227,2021-01-01,13430,12289,1141,8.5
48229,2021-01-01,1879,1726,153,8.1
48231,2021-01-01,44289,41401,2888,6.5
48233,2021-01-01,8493,7817,676,8
48235,2021-01-01,756,705,51,6.7
48237,2021-01-01,3268,3028,240,7.3
48239,2021-01-01,7246,6805,441,6.1
48241,2021-01-01,12853,11262,1591,12.4
48243,2021-01-01,981,928,53,5.4
48245,2021-01-01,105531,92566,12965,12.3
48247,2021-01-01,1911,1694,217,11.4
48249,2021-01-01,15648,13537,2111,13.5
48251,2021-01-01,83926,78560,5366,6.4
48253,2021-01-01,5801,5354,447,7.7
48255,2021-01-01,6930,6456,474,6.8
48257,2021-01-01,68414,64061,4353,6.4
48259,2021-01-01,22362,21285,1077,4.8
48261,2021-01-01,179,165,14,7.8
48263,2021-01-01,448,432,16,3.6
48265,2021-01-01,21266,20048,1218,5.7
48267,2021-01-01,1797,1687,110,6.1
48269,2021-01-01,261,257,4,1.5
48271,2021-01-01,1325,1229,96,7.2
48273,2021-01-01,13480,12326,1154,8.6
48275,2021-01-01,1479,1389,90,6.1
48277,2021-01-01,23827,22169,1658,7
48279,2021-01-01,5365,5045,320,6
48281,2021-01-01,9130,8590,540,5.9
48283,2021-01-01,3503,3277,226,6.5
48285,2021-01-01,8435,7947,488,5.8
48287,2021-01-01,8843,8349,494,5.6
48289,2021-01-01,6238,5658,580,9.3
48291,2021-01-01,34054,29839,4215,12.4
48293,2021-01-01,8415,7728,687,8.2
48295,2021-01-01,1558,1487,71,4.6
48297,2021-01-01,5101,4655,446,8.7
48299,2021-01-01,8505,7957,548,6.4
48301,2021-01-01,267,264,3,1.1
48303,2021-01-01,158300,149198,9102,5.7
48305,2021-01-01,2770,2617,153,5.5
48307,2021-01-01,3289,3019,270,8.2
48309,2021-01-01,122360,114864,7496,6.1
48311,2021-01-01,674,655,19,2.8
48313,2021-01-01,4498,4117,381,8.5
48315,2021-01-01,4273,3916,357,8.4
48317,2021-01-01,2487,2323,164,6.6
48319,2021-01-01,1725,1616,109,6.3
48321,2021-01-01,16283,14482,1801,11.1
48323,2021-01-01,25501,21162,4339,17
48325,2021-01-01,21756,20386,1370,6.3
48327,2021-01-01,872,825,47,5.4
48329,2021-01-01,95236,87348,7888,8.3
48331,2021-01-01,9904,9134,770,7.8
48333,2021-01-01,1942,1842,100,5.1
48335,2021-01-01,2398,2182,216,9
48337,2021-01-01,8983,8376,607,6.8
48339,2021-01-01,283296,261979,21317,7.5
48341,2021-01-01,10750,10273,477,4.4
48343,2021-01-01,4745,4092,653,13.8
48345,2021-01-01,431,407,24,5.6
48347,2021-01-01,28513,26532,1981,6.9
48349,2021-01-01,23028,21546,1482,6.4
48351,2021-01-01,5086,4476,610,12
48353,2021-01-01,7321,6868,453,6.2
48355,2021-01-01,161922,147498,14424,8.9
48357,2021-01-01,3969,3716,253,6.4
48359,2021-01-01,908,862,46,5.1
48361,2021-01-01,36067,32082,3985,11
48363,2021-01-01,13092,12078,1014,7.7
48365,2021-01-01,9193,8352,841,9.1
48367,2021-01-01,68994,64959,4035,5.8
48369,2021-01-01,5106,4935,171,3.3
48371,2021-01-01,6771,6180,591,8.7
48373,2021-01-01,18834,17020,1814,9.6
48375,2021-01-01,54578,51575,3003,5.5
48377,2021-01-01,3172,2722,450,14.2
48379,2021-01-01,6217,5933,284,4.6
48381,2021-01-01,72987,69669,3318,4.5
48383,2021-01-01,1729,1539,190,11
48385,2021-01-01,1131,1048,83,7.3
48387,2021-01-01,5299,4906,393,7.4
48389,2021-01-01,8225,7557,668,8.1
48391,2021-01-01,3073,2797,276,9
48393,2021-01-01,409,390,19,4.6
48395,2021-01-01,7375,6869,506,6.9
48397,2021-01-01,53923,50928,2995,5.6
48399,2021-01-01,4536,4300,236,5.2
48401,2021-01-01,22244,20467,1777,8
48403,2021-01-01,4114,3620,494,12
48405,2021-01-01,2979,2665,314,10.5
48407,2021-01-01,11817,10716,1101,9.3
48409,2021-01-01,29099,25917,3182,10.9
48411,2021-01-01,2172,2043,129,5.9
48413,2021-01-01,1174,1084,90,7.7
48415,2021-01-01,6090,5549,541,8.9
48417,2021-01-01,1740,1641,99,5.7
48419,2021-01-01,11354,10534,820,7.2
48421,2021-01-01,1323,1270,53,4
48423,2021-01-01,109335,102053,7282,6.7
48425,2021-01-01,4394,4101,293,6.7
48427,2021-01-01,27057,21946,5111,18.9
48429,2021-01-01,4089,3818,271,6.6
48431,2021-01-01,563,519,44,7.8
48433,2021-01-01,577,543,34,5.9
48435,2021-01-01,1192,1065,127,10.7
48437,2021-01-01,2577,2411,166,6.4
48439,2021-01-01,NA,NA,74127,6.8
48441,2021-01-01,66373,62723,3650,5.5
48443,2021-01-01,408,392,16,3.9
48445,2021-01-01,4781,4405,376,7.9
48447,2021-01-01,631,594,37,5.9
48449,2021-01-01,13521,12623,898,6.6
48451,2021-01-01,53552,50136,3416,6.4
48453,2021-01-01,749559,709315,40244,5.4
48455,2021-01-01,5368,4901,467,8.7
48457,2021-01-01,7517,6716,801,10.7
48459,2021-01-01,17468,16070,1398,8
48461,2021-01-01,1909,1800,109,5.7
48463,2021-01-01,11189,10395,794,7.1
48465,2021-01-01,23005,21293,1712,7.4
48467,2021-01-01,26407,24780,1627,6.2
48469,2021-01-01,41049,37649,3400,8.3
48471,2021-01-01,24140,22272,1868,7.7
48473,2021-01-01,23837,21835,2002,8.4
48475,2021-01-01,5841,5257,584,10
48477,2021-01-01,15518,14497,1021,6.6
48479,2021-01-01,115892,106202,9690,8.4
48481,2021-01-01,21221,19667,1554,7.3
48483,2021-01-01,2310,2127,183,7.9
48485,2021-01-01,55253,51384,3869,7
48487,2021-01-01,5085,4698,387,7.6
48489,2021-01-01,6620,5777,843,12.7
48491,2021-01-01,323155,306374,16781,5.2
48493,2021-01-01,24799,23397,1402,5.7
48495,2021-01-01,3979,3581,398,10
48497,2021-01-01,32453,30429,2024,6.2
48499,2021-01-01,18188,16955,1233,6.8
48501,2021-01-01,3365,2989,376,11.2
48503,2021-01-01,7679,7235,444,5.8
48505,2021-01-01,4355,3694,661,15.2
48507,2021-01-01,3561,3011,550,15.4
49001,2021-01-01,2701,2610,91,3.4
49003,2021-01-01,26373,25577,796,3
49005,2021-01-01,65894,64271,1623,2.5
49007,2021-01-01,8545,8118,427,5
49009,2021-01-01,327,305,22,6.7
49011,2021-01-01,177393,172123,5270,3
49013,2021-01-01,7497,6974,523,7
49015,2021-01-01,4306,4095,211,4.9
49017,2021-01-01,2180,1884,296,13.6
49019,2021-01-01,5402,4804,598,11.1
49021,2021-01-01,25281,24391,890,3.5
49023,2021-01-01,5969,5810,159,2.7
49025,2021-01-01,3503,3338,165,4.7
49027,2021-01-01,5617,5444,173,3.1
49029,2021-01-01,5622,5468,154,2.7
49031,2021-01-01,458,428,30,6.6
49033,2021-01-01,936,894,42,4.5
49035,2021-01-01,645771,623422,22349,3.5
49037,2021-01-01,5009,4540,469,9.4
49039,2021-01-01,12628,12177,451,3.6
49041,2021-01-01,9625,9226,399,4.1
49043,2021-01-01,25460,24604,856,3.4
49045,2021-01-01,35482,34192,1290,3.6
49047,2021-01-01,12802,11812,990,7.7
49049,2021-01-01,316787,307522,9265,2.9
49051,2021-01-01,16245,15681,564,3.5
49053,2021-01-01,80201,77081,3120,3.9
49055,2021-01-01,1257,1148,109,8.7
49057,2021-01-01,130901,126147,4754,3.6
50001,2021-01-01,19317,18681,636,3.3
50003,2021-01-01,16035,15298,737,4.6
50005,2021-01-01,13630,13081,549,4
50007,2021-01-01,87028,84348,2680,3.1
50009,2021-01-01,2476,2355,121,4.9
50011,2021-01-01,24469,23553,916,3.7
50013,2021-01-01,3736,3582,154,4.1
50015,2021-01-01,12258,11700,558,4.6
50017,2021-01-01,14767,14233,534,3.6
50019,2021-01-01,12045,11375,670,5.6
50021,2021-01-01,27678,26492,1186,4.3
50023,2021-01-01,31275,30270,1005,3.2
50025,2021-01-01,20061,19215,846,4.2
50027,2021-01-01,26950,26052,898,3.3
51001,2021-01-01,15721,14638,1083,6.9
51003,2021-01-01,53863,51267,2596,4.8
51005,2021-01-01,6715,6323,392,5.8
51007,2021-01-01,6007,5668,339,5.6
51009,2021-01-01,14157,13391,766,5.4
51011,2021-01-01,6825,6412,413,6.1
51013,2021-01-01,146948,140629,6319,4.3
51015,2021-01-01,36746,35151,1595,4.3
51017,2021-01-01,2252,2085,167,7.4
51019,2021-01-01,36397,34532,1865,5.1
51021,2021-01-01,2797,2653,144,5.1
51023,2021-01-01,16697,15990,707,4.2
51025,2021-01-01,5829,5359,470,8.1
51027,2021-01-01,6329,5702,627,9.9
51029,2021-01-01,6165,5689,476,7.7
51031,2021-01-01,24567,23153,1414,5.8
51033,2021-01-01,14428,13541,887,6.1
51035,2021-01-01,12909,12115,794,6.2
51036,2021-01-01,3483,3275,208,6
51037,2021-01-01,5073,4799,274,5.4
51041,2021-01-01,178688,169342,9346,5.2
51043,2021-01-01,7289,6991,298,4.1
51045,2021-01-01,2219,2120,99,4.5
51047,2021-01-01,23828,22711,1117,4.7
51049,2021-01-01,4491,4213,278,6.2
51051,2021-01-01,4702,4345,357,7.6
51053,2021-01-01,12996,12173,823,6.3
51057,2021-01-01,5463,5096,367,6.7
51059,2021-01-01,607662,576611,31051,5.1
51061,2021-01-01,35782,34267,1515,4.2
51063,2021-01-01,7776,7404,372,4.8
51065,2021-01-01,13273,12615,658,5
51067,2021-01-01,25370,24005,1365,5.4
51069,2021-01-01,47548,45600,1948,4.1
51071,2021-01-01,7376,6999,377,5.1
51073,2021-01-01,18732,17794,938,5
51075,2021-01-01,10739,10252,487,4.5
51077,2021-01-01,8437,8031,406,4.8
51079,2021-01-01,9802,9381,421,4.3
51081,2021-01-01,4190,3897,293,7
51083,2021-01-01,14908,13939,969,6.5
51085,2021-01-01,55689,53346,2343,4.2
51087,2021-01-01,173018,163044,9974,5.8
51089,2021-01-01,23879,22255,1624,6.8
51091,2021-01-01,1242,1186,56,4.5
51093,2021-01-01,18632,17708,924,5
51095,2021-01-01,35302,33233,2069,5.9
51097,2021-01-01,3819,3634,185,4.8
51099,2021-01-01,13860,13276,584,4.2
51101,2021-01-01,8734,8296,438,5
51103,2021-01-01,5383,4936,447,8.3
51105,2021-01-01,8182,7711,471,5.8
51107,2021-01-01,215876,205970,9906,4.6
51109,2021-01-01,19610,18684,926,4.7
51111,2021-01-01,5300,5010,290,5.5
51113,2021-01-01,7212,6957,255,3.5
51115,2021-01-01,3947,3763,184,4.7
51117,2021-01-01,12684,11874,810,6.4
51119,2021-01-01,4997,4760,237,4.7
51121,2021-01-01,46625,44663,1962,4.2
51125,2021-01-01,7055,6699,356,5
51127,2021-01-01,12057,11541,516,4.3
51131,2021-01-01,5393,4947,446,8.3
51133,2021-01-01,5600,5141,459,8.2
51135,2021-01-01,7059,6673,386,5.5
51137,2021-01-01,16836,15947,889,5.3
51139,2021-01-01,11811,10915,896,7.6
51141,2021-01-01,7038,6601,437,6.2
51143,2021-01-01,29880,28149,1731,5.8
51145,2021-01-01,13433,12859,574,4.3
51147,2021-01-01,10217,9570,647,6.3
51149,2021-01-01,14412,13476,936,6.5
51153,2021-01-01,237877,224082,13795,5.8
51155,2021-01-01,15230,14282,948,6.2
51157,2021-01-01,3578,3434,144,4
51159,2021-01-01,4057,3837,220,5.4
51161,2021-01-01,47321,45132,2189,4.6
51163,2021-01-01,10433,9848,585,5.6
51165,2021-01-01,40250,38496,1754,4.4
51167,2021-01-01,11107,10399,708,6.4
51169,2021-01-01,8688,8286,402,4.6
51171,2021-01-01,22131,20983,1148,5.2
51173,2021-01-01,13173,12397,776,5.9
51175,2021-01-01,9033,8600,433,4.8
51177,2021-01-01,65113,61578,3535,5.4
51179,2021-01-01,70257,66540,3717,5.3
51181,2021-01-01,3504,3298,206,5.9
51183,2021-01-01,3678,3368,310,8.4
51185,2021-01-01,15608,14468,1140,7.3
51187,2021-01-01,19639,18592,1047,5.3
51191,2021-01-01,25182,23878,1304,5.2
51193,2021-01-01,9372,8762,610,6.5
51195,2021-01-01,12861,11920,941,7.3
51197,2021-01-01,13588,12765,823,6.1
51199,2021-01-01,31356,29878,1478,4.7
51510,2021-01-01,97106,91754,5352,5.5
51520,2021-01-01,7058,6576,482,6.8
51530,2021-01-01,3141,2961,180,5.7
51540,2021-01-01,24462,23089,1373,5.6
51550,2021-01-01,118520,111933,6587,5.6
51570,2021-01-01,8168,7617,551,6.7
51580,2021-01-01,2357,2158,199,8.4
51590,2021-01-01,19194,17512,1682,8.8
51595,2021-01-01,2330,2075,255,10.9
51600,2021-01-01,12582,11985,597,4.7
51610,2021-01-01,8073,7762,311,3.9
51620,2021-01-01,3658,3318,340,9.3
51630,2021-01-01,13584,12688,896,6.6
51640,2021-01-01,2832,2668,164,5.8
51650,2021-01-01,62725,57733,4992,8
51660,2021-01-01,23355,22042,1313,5.6
51670,2021-01-01,9497,8473,1024,10.8
51678,2021-01-01,2068,1922,146,7.1
51680,2021-01-01,34700,32221,2479,7.1
51683,2021-01-01,20960,19757,1203,5.7
51685,2021-01-01,9137,8604,533,5.8
51690,2021-01-01,5638,5062,576,10.2
51700,2021-01-01,86951,80046,6905,7.9
51710,2021-01-01,108916,99724,9192,8.4
51720,2021-01-01,1636,1521,115,7
51730,2021-01-01,13156,11201,1955,14.9
51735,2021-01-01,6083,5857,226,3.7
51740,2021-01-01,43811,39492,4319,9.9
51750,2021-01-01,8131,7635,496,6.1
51760,2021-01-01,114986,105742,9244,8
51770,2021-01-01,47629,44304,3325,7
51775,2021-01-01,12268,11657,611,5
51790,2021-01-01,12067,11407,660,5.5
51800,2021-01-01,43487,40701,2786,6.4
51810,2021-01-01,222931,210955,11976,5.4
51820,2021-01-01,10544,9938,606,5.7
51830,2021-01-01,6454,6008,446,6.9
51840,2021-01-01,14529,13816,713,4.9
53001,2021-01-01,9567,8911,656,6.9
53003,2021-01-01,10130,9728,402,4
53005,2021-01-01,100024,93539,6485,6.5
53007,2021-01-01,41124,38286,2838,6.9
53009,2021-01-01,28420,26253,2167,7.6
53011,2021-01-01,230902,216303,14599,6.3
53013,2021-01-01,1672,1565,107,6.4
53015,2021-01-01,46574,43212,3362,7.2
53017,2021-01-01,20469,19003,1466,7.2
53019,2021-01-01,2367,2134,233,9.8
53021,2021-01-01,41997,38694,3303,7.9
53023,2021-01-01,785,731,54,6.9
53025,2021-01-01,46936,43170,3766,8
53027,2021-01-01,27734,25112,2622,9.5
53029,2021-01-01,36554,34342,2212,6.1
53031,2021-01-01,12154,11246,908,7.5
53033,2021-01-01,NA,NA,82270,6.3
53035,2021-01-01,123619,116355,7264,5.9
53037,2021-01-01,22262,20624,1638,7.4
53039,2021-01-01,9508,8821,687,7.2
53041,2021-01-01,35234,32843,2391,6.8
53043,2021-01-01,4576,4324,252,5.5
53045,2021-01-01,24101,22169,1932,8
53047,2021-01-01,18598,17080,1518,8.2
53049,2021-01-01,7890,7075,815,10.3
53051,2021-01-01,4785,4343,442,9.2
53053,2021-01-01,427320,397258,30062,7
53055,2021-01-01,7974,7444,530,6.6
53057,2021-01-01,59672,55275,4397,7.4
53059,2021-01-01,5318,4886,432,8.1
53061,2021-01-01,445498,412659,32839,7.4
53063,2021-01-01,246244,229685,16559,6.7
53065,2021-01-01,17926,16486,1440,8
53067,2021-01-01,139900,131483,8417,6
53069,2021-01-01,1521,1425,96,6.3
53071,2021-01-01,29400,27629,1771,6
53073,2021-01-01,109711,101921,7790,7.1
53075,2021-01-01,21441,20467,974,4.5
53077,2021-01-01,127152,116388,10764,8.5
54001,2021-01-01,7344,6808,536,7.3
54003,2021-01-01,57785,54937,2848,4.9
54005,2021-01-01,7280,6666,614,8.4
54007,2021-01-01,5029,4519,510,10.1
54009,2021-01-01,9871,9065,806,8.2
54011,2021-01-01,41787,39124,2663,6.4
54013,2021-01-01,2501,2075,426,17
54015,2021-01-01,3090,2744,346,11.2
54017,2021-01-01,3716,3491,225,6.1
54019,2021-01-01,15982,14560,1422,8.9
54021,2021-01-01,2296,2045,251,10.9
54023,2021-01-01,5980,5583,397,6.6
54025,2021-01-01,15369,14306,1063,6.9
54027,2021-01-01,10887,10360,527,4.8
54029,2021-01-01,13017,11904,1113,8.6
54031,2021-01-01,5848,5426,422,7.2
54033,2021-01-01,33408,31197,2211,6.6
54035,2021-01-01,12471,11486,985,7.9
54037,2021-01-01,29813,28492,1321,4.4
54039,2021-01-01,81061,75203,5858,7.2
54041,2021-01-01,6127,5487,640,10.4
54043,2021-01-01,7320,6651,669,9.1
54045,2021-01-01,10815,9803,1012,9.4
54047,2021-01-01,4370,3889,481,11
54049,2021-01-01,25340,23587,1753,6.9
54051,2021-01-01,13516,12317,1199,8.9
54053,2021-01-01,10368,9568,800,7.7
54055,2021-01-01,20573,18908,1665,8.1
54057,2021-01-01,12022,11244,778,6.5
54059,2021-01-01,6572,5833,739,11.2
54061,2021-01-01,54357,51623,2734,5
54063,2021-01-01,5959,5616,343,5.8
54065,2021-01-01,8410,7995,415,4.9
54067,2021-01-01,9550,8780,770,8.1
54069,2021-01-01,20263,18808,1455,7.2
54071,2021-01-01,3732,3577,155,4.2
54073,2021-01-01,2685,2400,285,10.6
54075,2021-01-01,4245,3977,268,6.3
54077,2021-01-01,15407,14440,967,6.3
54079,2021-01-01,26964,25419,1545,5.7
54081,2021-01-01,29854,27674,2180,7.3
54083,2021-01-01,12063,11052,1011,8.4
54085,2021-01-01,4334,3990,344,7.9
54087,2021-01-01,5079,4460,619,12.2
54089,2021-01-01,4244,3936,308,7.3
54091,2021-01-01,7760,7281,479,6.2
54093,2021-01-01,3371,3088,283,8.4
54095,2021-01-01,3179,2823,356,11.2
54097,2021-01-01,9349,8554,795,8.5
54099,2021-01-01,15841,14713,1128,7.1
54101,2021-01-01,3282,3022,260,7.9
54103,2021-01-01,6685,6038,647,9.7
54105,2021-01-01,2280,2034,246,10.8
54107,2021-01-01,36001,33240,2761,7.7
54109,2021-01-01,6417,5845,572,8.9
55001,2021-01-01,7825,7194,631,8.1
55003,2021-01-01,7346,6895,451,6.1
55005,2021-01-01,23920,22703,1217,5.1
55007,2021-01-01,7201,6626,575,8
55009,2021-01-01,139501,134024,5477,3.9
55011,2021-01-01,6342,5989,353,5.6
55013,2021-01-01,7015,6516,499,7.1
55015,2021-01-01,27302,26429,873,3.2
55017,2021-01-01,33582,31790,1792,5.3
55019,2021-01-01,17843,17096,747,4.2
55021,2021-01-01,30947,29571,1376,4.4
55023,2021-01-01,7541,7097,444,5.9
55025,2021-01-01,314543,303978,10565,3.4
55027,2021-01-01,47167,45284,1883,4
55029,2021-01-01,13802,12830,972,7
55031,2021-01-01,22235,21067,1168,5.3
55033,2021-01-01,23705,22628,1077,4.5
55035,2021-01-01,58631,56308,2323,4
55037,2021-01-01,2187,2068,119,5.4
55039,2021-01-01,56757,54575,2182,3.8
55041,2021-01-01,3809,3496,313,8.2
55043,2021-01-01,27416,26430,986,3.6
55045,2021-01-01,20587,19795,792,3.8
55047,2021-01-01,9095,8584,511,5.6
55049,2021-01-01,13497,12908,589,4.4
55051,2021-01-01,2530,2332,198,7.8
55053,2021-01-01,9616,8953,663,6.9
55055,2021-01-01,45325,43453,1872,4.1
55057,2021-01-01,13185,12432,753,5.7
55059,2021-01-01,86302,82067,4235,4.9
55061,2021-01-01,10893,10494,399,3.7
55063,2021-01-01,64207,61723,2484,3.9
55065,2021-01-01,9958,9626,332,3.3
55067,2021-01-01,9386,8880,506,5.4
55069,2021-01-01,14649,13954,695,4.7
55071,2021-01-01,40290,38552,1738,4.3
55073,2021-01-01,72490,69960,2530,3.5
55075,2021-01-01,19513,18467,1046,5.4
55077,2021-01-01,7695,7226,469,6.1
55078,2021-01-01,1569,1438,131,8.3
55079,2021-01-01,451522,424833,26689,5.9
55081,2021-01-01,23294,22351,943,4
55083,2021-01-01,20404,19414,990,4.9
55085,2021-01-01,17285,16263,1022,5.9
55087,2021-01-01,102640,98846,3794,3.7
55089,2021-01-01,47202,45517,1685,3.6
55091,2021-01-01,4054,3850,204,5
55093,2021-01-01,24356,23274,1082,4.4
55095,2021-01-01,24288,22869,1419,5.8
55097,2021-01-01,37255,35657,1598,4.3
55099,2021-01-01,6153,5853,300,4.9
55101,2021-01-01,95268,89999,5269,5.5
55103,2021-01-01,9132,8731,401,4.4
55105,2021-01-01,83441,79263,4178,5
55107,2021-01-01,6734,6371,363,5.4
55109,2021-01-01,48638,46489,2149,4.4
55111,2021-01-01,33584,31862,1722,5.1
55113,2021-01-01,7686,7170,516,6.7
55115,2021-01-01,21049,20099,950,4.5
55117,2021-01-01,61565,59385,2180,3.5
55119,2021-01-01,11438,10894,544,4.8
55121,2021-01-01,15570,14797,773,5
55123,2021-01-01,15053,14394,659,4.4
55125,2021-01-01,9956,9339,617,6.2
55127,2021-01-01,55422,52893,2529,4.6
55129,2021-01-01,7748,7269,479,6.2
55131,2021-01-01,74288,71516,2772,3.7
55133,2021-01-01,216091,208088,8003,3.7
55135,2021-01-01,25662,24556,1106,4.3
55137,2021-01-01,11297,10683,614,5.4
55139,2021-01-01,91551,88204,3347,3.7
55141,2021-01-01,34258,32400,1858,5.4
56001,2021-01-01,19120,18255,865,4.5
56003,2021-01-01,5294,4966,328,6.2
56005,2021-01-01,23062,21447,1615,7
56007,2021-01-01,8113,7673,440,5.4
56009,2021-01-01,7854,7325,529,6.7
56011,2021-01-01,3880,3726,154,4
56013,2021-01-01,19236,18006,1230,6.4
56015,2021-01-01,6662,6345,317,4.8
56017,2021-01-01,2248,2122,126,5.6
56019,2021-01-01,4082,3844,238,5.8
56021,2021-01-01,50814,48085,2729,5.4
56023,2021-01-01,9442,8948,494,5.2
56025,2021-01-01,40705,37357,3348,8.2
56027,2021-01-01,1284,1217,67,5.2
56029,2021-01-01,14784,13880,904,6.1
56031,2021-01-01,4715,4454,261,5.5
56033,2021-01-01,16179,15274,905,5.6
56035,2021-01-01,3945,3619,326,8.3
56037,2021-01-01,20516,18945,1571,7.7
56039,2021-01-01,14938,14314,624,4.2
56041,2021-01-01,9255,8666,589,6.4
56043,2021-01-01,4043,3822,221,5.5
56045,2021-01-01,3836,3689,147,3.8
72001,2021-01-01,4010,3435,575,14.3
72003,2021-01-01,11347,10275,1072,9.4
72005,2021-01-01,13798,12404,1394,10.1
72007,2021-01-01,6151,5522,629,10.2
72009,2021-01-01,6019,5410,609,10.1
72011,2021-01-01,8461,7752,709,8.4
72013,2021-01-01,22994,20856,2138,9.3
72015,2021-01-01,4447,3977,470,10.6
72017,2021-01-01,5519,4926,593,10.7
72019,2021-01-01,6864,6190,674,9.8
72021,2021-01-01,62149,56623,5526,8.9
72023,2021-01-01,13271,12100,1171,8.8
72025,2021-01-01,45128,41459,3669,8.1
72027,2021-01-01,9160,8419,741,8.1
72029,2021-01-01,15410,14061,1349,8.8
72031,2021-01-01,58613,53544,5069,8.6
72033,2021-01-01,7456,6746,710,9.5
72035,2021-01-01,15078,13990,1088,7.2
72037,2021-01-01,3422,3087,335,9.8
72039,2021-01-01,3522,3058,464,13.2
72041,2021-01-01,14373,13457,916,6.4
72043,2021-01-01,9469,8470,999,10.6
72045,2021-01-01,4644,4149,495,10.7
72047,2021-01-01,8524,7506,1018,11.9
72049,2021-01-01,911,843,68,7.5
72051,2021-01-01,12621,11710,911,7.2
72053,2021-01-01,10159,9081,1078,10.6
72054,2021-01-01,3106,2741,365,11.8
72055,2021-01-01,3923,3413,510,13
72057,2021-01-01,10402,9521,881,8.5
72059,2021-01-01,4477,3945,532,11.9
72061,2021-01-01,35702,33703,1999,5.6
72063,2021-01-01,17223,16164,1059,6.1
72065,2021-01-01,12774,11643,1131,8.9
72067,2021-01-01,5120,4653,467,9.1
72069,2021-01-01,16185,14719,1466,9.1
72071,2021-01-01,11167,10186,981,8.8
72073,2021-01-01,4188,3670,518,12.4
72075,2021-01-01,14608,13404,1204,8.2
72077,2021-01-01,11632,10542,1090,9.4
72079,2021-01-01,5039,4430,609,12.1
72081,2021-01-01,6592,5805,787,11.9
72083,2021-01-01,2359,2120,239,10.1
72085,2021-01-01,10675,9722,953,8.9
72087,2021-01-01,8016,7178,838,10.5
72089,2021-01-01,5880,5257,623,10.6
72091,2021-01-01,10683,9729,954,8.9
72093,2021-01-01,1806,1624,182,10.1
72095,2021-01-01,2622,2308,314,12
72097,2021-01-01,20406,18436,1970,9.7
72099,2021-01-01,9917,8945,972,9.8
72101,2021-01-01,7597,6777,820,10.8
72103,2021-01-01,7677,7019,658,8.6
72105,2021-01-01,6811,5991,820,12
72107,2021-01-01,4658,4054,604,13
72109,2021-01-01,4022,3547,475,11.8
72111,2021-01-01,5371,4710,661,12.3
72113,2021-01-01,42390,38411,3979,9.4
72115,2021-01-01,5814,5202,612,10.5
72117,2021-01-01,4391,3947,444,10.1
72119,2021-01-01,16208,14606,1602,9.9
72121,2021-01-01,5739,5154,585,10.2
72123,2021-01-01,6611,5880,731,11.1
72125,2021-01-01,9280,8345,935,10.1
72127,2021-01-01,128055,117766,10289,8
72129,2021-01-01,10898,9925,973,8.9
72131,2021-01-01,9659,8558,1101,11.4
72133,2021-01-01,9667,8942,725,7.5
72135,2021-01-01,25973,24049,1924,7.4
72137,2021-01-01,27680,25423,2257,8.2
72139,2021-01-01,25627,23927,1700,6.6
72141,2021-01-01,6228,5621,607,9.7
72143,2021-01-01,9327,8323,1004,10.8
72145,2021-01-01,12691,11248,1443,11.4
72147,2021-01-01,2698,2368,330,12.2
72149,2021-01-01,6846,5876,970,14.2
72151,2021-01-01,8268,7191,1077,13
72153,2021-01-01,9000,7770,1230,13.7
