fips,month,labor_force,employed,unemployed,unemployment_rate
01001,2020-01-01,26033,25272,761,2.9
01003,2020-01-01,95485,92615,2870,3
01005,2020-01-01,8353,8041,312,3.7
01007,2020-01-01,8572,8296,276,3.2
01009,2020-01-01,24940,24219,721,2.9
01011,2020-01-01,4687,4499,188,4
01013,2020-01-01,9039,8672,367,4.1
01015,2020-01-01,45916,44239,1677,3.7
01017,2020-01-01,15824,15333,491,3.1
01019,2020-01-01,11556,11187,369,3.2
01021,2020-01-01,19595,19052,543,2.8
01023,2020-01-01,4452,4220,232,5.2
01025,2020-01-01,7626,7183,443,5.8
01027,2020-01-01,6089,5900,189,3.1
01029,2020-01-01,5750,5567,183,3.2
01031,2020-01-01,21481,20843,638,3
01033,2020-01-01,23421,22475,946,4
01035,2020-01-01,4413,4230,183,4.1
01037,2020-01-01,4435,4286,149,3.4
01039,2020-01-01,15048,14512,536,3.6
01041,2020-01-01,6168,5960,208,3.4
01043,2020-01-01,38231,37173,1058,2.8
01045,2020-01-01,20383,19745,638,3.1
01047,2020-01-01,14298,13531,767,5.4
01049,2020-01-01,30788,29845,943,3.1
01051,2020-01-01,36948,35895,1053,2.8
01053,2020-01-01,14423,13894,529,3.7
01055,2020-01-01,41692,39970,1722,4.1
01057,2020-01-01,6597,6379,218,3.3
01059,2020-01-01,14449,14012,437,3
01061,2020-01-01,10750,10413,337,3.1
01063,2020-01-01,2976,2817,159,5.3
01065,2020-01-01,5994,5742,252,4.2
01067,2020-01-01,6809,6558,251,3.7
01069,2020-01-01,46096,44671,1425,3.1
01071,2020-01-01,22799,21971,828,3.6
01073,2020-01-01,314893,305612,9281,2.9
01075,2020-01-01,5692,5506,186,3.3
01077,2020-01-01,41838,40432,1406,3.4
01079,2020-01-01,14239,13778,461,3.2
01081,2020-01-01,76083,73951,2132,2.8
01083,2020-01-01,44656,43449,1207,2.7
01085,2020-01-01,3433,3244,189,5.5
01087,2020-01-01,7895,7579,316,4
01089,2020-01-01,186963,182096,4867,2.6
01091,2020-01-01,7800,7510,290,3.7
01093,2020-01-01,12772,12291,481,3.8
01095,2020-01-01,43835,42700,1135,2.6
01097,2020-01-01,188287,181069,7218,3.8
01099,2020-01-01,7376,6996,380,5.2
01101,2020-01-01,105219,101835,3384,3.2
01103,2020-01-01,58576,57017,1559,2.7
01105,2020-01-01,3230,3064,166,5.1
01107,2020-01-01,7860,7584,276,3.5
01109,2020-01-01,15399,14883,516,3.4
01111,2020-01-01,9349,9047,302,3.2
01113,2020-01-01,23781,23048,733,3.1
01115,2020-01-01,40403,39275,1128,2.8
01117,2020-01-01,115727,113062,2665,2.3
01119,2020-01-01,4594,4399,195,4.2
01121,2020-01-01,35772,34498,1274,3.6
01123,2020-01-01,17867,17267,600,3.4
01125,2020-01-01,105302,102462,2840,2.7
01127,2020-01-01,25035,24097,938,3.7
01129,2020-01-01,6567,6245,322,4.9
01131,2020-01-01,2699,2466,233,8.6
01133,2020-01-01,10157,9796,361,3.6
02013,2020-01-01,2276,2214,62,2.7
02016,2020-01-01,4049,3939,110,2.7
02020,2020-01-01,150045,143738,6307,4.2
02050,2020-01-01,7346,6596,750,10.2
02060,2020-01-01,225,196,29,12.9
02068,2020-01-01,572,479,93,16.3
02070,2020-01-01,1653,1522,131,7.9
02090,2020-01-01,45199,43054,2145,4.7
02100,2020-01-01,912,791,121,13.3
02105,2020-01-01,1016,873,143,14.1
02110,2020-01-01,16532,15876,656,4
02122,2020-01-01,25770,24055,1715,6.7
02130,2020-01-01,6306,5883,423,6.7
02150,2020-01-01,5546,5177,369,6.7
02158,2020-01-01,2308,1893,415,18
02164,2020-01-01,562,505,57,10.1
02170,2020-01-01,48805,45844,2961,6.1
02180,2020-01-01,4066,3708,358,8.8
02185,2020-01-01,3868,3686,182,4.7
02188,2020-01-01,2920,2597,323,11.1
02195,2020-01-01,1372,1245,127,9.3
02198,2020-01-01,2730,2492,238,8.7
02220,2020-01-01,3861,3691,170,4.4
02230,2020-01-01,534,430,104,19.5
02240,2020-01-01,2884,2648,236,8.2
02261,2020-01-01,3973,3585,388,9.8
02275,2020-01-01,985,914,71,7.2
02282,2020-01-01,242,216,26,10.7
02290,2020-01-01,2270,1997,273,12
04001,2020-01-01,20946,18588,2358,11.3
04003,2020-01-01,51646,48600,3046,5.9
04005,2020-01-01,76940,71851,5089,6.6
04007,2020-01-01,20955,19679,1276,6.1
04009,2020-01-01,15626,14824,802,5.1
04011,2020-01-01,4509,4334,175,3.9
04012,2020-01-01,9478,8880,598,6.3
04013,2020-01-01,NA,NA,97646,4.2
04015,2020-01-01,88203,82771,5432,6.2
04017,2020-01-01,40290,36866,3424,8.5
04019,2020-01-01,498831,475526,23305,4.7
04021,2020-01-01,193554,183696,9858,5.1
04023,2020-01-01,20100,18456,1644,8.2
04025,2020-01-01,107161,102172,4989,4.7
04027,2020-01-01,101528,87258,14270,14.1
05001,2020-01-01,9446,9109,337,3.6
05003,2020-01-01,7230,6679,551,7.6
05005,2020-01-01,16353,15585,768,4.7
05007,2020-01-01,139537,135355,4182,3
05009,2020-01-01,15872,15248,624,3.9
05011,2020-01-01,4485,4275,210,4.7
05013,2020-01-01,2451,2325,126,5.1
05015,2020-01-01,12543,11988,555,4.4
05017,2020-01-01,3209,2921,288,9
05019,2020-01-01,9422,9016,406,4.3
05021,2020-01-01,5557,5220,337,6.1
05023,2020-01-01,9073,8551,522,5.8
05025,2020-01-01,3197,3031,166,5.2
05027,2020-01-01,9184,8725,459,5
05029,2020-01-01,8379,7963,416,5
05031,2020-01-01,56015,54155,1860,3.3
05033,2020-01-01,26464,25426,1038,3.9
05035,2020-01-01,21010,19990,1020,4.9
05037,2020-01-01,7408,7046,362,4.9
05039,2020-01-01,2770,2632,138,5
05041,2020-01-01,5409,5123,286,5.3
05043,2020-01-01,7872,7386,486,6.2
05045,2020-01-01,62524,60323,2201,3.5
05047,2020-01-01,7437,7146,291,3.9
05049,2020-01-01,4998,4774,224,4.5
05051,2020-01-01,40686,38970,1716,4.2
05053,2020-01-01,8405,8075,330,3.9
05055,2020-01-01,19718,18880,838,4.2
05057,2020-01-01,9732,9287,445,4.6
05059,2020-01-01,14159,13604,555,3.9
05061,2020-01-01,5579,5347,232,4.2
05063,2020-01-01,16660,15895,765,4.6
05065,2020-01-01,4721,4401,320,6.8
05067,2020-01-01,5830,5391,439,7.5
05069,2020-01-01,27103,25385,1718,6.3
05071,2020-01-01,10309,9810,499,4.8
05073,2020-01-01,2402,2267,135,5.6
05075,2020-01-01,6887,6557,330,4.8
05077,2020-01-01,2799,2617,182,6.5
05079,2020-01-01,3849,3632,217,5.6
05081,2020-01-01,5474,5197,277,5.1
05083,2020-01-01,8695,8237,458,5.3
05085,2020-01-01,34037,32790,1247,3.7
05087,2020-01-01,7427,7215,212,2.9
05089,2020-01-01,6427,6098,329,5.1
05091,2020-01-01,19473,18580,893,4.6
05093,2020-01-01,17346,16343,1003,5.8
05095,2020-01-01,2737,2598,139,5.1
05097,2020-01-01,2904,2725,179,6.2
05099,2020-01-01,3559,3410,149,4.2
05101,2020-01-01,3305,3143,162,4.9
05103,2020-01-01,9878,9313,565,5.7
05105,2020-01-01,4291,4084,207,4.8
05107,2020-01-01,6315,5849,466,7.4
05109,2020-01-01,4210,4008,202,4.8
05111,2020-01-01,10071,9616,455,4.5
05113,2020-01-01,8098,7600,498,6.1
05115,2020-01-01,28177,26749,1428,5.1
05117,2020-01-01,3611,3455,156,4.3
05119,2020-01-01,188358,180969,7389,3.9
05121,2020-01-01,7369,7013,356,4.8
05123,2020-01-01,8164,7696,468,5.7
05125,2020-01-01,59085,57153,1932,3.3
05127,2020-01-01,4398,4224,174,4
05129,2020-01-01,2798,2620,178,6.4
05131,2020-01-01,55935,53688,2247,4
05133,2020-01-01,5502,5191,311,5.7
05135,2020-01-01,5731,5385,346,6
05137,2020-01-01,4543,4266,277,6.1
05139,2020-01-01,15686,14654,1032,6.6
05141,2020-01-01,5727,5380,347,6.1
05143,2020-01-01,125189,121719,3470,2.8
05145,2020-01-01,34083,32232,1851,5.4
05147,2020-01-01,2823,2657,166,5.9
05149,2020-01-01,8143,7774,369,4.5
06001,2020-01-01,837978,811745,26233,3.1
06003,2020-01-01,647,617,30,4.6
06005,2020-01-01,14707,13994,713,4.8
06007,2020-01-01,96273,90837,5436,5.6
06009,2020-01-01,21496,20551,945,4.4
06011,2020-01-01,10606,8487,2119,20
06013,2020-01-01,557538,539165,18373,3.3
06015,2020-01-01,9606,8966,640,6.7
06017,2020-01-01,92189,88667,3522,3.8
06019,2020-01-01,451090,413821,37269,8.3
06021,2020-01-01,12862,11873,989,7.7
06023,2020-01-01,61101,58552,2549,4.2
06025,2020-01-01,72747,58296,14451,19.9
06027,2020-01-01,8616,8271,345,4
06029,2020-01-01,393050,358522,34528,8.8
06031,2020-01-01,57665,52103,5562,9.6
06033,2020-01-01,28615,26825,1790,6.3
06035,2020-01-01,9400,8838,562,6
06037,2020-01-01,NA,NA,253528,4.9
06039,2020-01-01,63280,58077,5203,8.2
06041,2020-01-01,137803,134378,3425,2.5
06043,2020-01-01,7447,6999,448,6
06045,2020-01-01,38158,36296,1862,4.9
06047,2020-01-01,115790,104292,11498,9.9
06049,2020-01-01,3046,2739,307,10.1
06051,2020-01-01,9116,8787,329,3.6
06053,2020-01-01,209703,188533,21170,10.1
06055,2020-01-01,70489,67915,2574,3.7
06057,2020-01-01,48766,46944,1822,3.7
06059,2020-01-01,NA,NA,47330,2.9
06061,2020-01-01,188740,182393,6347,3.4
06063,2020-01-01,7413,6613,800,10.8
06065,2020-01-01,NA,NA,47714,4.3
06067,2020-01-01,710992,682762,28230,4
06069,2020-01-01,32341,30344,1997,6.2
06071,2020-01-01,978079,939448,38631,3.9
06073,2020-01-01,NA,NA,53959,3.4
06075,2020-01-01,580748,567025,13723,2.4
06077,2020-01-01,329406,307123,22283,6.8
06079,2020-01-01,138446,133973,4473,3.2
06081,2020-01-01,456952,446947,10005,2.2
06083,2020-01-01,219246,209052,10194,4.6
06085,2020-01-01,NA,NA,28109,2.7
06087,2020-01-01,138391,129618,8773,6.3
06089,2020-01-01,73626,69547,4079,5.5
06091,2020-01-01,1305,1221,84,6.4
06093,2020-01-01,16953,15516,1437,8.5
06095,2020-01-01,206403,197809,8594,4.2
06097,2020-01-01,254136,246417,7719,3
06099,2020-01-01,240700,224351,16349,6.8
06101,2020-01-01,45219,41090,4129,9.1
06103,2020-01-01,25914,24244,1670,6.4
06105,2020-01-01,4392,4085,307,7
06107,2020-01-01,204502,181688,22814,11.2
06109,2020-01-01,20439,19374,1065,5.2
06111,2020-01-01,419789,403087,16702,4
06113,2020-01-01,107924,102424,5500,5.1
06115,2020-01-01,30209,27992,2217,7.3
08001,2020-01-01,275696,267118,8578,3.1
08003,2020-01-01,8249,7925,324,3.9
08005,2020-01-01,367609,357381,10228,2.8
08007,2020-01-01,6678,6442,236,3.5
08009,2020-01-01,2108,2066,42,2
08011,2020-01-01,1844,1792,52,2.8
08013,2020-01-01,195246,190604,4642,2.4
08014,2020-01-01,40799,39782,1017,2.5
08015,2020-01-01,9396,9131,265,2.8
08017,2020-01-01,1096,1077,19,1.7
08019,2020-01-01,6085,5944,141,2.3
08021,2020-01-01,4026,3865,161,4
08023,2020-01-01,1823,1745,78,4.3
08025,2020-01-01,1536,1461,75,4.9
08027,2020-01-01,2023,1958,65,3.2
08029,2020-01-01,13982,13394,588,4.2
08031,2020-01-01,423254,411344,11910,2.8
08033,2020-01-01,1109,1064,45,4.1
08035,2020-01-01,198724,194046,4678,2.4
08037,2020-01-01,38888,38085,803,2.1
08039,2020-01-01,15353,14991,362,2.4
08041,2020-01-01,343639,332291,11348,3.3
08043,2020-01-01,14700,13972,728,5
08045,2020-01-01,33481,32415,1066,3.2
08047,2020-01-01,3849,3757,92,2.4
08049,2020-01-01,10373,10135,238,2.3
08051,2020-01-01,11515,11261,254,2.2
08053,2020-01-01,387,373,14,3.6
08055,2020-01-01,2532,2352,180,7.1
08057,2020-01-01,894,870,24,2.7
08059,2020-01-01,336534,327680,8854,2.6
08061,2020-01-01,941,927,14,1.5
08063,2020-01-01,4285,4206,79,1.8
08065,2020-01-01,5275,5167,108,2
08067,2020-01-01,31213,30322,891,2.9
08069,2020-01-01,204578,199252,5326,2.6
08071,2020-01-01,6343,6097,246,3.9
08073,2020-01-01,2350,2279,71,3
08075,2020-01-01,10907,10613,294,2.7
08077,2020-01-01,75811,72711,3100,4.1
08079,2020-01-01,570,557,13,2.3
08081,2020-01-01,7350,7052,298,4.1
08083,2020-01-01,12467,11788,679,5.4
08085,2020-01-01,21459,20721,738,3.4
08087,2020-01-01,16234,15800,434,2.7
08089,2020-01-01,8120,7774,346,4.3
08091,2020-01-01,2366,2288,78,3.3
08093,2020-01-01,11286,10998,288,2.6
08095,2020-01-01,2510,2467,43,1.7
08097,2020-01-01,11276,11001,275,2.4
08099,2020-01-01,6150,5987,163,2.7
08101,2020-01-01,77202,73981,3221,4.2
08103,2020-01-01,2899,2789,110,3.8
08105,2020-01-01,5294,5017,277,5.2
08107,2020-01-01,17197,16837,360,2.1
08109,2020-01-01,3414,3248,166,4.9
08111,2020-01-01,499,482,17,3.4
08113,2020-01-01,6177,6062,115,1.9
08115,2020-01-01,1161,1132,29,2.5
08117,2020-01-01,25734,25322,412,1.6
08119,2020-01-01,12871,12469,402,3.1
08121,2020-01-01,2878,2816,62,2.2
08123,2020-01-01,169082,164310,4772,2.8
08125,2020-01-01,5555,5448,107,1.9
09001,2020-01-01,480477,460270,20207,4.2
09003,2020-01-01,485063,464451,20612,4.2
09005,2020-01-01,105396,100905,4491,4.3
09007,2020-01-01,94699,91033,3666,3.9
09009,2020-01-01,463643,443343,20300,4.4
09011,2020-01-01,135359,129530,5829,4.3
09013,2020-01-01,87621,84238,3383,3.9
09015,2020-01-01,64295,61326,2969,4.6
10001,2020-01-01,81339,77280,4059,5
10003,2020-01-01,304697,291541,13156,4.3
10005,2020-01-01,106320,100696,5624,5.3
11001,2020-01-01,421801,400775,21026,5
12001,2020-01-01,140322,135642,4680,3.3
12003,2020-01-01,12145,11702,443,3.6
12005,2020-01-01,83343,80118,3225,3.9
12007,2020-01-01,10903,10486,417,3.8
12009,2020-01-01,287001,276503,10498,3.7
12011,2020-01-01,NA,NA,35692,3.4
12013,2020-01-01,4833,4631,202,4.2
12015,2020-01-01,73397,70372,3025,4.1
12017,2020-01-01,47453,44788,2665,5.6
12019,2020-01-01,108490,104686,3804,3.5
12021,2020-01-01,188531,182193,6338,3.4
12023,2020-01-01,29962,28865,1097,3.7
12027,2020-01-01,15078,14483,595,3.9
12029,2020-01-01,5987,5726,261,4.4
12031,2020-01-01,492122,473965,18157,3.7
12033,2020-01-01,145807,140206,5601,3.8
12035,2020-01-01,48110,46022,2088,4.3
12037,2020-01-01,4629,4467,162,3.5
12039,2020-01-01,18843,17986,857,4.5
12041,2020-01-01,7366,7081,285,3.9
12043,2020-01-01,5430,5194,236,4.3
12045,2020-01-01,5109,4881,228,4.5
12047,2020-01-01,4242,4018,224,5.3
12049,2020-01-01,8629,8182,447,5.2
12051,2020-01-01,15947,15007,940,5.9
12053,2020-01-01,72967,69504,3463,4.7
12055,2020-01-01,35864,33978,1886,5.3
12057,2020-01-01,767770,741276,26494,3.5
12059,2020-01-01,7013,6714,299,4.3
12061,2020-01-01,67226,64419,2807,4.2
12063,2020-01-01,17243,16569,674,3.9
12065,2020-01-01,5567,5358,209,3.8
12067,2020-01-01,2879,2783,96,3.3
12069,2020-01-01,163324,157275,6049,3.7
12071,2020-01-01,357358,344717,12641,3.5
12073,2020-01-01,156482,150937,5545,3.5
12075,2020-01-01,16928,16222,706,4.2
12077,2020-01-01,2695,2592,103,3.8
12079,2020-01-01,7624,7316,308,4
12081,2020-01-01,182554,176035,6519,3.6
12083,2020-01-01,140636,134520,6116,4.3
12085,2020-01-01,74651,72016,2635,3.5
12086,2020-01-01,NA,NA,25413,1.8
12087,2020-01-01,47378,46265,1113,2.3
12089,2020-01-01,42301,40853,1448,3.4
12091,2020-01-01,95775,92660,3115,3.3
12093,2020-01-01,17929,17288,641,3.6
12095,2020-01-01,765403,739898,25505,3.3
12097,2020-01-01,187229,180170,7059,3.8
12099,2020-01-01,747078,720307,26771,3.6
12101,2020-01-01,243356,233632,9724,4
12103,2020-01-01,492480,475595,16885,3.4
12105,2020-01-01,312921,299913,13008,4.2
12107,2020-01-01,26561,25188,1373,5.2
12109,2020-01-01,137298,133109,4189,3.1
12111,2020-01-01,148914,142414,6500,4.4
12113,2020-01-01,84212,81305,2907,3.5
12115,2020-01-01,190764,183969,6795,3.6
12117,2020-01-01,256173,247587,8586,3.4
12119,2020-01-01,33545,31761,1784,5.3
12121,2020-01-01,18311,17593,718,3.9
12123,2020-01-01,8229,7904,325,3.9
12125,2020-01-01,4658,4495,163,3.5
12127,2020-01-01,256443,246242,10201,4
12129,2020-01-01,15559,15043,516,3.3
12131,2020-01-01,31898,30808,1090,3.4
12133,2020-01-01,9801,9398,403,4.1
13001,2020-01-01,9620,9232,388,4
13003,2020-01-01,4639,4496,143,3.1
13005,2020-01-01,5001,4803,198,4
13007,2020-01-01,1243,1190,53,4.3
13009,2020-01-01,18034,17193,841,4.7
13011,2020-01-01,10143,9846,297,2.9
13013,2020-01-01,41839,40586,1253,3
13015,2020-01-01,51600,49741,1859,3.6
13017,2020-01-01,5530,5213,317,5.7
13019,2020-01-01,7740,7374,366,4.7
13021,2020-01-01,68613,65873,2740,4
13023,2020-01-01,4663,4428,235,5
13025,2020-01-01,7346,7037,309,4.2
13027,2020-01-01,7194,6925,269,3.7
13029,2020-01-01,19326,18727,599,3.1
13031,2020-01-01,37830,36332,1498,4
13033,2020-01-01,9404,8881,523,5.6
13035,2020-01-01,11141,10756,385,3.5
13037,2020-01-01,2418,2326,92,3.8
13039,2020-01-01,21519,20718,801,3.7
13043,2020-01-01,5785,5620,165,2.9
13045,2020-01-01,56464,54375,2089,3.7
13047,2020-01-01,33741,32689,1052,3.1
13049,2020-01-01,5043,4847,196,3.9
13051,2020-01-01,142004,137145,4859,3.4
13053,2020-01-01,2071,1980,91,4.4
13055,2020-01-01,10195,9678,517,5.1
13057,2020-01-01,138603,134735,3868,2.8
13059,2020-01-01,60699,58524,2175,3.6
13061,2020-01-01,912,841,71,7.8
13063,2020-01-01,139902,133674,6228,4.5
13065,2020-01-01,2945,2837,108,3.7
13067,2020-01-01,428385,415104,13281,3.1
13069,2020-01-01,19182,18344,838,4.4
13071,2020-01-01,22532,21837,695,3.1
13073,2020-01-01,77288,74845,2443,3.2
13075,2020-01-01,8303,8015,288,3.5
13077,2020-01-01,76310,73986,2324,3
13079,2020-01-01,5725,5538,187,3.3
13081,2020-01-01,9707,9270,437,4.5
13083,2020-01-01,8157,7876,281,3.4
13085,2020-01-01,12871,12497,374,2.9
13087,2020-01-01,11820,11353,467,4
13089,2020-01-01,402269,387848,14421,3.6
13091,2020-01-01,7145,6730,415,5.8
13093,2020-01-01,5177,4973,204,3.9
13095,2020-01-01,38486,36603,1883,4.9
13097,2020-01-01,73985,71269,2716,3.7
13099,2020-01-01,4584,4385,199,4.3
13101,2020-01-01,2039,1978,61,3
13103,2020-01-01,32483,31525,958,2.9
13105,2020-01-01,8115,7770,345,4.3
13107,2020-01-01,8697,8241,456,5.2
13109,2020-01-01,5025,4844,181,3.6
13111,2020-01-01,11325,10922,403,3.6
13113,2020-01-01,58668,56894,1774,3
13115,2020-01-01,44370,42572,1798,4.1
13117,2020-01-01,126412,122941,3471,2.7
13119,2020-01-01,10258,9861,397,3.9
13121,2020-01-01,566508,546082,20426,3.6
13123,2020-01-01,12341,11906,435,3.5
13125,2020-01-01,1317,1264,53,4
13127,2020-01-01,39051,37681,1370,3.5
13129,2020-01-01,28956,27882,1074,3.7
13131,2020-01-01,11033,10663,370,3.4
13133,2020-01-01,7210,6917,293,4.1
13135,2020-01-01,495405,479901,15504,3.1
13137,2020-01-01,19546,18761,785,4
13139,2020-01-01,104592,101590,3002,2.9
13141,2020-01-01,2632,2476,156,5.9
13143,2020-01-01,12711,12264,447,3.5
13145,2020-01-01,17174,16639,535,3.1
13147,2020-01-01,11749,11271,478,4.1
13149,2020-01-01,5324,5125,199,3.7
13151,2020-01-01,118240,113975,4265,3.6
13153,2020-01-01,72114,69693,2421,3.4
13155,2020-01-01,3575,3397,178,5
13157,2020-01-01,39835,38771,1064,2.7
13159,2020-01-01,7097,6862,235,3.3
13161,2020-01-01,6346,6050,296,4.7
13163,2020-01-01,6912,6552,360,5.2
13165,2020-01-01,3236,3084,152,4.7
13167,2020-01-01,4135,3967,168,4.1
13169,2020-01-01,13947,13488,459,3.3
13171,2020-01-01,8295,7952,343,4.1
13173,2020-01-01,3860,3698,162,4.2
13175,2020-01-01,19704,18707,997,5.1
13177,2020-01-01,15455,14960,495,3.2
13179,2020-01-01,26180,25137,1043,4
13181,2020-01-01,3687,3519,168,4.6
13183,2020-01-01,8479,8171,308,3.6
13185,2020-01-01,52657,50673,1984,3.8
13187,2020-01-01,17187,16646,541,3.1
13189,2020-01-01,8916,8435,481,5.4
13191,2020-01-01,6219,6002,217,3.5
13193,2020-01-01,4840,4611,229,4.7
13195,2020-01-01,13646,13205,441,3.2
13197,2020-01-01,3348,3199,149,4.5
13199,2020-01-01,8998,8610,388,4.3
13201,2020-01-01,2939,2838,101,3.4
13205,2020-01-01,8825,8397,428,4.8
13207,2020-01-01,13194,12753,441,3.3
13209,2020-01-01,4015,3832,183,4.6
13211,2020-01-01,9560,9254,306,3.2
13213,2020-01-01,15782,14883,899,5.7
13215,2020-01-01,78517,74946,3571,4.5
13217,2020-01-01,53491,51415,2076,3.9
13219,2020-01-01,20355,19844,511,2.5
13221,2020-01-01,7233,6994,239,3.3
13223,2020-01-01,88821,86084,2737,3.1
13225,2020-01-01,12139,11647,492,4.1
13227,2020-01-01,15632,15139,493,3.2
13229,2020-01-01,8824,8521,303,3.4
13231,2020-01-01,9121,8821,300,3.3
13233,2020-01-01,18859,18125,734,3.9
13235,2020-01-01,4157,3997,160,3.8
13237,2020-01-01,8537,8161,376,4.4
13239,2020-01-01,815,778,37,4.5
13241,2020-01-01,7376,7110,266,3.6
13243,2020-01-01,2653,2536,117,4.4
13245,2020-01-01,86924,82671,4253,4.9
13247,2020-01-01,45099,43304,1795,4
13249,2020-01-01,2254,2168,86,3.8
13251,2020-01-01,5177,4944,233,4.5
13253,2020-01-01,3252,3118,134,4.1
13255,2020-01-01,29119,27890,1229,4.2
13257,2020-01-01,10761,10326,435,4
13259,2020-01-01,2627,2519,108,4.1
13261,2020-01-01,12995,12304,691,5.3
13263,2020-01-01,2833,2720,113,4
13265,2020-01-01,546,512,34,6.2
13267,2020-01-01,10178,9777,401,3.9
13269,2020-01-01,2803,2686,117,4.2
13271,2020-01-01,4012,3596,416,10.4
13273,2020-01-01,3618,3446,172,4.8
13275,2020-01-01,17278,16594,684,4
13277,2020-01-01,21064,20363,701,3.3
13279,2020-01-01,12338,11732,606,4.9
13281,2020-01-01,3864,3665,199,5.2
13283,2020-01-01,2763,2611,152,5.5
13285,2020-01-01,38573,37381,1192,3.1
13287,2020-01-01,3390,3231,159,4.7
13289,2020-01-01,2923,2742,181,6.2
13291,2020-01-01,10706,10343,363,3.4
13293,2020-01-01,11656,11209,447,3.8
13295,2020-01-01,31655,30555,1100,3.5
13297,2020-01-01,46797,45298,1499,3.2
13299,2020-01-01,15757,15140,617,3.9
13301,2020-01-01,2751,2622,129,4.7
13303,2020-01-01,7064,6734,330,4.7
13305,2020-01-01,11598,11114,484,4.2
13307,2020-01-01,1064,1013,51,4.8
13309,2020-01-01,1717,1588,129,7.5
13311,2020-01-01,16681,16226,455,2.7
13313,2020-01-01,44554,41982,2572,5.8
13315,2020-01-01,2853,2736,117,4.1
13317,2020-01-01,3846,3636,210,5.5
13319,2020-01-01,3993,3840,153,3.8
13321,2020-01-01,9308,8956,352,3.8
15001,2020-01-01,91714,89388,2326,2.5
15003,2020-01-01,460501,451481,9020,2
15007,2020-01-01,37020,36224,796,2.2
15009,2020-01-01,88151,86366,1785,2
16001,2020-01-01,257614,250850,6764,2.6
16003,2020-01-01,1706,1589,117,6.9
16005,2020-01-01,41996,40628,1368,3.3
16007,2020-01-01,2930,2817,113,3.9
16009,2020-01-01,4028,3808,220,5.5
16011,2020-01-01,23179,22442,737,3.2
16013,2020-01-01,12980,12630,350,2.7
16015,2020-01-01,3588,3414,174,4.8
16017,2020-01-01,20718,19729,989,4.8
16019,2020-01-01,57721,56126,1595,2.8
16021,2020-01-01,5268,4993,275,5.2
16023,2020-01-01,1362,1314,48,3.5
16025,2020-01-01,681,660,21,3.1
16027,2020-01-01,105506,101648,3858,3.7
16029,2020-01-01,4029,3891,138,3.4
16031,2020-01-01,12032,11713,319,2.7
16033,2020-01-01,355,336,19,5.4
16035,2020-01-01,2931,2761,170,5.8
16037,2020-01-01,2007,1903,104,5.2
16039,2020-01-01,11623,11218,405,3.5
16041,2020-01-01,6976,6805,171,2.5
16043,2020-01-01,7811,7544,267,3.4
16045,2020-01-01,8357,8039,318,3.8
16047,2020-01-01,8122,7865,257,3.2
16049,2020-01-01,6486,6154,332,5.1
16051,2020-01-01,13947,13550,397,2.8
16053,2020-01-01,12098,11728,370,3.1
16055,2020-01-01,79843,76319,3524,4.4
16057,2020-01-01,20559,20006,553,2.7
16059,2020-01-01,3501,3290,211,6
16061,2020-01-01,1570,1468,102,6.5
16063,2020-01-01,2736,2618,118,4.3
16065,2020-01-01,22480,22061,419,1.9
16067,2020-01-01,11254,10918,336,3
16069,2020-01-01,21015,20299,716,3.4
16071,2020-01-01,2268,2205,63,2.8
16073,2020-01-01,5297,5069,228,4.3
16075,2020-01-01,11754,11304,450,3.8
16077,2020-01-01,3813,3650,163,4.3
16079,2020-01-01,5529,5188,341,6.2
16081,2020-01-01,6349,6211,138,2.2
16083,2020-01-01,41060,39690,1370,3.3
16085,2020-01-01,5582,5344,238,4.3
16087,2020-01-01,4637,4443,194,4.2
17001,2020-01-01,31452,30454,998,3.2
17003,2020-01-01,1918,1812,106,5.5
17005,2020-01-01,7603,7332,271,3.6
17007,2020-01-01,26384,23979,2405,9.1
17009,2020-01-01,3015,2952,63,2.1
17011,2020-01-01,16346,15467,879,5.4
17013,2020-01-01,2268,2167,101,4.5
17015,2020-01-01,7069,6750,319,4.5
17017,2020-01-01,5896,5659,237,4
17019,2020-01-01,110214,106863,3351,3
17021,2020-01-01,13758,13090,668,4.9
17023,2020-01-01,7426,7099,327,4.4
17025,2020-01-01,6280,5986,294,4.7
17027,2020-01-01,20326,19705,621,3.1
17029,2020-01-01,23818,23037,781,3.3
17031,2020-01-01,NA,NA,98008,3.8
17033,2020-01-01,8444,8102,342,4.1
17035,2020-01-01,6033,5835,198,3.3
17037,2020-01-01,54752,52406,2346,4.3
17039,2020-01-01,7235,6952,283,3.9
17041,2020-01-01,10126,9819,307,3
17043,2020-01-01,499348,484512,14836,3
17045,2020-01-01,8791,8463,328,3.7
17047,2020-01-01,2596,2486,110,4.2
17049,2020-01-01,19527,18940,587,3
17051,2020-01-01,9595,9170,425,4.4
17053,2020-01-01,6246,5984,262,4.2
17055,2020-01-01,15974,15185,789,4.9
17057,2020-01-01,14793,13951,842,5.7
17059,2020-01-01,2106,1996,110,5.2
17061,2020-01-01,5872,5638,234,4
17063,2020-01-01,25328,23991,1337,5.3
17065,2020-01-01,4273,4133,140,3.3
17067,2020-01-01,7990,7626,364,4.6
17069,2020-01-01,1258,1177,81,6.4
17071,2020-01-01,3462,3301,161,4.7
17073,2020-01-01,24412,23235,1177,4.8
17075,2020-01-01,13590,12939,651,4.8
17077,2020-01-01,27118,26224,894,3.3
17079,2020-01-01,4515,4324,191,4.2
17081,2020-01-01,17042,16361,681,4
17083,2020-01-01,10936,10485,451,4.1
17085,2020-01-01,10331,9793,538,5.2
17087,2020-01-01,4073,3843,230,5.6
17089,2020-01-01,269045,256828,12217,4.5
17091,2020-01-01,55753,52889,2864,5.1
17093,2020-01-01,68625,66133,2492,3.6
17095,2020-01-01,20948,19989,959,4.6
17097,2020-01-01,372170,356725,15445,4.1
17099,2020-01-01,54352,51325,3027,5.6
17101,2020-01-01,5820,5543,277,4.8
17103,2020-01-01,17279,16598,681,3.9
17105,2020-01-01,15796,15138,658,4.2
17107,2020-01-01,12314,11839,475,3.9
17109,2020-01-01,13008,12529,479,3.7
17111,2020-01-01,163734,157589,6145,3.8
17113,2020-01-01,86565,83839,2726,3.1
17115,2020-01-01,47418,45121,2297,4.8
17117,2020-01-01,22671,21768,903,4
17119,2020-01-01,133847,129268,4579,3.4
17121,2020-01-01,17106,16418,688,4
17123,2020-01-01,5168,4908,260,5
17125,2020-01-01,5987,5652,335,5.6
17127,2020-01-01,5510,5227,283,5.1
17129,2020-01-01,6319,6062,257,4.1
17131,2020-01-01,7862,7402,460,5.9
17133,2020-01-01,18983,18477,506,2.7
17135,2020-01-01,11406,10750,656,5.8
17137,2020-01-01,15995,15360,635,4
17139,2020-01-01,7381,7165,216,2.9
17141,2020-01-01,24474,23098,1376,5.6
17143,2020-01-01,83762,79501,4261,5.1
17145,2020-01-01,8027,7677,350,4.4
17147,2020-01-01,8595,8316,279,3.2
17149,2020-01-01,6698,6392,306,4.6
17151,2020-01-01,1614,1532,82,5.1
17153,2020-01-01,1738,1626,112,6.4
17155,2020-01-01,2937,2753,184,6.3
17157,2020-01-01,13744,13259,485,3.5
17159,2020-01-01,7194,6934,260,3.6
17161,2020-01-01,69729,66386,3343,4.8
17163,2020-01-01,126213,121413,4800,3.8
17165,2020-01-01,9387,8894,493,5.3
17167,2020-01-01,98700,95082,3618,3.7
17169,2020-01-01,3105,2969,136,4.4
17171,2020-01-01,2404,2275,129,5.4
17173,2020-01-01,10326,9925,401,3.9
17175,2020-01-01,2404,2271,133,5.5
17177,2020-01-01,21142,20155,987,4.7
17179,2020-01-01,63011,60184,2827,4.5
17181,2020-01-01,7275,6856,419,5.8
17183,2020-01-01,32537,31038,1499,4.6
17185,2020-01-01,5661,5484,177,3.1
17187,2020-01-01,8112,7813,299,3.7
17189,2020-01-01,9636,9416,220,2.3
17191,2020-01-01,6663,6384,279,4.2
17193,2020-01-01,6185,5962,223,3.6
17195,2020-01-01,27995,26809,1186,4.2
17197,2020-01-01,353917,339027,14890,4.2
17199,2020-01-01,31352,30088,1264,4
17201,2020-01-01,137279,127305,9974,7.3
17203,2020-01-01,18463,17816,647,3.5
18001,2020-01-01,16945,16451,494,2.9
18003,2020-01-01,187123,180869,6254,3.3
18005,2020-01-01,45223,43986,1237,2.7
18007,2020-01-01,4381,4236,145,3.3
18009,2020-01-01,4902,4686,216,4.4
18011,2020-01-01,36506,35549,957,2.6
18013,2020-01-01,7641,7372,269,3.5
18015,2020-01-01,9906,9563,343,3.5
18017,2020-01-01,17637,16932,705,4
18019,2020-01-01,62353,60257,2096,3.4
18021,2020-01-01,11679,11214,465,4
18023,2020-01-01,17186,16694,492,2.9
18025,2020-01-01,4966,4672,294,5.9
18027,2020-01-01,16674,16180,494,3
18029,2020-01-01,25865,24854,1011,3.9
18031,2020-01-01,15129,14655,474,3.1
18033,2020-01-01,22520,21839,681,3
18035,2020-01-01,53978,51776,2202,4.1
18037,2020-01-01,22933,22332,601,2.6
18039,2020-01-01,111240,107912,3328,3
18041,2020-01-01,8554,8134,420,4.9
18043,2020-01-01,42172,40799,1373,3.3
18045,2020-01-01,7836,7538,298,3.8
18047,2020-01-01,11297,10877,420,3.7
18049,2020-01-01,9558,9167,391,4.1
18051,2020-01-01,19945,19393,552,2.8
18053,2020-01-01,30718,29496,1222,4
18055,2020-01-01,13594,12967,627,4.6
18057,2020-01-01,187366,182497,4869,2.6
18059,2020-01-01,41020,39786,1234,3
18061,2020-01-01,20467,19762,705,3.4
18063,2020-01-01,91362,88826,2536,2.8
18065,2020-01-01,22088,21297,791,3.6
18067,2020-01-01,36341,34822,1519,4.2
18069,2020-01-01,18154,17524,630,3.5
18071,2020-01-01,23122,22485,637,2.8
18073,2020-01-01,16082,15307,775,4.8
18075,2020-01-01,8958,8644,314,3.5
18077,2020-01-01,15321,14766,555,3.6
18079,2020-01-01,13634,13121,513,3.8
18081,2020-01-01,83647,81237,2410,2.9
18083,2020-01-01,18249,17648,601,3.3
18085,2020-01-01,41709,40445,1264,3
18087,2020-01-01,19397,18870,527,2.7
18089,2020-01-01,227214,215118,12096,5.3
18091,2020-01-01,47263,45041,2222,4.7
18093,2020-01-01,21162,20292,870,4.1
18095,2020-01-01,59076,56559,2517,4.3
18097,2020-01-01,493896,477450,16446,3.3
18099,2020-01-01,22900,22114,786,3.4
18101,2020-01-01,5381,5229,152,2.8
18103,2020-01-01,14918,14284,634,4.2
18105,2020-01-01,71647,69205,2442,3.4
18107,2020-01-01,18741,18140,601,3.2
18109,2020-01-01,36458,35198,1260,3.5
18111,2020-01-01,6796,6469,327,4.8
18113,2020-01-01,23149,22365,784,3.4
18115,2020-01-01,3228,3101,127,3.9
18117,2020-01-01,8788,8459,329,3.7
18119,2020-01-01,9438,9035,403,4.3
18121,2020-01-01,6808,6518,290,4.3
18123,2020-01-01,9298,8971,327,3.5
18125,2020-01-01,6107,5864,243,4
18127,2020-01-01,85919,82207,3712,4.3
18129,2020-01-01,13251,12851,400,3
18131,2020-01-01,6385,6132,253,4
18133,2020-01-01,16587,15976,611,3.7
18135,2020-01-01,11096,10622,474,4.3
18137,2020-01-01,14206,13692,514,3.6
18139,2020-01-01,8796,8537,259,2.9
18141,2020-01-01,136336,131007,5329,3.9
18143,2020-01-01,10570,10198,372,3.5
18145,2020-01-01,23124,22390,734,3.2
18147,2020-01-01,10238,9848,390,3.8
18149,2020-01-01,9693,9211,482,5
18151,2020-01-01,20492,19900,592,2.9
18153,2020-01-01,8079,7691,388,4.8
18155,2020-01-01,4992,4811,181,3.6
18157,2020-01-01,97223,94081,3142,3.2
18159,2020-01-01,9149,8888,261,2.9
18161,2020-01-01,3554,3429,125,3.5
18163,2020-01-01,93085,90013,3072,3.3
18165,2020-01-01,6768,6374,394,5.8
18167,2020-01-01,46554,44407,2147,4.6
18169,2020-01-01,14549,14041,508,3.5
18171,2020-01-01,4099,3969,130,3.2
18173,2020-01-01,32705,31667,1038,3.2
18175,2020-01-01,13695,13187,508,3.7
18177,2020-01-01,30529,29380,1149,3.8
18179,2020-01-01,14360,13910,450,3.1
18181,2020-01-01,13366,12973,393,2.9
18183,2020-01-01,17599,17054,545,3.1
19001,2020-01-01,4338,4218,120,2.8
19003,2020-01-01,2151,2101,50,2.3
19005,2020-01-01,7479,7065,414,5.5
19007,2020-01-01,5968,5711,257,4.3
19009,2020-01-01,3108,3005,103,3.3
19011,2020-01-01,13719,13196,523,3.8
19013,2020-01-01,69750,66765,2985,4.3
19015,2020-01-01,15040,14582,458,3
19017,2020-01-01,14185,13744,441,3.1
19019,2020-01-01,11598,11148,450,3.9
19021,2020-01-01,12014,11718,296,2.5
19023,2020-01-01,8022,7664,358,4.5
19025,2020-01-01,4264,4127,137,3.2
19027,2020-01-01,10943,10698,245,2.2
19029,2020-01-01,6961,6704,257,3.7
19031,2020-01-01,10863,10473,390,3.6
19033,2020-01-01,23797,23001,796,3.3
19035,2020-01-01,6296,6073,223,3.5
19037,2020-01-01,6539,6245,294,4.5
19039,2020-01-01,5044,4836,208,4.1
19041,2020-01-01,8708,8380,328,3.8
19043,2020-01-01,10206,9528,678,6.6
19045,2020-01-01,22953,21858,1095,4.8
19047,2020-01-01,8377,7916,461,5.5
19049,2020-01-01,51510,50299,1211,2.4
19051,2020-01-01,4268,4122,146,3.4
19053,2020-01-01,4434,4304,130,2.9
19055,2020-01-01,10750,10391,359,3.3
19057,2020-01-01,19154,18159,995,5.2
19059,2020-01-01,9700,9234,466,4.8
19061,2020-01-01,57415,55147,2268,4
19063,2020-01-01,5264,5092,172,3.3
19065,2020-01-01,10763,10205,558,5.2
19067,2020-01-01,8694,8246,448,5.2
19069,2020-01-01,5733,5534,199,3.5
19071,2020-01-01,3920,3827,93,2.4
19073,2020-01-01,5549,5416,133,2.4
19075,2020-01-01,6606,6383,223,3.4
19077,2020-01-01,5689,5464,225,4
19079,2020-01-01,6985,6756,229,3.3
19081,2020-01-01,5970,5786,184,3.1
19083,2020-01-01,8138,7800,338,4.2
19085,2020-01-01,7388,7158,230,3.1
19087,2020-01-01,9769,9410,359,3.7
19089,2020-01-01,5249,5035,214,4.1
19091,2020-01-01,5132,4939,193,3.8
19093,2020-01-01,4197,4065,132,3.1
19095,2020-01-01,10567,10216,351,3.3
19097,2020-01-01,11108,10567,541,4.9
19099,2020-01-01,19955,19199,756,3.8
19101,2020-01-01,10086,9798,288,2.9
19103,2020-01-01,86878,84885,1993,2.3
19105,2020-01-01,10957,10405,552,5
19107,2020-01-01,5324,5097,227,4.3
19109,2020-01-01,8568,8320,248,2.9
19111,2020-01-01,16248,15481,767,4.7
19113,2020-01-01,123766,119380,4386,3.5
19115,2020-01-01,6188,5926,262,4.2
19117,2020-01-01,4715,4598,117,2.5
19119,2020-01-01,7070,6884,186,2.6
19121,2020-01-01,8757,8325,432,4.9
19123,2020-01-01,12033,11656,377,3.1
19125,2020-01-01,18547,18013,534,2.9
19127,2020-01-01,18445,17100,1345,7.3
19129,2020-01-01,7456,7244,212,2.8
19131,2020-01-01,6175,6014,161,2.6
19133,2020-01-01,4528,4346,182,4
19135,2020-01-01,4111,3945,166,4
19137,2020-01-01,5021,4858,163,3.2
19139,2020-01-01,21956,21190,766,3.5
19141,2020-01-01,8366,8131,235,2.8
19143,2020-01-01,3627,3537,90,2.5
19145,2020-01-01,6352,6148,204,3.2
19147,2020-01-01,4904,4774,130,2.7
19149,2020-01-01,14985,14571,414,2.8
19151,2020-01-01,4376,4260,116,2.7
19153,2020-01-01,272179,262676,9503,3.5
19155,2020-01-01,48641,47073,1568,3.2
19157,2020-01-01,9740,9338,402,4.1
19159,2020-01-01,2477,2404,73,2.9
19161,2020-01-01,5341,5164,177,3.3
19163,2020-01-01,89457,85724,3733,4.2
19165,2020-01-01,6648,6451,197,3
19167,2020-01-01,21478,20874,604,2.8
19169,2020-01-01,59418,58160,1258,2.1
19171,2020-01-01,9779,9304,475,4.9
19173,2020-01-01,3167,3092,75,2.4
19175,2020-01-01,6386,6126,260,4.1
19177,2020-01-01,3745,3608,137,3.7
19179,2020-01-01,17771,17011,760,4.3
19181,2020-01-01,28745,27783,962,3.3
19183,2020-01-01,12186,11731,455,3.7
19185,2020-01-01,2871,2788,83,2.9
19187,2020-01-01,19227,18517,710,3.7
19189,2020-01-01,5128,4964,164,3.2
19191,2020-01-01,11643,11060,583,5
19193,2020-01-01,56364,54368,1996,3.5
19195,2020-01-01,4280,4103,177,4.1
19197,2020-01-01,7292,7084,208,2.9
20001,2020-01-01,6321,6094,227,3.6
20003,2020-01-01,4094,3943,151,3.7
20005,2020-01-01,6808,6458,350,5.1
20007,2020-01-01,2281,2213,68,3
20009,2020-01-01,13671,13192,479,3.5
20011,2020-01-01,6570,6280,290,4.4
20013,2020-01-01,5115,4948,167,3.3
20015,2020-01-01,32983,31871,1112,3.4
20017,2020-01-01,1457,1415,42,2.9
20019,2020-01-01,1441,1391,50,3.5
20021,2020-01-01,10043,9734,309,3.1
20023,2020-01-01,1281,1250,31,2.4
20025,2020-01-01,1118,1092,26,2.3
20027,2020-01-01,3693,3572,121,3.3
20029,2020-01-01,3797,3676,121,3.2
20031,2020-01-01,4031,3822,209,5.2
20033,2020-01-01,833,809,24,2.9
20035,2020-01-01,16463,15916,547,3.3
20037,2020-01-01,18757,18006,751,4
20039,2020-01-01,1189,1152,37,3.1
20041,2020-01-01,8832,8461,371,4.2
20043,2020-01-01,4121,3974,147,3.6
20045,2020-01-01,65276,63233,2043,3.1
20047,2020-01-01,1432,1398,34,2.4
20049,2020-01-01,1186,1150,36,3
20051,2020-01-01,17041,16669,372,2.2
20053,2020-01-01,2654,2584,70,2.6
20055,2020-01-01,20536,20099,437,2.1
20057,2020-01-01,17129,16718,411,2.4
20059,2020-01-01,14104,13604,500,3.5
20061,2020-01-01,11629,11127,502,4.3
20063,2020-01-01,1449,1415,34,2.3
20065,2020-01-01,1137,1105,32,2.8
20067,2020-01-01,3084,3010,74,2.4
20069,2020-01-01,3129,3059,70,2.2
20071,2020-01-01,806,791,15,1.9
20073,2020-01-01,3212,3094,118,3.7
20075,2020-01-01,1550,1522,28,1.8
20077,2020-01-01,2782,2704,78,2.8
20079,2020-01-01,17295,16774,521,3
20081,2020-01-01,2221,2179,42,1.9
20083,2020-01-01,984,953,31,3.2
20085,2020-01-01,7169,6916,253,3.5
20087,2020-01-01,10200,9833,367,3.6
20089,2020-01-01,1204,1172,32,2.7
20091,2020-01-01,342103,332942,9161,2.7
20093,2020-01-01,2011,1969,42,2.1
20095,2020-01-01,3371,3258,113,3.4
20097,2020-01-01,1248,1219,29,2.3
20099,2020-01-01,9630,9258,372,3.9
20101,2020-01-01,720,702,18,2.5
20103,2020-01-01,36862,35494,1368,3.7
20105,2020-01-01,1742,1695,47,2.7
20107,2020-01-01,4433,4146,287,6.5
20109,2020-01-01,1608,1576,32,2
20111,2020-01-01,16792,16208,584,3.5
20113,2020-01-01,17337,16942,395,2.3
20115,2020-01-01,6048,5889,159,2.6
20117,2020-01-01,5394,5242,152,2.8
20119,2020-01-01,2091,2044,47,2.2
20121,2020-01-01,17904,17214,690,3.9
20123,2020-01-01,3391,3320,71,2.1
20125,2020-01-01,14671,13985,686,4.7
20127,2020-01-01,3039,2939,100,3.3
20129,2020-01-01,1105,1074,31,2.8
20131,2020-01-01,5399,5253,146,2.7
20133,2020-01-01,6119,5837,282,4.6
20135,2020-01-01,1314,1280,34,2.6
20137,2020-01-01,2636,2584,52,2
20139,2020-01-01,8013,7689,324,4
20141,2020-01-01,1931,1892,39,2
20143,2020-01-01,2947,2864,83,2.8
20145,2020-01-01,2764,2670,94,3.4
20147,2020-01-01,2624,2559,65,2.5
20149,2020-01-01,12300,11920,380,3.1
20151,2020-01-01,4946,4813,133,2.7
20153,2020-01-01,1508,1476,32,2.1
20155,2020-01-01,29437,28482,955,3.2
20157,2020-01-01,2244,2187,57,2.5
20159,2020-01-01,5007,4869,138,2.8
20161,2020-01-01,34807,33824,983,2.8
20163,2020-01-01,2483,2405,78,3.1
20165,2020-01-01,1603,1556,47,2.9
20167,2020-01-01,3285,3191,94,2.9
20169,2020-01-01,29266,28269,997,3.4
20171,2020-01-01,2774,2721,53,1.9
20173,2020-01-01,256048,246691,9357,3.7
20175,2020-01-01,9673,9386,287,3
20177,2020-01-01,90613,87438,3175,3.5
20179,2020-01-01,1420,1384,36,2.5
20181,2020-01-01,2829,2756,73,2.6
20183,2020-01-01,1955,1906,49,2.5
20185,2020-01-01,2001,1939,62,3.1
20187,2020-01-01,1071,1042,29,2.7
20189,2020-01-01,2719,2651,68,2.5
20191,2020-01-01,10914,10558,356,3.3
20193,2020-01-01,4222,4130,92,2.2
20195,2020-01-01,1422,1378,44,3.1
20197,2020-01-01,3677,3538,139,3.8
20199,2020-01-01,793,772,21,2.6
20201,2020-01-01,2959,2885,74,2.5
20203,2020-01-01,1272,1244,28,2.2
20205,2020-01-01,3869,3704,165,4.3
20207,2020-01-01,1544,1481,63,4.1
20209,2020-01-01,77565,74190,3375,4.4
21001,2020-01-01,7029,6598,431,6.1
21003,2020-01-01,8970,8585,385,4.3
21005,2020-01-01,11972,11472,500,4.2
21007,2020-01-01,3463,3249,214,6.2
21009,2020-01-01,18690,17761,929,5
21011,2020-01-01,4707,4323,384,8.2
21013,2020-01-01,8484,7859,625,7.4
21015,2020-01-01,72115,69535,2580,3.6
21017,2020-01-01,9659,9256,403,4.2
21019,2020-01-01,17995,16851,1144,6.4
21021,2020-01-01,12616,12033,583,4.6
21023,2020-01-01,3906,3669,237,6.1
21025,2020-01-01,3419,3056,363,10.6
21027,2020-01-01,7957,7476,481,6
21029,2020-01-01,43148,41352,1796,4.2
21031,2020-01-01,5128,4846,282,5.5
21033,2020-01-01,5699,5410,289,5.1
21035,2020-01-01,18392,17615,777,4.2
21037,2020-01-01,51085,49216,1869,3.7
21039,2020-01-01,2239,2137,102,4.6
21041,2020-01-01,5359,5125,234,4.4
21043,2020-01-01,9735,8800,935,9.6
21045,2020-01-01,6764,6460,304,4.5
21047,2020-01-01,24727,23334,1393,5.6
21049,2020-01-01,17380,16625,755,4.3
21051,2020-01-01,5248,4875,373,7.1
21053,2020-01-01,4005,3773,232,5.8
21055,2020-01-01,3768,3573,195,5.2
21057,2020-01-01,3406,3251,155,4.6
21059,2020-01-01,47207,45211,1996,4.2
21061,2020-01-01,4711,4456,255,5.4
21063,2020-01-01,2060,1834,226,11
21065,2020-01-01,5357,5043,314,5.9
21067,2020-01-01,175841,169984,5857,3.3
21069,2020-01-01,6223,5850,373,6
21071,2020-01-01,11071,10255,816,7.4
21073,2020-01-01,25023,24038,985,3.9
21075,2020-01-01,1991,1888,103,5.2
21077,2020-01-01,4109,3936,173,4.2
21079,2020-01-01,7744,7355,389,5
21081,2020-01-01,11770,11215,555,4.7
21083,2020-01-01,15893,15128,765,4.8
21085,2020-01-01,11035,10436,599,5.4
21087,2020-01-01,5302,5086,216,4.1
21089,2020-01-01,13668,12619,1049,7.7
21091,2020-01-01,3909,3764,145,3.7
21093,2020-01-01,48778,46641,2137,4.4
21095,2020-01-01,6929,6147,782,11.3
21097,2020-01-01,8891,8502,389,4.4
21099,2020-01-01,7947,7429,518,6.5
21101,2020-01-01,21380,20525,855,4
21103,2020-01-01,8263,7941,322,3.9
21105,2020-01-01,1773,1685,88,5
21107,2020-01-01,18514,17617,897,4.8
21109,2020-01-01,4163,3884,279,6.7
21111,2020-01-01,398107,382403,15704,3.9
21113,2020-01-01,26852,25864,988,3.7
21115,2020-01-01,6705,6221,484,7.2
21117,2020-01-01,88417,85084,3333,3.8
21119,2020-01-01,4512,4173,339,7.5
21121,2020-01-01,10143,9557,586,5.8
21123,2020-01-01,5979,5696,283,4.7
21125,2020-01-01,25394,24184,1210,4.8
21127,2020-01-01,5309,4882,427,8
21129,2020-01-01,2104,1970,134,6.4
21131,2020-01-01,2775,2461,314,11.3
21133,2020-01-01,6353,5784,569,9
21135,2020-01-01,4769,4282,487,10.2
21137,2020-01-01,9356,8875,481,5.1
21139,2020-01-01,3619,3394,225,6.2
21141,2020-01-01,12461,11924,537,4.3
21143,2020-01-01,3018,2859,159,5.3
21145,2020-01-01,29070,27522,1548,5.3
21147,2020-01-01,4910,4585,325,6.6
21149,2020-01-01,4165,3967,198,4.8
21151,2020-01-01,47578,45740,1838,3.9
21153,2020-01-01,3306,2841,465,14.1
21155,2020-01-01,9539,9179,360,3.8
21157,2020-01-01,14988,14225,763,5.1
21159,2020-01-01,2577,2340,237,9.2
21161,2020-01-01,7045,6605,440,6.2
21163,2020-01-01,12107,11494,613,5.1
21165,2020-01-01,2350,2139,211,9
21167,2020-01-01,9940,9446,494,5
21169,2020-01-01,4120,3879,241,5.8
21171,2020-01-01,4648,4448,200,4.3
21173,2020-01-01,11572,10881,691,6
21175,2020-01-01,4513,4191,322,7.1
21177,2020-01-01,10348,9622,726,7
21179,2020-01-01,23247,22210,1037,4.5
21181,2020-01-01,3348,3176,172,5.1
21183,2020-01-01,9777,9195,582,6
21185,2020-01-01,33472,32397,1075,3.2
21187,2020-01-01,5140,4904,236,4.6
21189,2020-01-01,1083,1006,77,7.1
21191,2020-01-01,7072,6752,320,4.5
21193,2020-01-01,8491,7838,653,7.7
21195,2020-01-01,20184,18774,1410,7
21197,2020-01-01,5097,4769,328,6.4
21199,2020-01-01,26840,25506,1334,5
21201,2020-01-01,800,754,46,5.8
21203,2020-01-01,6677,6334,343,5.1
21205,2020-01-01,10234,9634,600,5.9
21207,2020-01-01,6277,5896,381,6.1
21209,2020-01-01,29856,28791,1065,3.6
21211,2020-01-01,25750,24908,842,3.3
21213,2020-01-01,8837,8423,414,4.7
21215,2020-01-01,10525,10147,378,3.6
21217,2020-01-01,13027,12488,539,4.1
21219,2020-01-01,5515,5275,240,4.4
21221,2020-01-01,6064,5749,315,5.2
21223,2020-01-01,3870,3694,176,4.5
21225,2020-01-01,6101,5812,289,4.7
21227,2020-01-01,64802,62132,2670,4.1
21229,2020-01-01,6180,5929,251,4.1
21231,2020-01-01,7441,6994,447,6
21233,2020-01-01,5583,5330,253,4.5
21235,2020-01-01,14101,13385,716,5.1
21237,2020-01-01,2180,2004,176,8.1
21239,2020-01-01,15115,14608,507,3.4
22001,2020-01-01,24147,22793,1354,5.6
22003,2020-01-01,9026,8432,594,6.6
22005,2020-01-01,65481,62569,2912,4.4
22007,2020-01-01,8843,8230,613,6.9
22009,2020-01-01,15332,14329,1003,6.5
22011,2020-01-01,14942,14066,876,5.9
22013,2020-01-01,5515,5164,351,6.4
22015,2020-01-01,58663,55962,2701,4.6
22017,2020-01-01,104287,98374,5913,5.7
22019,2020-01-01,106008,100929,5079,4.8
22021,2020-01-01,3769,3470,299,7.9
22023,2020-01-01,3923,3749,174,4.4
22025,2020-01-01,3496,3270,226,6.5
22027,2020-01-01,5682,5299,383,6.7
22029,2020-01-01,7137,6628,509,7.1
22031,2020-01-01,11106,10363,743,6.7
22033,2020-01-01,231978,220978,11000,4.7
22035,2020-01-01,1876,1658,218,11.6
22037,2020-01-01,7941,7558,383,4.8
22039,2020-01-01,12059,11299,760,6.3
22041,2020-01-01,7423,6824,599,8.1
22043,2020-01-01,8336,7795,541,6.5
22045,2020-01-01,28147,26481,1666,5.9
22047,2020-01-01,14064,13149,915,6.5
22049,2020-01-01,6939,6583,356,5.1
22051,2020-01-01,219599,210068,9531,4.3
22053,2020-01-01,13251,12552,699,5.3
22055,2020-01-01,116813,111323,5490,4.7
22057,2020-01-01,42416,40368,2048,4.8
22059,2020-01-01,6973,6659,314,4.5
22061,2020-01-01,22396,21128,1268,5.7
22063,2020-01-01,69805,66731,3074,4.4
22065,2020-01-01,3554,3250,304,8.6
22067,2020-01-01,10209,9218,991,9.7
22069,2020-01-01,16532,15487,1045,6.3
22071,2020-01-01,183920,174671,9249,5
22073,2020-01-01,71095,67013,4082,5.7
22075,2020-01-01,10219,9744,475,4.6
22077,2020-01-01,9779,9225,554,5.7
22079,2020-01-01,55919,52876,3043,5.4
22081,2020-01-01,3720,3496,224,6
22083,2020-01-01,8352,7723,629,7.5
22085,2020-01-01,9367,8864,503,5.4
22087,2020-01-01,20673,19592,1081,5.2
22089,2020-01-01,26066,24864,1202,4.6
22091,2020-01-01,4244,3968,276,6.5
22093,2020-01-01,9581,8954,627,6.5
22095,2020-01-01,20196,18961,1235,6.1
22097,2020-01-01,32641,30382,2259,6.9
22099,2020-01-01,22562,21329,1233,5.5
22101,2020-01-01,19746,18527,1219,6.2
22103,2020-01-01,124020,118618,5402,4.4
22105,2020-01-01,56385,53030,3355,6
22107,2020-01-01,1362,1231,131,9.6
22109,2020-01-01,46715,44370,2345,5
22111,2020-01-01,9176,8575,601,6.5
22113,2020-01-01,24373,23038,1335,5.5
22115,2020-01-01,16297,15261,1036,6.4
22117,2020-01-01,17033,16002,1031,6.1
22119,2020-01-01,14628,13664,964,6.6
22121,2020-01-01,13778,13118,660,4.8
22123,2020-01-01,3788,3268,520,13.7
22125,2020-01-01,5448,5198,250,4.6
22127,2020-01-01,4946,4611,335,6.8
23001,2020-01-01,55554,53924,1630,2.9
23003,2020-01-01,30089,28696,1393,4.6
23005,2020-01-01,164427,160533,3894,2.4
23007,2020-01-01,14330,13774,556,3.9
23009,2020-01-01,26958,25598,1360,5
23011,2020-01-01,62197,60255,1942,3.1
23013,2020-01-01,19849,19154,695,3.5
23015,2020-01-01,16254,15687,567,3.5
23017,2020-01-01,27107,26126,981,3.6
23019,2020-01-01,76433,73710,2723,3.6
23021,2020-01-01,7241,6938,303,4.2
23023,2020-01-01,19543,19067,476,2.4
23025,2020-01-01,22252,21125,1127,5.1
23027,2020-01-01,20197,19436,761,3.8
23029,2020-01-01,13484,12666,818,6.1
23031,2020-01-01,113361,109734,3627,3.2
24001,2020-01-01,31897,30060,1837,5.8
24003,2020-01-01,321859,312104,9755,3
24005,2020-01-01,460301,443252,17049,3.7
24009,2020-01-01,50936,49378,1558,3.1
24011,2020-01-01,18422,17716,706,3.8
24013,2020-01-01,97767,94824,2943,3
24015,2020-01-01,54270,52069,2201,4.1
24017,2020-01-01,89409,86199,3210,3.6
24019,2020-01-01,17015,16210,805,4.7
24021,2020-01-01,139667,135180,4487,3.2
24023,2020-01-01,16263,15413,850,5.2
24025,2020-01-01,144191,139313,4878,3.4
24027,2020-01-01,191738,186657,5081,2.6
24029,2020-01-01,10422,9879,543,5.2
24031,2020-01-01,569587,553093,16494,2.9
24033,2020-01-01,515913,496808,19105,3.7
24035,2020-01-01,28785,27816,969,3.4
24037,2020-01-01,59189,57274,1915,3.2
24039,2020-01-01,9084,8438,646,7.1
24041,2020-01-01,18543,17792,751,4.1
24043,2020-01-01,75678,72538,3140,4.1
24045,2020-01-01,49644,46944,2700,5.4
24047,2020-01-01,25896,22971,2925,11.3
24510,2020-01-01,288312,273639,14673,5.1
25001,2020-01-01,106879,100264,6615,6.2
25003,2020-01-01,63098,60281,2817,4.5
25005,2020-01-01,300607,286656,13951,4.6
25007,2020-01-01,8395,7780,615,7.3
25009,2020-01-01,423952,409592,14360,3.4
25011,2020-01-01,40745,39403,1342,3.3
25013,2020-01-01,224678,214352,10326,4.6
25015,2020-01-01,89090,86303,2787,3.1
25017,2020-01-01,917264,893507,23757,2.6
25019,2020-01-01,6161,5473,688,11.2
25021,2020-01-01,391984,380915,11069,2.8
25023,2020-01-01,283567,273124,10443,3.7
25025,2020-01-01,454270,441285,12985,2.9
25027,2020-01-01,444813,428571,16242,3.7
26001,2020-01-01,3788,3478,310,8.2
26003,2020-01-01,3069,2815,254,8.3
26005,2020-01-01,61992,60020,1972,3.2
26007,2020-01-01,13392,12734,658,4.9
26009,2020-01-01,9900,9303,597,6
26011,2020-01-01,5960,5479,481,8.1
26013,2020-01-01,3152,2933,219,6.9
26015,2020-01-01,31803,30729,1074,3.4
26017,2020-01-01,50190,47653,2537,5.1
26019,2020-01-01,8602,8036,566,6.6
26021,2020-01-01,72824,69757,3067,4.2
26023,2020-01-01,19135,18418,717,3.7
26025,2020-01-01,61441,59063,2378,3.9
26027,2020-01-01,24410,23355,1055,4.3
26029,2020-01-01,12366,11660,706,5.7
26031,2020-01-01,9996,8450,1546,15.5
26033,2020-01-01,16107,14946,1161,7.2
26035,2020-01-01,11538,10701,837,7.3
26037,2020-01-01,41143,40000,1143,2.8
26039,2020-01-01,5490,5115,375,6.8
26041,2020-01-01,16854,15850,1004,6
26043,2020-01-01,12065,11524,541,4.5
26045,2020-01-01,57479,55713,1766,3.1
26047,2020-01-01,16936,15764,1172,6.9
26049,2020-01-01,180521,171985,8536,4.7
26051,2020-01-01,9743,9111,632,6.5
26053,2020-01-01,6045,5751,294,4.9
26055,2020-01-01,47995,46143,1852,3.9
26057,2020-01-01,18002,17169,833,4.6
26059,2020-01-01,20145,19320,825,4.1
26061,2020-01-01,16696,15934,762,4.6
26063,2020-01-01,15099,14302,797,5.3
26065,2020-01-01,150854,146356,4498,3
26067,2020-01-01,30224,29173,1051,3.5
26069,2020-01-01,10104,9291,813,8
26071,2020-01-01,4953,4639,314,6.3
26073,2020-01-01,34233,32898,1335,3.9
26075,2020-01-01,74785,72089,2696,3.6
26077,2020-01-01,133681,129712,3969,3
26079,2020-01-01,7780,7232,548,7
26081,2020-01-01,361223,351665,9558,2.6
26083,2020-01-01,911,858,53,5.8
26085,2020-01-01,3883,3628,255,6.6
26087,2020-01-01,41474,38638,2836,6.8
26089,2020-01-01,10037,9615,422,4.2
26091,2020-01-01,45463,43687,1776,3.9
26093,2020-01-01,103605,100187,3418,3.3
26095,2020-01-01,2157,2009,148,6.9
26097,2020-01-01,4408,3586,822,18.6
26099,2020-01-01,450656,428557,22099,4.9
26101,2020-01-01,9907,9271,636,6.4
26103,2020-01-01,32545,30945,1600,4.9
26105,2020-01-01,13068,12305,763,5.8
26107,2020-01-01,18656,17721,935,5
26109,2020-01-01,10751,10332,419,3.9
26111,2020-01-01,39799,38192,1607,4
26113,2020-01-01,6778,6375,403,5.9
26115,2020-01-01,75009,72202,2807,3.7
26117,2020-01-01,28246,27079,1167,4.1
26119,2020-01-01,3036,2696,340,11.2
26121,2020-01-01,76365,73195,3170,4.2
26123,2020-01-01,23258,22241,1017,4.4
26125,2020-01-01,673705,650710,22995,3.4
26127,2020-01-01,11341,10507,834,7.4
26129,2020-01-01,7829,7156,673,8.6
26131,2020-01-01,2087,1954,133,6.4
26133,2020-01-01,11464,10974,490,4.3
26135,2020-01-01,2758,2536,222,8
26137,2020-01-01,11467,10821,646,5.6
26139,2020-01-01,161230,157212,4018,2.5
26141,2020-01-01,4903,4385,518,10.6
26143,2020-01-01,7426,6746,680,9.2
26145,2020-01-01,86001,81917,4084,4.7
26147,2020-01-01,75983,71737,4246,5.6
26149,2020-01-01,28101,26985,1116,4
26151,2020-01-01,19237,18132,1105,5.7
26153,2020-01-01,3266,2978,288,8.8
26155,2020-01-01,33179,31779,1400,4.2
26157,2020-01-01,23877,22536,1341,5.6
26159,2020-01-01,35156,33404,1752,5
26161,2020-01-01,197975,193364,4611,2.3
26163,2020-01-01,806281,763539,42742,5.3
26165,2020-01-01,14672,13916,756,5.2
27001,2020-01-01,7448,6762,686,9.2
27003,2020-01-01,200661,193831,6830,3.4
27005,2020-01-01,18795,17697,1098,5.8
27007,2020-01-01,24524,23159,1365,5.6
27009,2020-01-01,22164,20923,1241,5.6
27011,2020-01-01,2451,2268,183,7.5
27013,2020-01-01,40678,39451,1227,3
27015,2020-01-01,14149,13410,739,5.2
27017,2020-01-01,18045,16994,1051,5.8
27019,2020-01-01,59501,57776,1725,2.9
27021,2020-01-01,14076,12872,1204,8.6
27023,2020-01-01,6810,6450,360,5.3
27025,2020-01-01,30837,29197,1640,5.3
27027,2020-01-01,36199,34826,1373,3.8
27029,2020-01-01,4589,3928,661,14.4
27031,2020-01-01,2893,2709,184,6.4
27033,2020-01-01,5892,5640,252,4.3
27035,2020-01-01,32042,29992,2050,6.4
27037,2020-01-01,244746,237389,7357,3
27039,2020-01-01,11934,11393,541,4.5
27041,2020-01-01,20865,19997,868,4.2
27043,2020-01-01,6810,6399,411,6
27045,2020-01-01,11470,10906,564,4.9
27047,2020-01-01,16043,15365,678,4.2
27049,2020-01-01,26875,25759,1116,4.2
27051,2020-01-01,3238,3017,221,6.8
27053,2020-01-01,710825,692652,18173,2.6
27055,2020-01-01,10267,9802,465,4.5
27057,2020-01-01,9755,8953,802,8.2
27059,2020-01-01,22070,20785,1285,5.8
27061,2020-01-01,22195,20483,1712,7.7
27063,2020-01-01,5548,5317,231,4.2
27065,2020-01-01,9413,8410,1003,10.7
27067,2020-01-01,24203,23020,1183,4.9
27069,2020-01-01,2288,2185,103,4.5
27071,2020-01-01,5802,5393,409,7
27073,2020-01-01,3407,3213,194,5.7
27075,2020-01-01,5215,4950,265,5.1
27077,2020-01-01,2521,2415,106,4.2
27079,2020-01-01,16735,15540,1195,7.1
27081,2020-01-01,2991,2779,212,7.1
27083,2020-01-01,14142,13516,626,4.4
27085,2020-01-01,19353,18360,993,5.1
27087,2020-01-01,2346,2165,181,7.7
27089,2020-01-01,5354,4795,559,10.4
27091,2020-01-01,9690,9291,399,4.1
27093,2020-01-01,13318,12515,803,6
27095,2020-01-01,13419,12282,1137,8.5
27097,2020-01-01,17733,16217,1516,8.5
27099,2020-01-01,20615,19895,720,3.5
27101,2020-01-01,4604,4273,331,7.2
27103,2020-01-01,20885,20310,575,2.8
27105,2020-01-01,11185,10803,382,3.4
27107,2020-01-01,3142,2920,222,7.1
27109,2020-01-01,89777,87417,2360,2.6
27111,2020-01-01,30614,28659,1955,6.4
27113,2020-01-01,8917,8189,728,8.2
27115,2020-01-01,15139,13815,1324,8.7
27117,2020-01-01,4505,4259,246,5.5
27119,2020-01-01,16257,15479,778,4.8
27121,2020-01-01,6287,6021,266,4.2
27123,2020-01-01,290429,281859,8570,3
27125,2020-01-01,2257,2056,201,8.9
27127,2020-01-01,7414,7075,339,4.6
27129,2020-01-01,8233,7703,530,6.4
27131,2020-01-01,37514,36065,1449,3.9
27133,2020-01-01,5484,5332,152,2.8
27135,2020-01-01,7839,7457,382,4.9
27137,2020-01-01,102015,97308,4707,4.6
27139,2020-01-01,84872,82363,2509,3
27141,2020-01-01,53816,51317,2499,4.6
27143,2020-01-01,8364,7923,441,5.3
27145,2020-01-01,90594,86832,3762,4.2
27147,2020-01-01,20359,19547,812,4
27149,2020-01-01,5150,4964,186,3.6
27151,2020-01-01,4708,4398,310,6.6
27153,2020-01-01,13518,12715,803,5.9
27155,2020-01-01,1684,1583,101,6
27157,2020-01-01,12218,11650,568,4.6
27159,2020-01-01,6018,5463,555,9.2
27161,2020-01-01,8883,8363,520,5.9
27163,2020-01-01,145797,141373,4424,3
27165,2020-01-01,6440,6116,324,5
27167,2020-01-01,3327,3198,129,3.9
27169,2020-01-01,28070,27144,926,3.3
27171,2020-01-01,77610,74330,3280,4.2
27173,2020-01-01,5141,4906,235,4.6
28001,2020-01-01,10907,10109,798,7.3
28003,2020-01-01,16262,15481,781,4.8
28005,2020-01-01,4416,4084,332,7.5
28007,2020-01-01,6966,6486,480,6.9
28009,2020-01-01,3043,2848,195,6.4
28011,2020-01-01,11566,10621,945,8.2
28013,2020-01-01,5464,5133,331,6.1
28015,2020-01-01,3513,3283,230,6.5
28017,2020-01-01,6755,6391,364,5.4
28019,2020-01-01,3632,3425,207,5.7
28021,2020-01-01,3071,2751,320,10.4
28023,2020-01-01,5948,5544,404,6.8
28025,2020-01-01,7753,7151,602,7.8
28027,2020-01-01,8263,7538,725,8.8
28029,2020-01-01,10964,10246,718,6.5
28031,2020-01-01,8247,7836,411,5
28033,2020-01-01,92469,88409,4060,4.4
28035,2020-01-01,32794,31133,1661,5.1
28037,2020-01-01,2746,2541,205,7.5
28039,2020-01-01,8947,8197,750,8.4
28041,2020-01-01,4355,3929,426,9.8
28043,2020-01-01,9378,8898,480,5.1
28045,2020-01-01,18854,17793,1061,5.6
28047,2020-01-01,86913,82399,4514,5.2
28049,2020-01-01,104312,99001,5311,5.1
28051,2020-01-01,5573,4987,586,10.5
28053,2020-01-01,2173,1884,289,13.3
28055,2020-01-01,349,306,43,12.3
28057,2020-01-01,10523,10041,482,4.6
28059,2020-01-01,58645,55060,3585,6.1
28061,2020-01-01,6258,5726,532,8.5
28063,2020-01-01,2044,1675,369,18.1
28065,2020-01-01,4020,3740,280,7
28067,2020-01-01,26123,24686,1437,5.5
28069,2020-01-01,3430,3166,264,7.7
28071,2020-01-01,27593,26440,1153,4.2
28073,2020-01-01,30861,29515,1346,4.4
28075,2020-01-01,30141,28563,1578,5.2
28077,2020-01-01,4615,4298,317,6.9
28079,2020-01-01,8010,7559,451,5.6
28081,2020-01-01,41671,39879,1792,4.3
28083,2020-01-01,9903,9101,802,8.1
28085,2020-01-01,14598,13730,868,5.9
28087,2020-01-01,25377,24031,1346,5.3
28089,2020-01-01,53468,51165,2303,4.3
28091,2020-01-01,10195,9607,588,5.8
28093,2020-01-01,14372,13541,831,5.8
28095,2020-01-01,15720,14873,847,5.4
28097,2020-01-01,3906,3666,240,6.1
28099,2020-01-01,10210,9561,649,6.4
28101,2020-01-01,8271,7774,497,6
28103,2020-01-01,3691,3407,284,7.7
28105,2020-01-01,22266,21104,1162,5.2
28107,2020-01-01,12602,11776,826,6.6
28109,2020-01-01,23718,22500,1218,5.1
28111,2020-01-01,4283,3961,322,7.5
28113,2020-01-01,14458,13515,943,6.5
28115,2020-01-01,15038,14391,647,4.3
28117,2020-01-01,11249,10699,550,4.9
28119,2020-01-01,2250,2052,198,8.8
28121,2020-01-01,76722,73664,3058,4
28123,2020-01-01,12474,11902,572,4.6
28125,2020-01-01,1466,1309,157,10.7
28127,2020-01-01,10690,10111,579,5.4
28129,2020-01-01,6730,6342,388,5.8
28131,2020-01-01,6978,6554,424,6.1
28133,2020-01-01,7380,6583,797,10.8
28135,2020-01-01,5316,4939,377,7.1
28137,2020-01-01,12090,11431,659,5.5
28139,2020-01-01,9492,9031,461,4.9
28141,2020-01-01,8607,8113,494,5.7
28143,2020-01-01,4298,4002,296,6.9
28145,2020-01-01,14416,13798,618,4.3
28147,2020-01-01,5040,4692,348,6.9
28149,2020-01-01,20312,19185,1127,5.5
28151,2020-01-01,16038,14692,1346,8.4
28153,2020-01-01,7348,6851,497,6.8
28155,2020-01-01,3931,3691,240,6.1
28157,2020-01-01,2790,2470,320,11.5
28159,2020-01-01,7525,7069,456,6.1
28161,2020-01-01,4968,4704,264,5.3
28163,2020-01-01,9820,9180,640,6.5
29001,2020-01-01,10237,9827,410,4
29003,2020-01-01,9832,9514,318,3.2
29005,2020-01-01,2717,2625,92,3.4
29007,2020-01-01,10566,10152,414,3.9
29009,2020-01-01,15752,15011,741,4.7
29011,2020-01-01,5184,4993,191,3.7
29013,2020-01-01,7852,7499,353,4.5
29015,2020-01-01,7140,6736,404,5.7
29017,2020-01-01,5487,5237,250,4.6
29019,2020-01-01,96467,93625,2842,2.9
29021,2020-01-01,43926,42337,1589,3.6
29023,2020-01-01,18034,17186,848,4.7
29025,2020-01-01,4340,4181,159,3.7
29027,2020-01-01,21369,20620,749,3.5
29029,2020-01-01,18123,16866,1257,6.9
29031,2020-01-01,40654,39305,1349,3.3
29033,2020-01-01,4789,4615,174,3.6
29035,2020-01-01,2495,2350,145,5.8
29037,2020-01-01,55177,53129,2048,3.7
29039,2020-01-01,5740,5497,243,4.2
29041,2020-01-01,3788,3644,144,3.8
29043,2020-01-01,45600,44008,1592,3.5
29045,2020-01-01,3185,3039,146,4.6
29047,2020-01-01,137428,133024,4404,3.2
29049,2020-01-01,10663,10277,386,3.6
29051,2020-01-01,39095,37861,1234,3.2
29053,2020-01-01,7297,7005,292,4
29055,2020-01-01,10908,10416,492,4.5
29057,2020-01-01,3563,3427,136,3.8
29059,2020-01-01,7098,6747,351,4.9
29061,2020-01-01,4119,3960,159,3.9
29063,2020-01-01,4831,4639,192,4
29065,2020-01-01,6386,6099,287,4.5
29067,2020-01-01,5296,4734,562,10.6
29069,2020-01-01,11517,10810,707,6.1
29071,2020-01-01,53619,51497,2122,4
29073,2020-01-01,7664,7383,281,3.7
29075,2020-01-01,3458,3354,104,3
29077,2020-01-01,150868,145769,5099,3.4
29079,2020-01-01,4405,4233,172,3.9
29081,2020-01-01,3823,3645,178,4.7
29083,2020-01-01,9699,9251,448,4.6
29085,2020-01-01,3799,3598,201,5.3
29087,2020-01-01,2565,2477,88,3.4
29089,2020-01-01,4940,4757,183,3.7
29091,2020-01-01,16649,15770,879,5.3
29093,2020-01-01,3505,3305,200,5.7
29095,2020-01-01,361854,347382,14472,4
29097,2020-01-01,56020,54040,1980,3.5
29099,2020-01-01,119080,114506,4574,3.8
29101,2020-01-01,23283,22267,1016,4.4
29103,2020-01-01,1816,1752,64,3.5
29105,2020-01-01,16961,15796,1165,6.9
29107,2020-01-01,16885,16236,649,3.8
29109,2020-01-01,17833,17007,826,4.6
29111,2020-01-01,5026,4840,186,3.7
29113,2020-01-01,29545,28042,1503,5.1
29115,2020-01-01,5103,4818,285,5.6
29117,2020-01-01,7350,7100,250,3.4
29119,2020-01-01,10620,10225,395,3.7
29121,2020-01-01,7561,7253,308,4.1
29123,2020-01-01,5532,5299,233,4.2
29125,2020-01-01,3898,3744,154,4
29127,2020-01-01,14225,13716,509,3.6
29129,2020-01-01,1899,1820,79,4.2
29131,2020-01-01,12072,11407,665,5.5
29133,2020-01-01,5774,5521,253,4.4
29135,2020-01-01,7367,7100,267,3.6
29137,2020-01-01,3780,3590,190,5
29139,2020-01-01,5835,5590,245,4.2
29141,2020-01-01,8068,7579,489,6.1
29143,2020-01-01,8365,7969,396,4.7
29145,2020-01-01,26674,25658,1016,3.8
29147,2020-01-01,10856,10478,378,3.5
29149,2020-01-01,3977,3761,216,5.4
29151,2020-01-01,7098,6893,205,2.9
29153,2020-01-01,3455,3176,279,8.1
29155,2020-01-01,6259,5902,357,5.7
29157,2020-01-01,9955,9651,304,3.1
29159,2020-01-01,20842,20028,814,3.9
29161,2020-01-01,19804,18992,812,4.1
29163,2020-01-01,7514,7183,331,4.4
29165,2020-01-01,59107,57339,1768,3
29167,2020-01-01,14531,13986,545,3.8
29169,2020-01-01,14680,14000,680,4.6
29171,2020-01-01,2292,2193,99,4.3
29173,2020-01-01,5618,5413,205,3.6
29175,2020-01-01,10151,9691,460,4.5
29177,2020-01-01,11029,10587,442,4
29179,2020-01-01,2910,2775,135,4.6
29181,2020-01-01,4967,4712,255,5.1
29183,2020-01-01,229768,221755,8013,3.5
29185,2020-01-01,3747,3545,202,5.4
29186,2020-01-01,9087,8767,320,3.5
29187,2020-01-01,26598,25300,1298,4.9
29189,2020-01-01,532167,513312,18855,3.5
29195,2020-01-01,10882,10460,422,3.9
29197,2020-01-01,1984,1887,97,4.9
29199,2020-01-01,2393,2308,85,3.6
29201,2020-01-01,19934,19143,791,4
29203,2020-01-01,3292,3091,201,6.1
29205,2020-01-01,3080,2950,130,4.2
29207,2020-01-01,13353,12640,713,5.3
29209,2020-01-01,13174,11873,1301,9.9
29211,2020-01-01,2813,2686,127,4.5
29213,2020-01-01,25809,22848,2961,11.5
29215,2020-01-01,9005,8541,464,5.2
29217,2020-01-01,9503,9141,362,3.8
29219,2020-01-01,18692,17868,824,4.4
29221,2020-01-01,10317,9738,579,5.6
29223,2020-01-01,5102,4847,255,5
29225,2020-01-01,17462,16732,730,4.2
29227,2020-01-01,1169,1136,33,2.8
29229,2020-01-01,7527,6981,546,7.3
29510,2020-01-01,151721,145361,6360,4.2
30001,2020-01-01,5077,4884,193,3.8
30003,2020-01-01,4902,4544,358,7.3
30005,2020-01-01,2313,2190,123,5.3
30007,2020-01-01,2601,2454,147,5.7
30009,2020-01-01,5566,5280,286,5.1
30011,2020-01-01,647,631,16,2.5
30013,2020-01-01,38452,36753,1699,4.4
30015,2020-01-01,2454,2361,93,3.8
30017,2020-01-01,6205,5938,267,4.3
30019,2020-01-01,890,864,26,2.9
30021,2020-01-01,4651,4495,156,3.4
30023,2020-01-01,5020,4818,202,4
30025,2020-01-01,1687,1647,40,2.4
30027,2020-01-01,5707,5406,301,5.3
30029,2020-01-01,48532,45223,3309,6.8
30031,2020-01-01,69649,67778,1871,2.7
30033,2020-01-01,743,716,27,3.6
30035,2020-01-01,5558,5070,488,8.8
30037,2020-01-01,366,347,19,5.2
30039,2020-01-01,1717,1563,154,9
30041,2020-01-01,7671,7348,323,4.2
30043,2020-01-01,5770,5509,261,4.5
30045,2020-01-01,1075,1025,50,4.7
30047,2020-01-01,13521,12715,806,6
30049,2020-01-01,36246,34826,1420,3.9
30051,2020-01-01,963,932,31,3.2
30053,2020-01-01,8079,7191,888,11
30055,2020-01-01,926,904,22,2.4
30057,2020-01-01,5234,5024,210,4
30059,2020-01-01,1044,1002,42,4
30061,2020-01-01,1777,1572,205,11.5
30063,2020-01-01,64652,61873,2779,4.3
30065,2020-01-01,2336,2184,152,6.5
30067,2020-01-01,8753,8350,403,4.6
30069,2020-01-01,264,253,11,4.2
30071,2020-01-01,1871,1770,101,5.4
30073,2020-01-01,2653,2552,101,3.8
30075,2020-01-01,943,913,30,3.2
30077,2020-01-01,2800,2665,135,4.8
30079,2020-01-01,458,434,24,5.2
30081,2020-01-01,20524,19418,1106,5.4
30083,2020-01-01,5926,5729,197,3.3
30085,2020-01-01,4456,4230,226,5.1
30087,2020-01-01,3692,3498,194,5.3
30089,2020-01-01,4993,4566,427,8.6
30091,2020-01-01,1757,1699,58,3.3
30093,2020-01-01,17276,16423,853,4.9
30095,2020-01-01,5380,5167,213,4
30097,2020-01-01,1786,1719,67,3.8
30099,2020-01-01,2763,2619,144,5.2
30101,2020-01-01,2094,2024,70,3.3
30103,2020-01-01,334,326,8,2.4
30105,2020-01-01,4008,3831,177,4.4
30107,2020-01-01,744,694,50,6.7
30109,2020-01-01,426,413,13,3.1
30111,2020-01-01,83024,79724,3300,4
31001,2020-01-01,16753,16138,615,3.7
31003,2020-01-01,3906,3812,94,2.4
31005,2020-01-01,240,229,11,4.6
31007,2020-01-01,388,378,10,2.6
31009,2020-01-01,269,252,17,6.3
31011,2020-01-01,2984,2887,97,3.3
31013,2020-01-01,5324,5148,176,3.3
31015,2020-01-01,1086,1050,36,3.3
31017,2020-01-01,1396,1354,42,3
31019,2020-01-01,27949,27212,737,2.6
31021,2020-01-01,3545,3392,153,4.3
31023,2020-01-01,4662,4544,118,2.5
31025,2020-01-01,13571,13061,510,3.8
31027,2020-01-01,4508,4391,117,2.6
31029,2020-01-01,2316,2272,44,1.9
31031,2020-01-01,3346,3260,86,2.6
31033,2020-01-01,4308,4161,147,3.4
31035,2020-01-01,3280,3163,117,3.6
31037,2020-01-01,5611,5458,153,2.7
31039,2020-01-01,4822,4694,128,2.7
31041,2020-01-01,6415,6270,145,2.3
31043,2020-01-01,10764,10250,514,4.8
31045,2020-01-01,4967,4847,120,2.4
31047,2020-01-01,13297,12879,418,3.1
31049,2020-01-01,975,944,31,3.2
31051,2020-01-01,3021,2931,90,3
31053,2020-01-01,19909,19301,608,3.1
31055,2020-01-01,298797,288492,10305,3.4
31057,2020-01-01,1173,1144,29,2.5
31059,2020-01-01,3228,3144,84,2.6
31061,2020-01-01,1507,1463,44,2.9
31063,2020-01-01,1613,1556,57,3.5
31065,2020-01-01,2594,2521,73,2.8
31067,2020-01-01,10998,10595,403,3.7
31069,2020-01-01,1086,1046,40,3.7
31071,2020-01-01,1163,1136,27,2.3
31073,2020-01-01,1069,1044,25,2.3
31075,2020-01-01,421,411,10,2.4
31077,2020-01-01,1244,1208,36,2.9
31079,2020-01-01,32143,30475,1668,5.2
31081,2020-01-01,4858,4671,187,3.8
31083,2020-01-01,1744,1696,48,2.8
31085,2020-01-01,636,617,19,3
31087,2020-01-01,1304,1258,46,3.5
31089,2020-01-01,5768,5615,153,2.7
31091,2020-01-01,381,368,13,3.4
31093,2020-01-01,3436,3247,189,5.5
31095,2020-01-01,4179,4064,115,2.8
31097,2020-01-01,2066,1982,84,4.1
31099,2020-01-01,3821,3741,80,2.1
31101,2020-01-01,4534,4379,155,3.4
31103,2020-01-01,620,605,15,2.4
31105,2020-01-01,1991,1930,61,3.1
31107,2020-01-01,4691,4517,174,3.7
31109,2020-01-01,177635,172653,4982,2.8
31111,2020-01-01,18209,17537,672,3.7
31113,2020-01-01,484,473,11,2.3
31115,2020-01-01,427,406,21,4.9
31117,2020-01-01,449,436,13,2.9
31119,2020-01-01,19474,18859,615,3.2
31121,2020-01-01,4090,3916,174,4.3
31123,2020-01-01,2630,2534,96,3.7
31125,2020-01-01,2009,1946,63,3.1
31127,2020-01-01,3623,3491,132,3.6
31129,2020-01-01,2515,2431,84,3.3
31131,2020-01-01,8364,8102,262,3.1
31133,2020-01-01,1489,1451,38,2.6
31135,2020-01-01,1860,1818,42,2.3
31137,2020-01-01,5047,4923,124,2.5
31139,2020-01-01,4098,3972,126,3.1
31141,2020-01-01,17734,17212,522,2.9
31143,2020-01-01,2950,2866,84,2.8
31145,2020-01-01,5820,5658,162,2.8
31147,2020-01-01,4209,4070,139,3.3
31149,2020-01-01,892,869,23,2.6
31151,2020-01-01,7454,7192,262,3.5
31153,2020-01-01,96872,93970,2902,3
31155,2020-01-01,11308,10968,340,3
31157,2020-01-01,18009,17321,688,3.8
31159,2020-01-01,8984,8720,264,2.9
31161,2020-01-01,2770,2699,71,2.6
31163,2020-01-01,1688,1627,61,3.6
31165,2020-01-01,763,742,21,2.8
31167,2020-01-01,3512,3407,105,3
31169,2020-01-01,2782,2715,67,2.4
31171,2020-01-01,454,429,25,5.5
31173,2020-01-01,3051,2921,130,4.3
31175,2020-01-01,2161,2090,71,3.3
31177,2020-01-01,11255,10898,357,3.2
31179,2020-01-01,5821,5670,151,2.6
31181,2020-01-01,1679,1614,65,3.9
31183,2020-01-01,576,563,13,2.3
31185,2020-01-01,7242,7055,187,2.6
32001,2020-01-01,11609,11165,444,3.8
32003,2020-01-01,NA,NA,46406,4
32005,2020-01-01,23643,22670,973,4.1
32007,2020-01-01,27892,26976,916,3.3
32009,2020-01-01,442,423,19,4.3
32011,2020-01-01,1187,1161,26,2.2
32013,2020-01-01,8644,8371,273,3.2
32015,2020-01-01,3292,3162,130,3.9
32017,2020-01-01,2148,2066,82,3.8
32019,2020-01-01,23869,22640,1229,5.1
32021,2020-01-01,2208,2123,85,3.8
32023,2020-01-01,18318,17394,924,5
32027,2020-01-01,2734,2627,107,3.9
32029,2020-01-01,2103,2020,83,3.9
32031,2020-01-01,261929,252825,9104,3.5
32033,2020-01-01,4761,4615,146,3.1
32510,2020-01-01,26771,25637,1134,4.2
33001,2020-01-01,31208,30224,984,3.2
33003,2020-01-01,23984,23232,752,3.1
33005,2020-01-01,40436,39159,1277,3.2
33007,2020-01-01,14665,14058,607,4.1
33009,2020-01-01,49020,47748,1272,2.6
33011,2020-01-01,244885,237174,7711,3.1
33013,2020-01-01,84087,81845,2242,2.7
33015,2020-01-01,189469,183273,6196,3.3
33017,2020-01-01,73673,71662,2011,2.7
33019,2020-01-01,23166,22509,657,2.8
34001,2020-01-01,120865,113235,7630,6.3
34003,2020-01-01,491827,475853,15974,3.2
34005,2020-01-01,234602,226176,8426,3.6
34007,2020-01-01,257931,246344,11587,4.5
34009,2020-01-01,40734,35424,5310,13
34011,2020-01-01,66349,61907,4442,6.7
34013,2020-01-01,377302,358827,18475,4.9
34015,2020-01-01,153027,146539,6488,4.2
34017,2020-01-01,368344,355261,13083,3.6
34019,2020-01-01,65566,63447,2119,3.2
34021,2020-01-01,206907,199506,7401,3.6
34023,2020-01-01,442702,427418,15284,3.5
34025,2020-01-01,331943,319694,12249,3.7
34027,2020-01-01,261213,252964,8249,3.2
34029,2020-01-01,282452,269825,12627,4.5
34031,2020-01-01,248551,236139,12412,5
34033,2020-01-01,29326,27623,1703,5.8
34035,2020-01-01,174084,168219,5865,3.4
34037,2020-01-01,75642,72410,3232,4.3
34039,2020-01-01,282457,270600,11857,4.2
34041,2020-01-01,56544,54238,2306,4.1
35001,2020-01-01,336719,321205,15514,4.6
35003,2020-01-01,1114,1020,94,8.4
35005,2020-01-01,28020,26598,1422,5.1
35006,2020-01-01,9013,8407,606,6.7
35007,2020-01-01,5457,5205,252,4.6
35009,2020-01-01,22387,21462,925,4.1
35011,2020-01-01,703,670,33,4.7
35013,2020-01-01,98031,91838,6193,6.3
35015,2020-01-01,35630,34479,1151,3.2
35017,2020-01-01,12278,11648,630,5.1
35019,2020-01-01,1545,1467,78,5
35021,2020-01-01,279,268,11,3.9
35023,2020-01-01,2021,1927,94,4.7
35025,2020-01-01,31230,29819,1411,4.5
35027,2020-01-01,8878,8428,450,5.1
35028,2020-01-01,9772,9444,328,3.4
35029,2020-01-01,10252,8623,1629,15.9
35031,2020-01-01,24597,22813,1784,7.3
35033,2020-01-01,2093,1934,159,7.6
35035,2020-01-01,26302,24988,1314,5
35037,2020-01-01,3132,2964,168,5.4
35039,2020-01-01,16893,15928,965,5.7
35041,2020-01-01,7691,7330,361,4.7
35043,2020-01-01,67326,64004,3322,4.9
35045,2020-01-01,51643,48339,3304,6.4
35047,2020-01-01,10688,10028,660,6.2
35049,2020-01-01,74062,70909,3153,4.3
35051,2020-01-01,4055,3761,294,7.3
35053,2020-01-01,6375,5994,381,6
35055,2020-01-01,16133,15188,945,5.9
35057,2020-01-01,5412,5016,396,7.3
35059,2020-01-01,1643,1571,72,4.4
35061,2020-01-01,30875,29205,1670,5.4
36001,2020-01-01,156964,151049,5915,3.8
36003,2020-01-01,19511,18235,1276,6.5
36005,2020-01-01,598557,566881,31676,5.3
36007,2020-01-01,82124,77542,4582,5.6
36009,2020-01-01,34573,32380,2193,6.3
36011,2020-01-01,35783,33952,1831,5.1
36013,2020-01-01,53832,50749,3083,5.7
36015,2020-01-01,35821,34128,1693,4.7
36017,2020-01-01,22188,21002,1186,5.3
36019,2020-01-01,36147,34172,1975,5.5
36021,2020-01-01,30785,29647,1138,3.7
36023,2020-01-01,23022,21565,1457,6.3
36025,2020-01-01,18930,17911,1019,5.4
36027,2020-01-01,144613,139044,5569,3.9
36029,2020-01-01,442271,421218,21053,4.8
36031,2020-01-01,17329,16312,1017,5.9
36033,2020-01-01,19477,18350,1127,5.8
36035,2020-01-01,22677,21390,1287,5.7
36037,2020-01-01,29609,28153,1456,4.9
36039,2020-01-01,20840,19802,1038,5
36041,2020-01-01,2114,1932,182,8.6
36043,2020-01-01,27927,26262,1665,6
36045,2020-01-01,43103,39940,3163,7.3
36047,2020-01-01,NA,NA,47037,3.9
36049,2020-01-01,11858,10981,877,7.4
36051,2020-01-01,30789,29227,1562,5.1
36053,2020-01-01,33062,31297,1765,5.3
36055,2020-01-01,360171,344294,15877,4.4
36057,2020-01-01,22426,21067,1359,6.1
36059,2020-01-01,707528,682626,24902,3.5
36061,2020-01-01,921407,890022,31385,3.4
36063,2020-01-01,99028,93237,5791,5.8
36065,2020-01-01,100826,96070,4756,4.7
36067,2020-01-01,219744,210369,9375,4.3
36069,2020-01-01,55522,53000,2522,4.5
36071,2020-01-01,187569,180159,7410,4
36073,2020-01-01,17615,16623,992,5.6
36075,2020-01-01,53044,49568,3476,6.6
36077,2020-01-01,27544,26061,1483,5.4
36079,2020-01-01,51019,49014,2005,3.9
36081,2020-01-01,NA,NA,38341,3.4
36083,2020-01-01,81119,77767,3352,4.1
36085,2020-01-01,224647,216304,8343,3.7
36087,2020-01-01,155932,150343,5589,3.6
36089,2020-01-01,43139,40378,2761,6.4
36091,2020-01-01,119272,114913,4359,3.7
36093,2020-01-01,76228,73158,3070,4
36095,2020-01-01,14850,13963,887,6
36097,2020-01-01,7993,7482,511,6.4
36099,2020-01-01,15737,14958,779,5
36101,2020-01-01,42918,40599,2319,5.4
36103,2020-01-01,778358,746762,31596,4.1
36105,2020-01-01,36390,34723,1667,4.6
36107,2020-01-01,22329,21199,1130,5.1
36109,2020-01-01,47958,46170,1788,3.7
36111,2020-01-01,87123,83547,3576,4.1
36113,2020-01-01,30763,29003,1760,5.7
36115,2020-01-01,27518,26156,1362,4.9
36117,2020-01-01,44087,41923,2164,4.9
36119,2020-01-01,486675,467958,18717,3.8
36121,2020-01-01,18230,17116,1114,6.1
36123,2020-01-01,12048,11473,575,4.8
37001,2020-01-01,82499,79622,2877,3.5
37003,2020-01-01,18014,17487,527,2.9
37005,2020-01-01,4362,4148,214,4.9
37007,2020-01-01,10776,10306,470,4.4
37009,2020-01-01,13005,12525,480,3.7
37011,2020-01-01,7346,7070,276,3.8
37013,2020-01-01,19768,18936,832,4.2
37015,2020-01-01,7969,7579,390,4.9
37017,2020-01-01,14978,14278,700,4.7
37019,2020-01-01,52618,49657,2961,5.6
37021,2020-01-01,140318,136289,4029,2.9
37023,2020-01-01,40875,39461,1414,3.5
37025,2020-01-01,111111,107394,3717,3.3
37027,2020-01-01,36386,35088,1298,3.6
37029,2020-01-01,4749,4571,178,3.7
37031,2020-01-01,31633,30336,1297,4.1
37033,2020-01-01,9859,9444,415,4.2
37035,2020-01-01,78985,76332,2653,3.4
37037,2020-01-01,36727,35588,1139,3.1
37039,2020-01-01,11273,10787,486,4.3
37041,2020-01-01,5608,5379,229,4.1
37043,2020-01-01,4190,4007,183,4.4
37045,2020-01-01,49369,47438,1931,3.9
37047,2020-01-01,22735,21589,1146,5
37049,2020-01-01,41564,40023,1541,3.7
37051,2020-01-01,128641,122469,6172,4.8
37053,2020-01-01,14345,13818,527,3.7
37055,2020-01-01,18002,16661,1341,7.4
37057,2020-01-01,81459,78589,2870,3.5
37059,2020-01-01,20742,20076,666,3.2
37061,2020-01-01,26075,25097,978,3.8
37063,2020-01-01,175470,170076,5394,3.1
37065,2020-01-01,21005,19903,1102,5.2
37067,2020-01-01,189247,182697,6550,3.5
37069,2020-01-01,31939,30759,1180,3.7
37071,2020-01-01,111424,107212,4212,3.8
37073,2020-01-01,5307,5107,200,3.8
37075,2020-01-01,3027,2817,210,6.9
37077,2020-01-01,30453,29489,964,3.2
37079,2020-01-01,9891,9566,325,3.3
37081,2020-01-01,263119,253084,10035,3.8
37083,2020-01-01,20489,19323,1166,5.7
37085,2020-01-01,54054,51859,2195,4.1
37087,2020-01-01,29906,28891,1015,3.4
37089,2020-01-01,54983,53252,1731,3.1
37091,2020-01-01,9357,8913,444,4.7
37093,2020-01-01,20297,19338,959,4.7
37095,2020-01-01,1871,1639,232,12.4
37097,2020-01-01,90792,87660,3132,3.4
37099,2020-01-01,19615,18832,783,4
37101,2020-01-01,101435,98031,3404,3.4
37103,2020-01-01,4342,4196,146,3.4
37105,2020-01-01,26736,25692,1044,3.9
37107,2020-01-01,28423,27416,1007,3.5
37109,2020-01-01,44512,43008,1504,3.4
37111,2020-01-01,20896,20125,771,3.7
37113,2020-01-01,15501,14887,614,4
37115,2020-01-01,10078,9734,344,3.4
37117,2020-01-01,9184,8770,414,4.5
37119,2020-01-01,627084,605955,21129,3.4
37121,2020-01-01,6044,5761,283,4.7
37123,2020-01-01,11639,11208,431,3.7
37125,2020-01-01,42285,40754,1531,3.6
37127,2020-01-01,43347,41433,1914,4.4
37129,2020-01-01,123169,119026,4143,3.4
37131,2020-01-01,7839,7410,429,5.5
37133,2020-01-01,64830,62076,2754,4.2
37135,2020-01-01,80926,78558,2368,2.9
37137,2020-01-01,5409,5211,198,3.7
37139,2020-01-01,16884,16128,756,4.5
37141,2020-01-01,28960,27851,1109,3.8
37143,2020-01-01,5027,4788,239,4.8
37145,2020-01-01,18655,17931,724,3.9
37147,2020-01-01,89975,86549,3426,3.8
37149,2020-01-01,9210,8895,315,3.4
37151,2020-01-01,66260,63916,2344,3.5
37153,2020-01-01,16755,15913,842,5
37155,2020-01-01,50887,48350,2537,5
37157,2020-01-01,40209,38504,1705,4.2
37159,2020-01-01,66392,63777,2615,3.9
37161,2020-01-01,25130,23882,1248,5
37163,2020-01-01,29912,28817,1095,3.7
37165,2020-01-01,11614,10856,758,6.5
37167,2020-01-01,30568,29466,1102,3.6
37169,2020-01-01,21823,21045,778,3.6
37171,2020-01-01,33665,32451,1214,3.6
37173,2020-01-01,6844,6522,322,4.7
37175,2020-01-01,14573,14071,502,3.4
37177,2020-01-01,1308,1205,103,7.9
37179,2020-01-01,125278,121290,3988,3.2
37181,2020-01-01,17448,16494,954,5.5
37183,2020-01-01,599669,581023,18646,3.1
37185,2020-01-01,6600,6237,363,5.5
37187,2020-01-01,4475,4200,275,6.1
37189,2020-01-01,28925,28047,878,3
37191,2020-01-01,52512,50498,2014,3.8
37193,2020-01-01,29100,27954,1146,3.9
37195,2020-01-01,35463,33626,1837,5.2
37197,2020-01-01,17877,17275,602,3.4
37199,2020-01-01,8375,8044,331,4
38001,2020-01-01,1008,979,29,2.9
38003,2020-01-01,5132,4982,150,2.9
38005,2020-01-01,2265,2154,111,4.9
38007,2020-01-01,381,368,13,3.4
38009,2020-01-01,2827,2717,110,3.9
38011,2020-01-01,1591,1556,35,2.2
38013,2020-01-01,994,958,36,3.6
38015,2020-01-01,49360,47882,1478,3
38017,2020-01-01,103387,100688,2699,2.6
38019,2020-01-01,1857,1798,59,3.2
38021,2020-01-01,2229,2182,47,2.1
38023,2020-01-01,1397,1375,22,1.6
38025,2020-01-01,3255,3204,51,1.6
38027,2020-01-01,1184,1123,61,5.2
38029,2020-01-01,1467,1379,88,6
38031,2020-01-01,1500,1449,51,3.4
38033,2020-01-01,830,816,14,1.7
38035,2020-01-01,36612,35744,868,2.4
38037,2020-01-01,1151,1120,31,2.7
38039,2020-01-01,1006,983,23,2.3
38041,2020-01-01,1346,1301,45,3.3
38043,2020-01-01,1266,1190,76,6
38045,2020-01-01,1966,1921,45,2.3
38047,2020-01-01,834,806,28,3.4
38049,2020-01-01,3005,2851,154,5.1
38051,2020-01-01,1048,1011,37,3.5
38053,2020-01-01,9989,9761,228,2.3
38055,2020-01-01,4660,4452,208,4.5
38057,2020-01-01,3499,3313,186,5.3
38059,2020-01-01,16404,15733,671,4.1
38061,2020-01-01,7287,7162,125,1.7
38063,2020-01-01,1335,1283,52,3.9
38065,2020-01-01,865,822,43,5
38067,2020-01-01,3284,3138,146,4.4
38069,2020-01-01,1653,1592,61,3.7
38071,2020-01-01,5561,5368,193,3.5
38073,2020-01-01,2803,2729,74,2.6
38075,2020-01-01,1219,1175,44,3.6
38077,2020-01-01,8351,8129,222,2.7
38079,2020-01-01,4610,4200,410,8.9
38081,2020-01-01,2709,2659,50,1.8
38083,2020-01-01,660,608,52,7.9
38085,2020-01-01,1170,1138,32,2.7
38087,2020-01-01,387,378,9,2.3
38089,2020-01-01,18405,17924,481,2.6
38091,2020-01-01,918,901,17,1.9
38093,2020-01-01,10334,10048,286,2.8
38095,2020-01-01,1091,1060,31,2.8
38097,2020-01-01,4356,4230,126,2.9
38099,2020-01-01,4994,4811,183,3.7
38101,2020-01-01,31471,30492,979,3.1
38103,2020-01-01,1873,1777,96,5.1
38105,2020-01-01,24080,23555,525,2.2
39001,2020-01-01,11119,10042,1077,9.7
39003,2020-01-01,48187,45595,2592,5.4
39005,2020-01-01,26680,25230,1450,5.4
39007,2020-01-01,44674,41685,2989,6.7
39009,2020-01-01,27801,25941,1860,6.7
39011,2020-01-01,25030,24077,953,3.8
39013,2020-01-01,29517,26902,2615,8.9
39015,2020-01-01,19792,18424,1368,6.9
39017,2020-01-01,196539,187431,9108,4.6
39019,2020-01-01,13089,12158,931,7.1
39021,2020-01-01,20138,19133,1005,5
39023,2020-01-01,63370,59666,3704,5.8
39025,2020-01-01,107938,102860,5078,4.7
39027,2020-01-01,17772,16684,1088,6.1
39029,2020-01-01,47661,44588,3073,6.4
39031,2020-01-01,14151,13066,1085,7.7
39033,2020-01-01,18376,17288,1088,5.9
39035,2020-01-01,620379,589144,31235,5
39037,2020-01-01,25851,24564,1287,5
39039,2020-01-01,18003,17088,915,5.1
39041,2020-01-01,112946,108700,4246,3.8
39043,2020-01-01,36411,33895,2516,6.9
39045,2020-01-01,79450,75701,3749,4.7
39047,2020-01-01,14035,13341,694,4.9
39049,2020-01-01,703424,674105,29319,4.2
39051,2020-01-01,22658,21300,1358,6
39053,2020-01-01,12561,11599,962,7.7
39055,2020-01-01,49870,47588,2282,4.6
39057,2020-01-01,84097,80289,3808,4.5
39059,2020-01-01,18568,17044,1524,8.2
39061,2020-01-01,417926,399082,18844,4.5
39063,2020-01-01,41805,40166,1639,3.9
39065,2020-01-01,14009,13261,748,5.3
39067,2020-01-01,6836,6293,543,7.9
39069,2020-01-01,13102,12225,877,6.7
39071,2020-01-01,17099,15892,1207,7.1
39073,2020-01-01,13230,12375,855,6.5
39075,2020-01-01,20814,19997,817,3.9
39077,2020-01-01,28003,25528,2475,8.8
39079,2020-01-01,13261,12124,1137,8.6
39081,2020-01-01,27711,25570,2141,7.7
39083,2020-01-01,31316,29694,1622,5.2
39085,2020-01-01,128995,122772,6223,4.8
39087,2020-01-01,24227,22634,1593,6.6
39089,2020-01-01,91639,87301,4338,4.7
39091,2020-01-01,22812,21706,1106,4.8
39093,2020-01-01,157583,148895,8688,5.5
39095,2020-01-01,210485,198500,11985,5.7
39097,2020-01-01,21078,20155,923,4.4
39099,2020-01-01,102756,95505,7251,7.1
39101,2020-01-01,28441,27012,1429,5
39103,2020-01-01,99837,95513,4324,4.3
39105,2020-01-01,9306,8405,901,9.7
39107,2020-01-01,23444,22663,781,3.3
39109,2020-01-01,54941,52348,2593,4.7
39111,2020-01-01,5545,4867,678,12.2
39113,2020-01-01,253535,240870,12665,5
39115,2020-01-01,6915,6230,685,9.9
39117,2020-01-01,17147,16139,1008,5.9
39119,2020-01-01,40759,37967,2792,6.9
39121,2020-01-01,4762,4300,462,9.7
39123,2020-01-01,20279,18416,1863,9.2
39125,2020-01-01,8858,8440,418,4.7
39127,2020-01-01,16286,15075,1211,7.4
39129,2020-01-01,26874,25458,1416,5.3
39131,2020-01-01,10873,9950,923,8.5
39133,2020-01-01,87928,83074,4854,5.5
39135,2020-01-01,21363,20303,1060,5
39137,2020-01-01,18773,17957,816,4.3
39139,2020-01-01,52668,49592,3076,5.8
39141,2020-01-01,35803,33700,2103,5.9
39143,2020-01-01,30479,28670,1809,5.9
39145,2020-01-01,29602,27159,2443,8.3
39147,2020-01-01,27248,25772,1476,5.4
39149,2020-01-01,24049,22957,1092,4.5
39151,2020-01-01,186984,175936,11048,5.9
39153,2020-01-01,274055,259414,14641,5.3
39155,2020-01-01,86691,80075,6616,7.6
39157,2020-01-01,44739,42023,2716,6.1
39159,2020-01-01,29616,28441,1175,4
39161,2020-01-01,14840,14173,667,4.5
39163,2020-01-01,5721,5232,489,8.5
39165,2020-01-01,120877,115724,5153,4.3
39167,2020-01-01,27405,25334,2071,7.6
39169,2020-01-01,61716,59091,2625,4.3
39171,2020-01-01,19120,18297,823,4.3
39173,2020-01-01,71505,68202,3303,4.6
39175,2020-01-01,13150,12607,543,4.1
40001,2020-01-01,8201,7853,348,4.2
40003,2020-01-01,2814,2753,61,2.2
40005,2020-01-01,5150,4901,249,4.8
40007,2020-01-01,2691,2636,55,2
40009,2020-01-01,10185,9737,448,4.4
40011,2020-01-01,4495,4383,112,2.5
40013,2020-01-01,21948,21304,644,2.9
40015,2020-01-01,12019,11579,440,3.7
40017,2020-01-01,76076,73850,2226,2.9
40019,2020-01-01,21389,20632,757,3.5
40021,2020-01-01,19138,18410,728,3.8
40023,2020-01-01,5530,5243,287,5.2
40025,2020-01-01,1355,1334,21,1.5
40027,2020-01-01,143337,139497,3840,2.7
40029,2020-01-01,2324,2219,105,4.5
40031,2020-01-01,48382,46806,1576,3.3
40033,2020-01-01,2683,2608,75,2.8
40035,2020-01-01,5822,5592,230,4
40037,2020-01-01,31507,30335,1172,3.7
40039,2020-01-01,15259,14796,463,3
40041,2020-01-01,18160,17485,675,3.7
40043,2020-01-01,2788,2722,66,2.4
40045,2020-01-01,2094,2036,58,2.8
40047,2020-01-01,26797,25940,857,3.2
40049,2020-01-01,12780,12314,466,3.6
40051,2020-01-01,26690,25767,923,3.5
40053,2020-01-01,2644,2582,62,2.3
40055,2020-01-01,1833,1759,74,4
40057,2020-01-01,1155,1124,31,2.7
40059,2020-01-01,1770,1721,49,2.8
40061,2020-01-01,4221,3973,248,5.9
40063,2020-01-01,5378,5091,287,5.3
40065,2020-01-01,10549,10240,309,2.9
40067,2020-01-01,2549,2457,92,3.6
40069,2020-01-01,3756,3577,179,4.8
40071,2020-01-01,18330,17615,715,3.9
40073,2020-01-01,8893,8698,195,2.2
40075,2020-01-01,3451,3338,113,3.3
40077,2020-01-01,3111,2886,225,7.2
40079,2020-01-01,18971,18096,875,4.6
40081,2020-01-01,15765,15202,563,3.6
40083,2020-01-01,22389,21736,653,2.9
40085,2020-01-01,6503,6356,147,2.3
40087,2020-01-01,19893,19328,565,2.8
40089,2020-01-01,14831,13966,865,5.8
40091,2020-01-01,7212,6729,483,6.7
40093,2020-01-01,3709,3625,84,2.3
40095,2020-01-01,6775,6534,241,3.6
40097,2020-01-01,19494,18898,596,3.1
40099,2020-01-01,6242,6034,208,3.3
40101,2020-01-01,29814,28701,1113,3.7
40103,2020-01-01,5559,5414,145,2.6
40105,2020-01-01,4585,4438,147,3.2
40107,2020-01-01,4504,4272,232,5.2
40109,2020-01-01,385289,373900,11389,3
40111,2020-01-01,15698,14953,745,4.7
40113,2020-01-01,20590,19832,758,3.7
40115,2020-01-01,14462,14030,432,3
40117,2020-01-01,7347,7059,288,3.9
40119,2020-01-01,37957,36894,1063,2.8
40121,2020-01-01,17105,16347,758,4.4
40123,2020-01-01,19399,18828,571,2.9
40125,2020-01-01,32686,31542,1144,3.5
40127,2020-01-01,4465,4229,236,5.3
40129,2020-01-01,1834,1773,61,3.3
40131,2020-01-01,45154,43779,1375,3
40133,2020-01-01,9371,8896,475,5.1
40135,2020-01-01,16355,15659,696,4.3
40137,2020-01-01,19166,18299,867,4.5
40139,2020-01-01,11226,10999,227,2
40141,2020-01-01,3029,2930,99,3.3
40143,2020-01-01,323777,313788,9989,3.1
40145,2020-01-01,38425,37206,1219,3.2
40147,2020-01-01,22188,21475,713,3.2
40149,2020-01-01,5125,4916,209,4.1
40151,2020-01-01,4555,4465,90,2
40153,2020-01-01,8964,8643,321,3.6
41001,2020-01-01,6991,6592,399,5.7
41003,2020-01-01,47334,46101,1233,2.6
41005,2020-01-01,218854,211755,7099,3.2
41007,2020-01-01,18562,17809,753,4.1
41009,2020-01-01,24395,23259,1136,4.7
41011,2020-01-01,26108,24880,1228,4.7
41013,2020-01-01,9938,9341,597,6
41015,2020-01-01,8658,8159,499,5.8
41017,2020-01-01,96633,92660,3973,4.1
41019,2020-01-01,46638,44324,2314,5
41021,2020-01-01,906,862,44,4.9
41023,2020-01-01,3080,2796,284,9.2
41025,2020-01-01,3503,3276,227,6.5
41027,2020-01-01,13514,13055,459,3.4
41029,2020-01-01,103119,98678,4441,4.3
41031,2020-01-01,10046,9454,592,5.9
41033,2020-01-01,35394,33568,1826,5.2
41035,2020-01-01,29068,26751,2317,8
41037,2020-01-01,3471,3282,189,5.4
41039,2020-01-01,180472,173576,6896,3.8
41041,2020-01-01,20202,19283,919,4.5
41043,2020-01-01,58407,55904,2503,4.3
41045,2020-01-01,12139,11600,539,4.4
41047,2020-01-01,159488,153099,6389,4
41049,2020-01-01,5490,5231,259,4.7
41051,2020-01-01,453134,438857,14277,3.2
41053,2020-01-01,39690,38134,1556,3.9
41055,2020-01-01,935,887,48,5.1
41057,2020-01-01,11534,11051,483,4.2
41059,2020-01-01,35486,33562,1924,5.4
41061,2020-01-01,11860,11178,682,5.8
41063,2020-01-01,3245,3028,217,6.7
41065,2020-01-01,12227,11641,586,4.8
41067,2020-01-01,325113,315805,9308,2.9
41069,2020-01-01,684,654,30,4.4
41071,2020-01-01,54291,52545,1746,3.2
42001,2020-01-01,55121,53038,2083,3.8
42003,2020-01-01,647213,617111,30102,4.7
42005,2020-01-01,32419,30096,2323,7.2
42007,2020-01-01,83959,79314,4645,5.5
42009,2020-01-01,23487,21976,1511,6.4
42011,2020-01-01,215313,204707,10606,4.9
42013,2020-01-01,59674,56551,3123,5.2
42015,2020-01-01,28344,26766,1578,5.6
42017,2020-01-01,347183,332214,14969,4.3
42019,2020-01-01,99997,95184,4813,4.8
42021,2020-01-01,57371,53687,3684,6.4
42023,2020-01-01,2025,1863,162,8
42025,2020-01-01,32369,30431,1938,6
42027,2020-01-01,81051,78036,3015,3.7
42029,2020-01-01,287044,277149,9895,3.4
42031,2020-01-01,17123,15984,1139,6.7
42033,2020-01-01,36420,33863,2557,7
42035,2020-01-01,18002,16763,1239,6.9
42037,2020-01-01,33558,31548,2010,6
42039,2020-01-01,38526,36281,2245,5.8
42041,2020-01-01,132732,127793,4939,3.7
42043,2020-01-01,144712,138362,6350,4.4
42045,2020-01-01,301280,288204,13076,4.3
42047,2020-01-01,15632,14591,1041,6.7
42049,2020-01-01,129271,121961,7310,5.7
42051,2020-01-01,57433,52890,4543,7.9
42053,2020-01-01,1795,1627,168,9.4
42055,2020-01-01,77822,74400,3422,4.4
42057,2020-01-01,7834,7325,509,6.5
42059,2020-01-01,16678,15603,1075,6.4
42061,2020-01-01,19864,18244,1620,8.2
42063,2020-01-01,38465,35936,2529,6.6
42065,2020-01-01,20423,19118,1305,6.4
42067,2020-01-01,12619,11938,681,5.4
42069,2020-01-01,105803,99883,5920,5.6
42071,2020-01-01,284109,273047,11062,3.9
42073,2020-01-01,40790,37834,2956,7.2
42075,2020-01-01,71753,68558,3195,4.5
42077,2020-01-01,194441,185074,9367,4.8
42079,2020-01-01,159554,149129,10425,6.5
42081,2020-01-01,57156,53781,3375,5.9
42083,2020-01-01,17481,16280,1201,6.9
42085,2020-01-01,48620,45783,2837,5.8
42087,2020-01-01,21085,19901,1184,5.6
42089,2020-01-01,84069,78875,5194,6.2
42091,2020-01-01,459393,442017,17376,3.8
42093,2020-01-01,9119,8744,375,4.1
42095,2020-01-01,162817,154714,8103,5
42097,2020-01-01,42533,39636,2897,6.8
42099,2020-01-01,24458,23357,1101,4.5
42101,2020-01-01,733679,690833,42846,5.8
42103,2020-01-01,25544,23871,1673,6.5
42105,2020-01-01,7160,6507,653,9.1
42107,2020-01-01,66895,62914,3981,6
42109,2020-01-01,19340,18153,1187,6.1
42111,2020-01-01,33821,31440,2381,7
42113,2020-01-01,2588,2391,197,7.6
42115,2020-01-01,20264,19080,1184,5.8
42117,2020-01-01,19045,17772,1273,6.7
42119,2020-01-01,20008,19126,882,4.4
42121,2020-01-01,22341,20966,1375,6.2
42123,2020-01-01,18736,17692,1044,5.6
42125,2020-01-01,107209,101348,5861,5.5
42127,2020-01-01,22133,20651,1482,6.7
42129,2020-01-01,180886,170987,9899,5.5
42131,2020-01-01,13657,12801,856,6.3
42133,2020-01-01,236465,226308,10157,4.3
44001,2020-01-01,26046,25087,959,3.7
44003,2020-01-01,91573,87876,3697,4
44005,2020-01-01,44544,42582,1962,4.4
44007,2020-01-01,328761,313761,15000,4.6
44009,2020-01-01,68928,66160,2768,4
45001,2020-01-01,10068,9692,376,3.7
45003,2020-01-01,75544,73240,2304,3
45005,2020-01-01,2639,2452,187,7.1
45007,2020-01-01,90346,87728,2618,2.9
45009,2020-01-01,4910,4626,284,5.8
45011,2020-01-01,7876,7489,387,4.9
45013,2020-01-01,76309,74161,2148,2.8
45015,2020-01-01,105188,102354,2834,2.7
45017,2020-01-01,6540,6301,239,3.7
45019,2020-01-01,210744,205649,5095,2.4
45021,2020-01-01,25052,24176,876,3.5
45023,2020-01-01,13350,12715,635,4.8
45025,2020-01-01,21547,20839,708,3.3
45027,2020-01-01,12643,12102,541,4.3
45029,2020-01-01,16724,16164,560,3.3
45031,2020-01-01,30123,29057,1066,3.5
45033,2020-01-01,13020,12449,571,4.4
45035,2020-01-01,77700,75652,2048,2.6
45037,2020-01-01,10834,10500,334,3.1
45039,2020-01-01,9522,9042,480,5
45041,2020-01-01,66644,64575,2069,3.1
45043,2020-01-01,25385,24260,1125,4.4
45045,2020-01-01,254269,247666,6603,2.6
45047,2020-01-01,31388,30328,1060,3.4
45049,2020-01-01,8195,7960,235,2.9
45051,2020-01-01,142402,135709,6693,4.7
45053,2020-01-01,12777,12445,332,2.6
45055,2020-01-01,29431,28441,990,3.4
45057,2020-01-01,42106,40564,1542,3.7
45059,2020-01-01,29868,28902,966,3.2
45061,2020-01-01,6596,6252,344,5.2
45063,2020-01-01,150098,146484,3614,2.4
45065,2020-01-01,3317,3179,138,4.2
45067,2020-01-01,12707,12124,583,4.6
45069,2020-01-01,8837,8416,421,4.8
45071,2020-01-01,18869,18321,548,2.9
45073,2020-01-01,34518,33497,1021,3
45075,2020-01-01,34389,32576,1813,5.3
45077,2020-01-01,57245,55529,1716,3
45079,2020-01-01,196793,191053,5740,2.9
45081,2020-01-01,8791,8546,245,2.8
45083,2020-01-01,155442,151133,4309,2.8
45085,2020-01-01,42889,41242,1647,3.8
45087,2020-01-01,11583,11151,432,3.7
45089,2020-01-01,11793,11161,632,5.4
45091,2020-01-01,142505,138360,4145,2.9
46003,2020-01-01,1480,1441,39,2.6
46005,2020-01-01,9299,9022,277,3
46007,2020-01-01,1060,1007,53,5
46009,2020-01-01,2794,2705,89,3.2
46011,2020-01-01,18494,17886,608,3.3
46013,2020-01-01,20422,19805,617,3
46015,2020-01-01,2405,2330,75,3.1
46017,2020-01-01,641,604,37,5.8
46019,2020-01-01,4932,4761,171,3.5
46021,2020-01-01,749,722,27,3.6
46023,2020-01-01,3615,3496,119,3.3
46025,2020-01-01,1964,1884,80,4.1
46027,2020-01-01,7459,7241,218,2.9
46029,2020-01-01,15443,14983,460,3
46031,2020-01-01,1330,1270,60,4.5
46033,2020-01-01,3968,3778,190,4.8
46035,2020-01-01,10910,10594,316,2.9
46037,2020-01-01,2667,2519,148,5.5
46039,2020-01-01,2139,1995,144,6.7
46041,2020-01-01,2176,2048,128,5.9
46043,2020-01-01,1503,1453,50,3.3
46045,2020-01-01,1992,1932,60,3
46047,2020-01-01,2885,2761,124,4.3
46049,2020-01-01,1011,978,33,3.3
46051,2020-01-01,4356,4162,194,4.5
46053,2020-01-01,1954,1882,72,3.7
46055,2020-01-01,1051,1022,29,2.8
46057,2020-01-01,3224,3119,105,3.3
46059,2020-01-01,1699,1654,45,2.6
46061,2020-01-01,1764,1671,93,5.3
46063,2020-01-01,704,687,17,2.4
46065,2020-01-01,9737,9467,270,2.8
46067,2020-01-01,3664,3540,124,3.4
46069,2020-01-01,676,653,23,3.4
46071,2020-01-01,1134,1072,62,5.5
46073,2020-01-01,1095,1073,22,2
46075,2020-01-01,487,471,16,3.3
46077,2020-01-01,2588,2506,82,3.2
46079,2020-01-01,6433,6226,207,3.2
46081,2020-01-01,13185,12813,372,2.8
46083,2020-01-01,35605,34725,880,2.5
46085,2020-01-01,1596,1523,73,4.6
46087,2020-01-01,3059,2968,91,3
46089,2020-01-01,997,952,45,4.5
46091,2020-01-01,2331,2235,96,4.1
46093,2020-01-01,13577,13111,466,3.4
46095,2020-01-01,732,689,43,5.9
46097,2020-01-01,1134,1102,32,2.8
46099,2020-01-01,112409,109056,3353,3
46101,2020-01-01,3940,3809,131,3.3
46102,2020-01-01,3512,3237,275,7.8
46103,2020-01-01,55519,53682,1837,3.3
46105,2020-01-01,1334,1300,34,2.5
46107,2020-01-01,981,952,29,3
46109,2020-01-01,4647,4391,256,5.5
46111,2020-01-01,1141,1105,36,3.2
46115,2020-01-01,3037,2916,121,4
46117,2020-01-01,1859,1793,66,3.6
46119,2020-01-01,773,753,20,2.6
46121,2020-01-01,3091,2904,187,6
46123,2020-01-01,2944,2862,82,2.8
46125,2020-01-01,4628,4460,168,3.6
46127,2020-01-01,8564,8287,277,3.2
46129,2020-01-01,2049,1923,126,6.1
46135,2020-01-01,11750,11429,321,2.7
46137,2020-01-01,920,887,33,3.6
47001,2020-01-01,34673,33321,1352,3.9
47003,2020-01-01,20989,20122,867,4.1
47005,2020-01-01,6849,6450,399,5.8
47007,2020-01-01,4436,4164,272,6.1
47009,2020-01-01,64345,61832,2513,3.9
47011,2020-01-01,52544,50469,2075,3.9
47013,2020-01-01,14951,14140,811,5.4
47015,2020-01-01,6699,6478,221,3.3
47017,2020-01-01,11939,11222,717,6
47019,2020-01-01,23925,22796,1129,4.7
47021,2020-01-01,21998,21335,663,3
47023,2020-01-01,8548,8235,313,3.7
47025,2020-01-01,13025,12347,678,5.2
47027,2020-01-01,2752,2546,206,7.5
47029,2020-01-01,14807,13764,1043,7
47031,2020-01-01,25832,24787,1045,4
47033,2020-01-01,7053,6723,330,4.7
47035,2020-01-01,23504,21882,1622,6.9
47037,2020-01-01,404469,393108,11361,2.8
47039,2020-01-01,4612,4282,330,7.2
47041,2020-01-01,7613,7227,386,5.1
47043,2020-01-01,27326,26388,938,3.4
47045,2020-01-01,16118,15183,935,5.8
47047,2020-01-01,19482,18703,779,4
47049,2020-01-01,7640,7256,384,5
47051,2020-01-01,20337,19487,850,4.2
47053,2020-01-01,21906,20786,1120,5.1
47055,2020-01-01,15042,14222,820,5.5
47057,2020-01-01,9644,9153,491,5.1
47059,2020-01-01,29552,27971,1581,5.3
47061,2020-01-01,5190,4935,255,4.9
47063,2020-01-01,28263,26943,1320,4.7
47065,2020-01-01,184983,177950,7033,3.8
47067,2020-01-01,2198,2050,148,6.7
47069,2020-01-01,9514,8935,579,6.1
47071,2020-01-01,10402,9838,564,5.4
47073,2020-01-01,23994,22760,1234,5.1
47075,2020-01-01,7842,7415,427,5.4
47077,2020-01-01,12214,11553,661,5.4
47079,2020-01-01,14085,13308,777,5.5
47081,2020-01-01,11510,11107,403,3.5
47083,2020-01-01,3361,3155,206,6.1
47085,2020-01-01,8937,8456,481,5.4
47087,2020-01-01,4752,4477,275,5.8
47089,2020-01-01,24911,23654,1257,5
47091,2020-01-01,7912,7547,365,4.6
47093,2020-01-01,245228,237426,7802,3.2
47095,2020-01-01,1722,1598,124,7.2
47097,2020-01-01,9796,9208,588,6
47099,2020-01-01,19259,18373,886,4.6
47101,2020-01-01,5318,5093,225,4.2
47103,2020-01-01,16433,15150,1283,7.8
47105,2020-01-01,23963,23017,946,3.9
47107,2020-01-01,24112,23065,1047,4.3
47109,2020-01-01,8493,7946,547,6.4
47111,2020-01-01,11533,11138,395,3.4
47113,2020-01-01,48988,47066,1922,3.9
47115,2020-01-01,12646,11983,663,5.2
47117,2020-01-01,15690,15029,661,4.2
47119,2020-01-01,50505,48786,1719,3.4
47121,2020-01-01,5248,4954,294,5.6
47123,2020-01-01,20403,19506,897,4.4
47125,2020-01-01,86991,83277,3714,4.3
47127,2020-01-01,3677,3550,127,3.5
47129,2020-01-01,7859,7462,397,5.1
47131,2020-01-01,12300,11643,657,5.3
47133,2020-01-01,9932,9428,504,5.1
47135,2020-01-01,2999,2765,234,7.8
47137,2020-01-01,2262,2118,144,6.4
47139,2020-01-01,7508,7133,375,5
47141,2020-01-01,35231,33838,1393,4
47143,2020-01-01,13716,12890,826,6
47145,2020-01-01,23542,22396,1146,4.9
47147,2020-01-01,38574,37321,1253,3.2
47149,2020-01-01,188055,182787,5268,2.8
47151,2020-01-01,8317,7916,401,4.8
47153,2020-01-01,6227,5942,285,4.6
47155,2020-01-01,55009,51430,3579,6.5
47157,2020-01-01,444746,424577,20169,4.5
47159,2020-01-01,9592,9259,333,3.5
47161,2020-01-01,5583,5289,294,5.3
47163,2020-01-01,70598,67555,3043,4.3
47165,2020-01-01,104572,101405,3167,3
47167,2020-01-01,28228,26921,1307,4.6
47169,2020-01-01,5571,5382,189,3.4
47171,2020-01-01,7269,6769,500,6.9
47173,2020-01-01,7700,7359,341,4.4
47175,2020-01-01,2046,1943,103,5
47177,2020-01-01,17151,16357,794,4.6
47179,2020-01-01,60452,58038,2414,4
47181,2020-01-01,6476,6075,401,6.2
47183,2020-01-01,15935,15261,674,4.2
47185,2020-01-01,12225,11686,539,4.4
47187,2020-01-01,131752,128373,3379,2.6
47189,2020-01-01,78847,76510,2337,3
48001,2020-01-01,23270,22546,724,3.1
48003,2020-01-01,9753,9502,251,2.6
48005,2020-01-01,35627,34049,1578,4.4
48007,2020-01-01,9187,8767,420,4.6
48009,2020-01-01,3997,3878,119,3
48011,2020-01-01,932,903,29,3.1
48013,2020-01-01,21847,21014,833,3.8
48015,2020-01-01,14060,13543,517,3.7
48017,2020-01-01,2437,2343,94,3.9
48019,2020-01-01,10082,9742,340,3.4
48021,2020-01-01,43436,42102,1334,3.1
48023,2020-01-01,1819,1775,44,2.4
48025,2020-01-01,9918,9443,475,4.8
48027,2020-01-01,145219,139631,5588,3.8
48029,2020-01-01,948459,917624,30835,3.3
48031,2020-01-01,6718,6558,160,2.4
48033,2020-01-01,477,467,10,2.1
48035,2020-01-01,8359,8042,317,3.8
48037,2020-01-01,39422,37766,1656,4.2
48039,2020-01-01,181552,173078,8474,4.7
48041,2020-01-01,119739,116417,3322,2.8
48043,2020-01-01,4211,4096,115,2.7
48045,2020-01-01,564,539,25,4.4
48047,2020-01-01,2737,2593,144,5.3
48049,2020-01-01,15444,14815,629,4.1
48051,2020-01-01,8371,8070,301,3.6
48053,2020-01-01,23803,23143,660,2.8
48055,2020-01-01,19702,19042,660,3.3
48057,2020-01-01,12165,11726,439,3.6
48059,2020-01-01,6137,5931,206,3.4
48061,2020-01-01,170517,159971,10546,6.2
48063,2020-01-01,4945,4721,224,4.5
48065,2020-01-01,2991,2904,87,2.9
48067,2020-01-01,12197,11629,568,4.7
48069,2020-01-01,3306,3216,90,2.7
48071,2020-01-01,20122,19122,1000,5
48073,2020-01-01,21107,20221,886,4.2
48075,2020-01-01,2864,2770,94,3.3
48077,2020-01-01,4889,4738,151,3.1
48079,2020-01-01,1111,1069,42,3.8
48081,2020-01-01,1397,1356,41,2.9
48083,2020-01-01,2874,2739,135,4.7
48085,2020-01-01,579198,561458,17740,3.1
48087,2020-01-01,1086,1045,41,3.8
48089,2020-01-01,9835,9501,334,3.4
48091,2020-01-01,76402,74076,2326,3
48093,2020-01-01,5600,5392,208,3.7
48095,2020-01-01,1334,1296,38,2.8
48097,2020-01-01,19633,19023,610,3.1
48099,2020-01-01,24219,23260,959,4
48101,2020-01-01,530,501,29,5.5
48103,2020-01-01,1564,1486,78,5
48105,2020-01-01,1549,1481,68,4.4
48107,2020-01-01,2430,2334,96,4
48109,2020-01-01,1121,1079,42,3.7
48111,2020-01-01,3757,3670,87,2.3
48113,2020-01-01,NA,NA,47075,3.5
48115,2020-01-01,4587,4379,208,4.5
48117,2020-01-01,8501,8270,231,2.7
48119,2020-01-01,2443,2356,87,3.6
48121,2020-01-01,509832,494921,14911,2.9
48123,2020-01-01,9427,9168,259,2.7
48125,2020-01-01,649,617,32,4.9
48127,2020-01-01,7209,7007,202,2.8
48129,2020-01-01,1463,1411,52,3.6
48131,2020-01-01,4865,4605,260,5.3
48133,2020-01-01,7809,7489,320,4.1
48135,2020-01-01,87266,84290,2976,3.4
48137,2020-01-01,1162,1139,23,2
48139,2020-01-01,95292,92337,2955,3.1
48141,2020-01-01,365693,351262,14431,3.9
48143,2020-01-01,20658,19918,740,3.6
48145,2020-01-01,6513,6285,228,3.5
48147,2020-01-01,16937,16460,477,2.8
48149,2020-01-01,12159,11831,328,2.7
48151,2020-01-01,1618,1573,45,2.8
48153,2020-01-01,2523,2388,135,5.4
48155,2020-01-01,598,583,15,2.5
48157,2020-01-01,402721,388314,14407,3.6
48159,2020-01-01,4736,4573,163,3.4
48161,2020-01-01,6410,6060,350,5.5
48163,2020-01-01,10257,9940,317,3.1
48165,2020-01-01,9892,9626,266,2.7
48167,2020-01-01,167252,160030,7222,4.3
48169,2020-01-01,2071,2001,70,3.4
48171,2020-01-01,13563,13217,346,2.6
48173,2020-01-01,849,833,16,1.9
48175,2020-01-01,3237,3111,126,3.9
48177,2020-01-01,9715,9420,295,3
48179,2020-01-01,7942,7609,333,4.2
48181,2020-01-01,64799,62688,2111,3.3
48183,2020-01-01,57831,55429,2402,4.2
48185,2020-01-01,11141,10634,507,4.6
48187,2020-01-01,82151,79697,2454,3
48189,2020-01-01,11884,11335,549,4.6
48191,2020-01-01,1051,1006,45,4.3
48193,2020-01-01,3771,3659,112,3
48195,2020-01-01,2540,2473,67,2.6
48197,2020-01-01,1749,1697,52,3
48199,2020-01-01,25643,24402,1241,4.8
48201,2020-01-01,NA,NA,94984,4.1
48203,2020-01-01,29358,28084,1274,4.3
48205,2020-01-01,2650,2599,51,1.9
48207,2020-01-01,2693,2616,77,2.9
48209,2020-01-01,123133,119644,3489,2.8
48211,2020-01-01,2029,1962,67,3.3
48213,2020-01-01,37210,35806,1404,3.8
48215,2020-01-01,361679,334451,27228,7.5
48217,2020-01-01,16320,15736,584,3.6
48219,2020-01-01,11248,10877,371,3.3
48221,2020-01-01,28068,27047,1021,3.6
48223,2020-01-01,17725,17167,558,3.1
48225,2020-01-01,10035,9680,355,3.5
48227,2020-01-01,14149,13680,469,3.3
48229,2020-01-01,1858,1778,80,4.3
48231,2020-01-01,44284,42684,1600,3.6
48233,2020-01-01,8553,8132,421,4.9
48235,2020-01-01,756,739,17,2.2
48237,2020-01-01,3428,3287,141,4.1
48239,2020-01-01,7580,7320,260,3.4
48241,2020-01-01,12792,11872,920,7.2
48243,2020-01-01,1009,977,32,3.2
48245,2020-01-01,106459,99679,6780,6.4
48247,2020-01-01,1891,1801,90,4.8
48249,2020-01-01,16729,15811,918,5.5
48251,2020-01-01,84275,81487,2788,3.3
48253,2020-01-01,5824,5580,244,4.2
48255,2020-01-01,7503,7316,187,2.5
48257,2020-01-01,68288,66029,2259,3.3
48259,2020-01-01,22730,22094,636,2.8
48261,2020-01-01,231,222,9,3.9
48263,2020-01-01,452,435,17,3.8
48265,2020-01-01,22035,21294,741,3.4
48267,2020-01-01,1800,1740,60,3.3
48269,2020-01-01,239,235,4,1.7
48271,2020-01-01,1367,1296,71,5.2
48273,2020-01-01,13482,12869,613,4.5
48275,2020-01-01,1455,1401,54,3.7
48277,2020-01-01,23721,22897,824,3.5
48279,2020-01-01,5297,5086,211,4
48281,2020-01-01,9200,8882,318,3.5
48283,2020-01-01,4219,4100,119,2.8
48285,2020-01-01,8616,8368,248,2.9
48287,2020-01-01,9446,9164,282,3
48289,2020-01-01,6244,5937,307,4.9
48291,2020-01-01,33926,31950,1976,5.8
48293,2020-01-01,8569,8216,353,4.1
48295,2020-01-01,1596,1551,45,2.8
48297,2020-01-01,5518,5328,190,3.4
48299,2020-01-01,8553,8248,305,3.6
48301,2020-01-01,366,362,4,1.1
48303,2020-01-01,158210,153663,4547,2.9
48305,2020-01-01,2770,2676,94,3.4
48307,2020-01-01,3340,3185,155,4.6
48309,2020-01-01,119991,115930,4061,3.4
48311,2020-01-01,806,793,13,1.6
48313,2020-01-01,4451,4262,189,4.2
48315,2020-01-01,4262,4048,214,5
48317,2020-01-01,2794,2713,81,2.9
48319,2020-01-01,1756,1695,61,3.5
48321,2020-01-01,16705,15595,1110,6.6
48323,2020-01-01,24455,22082,2373,9.7
48325,2020-01-01,21867,21143,724,3.3
48327,2020-01-01,884,855,29,3.3
48329,2020-01-01,106486,103955,2531,2.4
48331,2020-01-01,9725,9261,464,4.8
48333,2020-01-01,1897,1835,62,3.3
48335,2020-01-01,2348,2267,81,3.4
48337,2020-01-01,9372,9080,292,3.1
48339,2020-01-01,291144,280716,10428,3.6
48341,2020-01-01,10674,10414,260,2.4
48343,2020-01-01,4802,4527,275,5.7
48345,2020-01-01,446,429,17,3.8
48347,2020-01-01,28598,27526,1072,3.7
48349,2020-01-01,23678,22734,944,4
48351,2020-01-01,5193,4812,381,7.3
48353,2020-01-01,7220,6992,228,3.2
48355,2020-01-01,165462,157998,7464,4.5
48357,2020-01-01,4256,4119,137,3.2
48359,2020-01-01,911,883,28,3.1
48361,2020-01-01,36554,34559,1995,5.5
48363,2020-01-01,13403,12969,434,3.2
48365,2020-01-01,9686,9209,477,4.9
48367,2020-01-01,69526,67376,2150,3.1
48369,2020-01-01,4833,4721,112,2.3
48371,2020-01-01,6343,6092,251,4
48373,2020-01-01,18382,17385,997,5.4
48375,2020-01-01,54685,53161,1524,2.8
48377,2020-01-01,3269,2977,292,8.9
48379,2020-01-01,6145,5956,189,3.1
48381,2020-01-01,73534,71718,1816,2.5
48383,2020-01-01,1871,1809,62,3.3
48385,2020-01-01,1038,994,44,4.2
48387,2020-01-01,5143,4896,247,4.8
48389,2020-01-01,10696,10443,253,2.4
48391,2020-01-01,3137,3012,125,4
48393,2020-01-01,416,404,12,2.9
48395,2020-01-01,7517,7231,286,3.8
48397,2020-01-01,54196,52524,1672,3.1
48399,2020-01-01,4580,4441,139,3
48401,2020-01-01,22845,21882,963,4.2
48403,2020-01-01,3855,3569,286,7.4
48405,2020-01-01,3080,2890,190,6.2
48407,2020-01-01,11828,11235,593,5
48409,2020-01-01,29559,27737,1822,6.2
48411,2020-01-01,2447,2355,92,3.8
48413,2020-01-01,1255,1216,39,3.1
48415,2020-01-01,6422,6174,248,3.9
48417,2020-01-01,1810,1759,51,2.8
48419,2020-01-01,11294,10796,498,4.4
48421,2020-01-01,1349,1314,35,2.6
48423,2020-01-01,108773,104936,3837,3.5
48425,2020-01-01,4428,4255,173,3.9
48427,2020-01-01,26335,22717,3618,13.7
48429,2020-01-01,4046,3912,134,3.3
48431,2020-01-01,560,540,20,3.6
48433,2020-01-01,566,549,17,3
48435,2020-01-01,1247,1187,60,4.8
48437,2020-01-01,2567,2470,97,3.8
48439,2020-01-01,NA,NA,36080,3.3
48441,2020-01-01,67610,65619,1991,2.9
48443,2020-01-01,396,384,12,3
48445,2020-01-01,4852,4666,186,3.8
48447,2020-01-01,645,622,23,3.6
48449,2020-01-01,13316,12742,574,4.3
48451,2020-01-01,54735,53006,1729,3.2
48453,2020-01-01,751130,731311,19819,2.6
48455,2020-01-01,5312,5014,298,5.6
48457,2020-01-01,7403,6922,481,6.5
48459,2020-01-01,17960,17183,777,4.3
48461,2020-01-01,1877,1822,55,2.9
48463,2020-01-01,11330,10897,433,3.8
48465,2020-01-01,22418,21459,959,4.3
48467,2020-01-01,26265,25339,926,3.5
48469,2020-01-01,42013,40359,1654,3.9
48471,2020-01-01,24240,23277,963,4
48473,2020-01-01,24327,23356,971,4
48475,2020-01-01,6779,6568,211,3.1
48477,2020-01-01,15276,14744,532,3.5
48479,2020-01-01,119327,114486,4841,4.1
48481,2020-01-01,21893,21060,833,3.8
48483,2020-01-01,2297,2223,74,3.2
48485,2020-01-01,56069,54228,1841,3.3
48487,2020-01-01,5000,4805,195,3.9
48489,2020-01-01,6638,6084,554,8.3
48491,2020-01-01,324834,315660,9174,2.8
48493,2020-01-01,25047,24291,756,3
48495,2020-01-01,4358,4208,150,3.4
48497,2020-01-01,32657,31547,1110,3.4
48499,2020-01-01,17872,17124,748,4.2
48501,2020-01-01,3579,3450,129,3.6
48503,2020-01-01,7844,7597,247,3.1
48505,2020-01-01,5071,4756,315,6.2
48507,2020-01-01,3596,3289,307,8.5
49001,2020-01-01,2786,2702,84,3
49003,2020-01-01,26153,25437,716,2.7
49005,2020-01-01,65973,64589,1384,2.1
49007,2020-01-01,8517,8196,321,3.8
49009,2020-01-01,319,299,20,6.3
49011,2020-01-01,174986,170878,4108,2.3
49013,2020-01-01,7794,7438,356,4.6
49015,2020-01-01,4200,4000,200,4.8
49017,2020-01-01,2238,1950,288,12.9
49019,2020-01-01,5412,4885,527,9.7
49021,2020-01-01,24923,24206,717,2.9
49023,2020-01-01,5949,5783,166,2.8
49025,2020-01-01,3649,3518,131,3.6
49027,2020-01-01,5793,5634,159,2.7
49029,2020-01-01,5565,5432,133,2.4
49031,2020-01-01,455,430,25,5.5
49033,2020-01-01,939,894,45,4.8
49035,2020-01-01,642351,626300,16051,2.5
49037,2020-01-01,5378,4962,416,7.7
49039,2020-01-01,12462,12034,428,3.4
49041,2020-01-01,9630,9282,348,3.6
49043,2020-01-01,27748,27192,556,2
49045,2020-01-01,35312,34337,975,2.8
49047,2020-01-01,13234,12534,700,5.3
49049,2020-01-01,313697,306137,7560,2.4
49051,2020-01-01,16403,15975,428,2.6
49053,2020-01-01,77118,74589,2529,3.3
49055,2020-01-01,1325,1186,139,10.5
49057,2020-01-01,128935,125213,3722,2.9
50001,2020-01-01,20370,19757,613,3
50003,2020-01-01,18195,17540,655,3.6
50005,2020-01-01,14499,13892,607,4.2
50007,2020-01-01,95751,93796,1955,2
50009,2020-01-01,2700,2570,130,4.8
50011,2020-01-01,27155,26367,788,2.9
50013,2020-01-01,4152,3984,168,4
50015,2020-01-01,14098,13506,592,4.2
50017,2020-01-01,15989,15377,612,3.8
50019,2020-01-01,13664,12808,856,6.3
50021,2020-01-01,30613,29622,991,3.2
50023,2020-01-01,34835,33719,1116,3.2
50025,2020-01-01,22160,21571,589,2.7
50027,2020-01-01,29603,28954,649,2.2
51001,2020-01-01,16196,15477,719,4.4
51003,2020-01-01,58223,56836,1387,2.4
51005,2020-01-01,7037,6737,300,4.3
51007,2020-01-01,6405,6196,209,3.3
51009,2020-01-01,15144,14654,490,3.2
51011,2020-01-01,7278,7004,274,3.8
51013,2020-01-01,156375,153453,2922,1.9
51015,2020-01-01,37751,36838,913,2.4
51017,2020-01-01,2461,2386,75,3
51019,2020-01-01,38919,37787,1132,2.9
51021,2020-01-01,2820,2746,74,2.6
51023,2020-01-01,17695,17234,461,2.6
51025,2020-01-01,6037,5753,284,4.7
51027,2020-01-01,6944,6457,487,7
51029,2020-01-01,6595,6288,307,4.7
51031,2020-01-01,26179,25357,822,3.1
51033,2020-01-01,15390,14883,507,3.3
51035,2020-01-01,13258,12752,506,3.8
51036,2020-01-01,3715,3586,129,3.5
51037,2020-01-01,5216,5019,197,3.8
51041,2020-01-01,191450,186380,5070,2.6
51043,2020-01-01,7757,7576,181,2.3
51045,2020-01-01,2352,2282,70,3
51047,2020-01-01,25356,24672,684,2.7
51049,2020-01-01,4689,4532,157,3.3
51051,2020-01-01,4761,4483,278,5.8
51053,2020-01-01,13790,13342,448,3.2
51057,2020-01-01,5581,5371,210,3.8
51059,2020-01-01,643006,628871,14135,2.2
51061,2020-01-01,38084,37190,894,2.3
51063,2020-01-01,8160,7918,242,3
51065,2020-01-01,14341,14012,329,2.3
51067,2020-01-01,26660,25828,832,3.1
51069,2020-01-01,49262,48092,1170,2.4
51071,2020-01-01,7794,7536,258,3.3
51073,2020-01-01,19770,19250,520,2.6
51075,2020-01-01,11553,11244,309,2.7
51077,2020-01-01,7875,7617,258,3.3
51079,2020-01-01,10645,10399,246,2.3
51081,2020-01-01,4305,4170,135,3.1
51083,2020-01-01,15217,14547,670,4.4
51085,2020-01-01,60078,58653,1425,2.4
51087,2020-01-01,184483,179537,4946,2.7
51089,2020-01-01,23635,22777,858,3.6
51091,2020-01-01,1240,1198,42,3.4
51093,2020-01-01,19691,19147,544,2.8
51095,2020-01-01,37063,36011,1052,2.8
51097,2020-01-01,3914,3813,101,2.6
51099,2020-01-01,13832,13465,367,2.7
51101,2020-01-01,9351,9096,255,2.7
51103,2020-01-01,5412,5074,338,6.2
51105,2020-01-01,8302,7937,365,4.4
51107,2020-01-01,229710,224641,5069,2.2
51109,2020-01-01,20108,19509,599,3
51111,2020-01-01,5363,5206,157,2.9
51113,2020-01-01,7539,7375,164,2.2
51115,2020-01-01,4195,4072,123,2.9
51117,2020-01-01,12777,12251,526,4.1
51119,2020-01-01,5196,5045,151,2.9
51121,2020-01-01,49557,48228,1329,2.7
51125,2020-01-01,7561,7371,190,2.5
51127,2020-01-01,12977,12681,296,2.3
51131,2020-01-01,5301,5033,268,5.1
51133,2020-01-01,5666,5317,349,6.2
51135,2020-01-01,7329,7133,196,2.7
51137,2020-01-01,17372,16857,515,3
51139,2020-01-01,12005,11360,645,5.4
51141,2020-01-01,7292,7027,265,3.6
51143,2020-01-01,30249,29169,1080,3.6
51145,2020-01-01,14524,14131,393,2.7
51147,2020-01-01,10286,9898,388,3.8
51149,2020-01-01,15339,14829,510,3.3
51153,2020-01-01,250707,244516,6191,2.5
51155,2020-01-01,15941,15419,522,3.3
51157,2020-01-01,3805,3709,96,2.5
51159,2020-01-01,4092,3959,133,3.3
51161,2020-01-01,50017,48721,1296,2.6
51163,2020-01-01,10883,10571,312,2.9
51165,2020-01-01,43296,42296,1000,2.3
51167,2020-01-01,11469,10925,544,4.7
51169,2020-01-01,9210,8901,309,3.4
51171,2020-01-01,22354,21784,570,2.5
51173,2020-01-01,13587,13038,549,4
51175,2020-01-01,9189,8930,259,2.8
51177,2020-01-01,69074,67139,1935,2.8
51179,2020-01-01,74617,72633,1984,2.7
51181,2020-01-01,3675,3547,128,3.5
51183,2020-01-01,3827,3644,183,4.8
51185,2020-01-01,15685,14918,767,4.9
51187,2020-01-01,20846,20244,602,2.9
51191,2020-01-01,26591,25675,916,3.4
51193,2020-01-01,9480,9097,383,4
51195,2020-01-01,13328,12690,638,4.8
51197,2020-01-01,13764,13283,481,3.5
51199,2020-01-01,33299,32410,889,2.7
51510,2020-01-01,102247,100109,2138,2.1
51520,2020-01-01,7358,7078,280,3.8
51530,2020-01-01,3167,3073,94,3
51540,2020-01-01,26285,25683,602,2.3
51550,2020-01-01,124872,121415,3457,2.8
51570,2020-01-01,8652,8385,267,3.1
51580,2020-01-01,2432,2302,130,5.3
51590,2020-01-01,19255,18287,968,5
51595,2020-01-01,2304,2200,104,4.5
51600,2020-01-01,13351,13070,281,2.1
51610,2020-01-01,8636,8466,170,2
51620,2020-01-01,3595,3456,139,3.9
51630,2020-01-01,14304,13853,451,3.2
51640,2020-01-01,2900,2812,88,3
51650,2020-01-01,65065,62636,2429,3.7
51660,2020-01-01,25092,24369,723,2.9
51670,2020-01-01,9753,9333,420,4.3
51678,2020-01-01,2139,2046,93,4.3
51680,2020-01-01,36629,35335,1294,3.5
51683,2020-01-01,22130,21557,573,2.6
51685,2020-01-01,9625,9381,244,2.5
51690,2020-01-01,5476,5227,249,4.5
51700,2020-01-01,90068,86869,3199,3.6
51710,2020-01-01,111973,108228,3745,3.3
51720,2020-01-01,1697,1623,74,4.4
51730,2020-01-01,13040,12333,707,5.4
51735,2020-01-01,6488,6331,157,2.4
51740,2020-01-01,44487,42853,1634,3.7
51750,2020-01-01,8553,8254,299,3.5
51760,2020-01-01,120225,116382,3843,3.2
51770,2020-01-01,49368,47836,1532,3.1
51775,2020-01-01,12954,12592,362,2.8
51790,2020-01-01,12318,11985,333,2.7
51800,2020-01-01,45479,44145,1334,2.9
51810,2020-01-01,235025,228799,6226,2.6
51820,2020-01-01,10742,10446,296,2.8
51830,2020-01-01,6776,6518,258,3.8
51840,2020-01-01,14977,14551,426,2.8
53001,2020-01-01,8508,7809,699,8.2
53003,2020-01-01,10489,10019,470,4.5
53005,2020-01-01,102549,96155,6394,6.2
53007,2020-01-01,43123,40391,2732,6.3
53009,2020-01-01,29465,27125,2340,7.9
53011,2020-01-01,249761,237805,11956,4.8
53013,2020-01-01,1742,1623,119,6.8
53015,2020-01-01,48857,45785,3072,6.3
53017,2020-01-01,20922,19368,1554,7.4
53019,2020-01-01,2547,2232,315,12.4
53021,2020-01-01,41602,38242,3360,8.1
53023,2020-01-01,797,730,67,8.4
53025,2020-01-01,44985,40708,4277,9.5
53027,2020-01-01,29093,26701,2392,8.2
53029,2020-01-01,36834,34839,1995,5.4
53031,2020-01-01,13060,12240,820,6.3
53033,2020-01-01,NA,NA,33299,2.6
53035,2020-01-01,131807,125621,6186,4.7
53037,2020-01-01,22862,21348,1514,6.6
53039,2020-01-01,9521,8832,689,7.2
53041,2020-01-01,35503,33014,2489,7
53043,2020-01-01,4712,4413,299,6.3
53045,2020-01-01,25551,23761,1790,7
53047,2020-01-01,18959,17134,1825,9.6
53049,2020-01-01,8539,7924,615,7.2
53051,2020-01-01,5156,4649,507,9.8
53053,2020-01-01,455060,430446,24614,5.4
53055,2020-01-01,8098,7664,434,5.4
53057,2020-01-01,63235,59078,4157,6.6
53059,2020-01-01,5717,5364,353,6.2
53061,2020-01-01,443970,430845,13125,3
53063,2020-01-01,261969,246442,15527,5.9
53065,2020-01-01,19264,17586,1678,8.7
53067,2020-01-01,146274,138777,7497,5.1
53069,2020-01-01,1345,1245,100,7.4
53071,2020-01-01,30017,28366,1651,5.5
53073,2020-01-01,118250,111303,6947,5.9
53075,2020-01-01,23623,22606,1017,4.3
53077,2020-01-01,127095,115705,11390,9
54001,2020-01-01,7354,6863,491,6.7
54003,2020-01-01,59022,56992,2030,3.4
54005,2020-01-01,7544,7028,516,6.8
54007,2020-01-01,5342,4805,537,10.1
54009,2020-01-01,9910,9323,587,5.9
54011,2020-01-01,41867,40103,1764,4.2
54013,2020-01-01,2709,2161,548,20.2
54015,2020-01-01,3271,2885,386,11.8
54017,2020-01-01,3979,3765,214,5.4
54019,2020-01-01,16339,15154,1185,7.3
54021,2020-01-01,2308,2088,220,9.5
54023,2020-01-01,5941,5593,348,5.9
54025,2020-01-01,15555,14631,924,5.9
54027,2020-01-01,10757,10300,457,4.2
54029,2020-01-01,13020,12255,765,5.9
54031,2020-01-01,5819,5486,333,5.7
54033,2020-01-01,34339,32511,1828,5.3
54035,2020-01-01,12612,11765,847,6.7
54037,2020-01-01,30348,29403,945,3.1
54039,2020-01-01,83419,79287,4132,5
54041,2020-01-01,6347,5824,523,8.2
54043,2020-01-01,7391,6818,573,7.8
54045,2020-01-01,11378,10475,903,7.9
54047,2020-01-01,4578,4037,541,11.8
54049,2020-01-01,25887,24496,1391,5.4
54051,2020-01-01,13841,12709,1132,8.2
54053,2020-01-01,10388,9680,708,6.8
54055,2020-01-01,20997,19770,1227,5.8
54057,2020-01-01,12429,11672,757,6.1
54059,2020-01-01,6924,6227,697,10.1
54061,2020-01-01,55975,53977,1998,3.6
54063,2020-01-01,5923,5608,315,5.3
54065,2020-01-01,8372,8030,342,4.1
54067,2020-01-01,9470,8628,842,8.9
54069,2020-01-01,20481,19411,1070,5.2
54071,2020-01-01,3628,3459,169,4.7
54073,2020-01-01,2877,2610,267,9.3
54075,2020-01-01,4339,4097,242,5.6
54077,2020-01-01,15848,15026,822,5.2
54079,2020-01-01,27340,26052,1288,4.7
54081,2020-01-01,30478,28827,1651,5.4
54083,2020-01-01,12413,11529,884,7.1
54085,2020-01-01,4537,4204,333,7.3
54087,2020-01-01,5253,4632,621,11.8
54089,2020-01-01,4360,4062,298,6.8
54091,2020-01-01,7895,7463,432,5.5
54093,2020-01-01,3418,3195,223,6.5
54095,2020-01-01,3243,2959,284,8.8
54097,2020-01-01,9743,9088,655,6.7
54099,2020-01-01,16080,15085,995,6.2
54101,2020-01-01,3274,3009,265,8.1
54103,2020-01-01,6733,6116,617,9.2
54105,2020-01-01,2385,2122,263,11
54107,2020-01-01,36980,34778,2202,6
54109,2020-01-01,6988,6395,593,8.5
55001,2020-01-01,7981,7503,478,6
55003,2020-01-01,7406,7050,356,4.8
55005,2020-01-01,24004,22854,1150,4.8
55007,2020-01-01,7231,6749,482,6.7
55009,2020-01-01,140101,135758,4343,3.1
55011,2020-01-01,6355,6026,329,5.2
55013,2020-01-01,6954,6518,436,6.3
55015,2020-01-01,27339,26577,762,2.8
55017,2020-01-01,33001,31395,1606,4.9
55019,2020-01-01,17484,16774,710,4.1
55021,2020-01-01,31324,30253,1071,3.4
55023,2020-01-01,7537,7108,429,5.7
55025,2020-01-01,319316,311823,7493,2.3
55027,2020-01-01,46744,45157,1587,3.4
55029,2020-01-01,14074,13388,686,4.9
55031,2020-01-01,22809,21712,1097,4.8
55033,2020-01-01,23596,22618,978,4.1
55035,2020-01-01,57562,55705,1857,3.2
55037,2020-01-01,2151,2045,106,4.9
55039,2020-01-01,56120,54385,1735,3.1
55041,2020-01-01,4040,3816,224,5.5
55043,2020-01-01,27051,26020,1031,3.8
55045,2020-01-01,20858,20175,683,3.3
55047,2020-01-01,9076,8621,455,5
55049,2020-01-01,13594,13108,486,3.6
55051,2020-01-01,2515,2362,153,6.1
55053,2020-01-01,9922,9401,521,5.3
55055,2020-01-01,45370,43827,1543,3.4
55057,2020-01-01,13140,12606,534,4.1
55059,2020-01-01,87980,84547,3433,3.9
55061,2020-01-01,10911,10544,367,3.4
55063,2020-01-01,64685,62685,2000,3.1
55065,2020-01-01,9927,9622,305,3.1
55067,2020-01-01,9166,8725,441,4.8
55069,2020-01-01,14741,14049,692,4.7
55071,2020-01-01,40467,38945,1522,3.8
55073,2020-01-01,72264,70088,2176,3
55075,2020-01-01,19279,18315,964,5
55077,2020-01-01,7629,7261,368,4.8
55078,2020-01-01,1542,1451,91,5.9
55079,2020-01-01,457518,440413,17105,3.7
55081,2020-01-01,23173,22393,780,3.4
55083,2020-01-01,20549,19580,969,4.7
55085,2020-01-01,17231,16371,860,5
55087,2020-01-01,102755,99675,3080,3
55089,2020-01-01,48292,47034,1258,2.6
55091,2020-01-01,4038,3841,197,4.9
55093,2020-01-01,25278,24254,1024,4.1
55095,2020-01-01,24721,23402,1319,5.3
55097,2020-01-01,37745,36434,1311,3.5
55099,2020-01-01,6203,5903,300,4.8
55101,2020-01-01,96263,92201,4062,4.2
55103,2020-01-01,9046,8713,333,3.7
55105,2020-01-01,84515,80889,3626,4.3
55107,2020-01-01,6737,6346,391,5.8
55109,2020-01-01,50560,48568,1992,3.9
55111,2020-01-01,34639,33447,1192,3.4
55113,2020-01-01,7746,7334,412,5.3
55115,2020-01-01,21074,20248,826,3.9
55117,2020-01-01,60739,59019,1720,2.8
55119,2020-01-01,10973,10439,534,4.9
55121,2020-01-01,15794,15125,669,4.2
55123,2020-01-01,15067,14441,626,4.2
55125,2020-01-01,9862,9372,490,5
55127,2020-01-01,56056,54015,2041,3.6
55129,2020-01-01,7705,7307,398,5.2
55131,2020-01-01,76229,74025,2204,2.9
55133,2020-01-01,221992,215600,6392,2.9
55135,2020-01-01,25554,24645,909,3.6
55137,2020-01-01,11278,10725,553,4.9
55139,2020-01-01,90531,87916,2615,2.9
55141,2020-01-01,34161,32735,1426,4.2
56001,2020-01-01,20200,19439,761,3.8
56003,2020-01-01,5156,4830,326,6.3
56005,2020-01-01,23716,22664,1052,4.4
56007,2020-01-01,7659,7272,387,5.1
56009,2020-01-01,8864,8551,313,3.5
56011,2020-01-01,3702,3571,131,3.5
56013,2020-01-01,19168,17972,1196,6.2
56015,2020-01-01,6438,6165,273,4.2
56017,2020-01-01,2215,2112,103,4.7
56019,2020-01-01,4062,3850,212,5.2
56021,2020-01-01,50564,48329,2235,4.4
56023,2020-01-01,9185,8759,426,4.6
56025,2020-01-01,40860,38734,2126,5.2
56027,2020-01-01,1221,1173,48,3.9
56029,2020-01-01,14698,13814,884,6
56031,2020-01-01,4556,4318,238,5.2
56033,2020-01-01,15767,14993,774,4.9
56035,2020-01-01,4020,3731,289,7.2
56037,2020-01-01,21200,19879,1321,6.2
56039,2020-01-01,15760,15279,481,3.1
56041,2020-01-01,9144,8672,472,5.2
56043,2020-01-01,3989,3781,208,5.2
56045,2020-01-01,3878,3740,138,3.6
72001,2020-01-01,4226,3423,803,19
72003,2020-01-01,11518,10184,1334,11.6
72005,2020-01-01,13935,12357,1578,11.3
72007,2020-01-01,6285,5610,675,10.7
72009,2020-01-01,6264,5487,777,12.4
72011,2020-01-01,8575,7708,867,10.1
72013,2020-01-01,23272,20549,2723,11.7
72015,2020-01-01,4630,3908,722,15.6
72017,2020-01-01,5733,5000,733,12.8
72019,2020-01-01,7139,6383,756,10.6
72021,2020-01-01,61629,57332,4297,7
72023,2020-01-01,13101,11657,1444,11
72025,2020-01-01,45570,42078,3492,7.7
72027,2020-01-01,9214,8237,977,10.6
72029,2020-01-01,15367,14258,1109,7.2
72031,2020-01-01,58056,54309,3747,6.5
72033,2020-01-01,7412,6826,586,7.9
72035,2020-01-01,15476,14170,1306,8.4
72037,2020-01-01,3485,3118,367,10.5
72039,2020-01-01,3588,3097,491,13.7
72041,2020-01-01,14726,13643,1083,7.4
72043,2020-01-01,9780,8389,1391,14.2
72045,2020-01-01,4758,4223,535,11.2
72047,2020-01-01,8531,7641,890,10.4
72049,2020-01-01,852,822,30,3.5
72051,2020-01-01,12700,11855,845,6.7
72053,2020-01-01,10294,9185,1109,10.8
72054,2020-01-01,3190,2791,399,12.5
72055,2020-01-01,4260,3342,918,21.5
72057,2020-01-01,10737,9352,1385,12.9
72059,2020-01-01,4728,3921,807,17.1
72061,2020-01-01,35689,34051,1638,4.6
72063,2020-01-01,17587,16417,1170,6.7
72065,2020-01-01,13532,11453,2079,15.4
72067,2020-01-01,5182,4649,533,10.3
72069,2020-01-01,16570,14669,1901,11.5
72071,2020-01-01,11383,10147,1236,10.9
72073,2020-01-01,4206,3584,622,14.8
72075,2020-01-01,14958,13382,1576,10.5
72077,2020-01-01,11861,10729,1132,9.5
72079,2020-01-01,5115,4268,847,16.6
72081,2020-01-01,7034,5783,1251,17.8
72083,2020-01-01,2486,2091,395,15.9
72085,2020-01-01,10971,9858,1113,10.1
72087,2020-01-01,8044,7294,750,9.3
72089,2020-01-01,5886,5319,567,9.6
72091,2020-01-01,11045,10045,1000,9.1
72093,2020-01-01,1930,1614,316,16.4
72095,2020-01-01,2869,2353,516,18
72097,2020-01-01,20888,18318,2570,12.3
72099,2020-01-01,10164,8907,1257,12.4
72101,2020-01-01,7738,6895,843,10.9
72103,2020-01-01,7949,7133,816,10.3
72105,2020-01-01,6804,6114,690,10.1
72107,2020-01-01,4870,4167,703,14.4
72109,2020-01-01,4222,3485,737,17.5
72111,2020-01-01,5620,4728,892,15.9
72113,2020-01-01,43018,38392,4626,10.8
72115,2020-01-01,5956,5121,835,14
72117,2020-01-01,4766,3908,858,18
72119,2020-01-01,16129,14840,1289,8
72121,2020-01-01,6004,5031,973,16.2
72123,2020-01-01,6845,5800,1045,15.3
72125,2020-01-01,9369,8033,1336,14.3
72127,2020-01-01,126640,118781,7859,6.2
72129,2020-01-01,11226,10094,1132,10.1
72131,2020-01-01,10064,8443,1621,16.1
72133,2020-01-01,9895,8912,983,9.9
72135,2020-01-01,26068,24401,1667,6.4
72137,2020-01-01,27576,25803,1773,6.4
72139,2020-01-01,25708,24247,1461,5.7
72141,2020-01-01,6548,5609,939,14.3
72143,2020-01-01,9428,8472,956,10.1
72145,2020-01-01,12616,11257,1359,10.8
72147,2020-01-01,2494,2311,183,7.3
72149,2020-01-01,7385,5909,1476,20
72151,2020-01-01,8553,7289,1264,14.8
72153,2020-01-01,9997,7960,2037,20.4
01001,2020-02-01,26157,25467,690,2.6
01003,2020-02-01,96660,94213,2447,2.5
01005,2020-02-01,8573,8286,287,3.3
01007,2020-02-01,8615,8369,246,2.9
01009,2020-02-01,25141,24529,612,2.4
01011,2020-02-01,4805,4655,150,3.1
01013,2020-02-01,9120,8755,365,4
01015,2020-02-01,46095,44586,1509,3.3
01017,2020-02-01,15837,15409,428,2.7
01019,2020-02-01,11622,11310,312,2.7
01021,2020-02-01,19790,19324,466,2.4
01023,2020-02-01,4539,4325,214,4.7
01025,2020-02-01,7617,7220,397,5.2
01027,2020-02-01,6154,6001,153,2.5
01029,2020-02-01,5801,5638,163,2.8
01031,2020-02-01,21728,21185,543,2.5
01033,2020-02-01,23514,22664,850,3.6
01035,2020-02-01,4460,4298,162,3.6
01037,2020-02-01,4457,4332,125,2.8
01039,2020-02-01,15275,14795,480,3.1
01041,2020-02-01,6385,6211,174,2.7
01043,2020-02-01,38704,37760,944,2.4
01045,2020-02-01,20542,19994,548,2.7
01047,2020-02-01,14412,13696,716,5
01049,2020-02-01,31175,30376,799,2.6
01051,2020-02-01,37027,36099,928,2.5
01053,2020-02-01,14448,13971,477,3.3
01055,2020-02-01,41742,40117,1625,3.9
01057,2020-02-01,6634,6451,183,2.8
01059,2020-02-01,14683,14183,500,3.4
01061,2020-02-01,10984,10697,287,2.6
01063,2020-02-01,2996,2845,151,5
01065,2020-02-01,6163,5924,239,3.9
01067,2020-02-01,6882,6667,215,3.1
01069,2020-02-01,46311,45068,1243,2.7
01071,2020-02-01,22994,22251,743,3.2
01073,2020-02-01,315431,307230,8201,2.6
01075,2020-02-01,5739,5563,176,3.1
01077,2020-02-01,42000,40768,1232,2.9
01079,2020-02-01,14323,13924,399,2.8
01081,2020-02-01,76548,74728,1820,2.4
01083,2020-02-01,44939,43890,1049,2.3
01085,2020-02-01,3464,3293,171,4.9
01087,2020-02-01,7910,7623,287,3.6
01089,2020-02-01,187610,183383,4227,2.3
01091,2020-02-01,7818,7555,263,3.4
01093,2020-02-01,12946,12451,495,3.8
01095,2020-02-01,44352,43350,1002,2.3
01097,2020-02-01,188985,182131,6854,3.6
01099,2020-02-01,7443,7083,360,4.8
01101,2020-02-01,105411,102345,3066,2.9
01103,2020-02-01,58668,57319,1349,2.3
01105,2020-02-01,3290,3134,156,4.7
01107,2020-02-01,7971,7711,260,3.3
01109,2020-02-01,15518,15094,424,2.7
01111,2020-02-01,9579,9314,265,2.8
01113,2020-02-01,23889,23251,638,2.7
01115,2020-02-01,40533,39551,982,2.4
01117,2020-02-01,115965,113686,2279,2
01119,2020-02-01,4637,4455,182,3.9
01121,2020-02-01,35734,34594,1140,3.2
01123,2020-02-01,17897,17394,503,2.8
01125,2020-02-01,105346,102923,2423,2.3
01127,2020-02-01,25079,24284,795,3.2
01129,2020-02-01,6691,6382,309,4.6
01131,2020-02-01,2725,2500,225,8.3
01133,2020-02-01,10217,9905,312,3.1
02013,2020-02-01,3224,3167,57,1.8
02016,2020-02-01,5081,4997,84,1.7
02020,2020-02-01,148989,143088,5901,4
02050,2020-02-01,7286,6493,793,10.9
02060,2020-02-01,237,204,33,13.9
02068,2020-02-01,588,493,95,16.2
02070,2020-02-01,1679,1559,120,7.1
02090,2020-02-01,45017,43055,1962,4.4
02100,2020-02-01,925,794,131,14.2
02105,2020-02-01,1010,857,153,15.1
02110,2020-02-01,16577,15979,598,3.6
02122,2020-02-01,25685,24036,1649,6.4
02130,2020-02-01,6339,5923,416,6.6
02150,2020-02-01,6175,5936,239,3.9
02158,2020-02-01,2390,1916,474,19.8
02164,2020-02-01,576,516,60,10.4
02170,2020-02-01,48500,45638,2862,5.9
02180,2020-02-01,4082,3693,389,9.5
02185,2020-02-01,3900,3739,161,4.1
02188,2020-02-01,2943,2578,365,12.4
02195,2020-02-01,1396,1285,111,8
02198,2020-02-01,2718,2474,244,9
02220,2020-02-01,3951,3798,153,3.9
02230,2020-02-01,553,437,116,21
02240,2020-02-01,2911,2672,239,8.2
02261,2020-02-01,4083,3663,420,10.3
02275,2020-02-01,989,922,67,6.8
02282,2020-02-01,262,236,26,9.9
02290,2020-02-01,2343,2032,311,13.3
04001,2020-02-01,20710,18551,2159,10.4
04003,2020-02-01,51765,48933,2832,5.5
04005,2020-02-01,76899,72265,4634,6
04007,2020-02-01,20736,19551,1185,5.7
04009,2020-02-01,16037,15262,775,4.8
04011,2020-02-01,4536,4367,169,3.7
04012,2020-02-01,9438,8876,562,6
04013,2020-02-01,NA,NA,92689,4
04015,2020-02-01,88057,83027,5030,5.7
04017,2020-02-01,40026,36850,3176,7.9
04019,2020-02-01,503706,481702,22004,4.4
04021,2020-02-01,193833,184511,9322,4.8
04023,2020-02-01,19887,18429,1458,7.3
04025,2020-02-01,106946,102243,4703,4.4
04027,2020-02-01,99384,87197,12187,12.3
05001,2020-02-01,9536,9214,322,3.4
05003,2020-02-01,7264,6702,562,7.7
05005,2020-02-01,16551,15826,725,4.4
05007,2020-02-01,142134,138064,4070,2.9
05009,2020-02-01,16092,15503,589,3.7
05011,2020-02-01,4492,4292,200,4.5
05013,2020-02-01,2472,2343,129,5.2
05015,2020-02-01,12663,12145,518,4.1
05017,2020-02-01,3250,2958,292,9
05019,2020-02-01,9527,9148,379,4
05021,2020-02-01,5632,5292,340,6
05023,2020-02-01,9194,8668,526,5.7
05025,2020-02-01,3242,3080,162,5
05027,2020-02-01,9200,8760,440,4.8
05029,2020-02-01,8426,8021,405,4.8
05031,2020-02-01,56439,54685,1754,3.1
05033,2020-02-01,26695,25680,1015,3.8
05035,2020-02-01,21184,20212,972,4.6
05037,2020-02-01,7488,7143,345,4.6
05039,2020-02-01,2806,2662,144,5.1
05041,2020-02-01,5464,5179,285,5.2
05043,2020-02-01,7923,7433,490,6.2
05045,2020-02-01,63040,60884,2156,3.4
05047,2020-02-01,7495,7199,296,3.9
05049,2020-02-01,5036,4814,222,4.4
05051,2020-02-01,41513,39792,1721,4.1
05053,2020-02-01,8497,8157,340,4
05055,2020-02-01,19960,19106,854,4.3
05057,2020-02-01,9773,9334,439,4.5
05059,2020-02-01,14277,13729,548,3.8
05061,2020-02-01,5640,5413,227,4
05063,2020-02-01,16872,16123,749,4.4
05065,2020-02-01,4720,4383,337,7.1
05067,2020-02-01,5926,5491,435,7.3
05069,2020-02-01,27363,25677,1686,6.2
05071,2020-02-01,10416,9940,476,4.6
05073,2020-02-01,2429,2299,130,5.4
05075,2020-02-01,6972,6642,330,4.7
05077,2020-02-01,2836,2652,184,6.5
05079,2020-02-01,3907,3693,214,5.5
05081,2020-02-01,5523,5230,293,5.3
05083,2020-02-01,8710,8291,419,4.8
05085,2020-02-01,34438,33136,1302,3.8
05087,2020-02-01,7606,7393,213,2.8
05089,2020-02-01,6446,6126,320,5
05091,2020-02-01,19603,18715,888,4.5
05093,2020-02-01,17637,16579,1058,6
05095,2020-02-01,2760,2621,139,5
05097,2020-02-01,2967,2793,174,5.9
05099,2020-02-01,3577,3421,156,4.4
05101,2020-02-01,3354,3207,147,4.4
05103,2020-02-01,9905,9346,559,5.6
05105,2020-02-01,4325,4133,192,4.4
05107,2020-02-01,6429,5963,466,7.2
05109,2020-02-01,4251,4051,200,4.7
05111,2020-02-01,10180,9744,436,4.3
05113,2020-02-01,8154,7674,480,5.9
05115,2020-02-01,28406,27095,1311,4.6
05117,2020-02-01,3679,3515,164,4.5
05119,2020-02-01,190047,182540,7507,4
05121,2020-02-01,7446,7097,349,4.7
05123,2020-02-01,8186,7727,459,5.6
05125,2020-02-01,59537,57654,1883,3.2
05127,2020-02-01,4423,4254,169,3.8
05129,2020-02-01,2849,2673,176,6.2
05131,2020-02-01,56317,54183,2134,3.8
05133,2020-02-01,5598,5289,309,5.5
05135,2020-02-01,5760,5413,347,6
05137,2020-02-01,4620,4350,270,5.8
05139,2020-02-01,15729,14753,976,6.2
05141,2020-02-01,5750,5407,343,6
05143,2020-02-01,127477,124167,3310,2.6
05145,2020-02-01,34435,32592,1843,5.4
05147,2020-02-01,2848,2702,146,5.1
05149,2020-02-01,8265,7905,360,4.4
06001,2020-02-01,842129,817367,24762,2.9
06003,2020-02-01,628,596,32,5.1
06005,2020-02-01,14788,14141,647,4.4
06007,2020-02-01,96992,91799,5193,5.4
06009,2020-02-01,21605,20711,894,4.1
06011,2020-02-01,10831,8641,2190,20.2
06013,2020-02-01,560042,542722,17320,3.1
06015,2020-02-01,9541,8947,594,6.2
06017,2020-02-01,92523,89173,3350,3.6
06019,2020-02-01,453583,415518,38065,8.4
06021,2020-02-01,13128,12201,927,7.1
06023,2020-02-01,61764,59396,2368,3.8
06025,2020-02-01,71965,58919,13046,18.1
06027,2020-02-01,8608,8271,337,3.9
06029,2020-02-01,389747,354184,35563,9.1
06031,2020-02-01,58063,52391,5672,9.8
06033,2020-02-01,28921,27250,1671,5.8
06035,2020-02-01,9405,8846,559,5.9
06037,2020-02-01,NA,NA,245988,4.7
06039,2020-02-01,64246,59179,5067,7.9
06041,2020-02-01,137921,134670,3251,2.4
06043,2020-02-01,7496,7051,445,5.9
06045,2020-02-01,38218,36442,1776,4.6
06047,2020-02-01,116772,104873,11899,10.2
06049,2020-02-01,3104,2806,298,9.6
06051,2020-02-01,9007,8675,332,3.7
06053,2020-02-01,212684,191137,21547,10.1
06055,2020-02-01,72503,70181,2322,3.2
06057,2020-02-01,48784,47032,1752,3.6
06059,2020-02-01,NA,NA,44936,2.8
06061,2020-02-01,189479,183523,5956,3.1
06063,2020-02-01,7482,6677,805,10.8
06065,2020-02-01,NA,NA,45225,4
06067,2020-02-01,713760,687197,26563,3.7
06069,2020-02-01,32545,30609,1936,5.9
06071,2020-02-01,980397,943781,36616,3.7
06073,2020-02-01,NA,NA,50564,3.2
06075,2020-02-01,583926,570813,13113,2.2
06077,2020-02-01,330931,309509,21422,6.5
06079,2020-02-01,139965,135751,4214,3
06081,2020-02-01,459402,449803,9599,2.1
06083,2020-02-01,221977,212223,9754,4.4
06085,2020-02-01,NA,NA,26828,2.5
06087,2020-02-01,139667,130729,8938,6.4
06089,2020-02-01,72868,68913,3955,5.4
06091,2020-02-01,1308,1218,90,6.9
06093,2020-02-01,16971,15543,1428,8.4
06095,2020-02-01,207480,199400,8080,3.9
06097,2020-02-01,256046,248822,7224,2.8
06099,2020-02-01,242289,226490,15799,6.5
06101,2020-02-01,45806,41698,4108,9
06103,2020-02-01,25968,24382,1586,6.1
06105,2020-02-01,4434,4116,318,7.2
06107,2020-02-01,205976,182650,23326,11.3
06109,2020-02-01,20595,19541,1054,5.1
06111,2020-02-01,423480,407935,15545,3.7
06113,2020-02-01,108500,103259,5241,4.8
06115,2020-02-01,30415,28294,2121,7
08001,2020-02-01,276716,267878,8838,3.2
08003,2020-02-01,8360,8024,336,4
08005,2020-02-01,368989,358844,10145,2.7
08007,2020-02-01,6755,6516,239,3.5
08009,2020-02-01,2091,2048,43,2.1
08011,2020-02-01,1845,1798,47,2.5
08013,2020-02-01,198994,194289,4705,2.4
08014,2020-02-01,40931,39879,1052,2.6
08015,2020-02-01,9482,9231,251,2.6
08017,2020-02-01,1097,1080,17,1.5
08019,2020-02-01,6130,5973,157,2.6
08021,2020-02-01,4084,3903,181,4.4
08023,2020-02-01,1839,1762,77,4.2
08025,2020-02-01,1524,1456,68,4.5
08027,2020-02-01,2061,1997,64,3.1
08029,2020-02-01,14017,13441,576,4.1
08031,2020-02-01,424776,412964,11812,2.8
08033,2020-02-01,1089,1051,38,3.5
08035,2020-02-01,199481,194736,4745,2.4
08037,2020-02-01,38638,37857,781,2
08039,2020-02-01,15416,15055,361,2.3
08041,2020-02-01,345732,334198,11534,3.3
08043,2020-02-01,14723,13992,731,5
08045,2020-02-01,33609,32527,1082,3.2
08047,2020-02-01,3861,3780,81,2.1
08049,2020-02-01,10350,10125,225,2.2
08051,2020-02-01,11890,11631,259,2.2
08053,2020-02-01,393,382,11,2.8
08055,2020-02-01,2567,2382,185,7.2
08057,2020-02-01,904,874,30,3.3
08059,2020-02-01,337920,329173,8747,2.6
08061,2020-02-01,934,921,13,1.4
08063,2020-02-01,4238,4160,78,1.8
08065,2020-02-01,5274,5167,107,2
08067,2020-02-01,31589,30660,929,2.9
08069,2020-02-01,206916,201519,5397,2.6
08071,2020-02-01,6391,6129,262,4.1
08073,2020-02-01,2350,2280,70,3
08075,2020-02-01,10935,10660,275,2.5
08077,2020-02-01,76322,73251,3071,4
08079,2020-02-01,545,531,14,2.6
08081,2020-02-01,7351,7046,305,4.1
08083,2020-02-01,12509,11821,688,5.5
08085,2020-02-01,21532,20781,751,3.5
08087,2020-02-01,16200,15763,437,2.7
08089,2020-02-01,8136,7775,361,4.4
08091,2020-02-01,2370,2290,80,3.4
08093,2020-02-01,11391,11105,286,2.5
08095,2020-02-01,2470,2430,40,1.6
08097,2020-02-01,11348,11079,269,2.4
08099,2020-02-01,6222,6062,160,2.6
08101,2020-02-01,77437,74252,3185,4.1
08103,2020-02-01,2922,2818,104,3.6
08105,2020-02-01,5286,5012,274,5.2
08107,2020-02-01,17319,16968,351,2
08109,2020-02-01,3424,3259,165,4.8
08111,2020-02-01,510,493,17,3.3
08113,2020-02-01,6262,6151,111,1.8
08115,2020-02-01,1150,1123,27,2.3
08117,2020-02-01,25779,25387,392,1.5
08119,2020-02-01,12994,12596,398,3.1
08121,2020-02-01,2862,2799,63,2.2
08123,2020-02-01,170316,165488,4828,2.8
08125,2020-02-01,5507,5404,103,1.9
09001,2020-02-01,477644,458527,19117,4
09003,2020-02-01,485388,465863,19525,4
09005,2020-02-01,104709,100419,4290,4.1
09007,2020-02-01,94553,91199,3354,3.5
09009,2020-02-01,463588,444443,19145,4.1
09011,2020-02-01,135142,129691,5451,4
09013,2020-02-01,87618,84463,3155,3.6
09015,2020-02-01,64325,61510,2815,4.4
10001,2020-02-01,81298,77345,3953,4.9
10003,2020-02-01,307963,295174,12789,4.2
10005,2020-02-01,106193,100687,5506,5.2
11001,2020-02-01,425308,404594,20714,4.9
12001,2020-02-01,141434,137423,4011,2.8
12003,2020-02-01,12150,11780,370,3
12005,2020-02-01,83921,81200,2721,3.2
12007,2020-02-01,11049,10610,439,4
12009,2020-02-01,287132,277773,9359,3.3
12011,2020-02-01,NA,NA,34567,3.3
12013,2020-02-01,4835,4670,165,3.4
12015,2020-02-01,73943,71179,2764,3.7
12017,2020-02-01,47460,45042,2418,5.1
12019,2020-02-01,108815,105429,3386,3.1
12021,2020-02-01,188863,183209,5654,3
12023,2020-02-01,30066,29068,998,3.3
12027,2020-02-01,15178,14648,530,3.5
12029,2020-02-01,5991,5754,237,4
12031,2020-02-01,493642,477181,16461,3.3
12033,2020-02-01,146834,141854,4980,3.4
12035,2020-02-01,48441,46560,1881,3.9
12037,2020-02-01,4725,4575,150,3.2
12039,2020-02-01,18907,18136,771,4.1
12041,2020-02-01,7418,7172,246,3.3
12043,2020-02-01,5429,5210,219,4
12045,2020-02-01,5132,4944,188,3.7
12047,2020-02-01,4188,4002,186,4.4
12049,2020-02-01,8645,8256,389,4.5
12051,2020-02-01,15723,14906,817,5.2
12053,2020-02-01,73453,70227,3226,4.4
12055,2020-02-01,35871,34159,1712,4.8
12057,2020-02-01,773174,749257,23917,3.1
12059,2020-02-01,6975,6715,260,3.7
12061,2020-02-01,67255,64746,2509,3.7
12063,2020-02-01,17268,16685,583,3.4
12065,2020-02-01,5593,5402,191,3.4
12067,2020-02-01,2878,2797,81,2.8
12069,2020-02-01,164199,158810,5389,3.3
12071,2020-02-01,360135,348716,11419,3.2
12073,2020-02-01,156851,152119,4732,3
12075,2020-02-01,16958,16332,626,3.7
12077,2020-02-01,2704,2611,93,3.4
12079,2020-02-01,7599,7324,275,3.6
12081,2020-02-01,183775,177893,5882,3.2
12083,2020-02-01,141331,135833,5498,3.9
12085,2020-02-01,75030,72669,2361,3.1
12086,2020-02-01,NA,NA,22521,1.6
12087,2020-02-01,47720,46719,1001,2.1
12089,2020-02-01,42389,41121,1268,3
12091,2020-02-01,96610,93862,2748,2.8
12093,2020-02-01,17867,17301,566,3.2
12095,2020-02-01,770175,747321,22854,3
12097,2020-02-01,188290,182026,6264,3.3
12099,2020-02-01,751184,726737,24447,3.3
12101,2020-02-01,244755,236044,8711,3.6
12103,2020-02-01,496089,480549,15540,3.1
12105,2020-02-01,314138,302580,11558,3.7
12107,2020-02-01,26652,25356,1296,4.9
12109,2020-02-01,137645,133959,3686,2.7
12111,2020-02-01,149806,143857,5949,4
12113,2020-02-01,84788,82262,2526,3
12115,2020-02-01,191705,185632,6073,3.2
12117,2020-02-01,257657,249991,7666,3
12119,2020-02-01,33750,32103,1647,4.9
12121,2020-02-01,18353,17715,638,3.5
12123,2020-02-01,8280,7994,286,3.5
12125,2020-02-01,4685,4546,139,3
12127,2020-02-01,258271,249018,9253,3.6
12129,2020-02-01,15689,15231,458,2.9
12131,2020-02-01,32133,31181,952,3
12133,2020-02-01,9758,9400,358,3.7
13001,2020-02-01,9574,9223,351,3.7
13003,2020-02-01,4584,4438,146,3.2
13005,2020-02-01,4928,4746,182,3.7
13007,2020-02-01,1229,1175,54,4.4
13009,2020-02-01,18253,17477,776,4.3
13011,2020-02-01,10137,9867,270,2.7
13013,2020-02-01,42052,40859,1193,2.8
13015,2020-02-01,51799,50059,1740,3.4
13017,2020-02-01,5541,5257,284,5.1
13019,2020-02-01,7687,7349,338,4.4
13021,2020-02-01,68986,66301,2685,3.9
13023,2020-02-01,4750,4517,233,4.9
13025,2020-02-01,7335,7057,278,3.8
13027,2020-02-01,7139,6881,258,3.6
13029,2020-02-01,19465,18898,567,2.9
13031,2020-02-01,38043,36630,1413,3.7
13033,2020-02-01,9370,8911,459,4.9
13035,2020-02-01,11199,10824,375,3.3
13037,2020-02-01,2381,2293,88,3.7
13039,2020-02-01,21604,20841,763,3.5
13043,2020-02-01,5825,5675,150,2.6
13045,2020-02-01,56796,54726,2070,3.6
13047,2020-02-01,33976,32972,1004,3
13049,2020-02-01,5075,4894,181,3.6
13051,2020-02-01,143146,138459,4687,3.3
13053,2020-02-01,2080,1994,86,4.1
13055,2020-02-01,10131,9641,490,4.8
13057,2020-02-01,139450,135693,3757,2.7
13059,2020-02-01,60945,58852,2093,3.4
13061,2020-02-01,903,842,61,6.8
13063,2020-02-01,140599,134596,6003,4.3
13065,2020-02-01,3010,2911,99,3.3
13067,2020-02-01,430881,418072,12809,3
13069,2020-02-01,19188,18394,794,4.1
13071,2020-02-01,22491,21799,692,3.1
13073,2020-02-01,77600,75335,2265,2.9
13075,2020-02-01,8332,8049,283,3.4
13077,2020-02-01,76687,74488,2199,2.9
13079,2020-02-01,5758,5560,198,3.4
13081,2020-02-01,9734,9333,401,4.1
13083,2020-02-01,8212,7938,274,3.3
13085,2020-02-01,12923,12574,349,2.7
13087,2020-02-01,11764,11338,426,3.6
13089,2020-02-01,404579,390650,13929,3.4
13091,2020-02-01,7160,6791,369,5.2
13093,2020-02-01,5111,4916,195,3.8
13095,2020-02-01,38562,36787,1775,4.6
13097,2020-02-01,74413,71781,2632,3.5
13099,2020-02-01,4558,4360,198,4.3
13101,2020-02-01,2013,1956,57,2.8
13103,2020-02-01,32727,31818,909,2.8
13105,2020-02-01,8141,7818,323,4
13107,2020-02-01,8606,8216,390,4.5
13109,2020-02-01,5075,4902,173,3.4
13111,2020-02-01,11370,10968,402,3.5
13113,2020-02-01,58998,57296,1702,2.9
13115,2020-02-01,44477,42845,1632,3.7
13117,2020-02-01,127140,123782,3358,2.6
13119,2020-02-01,10274,9904,370,3.6
13121,2020-02-01,569635,549912,19723,3.5
13123,2020-02-01,12427,12000,427,3.4
13125,2020-02-01,1312,1262,50,3.8
13127,2020-02-01,39198,37930,1268,3.2
13129,2020-02-01,29158,28172,986,3.4
13131,2020-02-01,11044,10695,349,3.2
13133,2020-02-01,7186,6905,281,3.9
13135,2020-02-01,498291,483331,14960,3
13137,2020-02-01,19590,18943,647,3.3
13139,2020-02-01,105092,102321,2771,2.6
13141,2020-02-01,2632,2493,139,5.3
13143,2020-02-01,12804,12350,454,3.5
13145,2020-02-01,17301,16786,515,3
13147,2020-02-01,11677,11211,466,4
13149,2020-02-01,5345,5154,191,3.6
13151,2020-02-01,118896,114770,4126,3.5
13153,2020-02-01,72679,70324,2355,3.2
13155,2020-02-01,3557,3401,156,4.4
13157,2020-02-01,40083,39067,1016,2.5
13159,2020-02-01,7103,6898,205,2.9
13161,2020-02-01,6346,6069,277,4.4
13163,2020-02-01,6902,6575,327,4.7
13165,2020-02-01,3248,3107,141,4.3
13167,2020-02-01,4140,3976,164,4
13169,2020-02-01,14012,13558,454,3.2
13171,2020-02-01,8387,8007,380,4.5
13173,2020-02-01,3850,3700,150,3.9
13175,2020-02-01,19759,18794,965,4.9
13177,2020-02-01,15490,15031,459,3
13179,2020-02-01,26383,25387,996,3.8
13181,2020-02-01,3664,3523,141,3.8
13183,2020-02-01,8508,8221,287,3.4
13185,2020-02-01,52673,50764,1909,3.6
13187,2020-02-01,17286,16772,514,3
13189,2020-02-01,8939,8486,453,5.1
13191,2020-02-01,6227,6014,213,3.4
13193,2020-02-01,4818,4602,216,4.5
13195,2020-02-01,13700,13275,425,3.1
13197,2020-02-01,3364,3225,139,4.1
13199,2020-02-01,9031,8655,376,4.2
13201,2020-02-01,2950,2858,92,3.1
13205,2020-02-01,8791,8398,393,4.5
13207,2020-02-01,13268,12818,450,3.4
13209,2020-02-01,4037,3871,166,4.1
13211,2020-02-01,9577,9286,291,3
13213,2020-02-01,15839,15038,801,5.1
13215,2020-02-01,79105,75723,3382,4.3
13217,2020-02-01,53772,51753,2019,3.8
13219,2020-02-01,20436,19950,486,2.4
13221,2020-02-01,7233,7009,224,3.1
13223,2020-02-01,89288,86668,2620,2.9
13225,2020-02-01,12175,11716,459,3.8
13227,2020-02-01,15729,15246,483,3.1
13229,2020-02-01,8791,8522,269,3.1
13231,2020-02-01,9151,8874,277,3
13233,2020-02-01,18833,18165,668,3.5
13235,2020-02-01,4180,4017,163,3.9
13237,2020-02-01,8512,8168,344,4
13239,2020-02-01,819,784,35,4.3
13241,2020-02-01,7393,7145,248,3.4
13243,2020-02-01,2667,2547,120,4.5
13245,2020-02-01,86997,83222,3775,4.3
13247,2020-02-01,45355,43610,1745,3.8
13249,2020-02-01,2271,2192,79,3.5
13251,2020-02-01,5180,4961,219,4.2
13253,2020-02-01,3272,3143,129,3.9
13255,2020-02-01,29311,28075,1236,4.2
13257,2020-02-01,10726,10322,404,3.8
13259,2020-02-01,2619,2526,93,3.6
13261,2020-02-01,13048,12426,622,4.8
13263,2020-02-01,2834,2723,111,3.9
13265,2020-02-01,551,512,39,7.1
13267,2020-02-01,10124,9749,375,3.7
13269,2020-02-01,2835,2719,116,4.1
13271,2020-02-01,3970,3584,386,9.7
13273,2020-02-01,3611,3459,152,4.2
13275,2020-02-01,17454,16780,674,3.9
13277,2020-02-01,21022,20336,686,3.3
13279,2020-02-01,12385,11854,531,4.3
13281,2020-02-01,3927,3733,194,4.9
13283,2020-02-01,2786,2643,143,5.1
13285,2020-02-01,38647,37469,1178,3
13287,2020-02-01,3338,3183,155,4.6
13289,2020-02-01,2922,2758,164,5.6
13291,2020-02-01,10659,10311,348,3.3
13293,2020-02-01,11704,11242,462,3.9
13295,2020-02-01,31830,30797,1033,3.2
13297,2020-02-01,47043,45602,1441,3.1
13299,2020-02-01,15725,15150,575,3.7
13301,2020-02-01,2694,2571,123,4.6
13303,2020-02-01,7071,6751,320,4.5
13305,2020-02-01,11560,11123,437,3.8
13307,2020-02-01,1063,1013,50,4.7
13309,2020-02-01,1702,1579,123,7.2
13311,2020-02-01,16840,16407,433,2.6
13313,2020-02-01,44176,42474,1702,3.9
13315,2020-02-01,2825,2714,111,3.9
13317,2020-02-01,3826,3617,209,5.5
13319,2020-02-01,3984,3841,143,3.6
13321,2020-02-01,9315,8971,344,3.7
15001,2020-02-01,91625,89635,1990,2.2
15003,2020-02-01,459784,452327,7457,1.6
15007,2020-02-01,36841,36158,683,1.9
15009,2020-02-01,87474,85959,1515,1.7
16001,2020-02-01,259634,253612,6022,2.3
16003,2020-02-01,1699,1591,108,6.4
16005,2020-02-01,42767,41496,1271,3
16007,2020-02-01,2938,2836,102,3.5
16009,2020-02-01,4042,3794,248,6.1
16011,2020-02-01,23174,22508,666,2.9
16013,2020-02-01,12953,12573,380,2.9
16015,2020-02-01,3644,3455,189,5.2
16017,2020-02-01,20724,19766,958,4.6
16019,2020-02-01,57467,56023,1444,2.5
16021,2020-02-01,5251,4984,267,5.1
16023,2020-02-01,1347,1313,34,2.5
16025,2020-02-01,676,658,18,2.7
16027,2020-02-01,106254,102909,3345,3.1
16029,2020-02-01,4045,3911,134,3.3
16031,2020-02-01,11984,11712,272,2.3
16033,2020-02-01,356,339,17,4.8
16035,2020-02-01,2949,2771,178,6
16037,2020-02-01,2004,1920,84,4.2
16039,2020-02-01,11645,11245,400,3.4
16041,2020-02-01,6929,6780,149,2.2
16043,2020-02-01,7871,7648,223,2.8
16045,2020-02-01,8426,8138,288,3.4
16047,2020-02-01,8185,7946,239,2.9
16049,2020-02-01,6494,6183,311,4.8
16051,2020-02-01,13882,13540,342,2.5
16053,2020-02-01,12195,11835,360,3
16055,2020-02-01,79964,76764,3200,4
16057,2020-02-01,20942,20444,498,2.4
16059,2020-02-01,3500,3296,204,5.8
16061,2020-02-01,1570,1476,94,6
16063,2020-02-01,2748,2598,150,5.5
16065,2020-02-01,22741,22356,385,1.7
16067,2020-02-01,11258,10947,311,2.8
16069,2020-02-01,21002,20399,603,2.9
16071,2020-02-01,2299,2243,56,2.4
16073,2020-02-01,5315,5120,195,3.7
16075,2020-02-01,11857,11419,438,3.7
16077,2020-02-01,3839,3703,136,3.5
16079,2020-02-01,5500,5178,322,5.9
16081,2020-02-01,6335,6203,132,2.1
16083,2020-02-01,41217,40016,1201,2.9
16085,2020-02-01,5587,5347,240,4.3
16087,2020-02-01,4670,4470,200,4.3
17001,2020-02-01,31193,30311,882,2.8
17003,2020-02-01,1918,1814,104,5.4
17005,2020-02-01,7549,7305,244,3.2
17007,2020-02-01,25716,24301,1415,5.5
17009,2020-02-01,3043,2985,58,1.9
17011,2020-02-01,16135,15398,737,4.6
17013,2020-02-01,2251,2164,87,3.9
17015,2020-02-01,7029,6740,289,4.1
17017,2020-02-01,5847,5624,223,3.8
17019,2020-02-01,110719,107772,2947,2.7
17021,2020-02-01,13563,12953,610,4.5
17023,2020-02-01,7210,6910,300,4.2
17025,2020-02-01,6098,5827,271,4.4
17027,2020-02-01,20240,19675,565,2.8
17029,2020-02-01,23748,23065,683,2.9
17031,2020-02-01,NA,NA,96737,3.8
17033,2020-02-01,8525,8227,298,3.5
17035,2020-02-01,6005,5818,187,3.1
17037,2020-02-01,54330,52377,1953,3.6
17039,2020-02-01,7260,7011,249,3.4
17041,2020-02-01,10168,9907,261,2.6
17043,2020-02-01,504427,489974,14453,2.9
17045,2020-02-01,8702,8417,285,3.3
17047,2020-02-01,2570,2459,111,4.3
17049,2020-02-01,19580,19038,542,2.8
17051,2020-02-01,9560,9173,387,4
17053,2020-02-01,6222,5998,224,3.6
17055,2020-02-01,15786,15071,715,4.5
17057,2020-02-01,14868,14074,794,5.3
17059,2020-02-01,2026,1920,106,5.2
17061,2020-02-01,5864,5662,202,3.4
17063,2020-02-01,25520,24233,1287,5
17065,2020-02-01,4354,4214,140,3.2
17067,2020-02-01,8008,7660,348,4.3
17069,2020-02-01,1262,1190,72,5.7
17071,2020-02-01,3454,3290,164,4.7
17073,2020-02-01,24202,23130,1072,4.4
17075,2020-02-01,13504,12916,588,4.4
17077,2020-02-01,27481,26698,783,2.8
17079,2020-02-01,4481,4312,169,3.8
17081,2020-02-01,17094,16467,627,3.7
17083,2020-02-01,10909,10496,413,3.8
17085,2020-02-01,10263,9800,463,4.5
17087,2020-02-01,4192,3969,223,5.3
17089,2020-02-01,267986,256749,11237,4.2
17091,2020-02-01,55126,52562,2564,4.7
17093,2020-02-01,69192,66719,2473,3.6
17095,2020-02-01,20850,19957,893,4.3
17097,2020-02-01,370309,356228,14081,3.8
17099,2020-02-01,52881,50257,2624,5
17101,2020-02-01,5780,5537,243,4.2
17103,2020-02-01,16992,16418,574,3.4
17105,2020-02-01,15754,15179,575,3.6
17107,2020-02-01,12272,11846,426,3.5
17109,2020-02-01,13160,12733,427,3.2
17111,2020-02-01,165368,159311,6057,3.7
17113,2020-02-01,87165,84735,2430,2.8
17115,2020-02-01,47125,45041,2084,4.4
17117,2020-02-01,22566,21754,812,3.6
17119,2020-02-01,133472,129372,4100,3.1
17121,2020-02-01,16868,16253,615,3.6
17123,2020-02-01,5146,4907,239,4.6
17125,2020-02-01,5879,5588,291,4.9
17127,2020-02-01,5452,5203,249,4.6
17129,2020-02-01,6265,6033,232,3.7
17131,2020-02-01,7795,7358,437,5.6
17133,2020-02-01,18949,18477,472,2.5
17135,2020-02-01,11510,10915,595,5.2
17137,2020-02-01,16048,15489,559,3.5
17139,2020-02-01,7404,7213,191,2.6
17141,2020-02-01,24986,23917,1069,4.3
17143,2020-02-01,83432,79632,3800,4.6
17145,2020-02-01,8013,7696,317,4
17147,2020-02-01,8598,8362,236,2.7
17149,2020-02-01,6698,6415,283,4.2
17151,2020-02-01,1619,1547,72,4.4
17153,2020-02-01,1704,1586,118,6.9
17155,2020-02-01,2907,2742,165,5.7
17157,2020-02-01,13702,13281,421,3.1
17159,2020-02-01,7249,7015,234,3.2
17161,2020-02-01,69315,66271,3044,4.4
17163,2020-02-01,125833,121564,4269,3.4
17165,2020-02-01,9385,8950,435,4.6
17167,2020-02-01,98047,94787,3260,3.3
17169,2020-02-01,3090,2972,118,3.8
17171,2020-02-01,2401,2284,117,4.9
17173,2020-02-01,10226,9880,346,3.4
17175,2020-02-01,2383,2260,123,5.2
17177,2020-02-01,21059,20194,865,4.1
17179,2020-02-01,62723,60224,2499,4
17181,2020-02-01,7375,6985,390,5.3
17183,2020-02-01,32279,30941,1338,4.1
17185,2020-02-01,5600,5426,174,3.1
17187,2020-02-01,8178,7914,264,3.2
17189,2020-02-01,9590,9391,199,2.1
17191,2020-02-01,6772,6511,261,3.9
17193,2020-02-01,6171,5966,205,3.3
17195,2020-02-01,27861,26829,1032,3.7
17197,2020-02-01,357100,342226,14874,4.2
17199,2020-02-01,31768,30646,1122,3.5
17201,2020-02-01,135633,129179,6454,4.8
17203,2020-02-01,18398,17821,577,3.1
18001,2020-02-01,16898,16378,520,3.1
18003,2020-02-01,186383,179937,6446,3.5
18005,2020-02-01,44930,43795,1135,2.5
18007,2020-02-01,4439,4303,136,3.1
18009,2020-02-01,4833,4627,206,4.3
18011,2020-02-01,36337,35470,867,2.4
18013,2020-02-01,7584,7329,255,3.4
18015,2020-02-01,10062,9724,338,3.4
18017,2020-02-01,17584,16904,680,3.9
18019,2020-02-01,62274,60297,1977,3.2
18021,2020-02-01,11646,11186,460,3.9
18023,2020-02-01,17246,16790,456,2.6
18025,2020-02-01,4915,4641,274,5.6
18027,2020-02-01,16543,16080,463,2.8
18029,2020-02-01,25801,24789,1012,3.9
18031,2020-02-01,15132,14669,463,3.1
18033,2020-02-01,22376,21711,665,3
18035,2020-02-01,53993,51830,2163,4
18037,2020-02-01,22702,22146,556,2.4
18039,2020-02-01,111096,108000,3096,2.8
18041,2020-02-01,8526,8145,381,4.5
18043,2020-02-01,42137,40825,1312,3.1
18045,2020-02-01,7817,7543,274,3.5
18047,2020-02-01,11266,10830,436,3.9
18049,2020-02-01,9451,9087,364,3.9
18051,2020-02-01,19726,19203,523,2.7
18053,2020-02-01,32359,31190,1169,3.6
18055,2020-02-01,13577,12952,625,4.6
18057,2020-02-01,187037,182548,4489,2.4
18059,2020-02-01,40902,39754,1148,2.8
18061,2020-02-01,20444,19755,689,3.4
18063,2020-02-01,91266,88917,2349,2.6
18065,2020-02-01,21954,21204,750,3.4
18067,2020-02-01,35880,34456,1424,4
18069,2020-02-01,18156,17555,601,3.3
18071,2020-02-01,23017,22444,573,2.5
18073,2020-02-01,16021,15262,759,4.7
18075,2020-02-01,8813,8520,293,3.3
18077,2020-02-01,15202,14694,508,3.3
18079,2020-02-01,13554,13074,480,3.5
18081,2020-02-01,83469,81247,2222,2.7
18083,2020-02-01,18404,17823,581,3.2
18085,2020-02-01,41611,40415,1196,2.9
18087,2020-02-01,19253,18770,483,2.5
18089,2020-02-01,227029,215013,12016,5.3
18091,2020-02-01,47028,44786,2242,4.8
18093,2020-02-01,21237,20451,786,3.7
18095,2020-02-01,58963,56535,2428,4.1
18097,2020-02-01,493402,477667,15735,3.2
18099,2020-02-01,22760,22009,751,3.3
18101,2020-02-01,5321,5188,133,2.5
18103,2020-02-01,14713,14076,637,4.3
18105,2020-02-01,72400,70068,2332,3.2
18107,2020-02-01,18696,18143,553,3
18109,2020-02-01,36334,35134,1200,3.3
18111,2020-02-01,6771,6428,343,5.1
18113,2020-02-01,22987,22284,703,3.1
18115,2020-02-01,3198,3093,105,3.3
18117,2020-02-01,8836,8505,331,3.7
18119,2020-02-01,9503,9117,386,4.1
18121,2020-02-01,6690,6428,262,3.9
18123,2020-02-01,9284,8965,319,3.4
18125,2020-02-01,6060,5827,233,3.8
18127,2020-02-01,85736,82131,3605,4.2
18129,2020-02-01,13159,12783,376,2.9
18131,2020-02-01,6347,6105,242,3.8
18133,2020-02-01,16516,15947,569,3.4
18135,2020-02-01,11205,10748,457,4.1
18137,2020-02-01,14062,13538,524,3.7
18139,2020-02-01,8728,8489,239,2.7
18141,2020-02-01,135696,130727,4969,3.7
18143,2020-02-01,10550,10207,343,3.3
18145,2020-02-01,23053,22367,686,3
18147,2020-02-01,10214,9802,412,4
18149,2020-02-01,9730,9261,469,4.8
18151,2020-02-01,20410,19881,529,2.6
18153,2020-02-01,8078,7674,404,5
18155,2020-02-01,4945,4768,177,3.6
18157,2020-02-01,99491,96504,2987,3
18159,2020-02-01,9063,8804,259,2.9
18161,2020-02-01,3532,3416,116,3.3
18163,2020-02-01,92771,89832,2939,3.2
18165,2020-02-01,6739,6352,387,5.7
18167,2020-02-01,46424,44371,2053,4.4
18169,2020-02-01,14645,14159,486,3.3
18171,2020-02-01,4094,3971,123,3
18173,2020-02-01,32529,31554,975,3
18175,2020-02-01,13634,13125,509,3.7
18177,2020-02-01,30476,29376,1100,3.6
18179,2020-02-01,14239,13806,433,3
18181,2020-02-01,13385,13013,372,2.8
18183,2020-02-01,17484,16963,521,3
19001,2020-02-01,4364,4235,129,3
19003,2020-02-01,2166,2126,40,1.8
19005,2020-02-01,7516,7129,387,5.1
19007,2020-02-01,5994,5776,218,3.6
19009,2020-02-01,3154,3072,82,2.6
19011,2020-02-01,13689,13222,467,3.4
19013,2020-02-01,69988,67517,2471,3.5
19015,2020-02-01,15138,14719,419,2.8
19017,2020-02-01,14313,13937,376,2.6
19019,2020-02-01,11640,11233,407,3.5
19021,2020-02-01,12303,12038,265,2.2
19023,2020-02-01,8041,7694,347,4.3
19025,2020-02-01,4297,4177,120,2.8
19027,2020-02-01,10943,10717,226,2.1
19029,2020-02-01,6955,6724,231,3.3
19031,2020-02-01,10877,10530,347,3.2
19033,2020-02-01,23777,23064,713,3
19035,2020-02-01,6402,6201,201,3.1
19037,2020-02-01,6575,6310,265,4
19039,2020-02-01,5023,4832,191,3.8
19041,2020-02-01,8633,8351,282,3.3
19043,2020-02-01,10213,9563,650,6.4
19045,2020-02-01,22894,21936,958,4.2
19047,2020-02-01,8325,7922,403,4.8
19049,2020-02-01,51604,50578,1026,2
19051,2020-02-01,4289,4168,121,2.8
19053,2020-02-01,4597,4495,102,2.2
19055,2020-02-01,10770,10436,334,3.1
19057,2020-02-01,19064,18092,972,5.1
19059,2020-02-01,9611,9201,410,4.3
19061,2020-02-01,57144,55159,1985,3.5
19063,2020-02-01,5268,5107,161,3.1
19065,2020-02-01,10961,10454,507,4.6
19067,2020-02-01,8695,8293,402,4.6
19069,2020-02-01,5778,5595,183,3.2
19071,2020-02-01,3909,3828,81,2.1
19073,2020-02-01,5622,5493,129,2.3
19075,2020-02-01,6710,6497,213,3.2
19077,2020-02-01,5765,5535,230,4
19079,2020-02-01,7090,6872,218,3.1
19081,2020-02-01,6014,5852,162,2.7
19083,2020-02-01,8218,7917,301,3.7
19085,2020-02-01,7437,7225,212,2.9
19087,2020-02-01,9987,9653,334,3.3
19089,2020-02-01,5286,5078,208,3.9
19091,2020-02-01,5129,4961,168,3.3
19093,2020-02-01,4186,4059,127,3
19095,2020-02-01,10625,10309,316,3
19097,2020-02-01,11126,10621,505,4.5
19099,2020-02-01,19988,19296,692,3.5
19101,2020-02-01,10356,10097,259,2.5
19103,2020-02-01,87678,85977,1701,1.9
19105,2020-02-01,10963,10451,512,4.7
19107,2020-02-01,5369,5133,236,4.4
19109,2020-02-01,8575,8346,229,2.7
19111,2020-02-01,16229,15544,685,4.2
19113,2020-02-01,123231,119147,4084,3.3
19115,2020-02-01,6219,5956,263,4.2
19117,2020-02-01,4665,4561,104,2.2
19119,2020-02-01,7132,6967,165,2.3
19121,2020-02-01,8789,8388,401,4.6
19123,2020-02-01,12200,11856,344,2.8
19125,2020-02-01,18542,18087,455,2.5
19127,2020-02-01,18483,17227,1256,6.8
19129,2020-02-01,7478,7296,182,2.4
19131,2020-02-01,6117,5973,144,2.4
19133,2020-02-01,4536,4381,155,3.4
19135,2020-02-01,4099,3960,139,3.4
19137,2020-02-01,5039,4891,148,2.9
19139,2020-02-01,21985,21280,705,3.2
19141,2020-02-01,8365,8157,208,2.5
19143,2020-02-01,3629,3544,85,2.3
19145,2020-02-01,6382,6211,171,2.7
19147,2020-02-01,4857,4720,137,2.8
19149,2020-02-01,15067,14716,351,2.3
19151,2020-02-01,4390,4292,98,2.2
19153,2020-02-01,272352,263846,8506,3.1
19155,2020-02-01,48627,47287,1340,2.8
19157,2020-02-01,10638,10274,364,3.4
19159,2020-02-01,2496,2425,71,2.8
19161,2020-02-01,5414,5247,167,3.1
19163,2020-02-01,89320,86010,3310,3.7
19165,2020-02-01,6622,6450,172,2.6
19167,2020-02-01,21900,21357,543,2.5
19169,2020-02-01,60633,59625,1008,1.7
19171,2020-02-01,9767,9346,421,4.3
19173,2020-02-01,3179,3120,59,1.9
19175,2020-02-01,6498,6249,249,3.8
19177,2020-02-01,3784,3648,136,3.6
19179,2020-02-01,17750,17084,666,3.8
19181,2020-02-01,28802,27926,876,3
19183,2020-02-01,12346,11936,410,3.3
19185,2020-02-01,2884,2810,74,2.6
19187,2020-02-01,19220,18542,678,3.5
19189,2020-02-01,5173,5018,155,3
19191,2020-02-01,11998,11482,516,4.3
19193,2020-02-01,56435,54613,1822,3.2
19195,2020-02-01,4309,4155,154,3.6
19197,2020-02-01,7402,7191,211,2.9
20001,2020-02-01,6428,6202,226,3.5
20003,2020-02-01,4195,4054,141,3.4
20005,2020-02-01,6867,6479,388,5.7
20007,2020-02-01,2316,2255,61,2.6
20009,2020-02-01,13882,13387,495,3.6
20011,2020-02-01,6811,6499,312,4.6
20013,2020-02-01,5141,4981,160,3.1
20015,2020-02-01,33138,32025,1113,3.4
20017,2020-02-01,1478,1433,45,3
20019,2020-02-01,1448,1400,48,3.3
20021,2020-02-01,9941,9624,317,3.2
20023,2020-02-01,1303,1271,32,2.5
20025,2020-02-01,1106,1083,23,2.1
20027,2020-02-01,3713,3601,112,3
20029,2020-02-01,3824,3717,107,2.8
20031,2020-02-01,3941,3752,189,4.8
20033,2020-02-01,841,818,23,2.7
20035,2020-02-01,16770,16200,570,3.4
20037,2020-02-01,19008,18262,746,3.9
20039,2020-02-01,1188,1152,36,3
20041,2020-02-01,8944,8593,351,3.9
20043,2020-02-01,4159,4002,157,3.8
20045,2020-02-01,66832,64836,1996,3
20047,2020-02-01,1429,1399,30,2.1
20049,2020-02-01,1206,1170,36,3
20051,2020-02-01,17302,16942,360,2.1
20053,2020-02-01,2635,2566,69,2.6
20055,2020-02-01,20669,20238,431,2.1
20057,2020-02-01,17340,16930,410,2.4
20059,2020-02-01,14275,13766,509,3.6
20061,2020-02-01,11866,11360,506,4.3
20063,2020-02-01,1440,1413,27,1.9
20065,2020-02-01,1179,1151,28,2.4
20067,2020-02-01,3122,3044,78,2.5
20069,2020-02-01,3198,3129,69,2.2
20071,2020-02-01,800,786,14,1.8
20073,2020-02-01,3143,3017,126,4
20075,2020-02-01,1586,1558,28,1.8
20077,2020-02-01,2789,2714,75,2.7
20079,2020-02-01,17406,16866,540,3.1
20081,2020-02-01,2243,2197,46,2.1
20083,2020-02-01,992,962,30,3
20085,2020-02-01,7203,6966,237,3.3
20087,2020-02-01,10280,9913,367,3.6
20089,2020-02-01,1225,1193,32,2.6
20091,2020-02-01,342747,333557,9190,2.7
20093,2020-02-01,2025,1988,37,1.8
20095,2020-02-01,3397,3290,107,3.1
20097,2020-02-01,1234,1207,27,2.2
20099,2020-02-01,9707,9306,401,4.1
20101,2020-02-01,715,694,21,2.9
20103,2020-02-01,36921,35541,1380,3.7
20105,2020-02-01,1711,1672,39,2.3
20107,2020-02-01,4480,4167,313,7
20109,2020-02-01,1611,1575,36,2.2
20111,2020-02-01,16970,16391,579,3.4
20113,2020-02-01,17369,16961,408,2.3
20115,2020-02-01,6122,5967,155,2.5
20117,2020-02-01,5470,5317,153,2.8
20119,2020-02-01,2102,2057,45,2.1
20121,2020-02-01,17917,17246,671,3.7
20123,2020-02-01,3384,3311,73,2.2
20125,2020-02-01,14796,14134,662,4.5
20127,2020-02-01,3039,2943,96,3.2
20129,2020-02-01,1144,1117,27,2.4
20131,2020-02-01,5457,5320,137,2.5
20133,2020-02-01,6141,5870,271,4.4
20135,2020-02-01,1329,1295,34,2.6
20137,2020-02-01,2659,2604,55,2.1
20139,2020-02-01,8075,7763,312,3.9
20141,2020-02-01,1988,1931,57,2.9
20143,2020-02-01,2960,2880,80,2.7
20145,2020-02-01,2783,2694,89,3.2
20147,2020-02-01,2625,2564,61,2.3
20149,2020-02-01,12742,12359,383,3
20151,2020-02-01,4961,4847,114,2.3
20153,2020-02-01,1491,1463,28,1.9
20155,2020-02-01,29656,28687,969,3.3
20157,2020-02-01,2287,2232,55,2.4
20159,2020-02-01,5008,4878,130,2.6
20161,2020-02-01,35994,35041,953,2.6
20163,2020-02-01,2507,2432,75,3
20165,2020-02-01,1616,1573,43,2.7
20167,2020-02-01,3331,3233,98,2.9
20169,2020-02-01,29491,28483,1008,3.4
20171,2020-02-01,2809,2756,53,1.9
20173,2020-02-01,257862,247767,10095,3.9
20175,2020-02-01,9735,9455,280,2.9
20177,2020-02-01,91241,88002,3239,3.5
20179,2020-02-01,1425,1393,32,2.2
20181,2020-02-01,2866,2788,78,2.7
20183,2020-02-01,1978,1921,57,2.9
20185,2020-02-01,2024,1967,57,2.8
20187,2020-02-01,1060,1033,27,2.5
20189,2020-02-01,2773,2698,75,2.7
20191,2020-02-01,11012,10617,395,3.6
20193,2020-02-01,4243,4156,87,2.1
20195,2020-02-01,1454,1411,43,3
20197,2020-02-01,3710,3568,142,3.8
20199,2020-02-01,814,796,18,2.2
20201,2020-02-01,2983,2903,80,2.7
20203,2020-02-01,1322,1301,21,1.6
20205,2020-02-01,3886,3710,176,4.5
20207,2020-02-01,1545,1486,59,3.8
20209,2020-02-01,77727,74260,3467,4.5
21001,2020-02-01,7157,6737,420,5.9
21003,2020-02-01,8981,8628,353,3.9
21005,2020-02-01,12213,11734,479,3.9
21007,2020-02-01,3455,3254,201,5.8
21009,2020-02-01,18768,17880,888,4.7
21011,2020-02-01,4675,4296,379,8.1
21013,2020-02-01,8418,7815,603,7.2
21015,2020-02-01,72295,69846,2449,3.4
21017,2020-02-01,9434,9052,382,4
21019,2020-02-01,18007,16915,1092,6.1
21021,2020-02-01,12715,12166,549,4.3
21023,2020-02-01,3902,3671,231,5.9
21025,2020-02-01,3440,3077,363,10.6
21027,2020-02-01,7923,7429,494,6.2
21029,2020-02-01,43324,41609,1715,4
21031,2020-02-01,5214,4937,277,5.3
21033,2020-02-01,5638,5353,285,5.1
21035,2020-02-01,18567,17559,1008,5.4
21037,2020-02-01,51250,49491,1759,3.4
21039,2020-02-01,2224,2125,99,4.5
21041,2020-02-01,5344,5121,223,4.2
21043,2020-02-01,9759,8890,869,8.9
21045,2020-02-01,6714,6429,285,4.2
21047,2020-02-01,24864,23488,1376,5.5
21049,2020-02-01,17412,16684,728,4.2
21051,2020-02-01,5234,4877,357,6.8
21053,2020-02-01,3973,3744,229,5.8
21055,2020-02-01,3766,3586,180,4.8
21057,2020-02-01,3368,3194,174,5.2
21059,2020-02-01,46996,45093,1903,4
21061,2020-02-01,4782,4530,252,5.3
21063,2020-02-01,2070,1844,226,10.9
21065,2020-02-01,5408,5096,312,5.8
21067,2020-02-01,176039,170585,5454,3.1
21069,2020-02-01,6142,5749,393,6.4
21071,2020-02-01,11084,10256,828,7.5
21073,2020-02-01,25523,24596,927,3.6
21075,2020-02-01,1969,1875,94,4.8
21077,2020-02-01,4092,3930,162,4
21079,2020-02-01,7747,7389,358,4.6
21081,2020-02-01,11782,11250,532,4.5
21083,2020-02-01,15789,15060,729,4.6
21085,2020-02-01,11030,10427,603,5.5
21087,2020-02-01,5306,5094,212,4
21089,2020-02-01,13699,12645,1054,7.7
21091,2020-02-01,3885,3751,134,3.4
21093,2020-02-01,48875,46816,2059,4.2
21095,2020-02-01,7014,6218,796,11.3
21097,2020-02-01,8868,8503,365,4.1
21099,2020-02-01,7911,7398,513,6.5
21101,2020-02-01,21381,20547,834,3.9
21103,2020-02-01,8226,7928,298,3.6
21105,2020-02-01,1691,1603,88,5.2
21107,2020-02-01,18561,17690,871,4.7
21109,2020-02-01,4184,3913,271,6.5
21111,2020-02-01,400035,385183,14852,3.7
21113,2020-02-01,26919,26004,915,3.4
21115,2020-02-01,6698,6214,484,7.2
21117,2020-02-01,88651,85502,3149,3.6
21119,2020-02-01,4488,4160,328,7.3
21121,2020-02-01,10171,9636,535,5.3
21123,2020-02-01,5996,5711,285,4.8
21125,2020-02-01,25569,24394,1175,4.6
21127,2020-02-01,5332,4907,425,8
21129,2020-02-01,2110,1975,135,6.4
21131,2020-02-01,2755,2456,299,10.9
21133,2020-02-01,6334,5759,575,9.1
21135,2020-02-01,4805,4304,501,10.4
21137,2020-02-01,9420,8958,462,4.9
21139,2020-02-01,3638,3406,232,6.4
21141,2020-02-01,12431,11918,513,4.1
21143,2020-02-01,3023,2881,142,4.7
21145,2020-02-01,29206,27711,1495,5.1
21147,2020-02-01,4875,4571,304,6.2
21149,2020-02-01,4102,3921,181,4.4
21151,2020-02-01,47770,46004,1766,3.7
21153,2020-02-01,3402,2853,549,16.1
21155,2020-02-01,9496,9171,325,3.4
21157,2020-02-01,15272,14490,782,5.1
21159,2020-02-01,2586,2323,263,10.2
21161,2020-02-01,7015,6596,419,6
21163,2020-02-01,12109,11506,603,5
21165,2020-02-01,2361,2143,218,9.2
21167,2020-02-01,10033,9552,481,4.8
21169,2020-02-01,4089,3874,215,5.3
21171,2020-02-01,4613,4393,220,4.8
21173,2020-02-01,11579,10907,672,5.8
21175,2020-02-01,4519,4210,309,6.8
21177,2020-02-01,10416,9676,740,7.1
21179,2020-02-01,23321,22310,1011,4.3
21181,2020-02-01,3331,3162,169,5.1
21183,2020-02-01,9735,9132,603,6.2
21185,2020-02-01,33545,32571,974,2.9
21187,2020-02-01,5071,4854,217,4.3
21189,2020-02-01,1079,996,83,7.7
21191,2020-02-01,7094,6777,317,4.5
21193,2020-02-01,8493,7840,653,7.7
21195,2020-02-01,20149,18762,1387,6.9
21197,2020-02-01,5109,4776,333,6.5
21199,2020-02-01,26714,25413,1301,4.9
21201,2020-02-01,794,748,46,5.8
21203,2020-02-01,6710,6365,345,5.1
21205,2020-02-01,10496,9894,602,5.7
21207,2020-02-01,6235,5875,360,5.8
21209,2020-02-01,29842,28868,974,3.3
21211,2020-02-01,25713,24928,785,3.1
21213,2020-02-01,8811,8423,388,4.4
21215,2020-02-01,10562,10209,353,3.3
21217,2020-02-01,13117,12604,513,3.9
21219,2020-02-01,5449,5225,224,4.1
21221,2020-02-01,6070,5742,328,5.4
21223,2020-02-01,3859,3695,164,4.2
21225,2020-02-01,6016,5739,277,4.6
21227,2020-02-01,65796,63311,2485,3.8
21229,2020-02-01,6125,5896,229,3.7
21231,2020-02-01,7338,6926,412,5.6
21233,2020-02-01,5546,5288,258,4.7
21235,2020-02-01,14175,13492,683,4.8
21237,2020-02-01,2175,2008,167,7.7
21239,2020-02-01,14835,14359,476,3.2
22001,2020-02-01,24242,23150,1092,4.5
22003,2020-02-01,9010,8514,496,5.5
22005,2020-02-01,66221,63723,2498,3.8
22007,2020-02-01,8910,8336,574,6.4
22009,2020-02-01,15291,14506,785,5.1
22011,2020-02-01,14985,14272,713,4.8
22013,2020-02-01,5549,5233,316,5.7
22015,2020-02-01,58606,56465,2141,3.7
22017,2020-02-01,104099,99208,4891,4.7
22019,2020-02-01,105547,101374,4173,4
22021,2020-02-01,3758,3504,254,6.8
22023,2020-02-01,3915,3771,144,3.7
22025,2020-02-01,3467,3283,184,5.3
22027,2020-02-01,5663,5319,344,6.1
22029,2020-02-01,7102,6658,444,6.3
22031,2020-02-01,11084,10473,611,5.5
22033,2020-02-01,233876,225013,8863,3.8
22035,2020-02-01,1868,1657,211,11.3
22037,2020-02-01,8010,7705,305,3.8
22039,2020-02-01,12149,11549,600,4.9
22041,2020-02-01,7481,6981,500,6.7
22043,2020-02-01,8324,7873,451,5.4
22045,2020-02-01,28301,26845,1456,5.1
22047,2020-02-01,14228,13435,793,5.6
22049,2020-02-01,7003,6692,311,4.4
22051,2020-02-01,220062,212226,7836,3.6
22053,2020-02-01,13297,12743,554,4.2
22055,2020-02-01,116849,112432,4417,3.8
22057,2020-02-01,42498,40877,1621,3.8
22059,2020-02-01,6979,6726,253,3.6
22061,2020-02-01,22187,21265,922,4.2
22063,2020-02-01,70421,67994,2427,3.4
22065,2020-02-01,3585,3334,251,7
22067,2020-02-01,10143,9267,876,8.6
22069,2020-02-01,16941,16161,780,4.6
22071,2020-02-01,184018,176436,7582,4.1
22073,2020-02-01,71108,67682,3426,4.8
22075,2020-02-01,10268,9906,362,3.5
22077,2020-02-01,9891,9449,442,4.5
22079,2020-02-01,55778,53377,2401,4.3
22081,2020-02-01,3725,3532,193,5.2
22083,2020-02-01,8299,7774,525,6.3
22085,2020-02-01,9443,9041,402,4.3
22087,2020-02-01,20728,19823,905,4.4
22089,2020-02-01,26083,25123,960,3.7
22091,2020-02-01,4282,4051,231,5.4
22093,2020-02-01,9603,9063,540,5.6
22095,2020-02-01,20165,19154,1011,5
22097,2020-02-01,32662,30828,1834,5.6
22099,2020-02-01,22626,21603,1023,4.5
22101,2020-02-01,19822,18802,1020,5.1
22103,2020-02-01,124089,119834,4255,3.4
22105,2020-02-01,56190,53587,2603,4.6
22107,2020-02-01,1399,1281,118,8.4
22109,2020-02-01,46854,45000,1854,4
22111,2020-02-01,9225,8718,507,5.5
22113,2020-02-01,24403,23325,1078,4.4
22115,2020-02-01,16305,15331,974,6
22117,2020-02-01,16952,16119,833,4.9
22119,2020-02-01,14606,13792,814,5.6
22121,2020-02-01,13879,13354,525,3.8
22123,2020-02-01,3797,3373,424,11.2
22125,2020-02-01,5508,5310,198,3.6
22127,2020-02-01,4895,4610,285,5.8
23001,2020-02-01,55284,53572,1712,3.1
23003,2020-02-01,30321,28861,1460,4.8
23005,2020-02-01,164111,159951,4160,2.5
23007,2020-02-01,14717,14175,542,3.7
23009,2020-02-01,27458,26001,1457,5.3
23011,2020-02-01,62320,60254,2066,3.3
23013,2020-02-01,20008,19221,787,3.9
23015,2020-02-01,16419,15783,636,3.9
23017,2020-02-01,27075,26056,1019,3.8
23019,2020-02-01,77619,74817,2802,3.6
23021,2020-02-01,7276,6957,319,4.4
23023,2020-02-01,19677,19174,503,2.6
23025,2020-02-01,22490,21333,1157,5.1
23027,2020-02-01,20403,19617,786,3.9
23029,2020-02-01,13811,12969,842,6.1
23031,2020-02-01,113531,109923,3608,3.2
24001,2020-02-01,32083,30371,1712,5.3
24003,2020-02-01,322714,313184,9530,3
24005,2020-02-01,461063,444802,16261,3.5
24009,2020-02-01,51569,50071,1498,2.9
24011,2020-02-01,18395,17718,677,3.7
24013,2020-02-01,97961,95063,2898,3
24015,2020-02-01,54348,52173,2175,4
24017,2020-02-01,90489,87391,3098,3.4
24019,2020-02-01,17014,16280,734,4.3
24021,2020-02-01,139704,135384,4320,3.1
24023,2020-02-01,16393,15569,824,5
24025,2020-02-01,144476,139730,4746,3.3
24027,2020-02-01,192335,187331,5004,2.6
24029,2020-02-01,10418,9919,499,4.8
24031,2020-02-01,570989,554831,16158,2.8
24033,2020-02-01,522032,503742,18290,3.5
24035,2020-02-01,28776,27853,923,3.2
24037,2020-02-01,59420,57558,1862,3.1
24039,2020-02-01,9036,8487,549,6.1
24041,2020-02-01,18554,17828,726,3.9
24043,2020-02-01,74971,71904,3067,4.1
24045,2020-02-01,50004,47492,2512,5
24047,2020-02-01,25609,23227,2382,9.3
24510,2020-02-01,287930,274563,13367,4.6
25001,2020-02-01,106373,100175,6198,5.8
25003,2020-02-01,63092,60505,2587,4.1
25005,2020-02-01,300346,287283,13063,4.3
25007,2020-02-01,8312,7736,576,6.9
25009,2020-02-01,423561,410274,13287,3.1
25011,2020-02-01,40921,39713,1208,3
25013,2020-02-01,225590,216109,9481,4.2
25015,2020-02-01,89591,87019,2572,2.9
25017,2020-02-01,917805,896564,21241,2.3
25019,2020-02-01,6232,5558,674,10.8
25021,2020-02-01,392848,382729,10119,2.6
25023,2020-02-01,283889,274267,9622,3.4
25025,2020-02-01,454991,443418,11573,2.5
25027,2020-02-01,444601,429599,15002,3.4
26001,2020-02-01,3764,3483,281,7.5
26003,2020-02-01,3083,2856,227,7.4
26005,2020-02-01,62373,60528,1845,3
26007,2020-02-01,13464,12851,613,4.6
26009,2020-02-01,9935,9362,573,5.8
26011,2020-02-01,5910,5477,433,7.3
26013,2020-02-01,3156,2957,199,6.3
26015,2020-02-01,32132,31118,1014,3.2
26017,2020-02-01,50086,47772,2314,4.6
26019,2020-02-01,8616,8096,520,6
26021,2020-02-01,73065,70286,2779,3.8
26023,2020-02-01,19221,18577,644,3.4
26025,2020-02-01,62071,59794,2277,3.7
26027,2020-02-01,24458,23490,968,4
26029,2020-02-01,12238,11594,644,5.3
26031,2020-02-01,9909,8462,1447,14.6
26033,2020-02-01,16126,15070,1056,6.5
26035,2020-02-01,11627,10871,756,6.5
26037,2020-02-01,41746,40684,1062,2.5
26039,2020-02-01,5494,5153,341,6.2
26041,2020-02-01,16759,15839,920,5.5
26043,2020-02-01,12048,11548,500,4.2
26045,2020-02-01,58310,56617,1693,2.9
26047,2020-02-01,16894,15804,1090,6.5
26049,2020-02-01,181229,173635,7594,4.2
26051,2020-02-01,9778,9214,564,5.8
26053,2020-02-01,6093,5829,264,4.3
26055,2020-02-01,48206,46458,1748,3.6
26057,2020-02-01,17975,17255,720,4
26059,2020-02-01,20173,19442,731,3.6
26061,2020-02-01,17009,16280,729,4.3
26063,2020-02-01,15099,14410,689,4.6
26065,2020-02-01,152968,148681,4287,2.8
26067,2020-02-01,30430,29527,903,3
26069,2020-02-01,10046,9339,707,7
26071,2020-02-01,4955,4659,296,6
26073,2020-02-01,34403,33148,1255,3.6
26075,2020-02-01,75272,72715,2557,3.4
26077,2020-02-01,135038,131313,3725,2.8
26079,2020-02-01,7785,7274,511,6.6
26081,2020-02-01,364306,355520,8786,2.4
26083,2020-02-01,929,879,50,5.4
26085,2020-02-01,3896,3663,233,6
26087,2020-02-01,41272,38737,2535,6.1
26089,2020-02-01,10117,9708,409,4
26091,2020-02-01,46195,44619,1576,3.4
26093,2020-02-01,103796,100449,3347,3.2
26095,2020-02-01,2181,2046,135,6.2
26097,2020-02-01,4415,3641,774,17.5
26099,2020-02-01,446756,429109,17647,4
26101,2020-02-01,9935,9332,603,6.1
26103,2020-02-01,32924,31355,1569,4.8
26105,2020-02-01,13051,12357,694,5.3
26107,2020-02-01,18892,18025,867,4.6
26109,2020-02-01,10730,10343,387,3.6
26111,2020-02-01,39708,38220,1488,3.7
26113,2020-02-01,6824,6460,364,5.3
26115,2020-02-01,75613,73191,2422,3.2
26117,2020-02-01,28444,27386,1058,3.7
26119,2020-02-01,3000,2720,280,9.3
26121,2020-02-01,76755,73808,2947,3.8
26123,2020-02-01,23299,22329,970,4.2
26125,2020-02-01,673128,652173,20955,3.1
26127,2020-02-01,11403,10623,780,6.8
26129,2020-02-01,7777,7167,610,7.8
26131,2020-02-01,2103,1978,125,5.9
26133,2020-02-01,11538,11096,442,3.8
26135,2020-02-01,2709,2518,191,7.1
26137,2020-02-01,11414,10842,572,5
26139,2020-02-01,162723,158961,3762,2.3
26141,2020-02-01,4863,4370,493,10.1
26143,2020-02-01,7407,6785,622,8.4
26145,2020-02-01,85924,82080,3844,4.5
26147,2020-02-01,75709,71920,3789,5
26149,2020-02-01,28244,27345,899,3.2
26151,2020-02-01,19262,18320,942,4.9
26153,2020-02-01,3223,2972,251,7.8
26155,2020-02-01,33470,32189,1281,3.8
26157,2020-02-01,23698,22470,1228,5.2
26159,2020-02-01,35456,33842,1614,4.6
26161,2020-02-01,201577,197138,4439,2.2
26163,2020-02-01,801197,763760,37437,4.7
26165,2020-02-01,14758,14070,688,4.7
27001,2020-02-01,7383,6802,581,7.9
27003,2020-02-01,201691,195036,6655,3.3
27005,2020-02-01,18884,17830,1054,5.6
27007,2020-02-01,24668,23423,1245,5
27009,2020-02-01,22302,21148,1154,5.2
27011,2020-02-01,2445,2295,150,6.1
27013,2020-02-01,41214,39978,1236,3
27015,2020-02-01,14173,13495,678,4.8
27017,2020-02-01,18255,17267,988,5.4
27019,2020-02-01,59832,58147,1685,2.8
27021,2020-02-01,14037,12943,1094,7.8
27023,2020-02-01,6680,6338,342,5.1
27025,2020-02-01,30919,29392,1527,4.9
27027,2020-02-01,36667,35429,1238,3.4
27029,2020-02-01,4517,3965,552,12.2
27031,2020-02-01,2908,2744,164,5.6
27033,2020-02-01,5903,5677,226,3.8
27035,2020-02-01,31941,30129,1812,5.7
27037,2020-02-01,246069,238854,7215,2.9
27039,2020-02-01,11942,11438,504,4.2
27041,2020-02-01,21059,20245,814,3.9
27043,2020-02-01,6844,6476,368,5.4
27045,2020-02-01,11499,10956,543,4.7
27047,2020-02-01,16063,15459,604,3.8
27049,2020-02-01,26945,25908,1037,3.8
27051,2020-02-01,3234,3044,190,5.9
27053,2020-02-01,715593,697156,18437,2.6
27055,2020-02-01,10493,10057,436,4.2
27057,2020-02-01,9678,8975,703,7.3
27059,2020-02-01,22092,20917,1175,5.3
27061,2020-02-01,22138,20575,1563,7.1
27063,2020-02-01,5562,5347,215,3.9
27065,2020-02-01,9303,8449,854,9.2
27067,2020-02-01,24163,23065,1098,4.5
27069,2020-02-01,2307,2201,106,4.6
27071,2020-02-01,5772,5416,356,6.2
27073,2020-02-01,3478,3276,202,5.8
27075,2020-02-01,5243,5016,227,4.3
27077,2020-02-01,2520,2421,99,3.9
27079,2020-02-01,16725,15646,1079,6.5
27081,2020-02-01,3013,2825,188,6.2
27083,2020-02-01,14162,13624,538,3.8
27085,2020-02-01,19256,18344,912,4.7
27087,2020-02-01,2338,2176,162,6.9
27089,2020-02-01,5305,4832,473,8.9
27091,2020-02-01,9728,9349,379,3.9
27093,2020-02-01,13285,12592,693,5.2
27095,2020-02-01,13410,12363,1047,7.8
27097,2020-02-01,17775,16418,1357,7.6
27099,2020-02-01,20635,19940,695,3.4
27101,2020-02-01,4603,4306,297,6.5
27103,2020-02-01,21159,20588,571,2.7
27105,2020-02-01,11229,10850,379,3.4
27107,2020-02-01,3118,2930,188,6
27109,2020-02-01,90104,87711,2393,2.7
27111,2020-02-01,30626,28864,1762,5.8
27113,2020-02-01,8754,8145,609,7
27115,2020-02-01,15157,13952,1205,8
27117,2020-02-01,4497,4262,235,5.2
27119,2020-02-01,16478,15720,758,4.6
27121,2020-02-01,6327,6083,244,3.9
27123,2020-02-01,292148,283661,8487,2.9
27125,2020-02-01,2228,2041,187,8.4
27127,2020-02-01,7456,7135,321,4.3
27129,2020-02-01,8223,7718,505,6.1
27131,2020-02-01,37667,36320,1347,3.6
27133,2020-02-01,5491,5351,140,2.5
27135,2020-02-01,7864,7464,400,5.1
27137,2020-02-01,103405,98867,4538,4.4
27139,2020-02-01,85344,82878,2466,2.9
27141,2020-02-01,53987,51635,2352,4.4
27143,2020-02-01,8392,7977,415,4.9
27145,2020-02-01,91276,87759,3517,3.9
27147,2020-02-01,20361,19609,752,3.7
27149,2020-02-01,5249,5079,170,3.2
27151,2020-02-01,4708,4448,260,5.5
27153,2020-02-01,13623,12892,731,5.4
27155,2020-02-01,1651,1561,90,5.5
27157,2020-02-01,12240,11704,536,4.4
27159,2020-02-01,6049,5538,511,8.4
27161,2020-02-01,8866,8413,453,5.1
27163,2020-02-01,146568,142238,4330,3
27165,2020-02-01,6361,6077,284,4.5
27167,2020-02-01,3346,3227,119,3.6
27169,2020-02-01,28419,27534,885,3.1
27171,2020-02-01,77908,74817,3091,4
27173,2020-02-01,5139,4907,232,4.5
28001,2020-02-01,10822,10072,750,6.9
28003,2020-02-01,16172,15431,741,4.6
28005,2020-02-01,4420,4115,305,6.9
28007,2020-02-01,6981,6527,454,6.5
28009,2020-02-01,3048,2862,186,6.1
28011,2020-02-01,11760,10876,884,7.5
28013,2020-02-01,5528,5212,316,5.7
28015,2020-02-01,3554,3330,224,6.3
28017,2020-02-01,6818,6467,351,5.1
28019,2020-02-01,3686,3482,204,5.5
28021,2020-02-01,3116,2811,305,9.8
28023,2020-02-01,5968,5594,374,6.3
28025,2020-02-01,7795,7226,569,7.3
28027,2020-02-01,8336,7646,690,8.3
28029,2020-02-01,11000,10314,686,6.2
28031,2020-02-01,8265,7856,409,4.9
28033,2020-02-01,92682,88784,3898,4.2
28035,2020-02-01,33081,31424,1657,5
28037,2020-02-01,2746,2563,183,6.7
28039,2020-02-01,8934,8283,651,7.3
28041,2020-02-01,4317,3963,354,8.2
28043,2020-02-01,9477,9019,458,4.8
28045,2020-02-01,19019,17991,1028,5.4
28047,2020-02-01,87622,83097,4525,5.2
28049,2020-02-01,104874,99410,5464,5.2
28051,2020-02-01,5580,5046,534,9.6
28053,2020-02-01,2182,1919,263,12.1
28055,2020-02-01,345,313,32,9.3
28057,2020-02-01,10642,10116,526,4.9
28059,2020-02-01,58912,55472,3440,5.8
28061,2020-02-01,6243,5750,493,7.9
28063,2020-02-01,1965,1685,280,14.2
28065,2020-02-01,4022,3732,290,7.2
28067,2020-02-01,26166,24762,1404,5.4
28069,2020-02-01,3457,3201,256,7.4
28071,2020-02-01,28551,27442,1109,3.9
28073,2020-02-01,31103,29771,1332,4.3
28075,2020-02-01,30419,28709,1710,5.6
28077,2020-02-01,4603,4320,283,6.1
28079,2020-02-01,8006,7565,441,5.5
28081,2020-02-01,41871,40099,1772,4.2
28083,2020-02-01,9952,9201,751,7.5
28085,2020-02-01,14499,13723,776,5.4
28087,2020-02-01,25876,24553,1323,5.1
28089,2020-02-01,53711,51407,2304,4.3
28091,2020-02-01,10074,9512,562,5.6
28093,2020-02-01,14401,13622,779,5.4
28095,2020-02-01,15736,14918,818,5.2
28097,2020-02-01,3953,3715,238,6
28099,2020-02-01,10189,9581,608,6
28101,2020-02-01,8269,7807,462,5.6
28103,2020-02-01,3746,3476,270,7.2
28105,2020-02-01,22930,21795,1135,4.9
28107,2020-02-01,12586,11783,803,6.4
28109,2020-02-01,23931,22712,1219,5.1
28111,2020-02-01,4309,4006,303,7
28113,2020-02-01,14443,13568,875,6.1
28115,2020-02-01,15142,14508,634,4.2
28117,2020-02-01,11363,10808,555,4.9
28119,2020-02-01,2288,2106,182,8
28121,2020-02-01,77006,73967,3039,3.9
28123,2020-02-01,12532,11972,560,4.5
28125,2020-02-01,1499,1352,147,9.8
28127,2020-02-01,10761,10177,584,5.4
28129,2020-02-01,6832,6452,380,5.6
28131,2020-02-01,7075,6681,394,5.6
28133,2020-02-01,7454,6740,714,9.6
28135,2020-02-01,5258,4910,348,6.6
28137,2020-02-01,12163,11509,654,5.4
28139,2020-02-01,9539,9093,446,4.7
28141,2020-02-01,8617,8123,494,5.7
28143,2020-02-01,4300,4033,267,6.2
28145,2020-02-01,14575,13971,604,4.1
28147,2020-02-01,5027,4705,322,6.4
28149,2020-02-01,20643,19563,1080,5.2
28151,2020-02-01,15989,14711,1278,8
28153,2020-02-01,7431,6959,472,6.4
28155,2020-02-01,3961,3727,234,5.9
28157,2020-02-01,2775,2503,272,9.8
28159,2020-02-01,7497,7055,442,5.9
28161,2020-02-01,5068,4807,261,5.1
28163,2020-02-01,9905,9278,627,6.3
29001,2020-02-01,10348,9954,394,3.8
29003,2020-02-01,9888,9553,335,3.4
29005,2020-02-01,2797,2708,89,3.2
29007,2020-02-01,10584,10136,448,4.2
29009,2020-02-01,15836,15133,703,4.4
29011,2020-02-01,5174,4997,177,3.4
29013,2020-02-01,7874,7511,363,4.6
29015,2020-02-01,7203,6723,480,6.7
29017,2020-02-01,5506,5259,247,4.5
29019,2020-02-01,99376,96780,2596,2.6
29021,2020-02-01,44212,42576,1636,3.7
29023,2020-02-01,18207,17357,850,4.7
29025,2020-02-01,4365,4188,177,4.1
29027,2020-02-01,21461,20699,762,3.6
29029,2020-02-01,18119,16849,1270,7
29031,2020-02-01,40899,39524,1375,3.4
29033,2020-02-01,4645,4467,178,3.8
29035,2020-02-01,2495,2325,170,6.8
29037,2020-02-01,55214,53232,1982,3.6
29039,2020-02-01,5774,5542,232,4
29041,2020-02-01,3803,3652,151,4
29043,2020-02-01,45974,44456,1518,3.3
29045,2020-02-01,3193,3037,156,4.9
29047,2020-02-01,137607,133363,4244,3.1
29049,2020-02-01,10683,10309,374,3.5
29051,2020-02-01,39156,37985,1171,3
29053,2020-02-01,7354,7039,315,4.3
29055,2020-02-01,10929,10396,533,4.9
29057,2020-02-01,3605,3469,136,3.8
29059,2020-02-01,7156,6819,337,4.7
29061,2020-02-01,4177,4017,160,3.8
29063,2020-02-01,4872,4670,202,4.1
29065,2020-02-01,6390,6129,261,4.1
29067,2020-02-01,4992,4738,254,5.1
29069,2020-02-01,11674,10858,816,7
29071,2020-02-01,53982,51837,2145,4
29073,2020-02-01,7666,7382,284,3.7
29075,2020-02-01,3459,3356,103,3
29077,2020-02-01,152291,147479,4812,3.2
29079,2020-02-01,4446,4284,162,3.6
29081,2020-02-01,3878,3676,202,5.2
29083,2020-02-01,9748,9300,448,4.6
29085,2020-02-01,3808,3606,202,5.3
29087,2020-02-01,2607,2525,82,3.1
29089,2020-02-01,4960,4788,172,3.5
29091,2020-02-01,16414,15722,692,4.2
29093,2020-02-01,3531,3322,209,5.9
29095,2020-02-01,362939,348066,14873,4.1
29097,2020-02-01,56208,54332,1876,3.3
29099,2020-02-01,119823,115194,4629,3.9
29101,2020-02-01,23544,22487,1057,4.5
29103,2020-02-01,1819,1728,91,5
29105,2020-02-01,16956,15894,1062,6.3
29107,2020-02-01,16960,16292,668,3.9
29109,2020-02-01,17861,17079,782,4.4
29111,2020-02-01,5039,4849,190,3.8
29113,2020-02-01,29384,28238,1146,3.9
29115,2020-02-01,5126,4840,286,5.6
29117,2020-02-01,7382,7143,239,3.2
29119,2020-02-01,10735,10366,369,3.4
29121,2020-02-01,7522,7201,321,4.3
29123,2020-02-01,5529,5272,257,4.6
29125,2020-02-01,3906,3756,150,3.8
29127,2020-02-01,14295,13787,508,3.6
29129,2020-02-01,1918,1836,82,4.3
29131,2020-02-01,12194,11484,710,5.8
29133,2020-02-01,5796,5532,264,4.6
29135,2020-02-01,7412,7136,276,3.7
29137,2020-02-01,3817,3618,199,5.2
29139,2020-02-01,5814,5589,225,3.9
29141,2020-02-01,8146,7648,498,6.1
29143,2020-02-01,8415,7993,422,5
29145,2020-02-01,26768,25800,968,3.6
29147,2020-02-01,11045,10671,374,3.4
29149,2020-02-01,3975,3770,205,5.2
29151,2020-02-01,7103,6916,187,2.6
29153,2020-02-01,3397,3187,210,6.2
29155,2020-02-01,6320,5936,384,6.1
29157,2020-02-01,9917,9601,316,3.2
29159,2020-02-01,21411,20038,1373,6.4
29161,2020-02-01,19906,19122,784,3.9
29163,2020-02-01,7625,7317,308,4
29165,2020-02-01,59167,57494,1673,2.8
29167,2020-02-01,14604,14092,512,3.5
29169,2020-02-01,14813,14189,624,4.2
29171,2020-02-01,2296,2205,91,4
29173,2020-02-01,5658,5441,217,3.8
29175,2020-02-01,10321,9860,461,4.5
29177,2020-02-01,11044,10612,432,3.9
29179,2020-02-01,2943,2808,135,4.6
29181,2020-02-01,4962,4708,254,5.1
29183,2020-02-01,230140,223428,6712,2.9
29185,2020-02-01,3684,3494,190,5.2
29186,2020-02-01,9212,8835,377,4.1
29187,2020-02-01,26643,25255,1388,5.2
29189,2020-02-01,534435,516676,17759,3.3
29195,2020-02-01,10965,10514,451,4.1
29197,2020-02-01,2010,1909,101,5
29199,2020-02-01,2372,2296,76,3.2
29201,2020-02-01,20036,19200,836,4.2
29203,2020-02-01,3318,3113,205,6.2
29205,2020-02-01,3108,2965,143,4.6
29207,2020-02-01,13385,12675,710,5.3
29209,2020-02-01,13094,11635,1459,11.1
29211,2020-02-01,2830,2699,131,4.6
29213,2020-02-01,25709,22423,3286,12.8
29215,2020-02-01,9006,8550,456,5.1
29217,2020-02-01,9538,9176,362,3.8
29219,2020-02-01,18681,17988,693,3.7
29221,2020-02-01,10415,9769,646,6.2
29223,2020-02-01,5139,4870,269,5.2
29225,2020-02-01,17614,16906,708,4
29227,2020-02-01,1171,1141,30,2.6
29229,2020-02-01,7382,6966,416,5.6
29510,2020-02-01,152634,146363,6271,4.1
30001,2020-02-01,5097,4921,176,3.5
30003,2020-02-01,4995,4645,350,7
30005,2020-02-01,2339,2231,108,4.6
30007,2020-02-01,2623,2491,132,5
30009,2020-02-01,5605,5352,253,4.5
30011,2020-02-01,671,657,14,2.1
30013,2020-02-01,38493,37050,1443,3.7
30015,2020-02-01,2521,2439,82,3.3
30017,2020-02-01,6281,6024,257,4.1
30019,2020-02-01,899,873,26,2.9
30021,2020-02-01,4648,4511,137,2.9
30023,2020-02-01,5043,4848,195,3.9
30025,2020-02-01,1704,1669,35,2.1
30027,2020-02-01,5778,5496,282,4.9
30029,2020-02-01,48739,45726,3013,6.2
30031,2020-02-01,70453,68675,1778,2.5
30033,2020-02-01,751,729,22,2.9
30035,2020-02-01,5582,5132,450,8.1
30037,2020-02-01,373,354,19,5.1
30039,2020-02-01,1703,1581,122,7.2
30041,2020-02-01,7743,7469,274,3.5
30043,2020-02-01,5812,5579,233,4
30045,2020-02-01,1055,1013,42,4
30047,2020-02-01,13586,12846,740,5.4
30049,2020-02-01,36481,35181,1300,3.6
30051,2020-02-01,976,949,27,2.8
30053,2020-02-01,8055,7260,795,9.9
30055,2020-02-01,953,934,19,2
30057,2020-02-01,5284,5079,205,3.9
30059,2020-02-01,1032,994,38,3.7
30061,2020-02-01,1743,1557,186,10.7
30063,2020-02-01,65224,62618,2606,4
30065,2020-02-01,2365,2235,130,5.5
30067,2020-02-01,8828,8430,398,4.5
30069,2020-02-01,276,262,14,5.1
30071,2020-02-01,1900,1814,86,4.5
30073,2020-02-01,2691,2600,91,3.4
30075,2020-02-01,963,935,28,2.9
30077,2020-02-01,2834,2710,124,4.4
30079,2020-02-01,463,437,26,5.6
30081,2020-02-01,20634,19599,1035,5
30083,2020-02-01,5908,5726,182,3.1
30085,2020-02-01,4501,4278,223,5
30087,2020-02-01,3769,3582,187,5
30089,2020-02-01,5011,4620,391,7.8
30091,2020-02-01,1792,1745,47,2.6
30093,2020-02-01,17364,16574,790,4.5
30095,2020-02-01,5397,5211,186,3.4
30097,2020-02-01,1819,1765,54,3
30099,2020-02-01,2792,2675,117,4.2
30101,2020-02-01,2095,2026,69,3.3
30103,2020-02-01,342,334,8,2.3
30105,2020-02-01,4054,3898,156,3.8
30107,2020-02-01,756,718,38,5
30109,2020-02-01,443,430,13,2.9
30111,2020-02-01,83609,80568,3041,3.6
31001,2020-02-01,16859,16303,556,3.3
31003,2020-02-01,3879,3782,97,2.5
31005,2020-02-01,231,218,13,5.6
31007,2020-02-01,388,377,11,2.8
31009,2020-02-01,261,250,11,4.2
31011,2020-02-01,2996,2912,84,2.8
31013,2020-02-01,5373,5209,164,3.1
31015,2020-02-01,1076,1044,32,3
31017,2020-02-01,1400,1356,44,3.1
31019,2020-02-01,28129,27413,716,2.5
31021,2020-02-01,3590,3447,143,4
31023,2020-02-01,4581,4467,114,2.5
31025,2020-02-01,13655,13177,478,3.5
31027,2020-02-01,4468,4350,118,2.6
31029,2020-02-01,2321,2275,46,2
31031,2020-02-01,3294,3212,82,2.5
31033,2020-02-01,4254,4109,145,3.4
31035,2020-02-01,3259,3154,105,3.2
31037,2020-02-01,5646,5507,139,2.5
31039,2020-02-01,4831,4709,122,2.5
31041,2020-02-01,6401,6260,141,2.2
31043,2020-02-01,10850,10355,495,4.6
31045,2020-02-01,5007,4889,118,2.4
31047,2020-02-01,13347,12932,415,3.1
31049,2020-02-01,952,929,23,2.4
31051,2020-02-01,3033,2936,97,3.2
31053,2020-02-01,20210,19637,573,2.8
31055,2020-02-01,301810,291768,10042,3.3
31057,2020-02-01,1175,1150,25,2.1
31059,2020-02-01,3190,3114,76,2.4
31061,2020-02-01,1505,1461,44,2.9
31063,2020-02-01,1606,1549,57,3.5
31065,2020-02-01,2567,2500,67,2.6
31067,2020-02-01,11032,10632,400,3.6
31069,2020-02-01,1063,1025,38,3.6
31071,2020-02-01,1172,1145,27,2.3
31073,2020-02-01,1061,1038,23,2.2
31075,2020-02-01,421,411,10,2.4
31077,2020-02-01,1241,1209,32,2.6
31079,2020-02-01,32065,30848,1217,3.8
31081,2020-02-01,4841,4700,141,2.9
31083,2020-02-01,1737,1689,48,2.8
31085,2020-02-01,624,605,19,3
31087,2020-02-01,1301,1255,46,3.5
31089,2020-02-01,5740,5591,149,2.6
31091,2020-02-01,376,363,13,3.5
31093,2020-02-01,3371,3272,99,2.9
31095,2020-02-01,4179,4063,116,2.8
31097,2020-02-01,2083,2001,82,3.9
31099,2020-02-01,3833,3747,86,2.2
31101,2020-02-01,4500,4371,129,2.9
31103,2020-02-01,620,607,13,2.1
31105,2020-02-01,1984,1925,59,3
31107,2020-02-01,4644,4482,162,3.5
31109,2020-02-01,179779,174954,4825,2.7
31111,2020-02-01,18241,17634,607,3.3
31113,2020-02-01,476,465,11,2.3
31115,2020-02-01,414,397,17,4.1
31117,2020-02-01,451,434,17,3.8
31119,2020-02-01,19767,19165,602,3
31121,2020-02-01,4055,3941,114,2.8
31123,2020-02-01,2623,2526,97,3.7
31125,2020-02-01,1971,1914,57,2.9
31127,2020-02-01,3679,3569,110,3
31129,2020-02-01,2491,2409,82,3.3
31131,2020-02-01,8345,8101,244,2.9
31133,2020-02-01,1508,1476,32,2.1
31135,2020-02-01,1852,1814,38,2.1
31137,2020-02-01,5026,4908,118,2.3
31139,2020-02-01,4089,3973,116,2.8
31141,2020-02-01,17823,17322,501,2.8
31143,2020-02-01,2954,2855,99,3.4
31145,2020-02-01,5885,5717,168,2.9
31147,2020-02-01,4271,4147,124,2.9
31149,2020-02-01,886,867,19,2.1
31151,2020-02-01,7511,7246,265,3.5
31153,2020-02-01,97941,95074,2867,2.9
31155,2020-02-01,11360,11034,326,2.9
31157,2020-02-01,18219,17556,663,3.6
31159,2020-02-01,9022,8778,244,2.7
31161,2020-02-01,2759,2690,69,2.5
31163,2020-02-01,1678,1621,57,3.4
31165,2020-02-01,752,737,15,2
31167,2020-02-01,3524,3429,95,2.7
31169,2020-02-01,2765,2700,65,2.4
31171,2020-02-01,444,423,21,4.7
31173,2020-02-01,3062,2944,118,3.9
31175,2020-02-01,2157,2094,63,2.9
31177,2020-02-01,11344,10999,345,3
31179,2020-02-01,5936,5797,139,2.3
31181,2020-02-01,1688,1621,67,4
31183,2020-02-01,530,517,13,2.5
31185,2020-02-01,7289,7099,190,2.6
32001,2020-02-01,11562,11165,397,3.4
32003,2020-02-01,NA,NA,43266,3.6
32005,2020-02-01,23909,23005,904,3.8
32007,2020-02-01,27973,27131,842,3
32009,2020-02-01,440,423,17,3.9
32011,2020-02-01,1139,1115,24,2.1
32013,2020-02-01,8475,8214,261,3.1
32015,2020-02-01,3294,3179,115,3.5
32017,2020-02-01,2137,2060,77,3.6
32019,2020-02-01,23932,22801,1131,4.7
32021,2020-02-01,2230,2154,76,3.4
32023,2020-02-01,18366,17519,847,4.6
32027,2020-02-01,2687,2580,107,4
32029,2020-02-01,2139,2062,77,3.6
32031,2020-02-01,265585,257456,8129,3.1
32033,2020-02-01,4759,4609,150,3.2
32510,2020-02-01,27058,26003,1055,3.9
33001,2020-02-01,30954,30017,937,3
33003,2020-02-01,23587,22866,721,3.1
33005,2020-02-01,40901,39663,1238,3
33007,2020-02-01,14499,13911,588,4.1
33009,2020-02-01,49745,48499,1246,2.5
33011,2020-02-01,243906,236464,7442,3.1
33013,2020-02-01,84112,81979,2133,2.5
33015,2020-02-01,187853,181816,6037,3.2
33017,2020-02-01,75049,73050,1999,2.7
33019,2020-02-01,23104,22500,604,2.6
34001,2020-02-01,122716,115411,7305,6
34003,2020-02-01,495624,479815,15809,3.2
34005,2020-02-01,236492,228161,8331,3.5
34007,2020-02-01,259508,248370,11138,4.3
34009,2020-02-01,41003,36194,4809,11.7
34011,2020-02-01,66545,62276,4269,6.4
34013,2020-02-01,378802,360940,17862,4.7
34015,2020-02-01,154016,147756,6260,4.1
34017,2020-02-01,370740,358029,12711,3.4
34019,2020-02-01,66051,63939,2112,3.2
34021,2020-02-01,208602,201511,7091,3.4
34023,2020-02-01,444620,429558,15062,3.4
34025,2020-02-01,333733,321806,11927,3.6
34027,2020-02-01,262681,254502,8179,3.1
34029,2020-02-01,283859,271583,12276,4.3
34031,2020-02-01,249891,237987,11904,4.8
34033,2020-02-01,29520,27889,1631,5.5
34035,2020-02-01,174954,169197,5757,3.3
34037,2020-02-01,76091,72934,3157,4.1
34039,2020-02-01,283576,272071,11505,4.1
34041,2020-02-01,56990,54729,2261,4
35001,2020-02-01,338477,323239,15238,4.5
35003,2020-02-01,1119,1025,94,8.4
35005,2020-02-01,27936,26591,1345,4.8
35006,2020-02-01,8992,8404,588,6.5
35007,2020-02-01,5360,5106,254,4.7
35009,2020-02-01,22371,21494,877,3.9
35011,2020-02-01,704,674,30,4.3
35013,2020-02-01,99621,93351,6270,6.3
35015,2020-02-01,35801,34645,1156,3.2
35017,2020-02-01,12351,11751,600,4.9
35019,2020-02-01,1529,1458,71,4.6
35021,2020-02-01,277,266,11,4
35023,2020-02-01,1958,1861,97,5
35025,2020-02-01,31253,29873,1380,4.4
35027,2020-02-01,8779,8335,444,5.1
35028,2020-02-01,9826,9513,313,3.2
35029,2020-02-01,10250,8501,1749,17.1
35031,2020-02-01,24521,22798,1723,7
35033,2020-02-01,2093,1942,151,7.2
35035,2020-02-01,26019,24727,1292,5
35037,2020-02-01,3137,2969,168,5.4
35039,2020-02-01,16793,15832,961,5.7
35041,2020-02-01,8072,7726,346,4.3
35043,2020-02-01,67710,64436,3274,4.8
35045,2020-02-01,51736,48451,3285,6.3
35047,2020-02-01,10948,10304,644,5.9
35049,2020-02-01,74509,71410,3099,4.2
35051,2020-02-01,4036,3711,325,8.1
35053,2020-02-01,6383,6037,346,5.4
35055,2020-02-01,16074,15104,970,6
35057,2020-02-01,5436,5052,384,7.1
35059,2020-02-01,1659,1588,71,4.3
35061,2020-02-01,31083,29404,1679,5.4
36001,2020-02-01,156143,150229,5914,3.8
36003,2020-02-01,19742,18479,1263,6.4
36005,2020-02-01,602802,571870,30932,5.1
36007,2020-02-01,82237,77650,4587,5.6
36009,2020-02-01,34202,32074,2128,6.2
36011,2020-02-01,35304,33467,1837,5.2
36013,2020-02-01,53454,50370,3084,5.8
36015,2020-02-01,35230,33543,1687,4.8
36017,2020-02-01,21816,20587,1229,5.6
36019,2020-02-01,35793,33944,1849,5.2
36021,2020-02-01,30417,29247,1170,3.8
36023,2020-02-01,23233,21847,1386,6
36025,2020-02-01,18836,17788,1048,5.6
36027,2020-02-01,143699,138032,5667,3.9
36029,2020-02-01,439077,418038,21039,4.8
36031,2020-02-01,17005,15978,1027,6
36033,2020-02-01,19388,18261,1127,5.8
36035,2020-02-01,22458,21126,1332,5.9
36037,2020-02-01,29181,27723,1458,5
36039,2020-02-01,20551,19506,1045,5.1
36041,2020-02-01,2105,1918,187,8.9
36043,2020-02-01,27685,26039,1646,5.9
36045,2020-02-01,42713,39615,3098,7.3
36047,2020-02-01,NA,NA,46640,3.9
36049,2020-02-01,11630,10744,886,7.6
36051,2020-02-01,30440,28889,1551,5.1
36053,2020-02-01,32599,30873,1726,5.3
36055,2020-02-01,358822,342837,15985,4.5
36057,2020-02-01,22044,20671,1373,6.2
36059,2020-02-01,700532,675192,25340,3.6
36061,2020-02-01,929638,898784,30854,3.3
36063,2020-02-01,98213,92407,5806,5.9
36065,2020-02-01,100129,95477,4652,4.6
36067,2020-02-01,218303,208746,9557,4.4
36069,2020-02-01,55132,52610,2522,4.6
36071,2020-02-01,186040,178441,7599,4.1
36073,2020-02-01,17328,16356,972,5.6
36075,2020-02-01,52555,49118,3437,6.5
36077,2020-02-01,27654,26192,1462,5.3
36079,2020-02-01,50797,48736,2061,4.1
36081,2020-02-01,NA,NA,38025,3.3
36083,2020-02-01,80712,77324,3388,4.2
36085,2020-02-01,226432,218171,8261,3.6
36087,2020-02-01,155144,149386,5758,3.7
36089,2020-02-01,43045,40366,2679,6.2
36091,2020-02-01,118663,114246,4417,3.7
36093,2020-02-01,75855,72763,3092,4.1
36095,2020-02-01,14678,13789,889,6.1
36097,2020-02-01,7960,7446,514,6.5
36099,2020-02-01,15552,14777,775,5
36101,2020-02-01,42278,39925,2353,5.6
36103,2020-02-01,769711,737927,31784,4.1
36105,2020-02-01,35790,34072,1718,4.8
36107,2020-02-01,22339,21176,1163,5.2
36109,2020-02-01,49853,48053,1800,3.6
36111,2020-02-01,86748,83103,3645,4.2
36113,2020-02-01,30435,28755,1680,5.5
36115,2020-02-01,27078,25734,1344,5
36117,2020-02-01,43597,41409,2188,5
36119,2020-02-01,484307,465279,19028,3.9
36121,2020-02-01,17730,16644,1086,6.1
36123,2020-02-01,11817,11221,596,5
37001,2020-02-01,83244,80507,2737,3.3
37003,2020-02-01,18116,17616,500,2.8
37005,2020-02-01,4412,4204,208,4.7
37007,2020-02-01,10890,10441,449,4.1
37009,2020-02-01,13209,12752,457,3.5
37011,2020-02-01,7485,7221,264,3.5
37013,2020-02-01,19968,19175,793,4
37015,2020-02-01,7955,7578,377,4.7
37017,2020-02-01,15047,14400,647,4.3
37019,2020-02-01,53376,50748,2628,4.9
37021,2020-02-01,141648,137842,3806,2.7
37023,2020-02-01,41134,39804,1330,3.2
37025,2020-02-01,111870,108374,3496,3.1
37027,2020-02-01,36619,35400,1219,3.3
37029,2020-02-01,4768,4611,157,3.3
37031,2020-02-01,32118,30919,1199,3.7
37033,2020-02-01,9986,9594,392,3.9
37035,2020-02-01,79434,76927,2507,3.2
37037,2020-02-01,37172,36056,1116,3
37039,2020-02-01,11369,10920,449,3.9
37041,2020-02-01,5641,5420,221,3.9
37043,2020-02-01,4245,4086,159,3.7
37045,2020-02-01,49717,47941,1776,3.6
37047,2020-02-01,22835,21787,1048,4.6
37049,2020-02-01,41932,40497,1435,3.4
37051,2020-02-01,129001,123162,5839,4.5
37053,2020-02-01,14458,13949,509,3.5
37055,2020-02-01,18345,17059,1286,7
37057,2020-02-01,82021,79293,2728,3.3
37059,2020-02-01,20869,20243,626,3
37061,2020-02-01,26198,25302,896,3.4
37063,2020-02-01,176822,171757,5065,2.9
37065,2020-02-01,21027,19990,1037,4.9
37067,2020-02-01,190397,184255,6142,3.2
37069,2020-02-01,32185,31058,1127,3.5
37071,2020-02-01,112166,108201,3965,3.5
37073,2020-02-01,5331,5143,188,3.5
37075,2020-02-01,3087,2907,180,5.8
37077,2020-02-01,30618,29722,896,2.9
37079,2020-02-01,9959,9648,311,3.1
37081,2020-02-01,265229,255771,9458,3.6
37083,2020-02-01,20603,19489,1114,5.4
37085,2020-02-01,54455,52356,2099,3.9
37087,2020-02-01,30158,29201,957,3.2
37089,2020-02-01,55523,53827,1696,3.1
37091,2020-02-01,9352,8926,426,4.6
37093,2020-02-01,20364,19458,906,4.4
37095,2020-02-01,1798,1582,216,12
37097,2020-02-01,91454,88482,2972,3.2
37099,2020-02-01,20130,19380,750,3.7
37101,2020-02-01,102188,98979,3209,3.1
37103,2020-02-01,4378,4235,143,3.3
37105,2020-02-01,26868,25888,980,3.6
37107,2020-02-01,28533,27607,926,3.2
37109,2020-02-01,44877,43460,1417,3.2
37111,2020-02-01,21021,20307,714,3.4
37113,2020-02-01,15657,15069,588,3.8
37115,2020-02-01,10170,9836,334,3.3
37117,2020-02-01,9227,8844,383,4.2
37119,2020-02-01,632001,611859,20142,3.2
37121,2020-02-01,6135,5865,270,4.4
37123,2020-02-01,11734,11338,396,3.4
37125,2020-02-01,42455,41028,1427,3.4
37127,2020-02-01,43446,41650,1796,4.1
37129,2020-02-01,125159,121209,3950,3.2
37131,2020-02-01,7869,7473,396,5
37133,2020-02-01,65517,62961,2556,3.9
37135,2020-02-01,81841,79467,2374,2.9
37137,2020-02-01,5437,5265,172,3.2
37139,2020-02-01,16993,16290,703,4.1
37141,2020-02-01,29345,28336,1009,3.4
37143,2020-02-01,5053,4840,213,4.2
37145,2020-02-01,18770,18095,675,3.6
37147,2020-02-01,90886,87691,3195,3.5
37149,2020-02-01,9265,8973,292,3.2
37151,2020-02-01,66757,64577,2180,3.3
37153,2020-02-01,16985,16169,816,4.8
37155,2020-02-01,51141,48782,2359,4.6
37157,2020-02-01,40499,38921,1578,3.9
37159,2020-02-01,66877,64415,2462,3.7
37161,2020-02-01,25255,24112,1143,4.5
37163,2020-02-01,30009,28988,1021,3.4
37165,2020-02-01,11619,10903,716,6.2
37167,2020-02-01,30810,29773,1037,3.4
37169,2020-02-01,21963,21255,708,3.2
37171,2020-02-01,33875,32743,1132,3.3
37173,2020-02-01,6924,6631,293,4.2
37175,2020-02-01,14736,14279,457,3.1
37177,2020-02-01,1310,1222,88,6.7
37179,2020-02-01,126336,122525,3811,3
37181,2020-02-01,17302,16422,880,5.1
37183,2020-02-01,604457,586807,17650,2.9
37185,2020-02-01,6626,6295,331,5
37187,2020-02-01,4527,4262,265,5.9
37189,2020-02-01,29816,28964,852,2.9
37191,2020-02-01,52787,50910,1877,3.6
37193,2020-02-01,29267,28196,1071,3.7
37195,2020-02-01,35525,33811,1714,4.8
37197,2020-02-01,17965,17408,557,3.1
37199,2020-02-01,8462,8152,310,3.7
38001,2020-02-01,1003,971,32,3.2
38003,2020-02-01,5184,5047,137,2.6
38005,2020-02-01,2278,2171,107,4.7
38007,2020-02-01,381,371,10,2.6
38009,2020-02-01,2849,2726,123,4.3
38011,2020-02-01,1601,1568,33,2.1
38013,2020-02-01,998,966,32,3.2
38015,2020-02-01,49666,48215,1451,2.9
38017,2020-02-01,104505,102094,2411,2.3
38019,2020-02-01,1861,1795,66,3.5
38021,2020-02-01,2238,2193,45,2
38023,2020-02-01,1393,1374,19,1.4
38025,2020-02-01,3244,3189,55,1.7
38027,2020-02-01,1184,1128,56,4.7
38029,2020-02-01,1437,1356,81,5.6
38031,2020-02-01,1501,1457,44,2.9
38033,2020-02-01,837,821,16,1.9
38035,2020-02-01,37023,36145,878,2.4
38037,2020-02-01,1146,1114,32,2.8
38039,2020-02-01,999,976,23,2.3
38041,2020-02-01,1323,1287,36,2.7
38043,2020-02-01,1247,1179,68,5.5
38045,2020-02-01,2000,1950,50,2.5
38047,2020-02-01,831,799,32,3.9
38049,2020-02-01,3021,2864,157,5.2
38051,2020-02-01,1071,1035,36,3.4
38053,2020-02-01,10009,9789,220,2.2
38055,2020-02-01,4645,4442,203,4.4
38057,2020-02-01,3514,3323,191,5.4
38059,2020-02-01,16501,15865,636,3.9
38061,2020-02-01,7086,6959,127,1.8
38063,2020-02-01,1357,1303,54,4
38065,2020-02-01,875,824,51,5.8
38067,2020-02-01,3262,3124,138,4.2
38069,2020-02-01,1657,1591,66,4
38071,2020-02-01,5579,5390,189,3.4
38073,2020-02-01,2793,2730,63,2.3
38075,2020-02-01,1203,1161,42,3.5
38077,2020-02-01,8396,8182,214,2.5
38079,2020-02-01,4600,4196,404,8.8
38081,2020-02-01,2705,2661,44,1.6
38083,2020-02-01,672,619,53,7.9
38085,2020-02-01,1177,1140,37,3.1
38087,2020-02-01,391,382,9,2.3
38089,2020-02-01,18526,18058,468,2.5
38091,2020-02-01,923,906,17,1.8
38093,2020-02-01,10377,10104,273,2.6
38095,2020-02-01,1091,1062,29,2.7
38097,2020-02-01,4335,4215,120,2.8
38099,2020-02-01,4976,4801,175,3.5
38101,2020-02-01,31614,30630,984,3.1
38103,2020-02-01,1868,1779,89,4.8
38105,2020-02-01,24269,23749,520,2.1
39001,2020-02-01,11143,10161,982,8.8
39003,2020-02-01,48403,45946,2457,5.1
39005,2020-02-01,27128,25762,1366,5
39007,2020-02-01,44929,42104,2825,6.3
39009,2020-02-01,29852,28172,1680,5.6
39011,2020-02-01,25084,24139,945,3.8
39013,2020-02-01,29596,27125,2471,8.3
39015,2020-02-01,19906,18609,1297,6.5
39017,2020-02-01,197073,188685,8388,4.3
39019,2020-02-01,13160,12281,879,6.7
39021,2020-02-01,20239,19341,898,4.4
39023,2020-02-01,63697,60358,3339,5.2
39025,2020-02-01,108353,103591,4762,4.4
39027,2020-02-01,17952,16948,1004,5.6
39029,2020-02-01,47951,45039,2912,6.1
39031,2020-02-01,14286,13260,1026,7.2
39033,2020-02-01,18557,17530,1027,5.5
39035,2020-02-01,625450,591209,34241,5.5
39037,2020-02-01,26172,24956,1216,4.6
39039,2020-02-01,18109,17225,884,4.9
39041,2020-02-01,113435,109525,3910,3.4
39043,2020-02-01,36470,34214,2256,6.2
39045,2020-02-01,79821,76367,3454,4.3
39047,2020-02-01,14251,13618,633,4.4
39049,2020-02-01,705958,678678,27280,3.9
39051,2020-02-01,22925,21684,1241,5.4
39053,2020-02-01,12658,11746,912,7.2
39055,2020-02-01,50347,47906,2441,4.8
39057,2020-02-01,84444,80988,3456,4.1
39059,2020-02-01,18648,17162,1486,8
39061,2020-02-01,419233,401640,17593,4.2
39063,2020-02-01,42470,40956,1514,3.6
39065,2020-02-01,14317,13619,698,4.9
39067,2020-02-01,6847,6343,504,7.4
39069,2020-02-01,13170,12324,846,6.4
39071,2020-02-01,17399,16278,1121,6.4
39073,2020-02-01,13261,12464,797,6
39075,2020-02-01,21192,20464,728,3.4
39077,2020-02-01,28252,25917,2335,8.3
39079,2020-02-01,13315,12225,1090,8.2
39081,2020-02-01,28025,25983,2042,7.3
39083,2020-02-01,32033,30558,1475,4.6
39085,2020-02-01,130093,123288,6805,5.2
39087,2020-02-01,24223,22739,1484,6.1
39089,2020-02-01,92046,88085,3961,4.3
39091,2020-02-01,22833,21814,1019,4.5
39093,2020-02-01,158941,149604,9337,5.9
39095,2020-02-01,212085,201000,11085,5.2
39097,2020-02-01,21260,20417,843,4
39099,2020-02-01,103215,96382,6833,6.6
39101,2020-02-01,28502,27217,1285,4.5
39103,2020-02-01,100653,95998,4655,4.6
39105,2020-02-01,9399,8545,854,9.1
39107,2020-02-01,23666,22902,764,3.2
39109,2020-02-01,55217,52809,2408,4.4
39111,2020-02-01,5609,4976,633,11.3
39113,2020-02-01,254513,242605,11908,4.7
39115,2020-02-01,6931,6279,652,9.4
39117,2020-02-01,17191,16296,895,5.2
39119,2020-02-01,40958,38314,2644,6.5
39121,2020-02-01,4733,4289,444,9.4
39123,2020-02-01,20340,18582,1758,8.6
39125,2020-02-01,9042,8548,494,5.5
39127,2020-02-01,16348,15219,1129,6.9
39129,2020-02-01,27047,25724,1323,4.9
39131,2020-02-01,10912,10020,892,8.2
39133,2020-02-01,88490,83938,4552,5.1
39135,2020-02-01,21513,20509,1004,4.7
39137,2020-02-01,18949,18199,750,4
39139,2020-02-01,52925,50058,2867,5.4
39141,2020-02-01,35946,33938,2008,5.6
39143,2020-02-01,30552,28917,1635,5.4
39145,2020-02-01,29878,27496,2382,8
39147,2020-02-01,27453,26091,1362,5
39149,2020-02-01,24105,23075,1030,4.3
39151,2020-02-01,187450,177071,10379,5.5
39153,2020-02-01,275787,261943,13844,5
39155,2020-02-01,86945,80803,6142,7.1
39157,2020-02-01,44962,42384,2578,5.7
39159,2020-02-01,29881,28798,1083,3.6
39161,2020-02-01,15058,14350,708,4.7
39163,2020-02-01,5782,5280,502,8.7
39165,2020-02-01,121262,116529,4733,3.9
39167,2020-02-01,27437,25468,1969,7.2
39169,2020-02-01,62630,60225,2405,3.8
39171,2020-02-01,19131,18375,756,4
39173,2020-02-01,72077,69129,2948,4.1
39175,2020-02-01,13267,12763,504,3.8
40001,2020-02-01,8211,7897,314,3.8
40003,2020-02-01,2779,2716,63,2.3
40005,2020-02-01,5100,4865,235,4.6
40007,2020-02-01,2683,2632,51,1.9
40009,2020-02-01,10113,9687,426,4.2
40011,2020-02-01,4461,4344,117,2.6
40013,2020-02-01,22098,21480,618,2.8
40015,2020-02-01,11960,11520,440,3.7
40017,2020-02-01,76447,74290,2157,2.8
40019,2020-02-01,21303,20565,738,3.5
40021,2020-02-01,19193,18496,697,3.6
40023,2020-02-01,5465,5190,275,5
40025,2020-02-01,1321,1300,21,1.6
40027,2020-02-01,144074,140419,3655,2.5
40029,2020-02-01,2299,2194,105,4.6
40031,2020-02-01,48383,46880,1503,3.1
40033,2020-02-01,2667,2599,68,2.5
40035,2020-02-01,5761,5549,212,3.7
40037,2020-02-01,31549,30440,1109,3.5
40039,2020-02-01,15299,14845,454,3
40041,2020-02-01,18298,17654,644,3.5
40043,2020-02-01,2766,2695,71,2.6
40045,2020-02-01,2091,2041,50,2.4
40047,2020-02-01,26724,25895,829,3.1
40049,2020-02-01,12778,12329,449,3.5
40051,2020-02-01,26762,25875,887,3.3
40053,2020-02-01,2741,2683,58,2.1
40055,2020-02-01,1793,1726,67,3.7
40057,2020-02-01,1163,1132,31,2.7
40059,2020-02-01,1759,1718,41,2.3
40061,2020-02-01,4199,3956,243,5.8
40063,2020-02-01,5368,5094,274,5.1
40065,2020-02-01,10539,10251,288,2.7
40067,2020-02-01,2492,2405,87,3.5
40069,2020-02-01,3711,3536,175,4.7
40071,2020-02-01,18144,17437,707,3.9
40073,2020-02-01,8960,8766,194,2.2
40075,2020-02-01,3382,3277,105,3.1
40077,2020-02-01,3144,2913,231,7.3
40079,2020-02-01,18968,18117,851,4.5
40081,2020-02-01,15787,15260,527,3.3
40083,2020-02-01,22474,21844,630,2.8
40085,2020-02-01,6488,6345,143,2.2
40087,2020-02-01,19923,19393,530,2.7
40089,2020-02-01,14784,14010,774,5.2
40091,2020-02-01,7142,6669,473,6.6
40093,2020-02-01,3673,3593,80,2.2
40095,2020-02-01,6746,6509,237,3.5
40097,2020-02-01,19426,18862,564,2.9
40099,2020-02-01,6213,6021,192,3.1
40101,2020-02-01,29338,28250,1088,3.7
40103,2020-02-01,5547,5407,140,2.5
40105,2020-02-01,4562,4422,140,3.1
40107,2020-02-01,4422,4188,234,5.3
40109,2020-02-01,387225,376258,10967,2.8
40111,2020-02-01,15720,14995,725,4.6
40113,2020-02-01,20641,19898,743,3.6
40115,2020-02-01,14477,14050,427,2.9
40117,2020-02-01,7343,7072,271,3.7
40119,2020-02-01,38324,37288,1036,2.7
40121,2020-02-01,17039,16293,746,4.4
40123,2020-02-01,19268,18717,551,2.9
40125,2020-02-01,32779,31680,1099,3.4
40127,2020-02-01,4456,4225,231,5.2
40129,2020-02-01,1826,1766,60,3.3
40131,2020-02-01,45322,43976,1346,3
40133,2020-02-01,9382,8939,443,4.7
40135,2020-02-01,16353,15672,681,4.2
40137,2020-02-01,19029,18217,812,4.3
40139,2020-02-01,11213,11011,202,1.8
40141,2020-02-01,3007,2909,98,3.3
40143,2020-02-01,324801,315048,9753,3
40145,2020-02-01,38537,37353,1184,3.1
40147,2020-02-01,22304,21591,713,3.2
40149,2020-02-01,5081,4877,204,4
40151,2020-02-01,4596,4516,80,1.7
40153,2020-02-01,8919,8634,285,3.2
41001,2020-02-01,7071,6717,354,5
41003,2020-02-01,48084,46769,1315,2.7
41005,2020-02-01,220408,213402,7006,3.2
41007,2020-02-01,18758,18047,711,3.8
41009,2020-02-01,24504,23439,1065,4.3
41011,2020-02-01,26286,25120,1166,4.4
41013,2020-02-01,9938,9419,519,5.2
41015,2020-02-01,8777,8327,450,5.1
41017,2020-02-01,97069,93301,3768,3.9
41019,2020-02-01,46589,44440,2149,4.6
41021,2020-02-01,945,897,48,5.1
41023,2020-02-01,3091,2816,275,8.9
41025,2020-02-01,3487,3280,207,5.9
41027,2020-02-01,13712,13321,391,2.9
41029,2020-02-01,104010,99629,4381,4.2
41031,2020-02-01,10070,9517,553,5.5
41033,2020-02-01,35570,33841,1729,4.9
41035,2020-02-01,29096,27037,2059,7.1
41037,2020-02-01,3533,3357,176,5
41039,2020-02-01,182468,175716,6752,3.7
41041,2020-02-01,20422,19520,902,4.4
41043,2020-02-01,58710,56309,2401,4.1
41045,2020-02-01,12227,11707,520,4.3
41047,2020-02-01,161310,155165,6145,3.8
41049,2020-02-01,5605,5354,251,4.5
41051,2020-02-01,456257,442203,14054,3.1
41053,2020-02-01,40106,38583,1523,3.8
41055,2020-02-01,935,891,44,4.7
41057,2020-02-01,11638,11180,458,3.9
41059,2020-02-01,35922,34163,1759,4.9
41061,2020-02-01,11958,11331,627,5.2
41063,2020-02-01,3273,3043,230,7
41065,2020-02-01,12425,11870,555,4.5
41067,2020-02-01,327134,317980,9154,2.8
41069,2020-02-01,712,686,26,3.7
41071,2020-02-01,54775,52996,1779,3.2
42001,2020-02-01,55990,53924,2066,3.7
42003,2020-02-01,648883,618617,30266,4.7
42005,2020-02-01,32559,30238,2321,7.1
42007,2020-02-01,84385,79547,4838,5.7
42009,2020-02-01,23672,22090,1582,6.7
42011,2020-02-01,216029,205296,10733,5
42013,2020-02-01,59529,56384,3145,5.3
42015,2020-02-01,28399,26829,1570,5.5
42017,2020-02-01,347646,332413,15233,4.4
42019,2020-02-01,100422,95532,4890,4.9
42021,2020-02-01,57708,54035,3673,6.4
42023,2020-02-01,2033,1872,161,7.9
42025,2020-02-01,32438,30458,1980,6.1
42027,2020-02-01,81503,78422,3081,3.8
42029,2020-02-01,288545,278662,9883,3.4
42031,2020-02-01,17335,16238,1097,6.3
42033,2020-02-01,36239,33718,2521,7
42035,2020-02-01,18267,17019,1248,6.8
42037,2020-02-01,34066,32186,1880,5.5
42039,2020-02-01,38751,36465,2286,5.9
42041,2020-02-01,132830,127826,5004,3.8
42043,2020-02-01,144663,138230,6433,4.4
42045,2020-02-01,302818,289645,13173,4.4
42047,2020-02-01,15495,14483,1012,6.5
42049,2020-02-01,130076,122724,7352,5.7
42051,2020-02-01,57576,53084,4492,7.8
42053,2020-02-01,1794,1626,168,9.4
42055,2020-02-01,78137,74490,3647,4.7
42057,2020-02-01,7941,7314,627,7.9
42059,2020-02-01,16684,15589,1095,6.6
42061,2020-02-01,20192,18513,1679,8.3
42063,2020-02-01,39278,36849,2429,6.2
42065,2020-02-01,20235,18968,1267,6.3
42067,2020-02-01,12784,12074,710,5.6
42069,2020-02-01,105734,99894,5840,5.5
42071,2020-02-01,286859,275811,11048,3.9
42073,2020-02-01,40881,37839,3042,7.4
42075,2020-02-01,72749,69470,3279,4.5
42077,2020-02-01,194540,185100,9440,4.9
42079,2020-02-01,159594,149157,10437,6.5
42081,2020-02-01,57026,53599,3427,6
42083,2020-02-01,17435,16185,1250,7.2
42085,2020-02-01,48748,45889,2859,5.9
42087,2020-02-01,21146,19917,1229,5.8
42089,2020-02-01,84009,78832,5177,6.2
42091,2020-02-01,459668,442119,17549,3.8
42093,2020-02-01,9282,8923,359,3.9
42095,2020-02-01,162823,154739,8084,5
42097,2020-02-01,42703,39859,2844,6.7
42099,2020-02-01,24609,23463,1146,4.7
42101,2020-02-01,737799,694749,43050,5.8
42103,2020-02-01,25585,23910,1675,6.5
42105,2020-02-01,7208,6564,644,8.9
42107,2020-02-01,66704,62702,4002,6
42109,2020-02-01,19959,18814,1145,5.7
42111,2020-02-01,33810,31471,2339,6.9
42113,2020-02-01,2576,2399,177,6.9
42115,2020-02-01,20370,19156,1214,6
42117,2020-02-01,19248,17895,1353,7
42119,2020-02-01,20111,19260,851,4.2
42121,2020-02-01,22376,20909,1467,6.6
42123,2020-02-01,18754,17623,1131,6
42125,2020-02-01,107664,101675,5989,5.6
42127,2020-02-01,22130,20613,1517,6.9
42129,2020-02-01,181602,171524,10078,5.5
42131,2020-02-01,13685,12851,834,6.1
42133,2020-02-01,235990,225644,10346,4.4
44001,2020-02-01,26155,25232,923,3.5
44003,2020-02-01,92000,88382,3618,3.9
44005,2020-02-01,44683,42827,1856,4.2
44007,2020-02-01,330425,315573,14852,4.5
44009,2020-02-01,69164,66366,2798,4
45001,2020-02-01,10108,9751,357,3.5
45003,2020-02-01,75770,73538,2232,2.9
45005,2020-02-01,2616,2449,167,6.4
45007,2020-02-01,90690,88133,2557,2.8
45009,2020-02-01,4915,4644,271,5.5
45011,2020-02-01,7877,7512,365,4.6
45013,2020-02-01,76694,74566,2128,2.8
45015,2020-02-01,105672,102875,2797,2.6
45017,2020-02-01,6556,6331,225,3.4
45019,2020-02-01,211903,206862,5041,2.4
45021,2020-02-01,24942,24112,830,3.3
45023,2020-02-01,13372,12775,597,4.5
45025,2020-02-01,21627,20962,665,3.1
45027,2020-02-01,12650,12134,516,4.1
45029,2020-02-01,16713,16173,540,3.2
45031,2020-02-01,30038,29049,989,3.3
45033,2020-02-01,12941,12387,554,4.3
45035,2020-02-01,78038,76046,1992,2.6
45037,2020-02-01,10864,10550,314,2.9
45039,2020-02-01,9525,9082,443,4.7
45041,2020-02-01,66579,64592,1987,3
45043,2020-02-01,25590,24546,1044,4.1
45045,2020-02-01,255324,248797,6527,2.6
45047,2020-02-01,31545,30495,1050,3.3
45049,2020-02-01,8174,7940,234,2.9
45051,2020-02-01,143855,137785,6070,4.2
45053,2020-02-01,12886,12543,343,2.7
45055,2020-02-01,29528,28565,963,3.3
45057,2020-02-01,42292,40772,1520,3.6
45059,2020-02-01,30004,29046,958,3.2
45061,2020-02-01,6633,6287,346,5.2
45063,2020-02-01,150736,147136,3600,2.4
45065,2020-02-01,3330,3196,134,4
45067,2020-02-01,12731,12162,569,4.5
45069,2020-02-01,8755,8343,412,4.7
45071,2020-02-01,19061,18538,523,2.7
45073,2020-02-01,34739,33736,1003,2.9
45075,2020-02-01,34500,32876,1624,4.7
45077,2020-02-01,57465,55799,1666,2.9
45079,2020-02-01,197329,191817,5512,2.8
45081,2020-02-01,8831,8590,241,2.7
45083,2020-02-01,155552,151386,4166,2.7
45085,2020-02-01,43204,41612,1592,3.7
45087,2020-02-01,11607,11173,434,3.7
45089,2020-02-01,11733,11150,583,5
45091,2020-02-01,143063,139081,3982,2.8
46003,2020-02-01,1463,1425,38,2.6
46005,2020-02-01,9328,9054,274,2.9
46007,2020-02-01,1064,1012,52,4.9
46009,2020-02-01,2781,2692,89,3.2
46011,2020-02-01,18997,18463,534,2.8
46013,2020-02-01,20595,19985,610,3
46015,2020-02-01,2395,2323,72,3
46017,2020-02-01,633,595,38,6
46019,2020-02-01,4953,4785,168,3.4
46021,2020-02-01,754,726,28,3.7
46023,2020-02-01,3613,3502,111,3.1
46025,2020-02-01,1939,1861,78,4
46027,2020-02-01,7729,7541,188,2.4
46029,2020-02-01,15458,14993,465,3
46031,2020-02-01,1339,1275,64,4.8
46033,2020-02-01,3991,3801,190,4.8
46035,2020-02-01,10885,10564,321,2.9
46037,2020-02-01,2640,2486,154,5.8
46039,2020-02-01,2139,1995,144,6.7
46041,2020-02-01,2143,2019,124,5.8
46043,2020-02-01,1517,1464,53,3.5
46045,2020-02-01,1996,1941,55,2.8
46047,2020-02-01,2904,2782,122,4.2
46049,2020-02-01,997,963,34,3.4
46051,2020-02-01,4385,4175,210,4.8
46053,2020-02-01,1978,1912,66,3.3
46055,2020-02-01,1037,1007,30,2.9
46057,2020-02-01,3255,3155,100,3.1
46059,2020-02-01,1698,1657,41,2.4
46061,2020-02-01,1757,1660,97,5.5
46063,2020-02-01,695,679,16,2.3
46065,2020-02-01,9709,9432,277,2.9
46067,2020-02-01,3620,3487,133,3.7
46069,2020-02-01,672,650,22,3.3
46071,2020-02-01,1152,1091,61,5.3
46073,2020-02-01,1134,1110,24,2.1
46075,2020-02-01,488,471,17,3.5
46077,2020-02-01,2651,2563,88,3.3
46079,2020-02-01,6602,6401,201,3
46081,2020-02-01,13363,13003,360,2.7
46083,2020-02-01,35956,35082,874,2.4
46085,2020-02-01,1600,1528,72,4.5
46087,2020-02-01,3083,2989,94,3
46089,2020-02-01,999,954,45,4.5
46091,2020-02-01,2355,2244,111,4.7
46093,2020-02-01,13687,13226,461,3.4
46095,2020-02-01,715,676,39,5.5
46097,2020-02-01,1129,1099,30,2.7
46099,2020-02-01,113540,110199,3341,2.9
46101,2020-02-01,3981,3838,143,3.6
46102,2020-02-01,3549,3289,260,7.3
46103,2020-02-01,56021,54142,1879,3.4
46105,2020-02-01,1334,1293,41,3.1
46107,2020-02-01,981,953,28,2.9
46109,2020-02-01,4671,4392,279,6
46111,2020-02-01,1127,1089,38,3.4
46115,2020-02-01,3052,2919,133,4.4
46117,2020-02-01,1850,1781,69,3.7
46119,2020-02-01,766,746,20,2.6
46121,2020-02-01,3097,2918,179,5.8
46123,2020-02-01,2923,2845,78,2.7
46125,2020-02-01,4660,4500,160,3.4
46127,2020-02-01,8626,8339,287,3.3
46129,2020-02-01,2063,1931,132,6.4
46135,2020-02-01,11852,11520,332,2.8
46137,2020-02-01,902,871,31,3.4
47001,2020-02-01,34864,33531,1333,3.8
47003,2020-02-01,21193,20320,873,4.1
47005,2020-02-01,6858,6465,393,5.7
47007,2020-02-01,4440,4176,264,5.9
47009,2020-02-01,64697,62263,2434,3.8
47011,2020-02-01,52341,50379,1962,3.7
47013,2020-02-01,15027,14238,789,5.3
47015,2020-02-01,6718,6506,212,3.2
47017,2020-02-01,11975,11340,635,5.3
47019,2020-02-01,24269,23208,1061,4.4
47021,2020-02-01,22059,21410,649,2.9
47023,2020-02-01,8616,8303,313,3.6
47025,2020-02-01,13120,12489,631,4.8
47027,2020-02-01,2756,2554,202,7.3
47029,2020-02-01,14747,13787,960,6.5
47031,2020-02-01,25917,24878,1039,4
47033,2020-02-01,7124,6803,321,4.5
47035,2020-02-01,23400,21905,1495,6.4
47037,2020-02-01,405265,394138,11127,2.7
47039,2020-02-01,4556,4282,274,6
47041,2020-02-01,7699,7314,385,5
47043,2020-02-01,27380,26474,906,3.3
47045,2020-02-01,16177,15318,859,5.3
47047,2020-02-01,19541,18821,720,3.7
47049,2020-02-01,7687,7328,359,4.7
47051,2020-02-01,20429,19572,857,4.2
47053,2020-02-01,21877,20832,1045,4.8
47055,2020-02-01,15001,14263,738,4.9
47057,2020-02-01,9711,9231,480,4.9
47059,2020-02-01,29493,27946,1547,5.2
47061,2020-02-01,5194,4950,244,4.7
47063,2020-02-01,28524,27271,1253,4.4
47065,2020-02-01,185342,178648,6694,3.6
47067,2020-02-01,2213,2068,145,6.6
47069,2020-02-01,9519,8987,532,5.6
47071,2020-02-01,10308,9741,567,5.5
47073,2020-02-01,23971,22827,1144,4.8
47075,2020-02-01,7844,7451,393,5
47077,2020-02-01,12228,11591,637,5.2
47079,2020-02-01,14026,13256,770,5.5
47081,2020-02-01,11551,11154,397,3.4
47083,2020-02-01,3370,3158,212,6.3
47085,2020-02-01,8906,8460,446,5
47087,2020-02-01,4773,4507,266,5.6
47089,2020-02-01,25145,23941,1204,4.8
47091,2020-02-01,7932,7587,345,4.3
47093,2020-02-01,246710,238959,7751,3.1
47095,2020-02-01,1707,1598,109,6.4
47097,2020-02-01,9839,9276,563,5.7
47099,2020-02-01,19221,18378,843,4.4
47101,2020-02-01,5362,5146,216,4
47103,2020-02-01,16374,15162,1212,7.4
47105,2020-02-01,24119,23219,900,3.7
47107,2020-02-01,24162,23164,998,4.1
47109,2020-02-01,8486,7958,528,6.2
47111,2020-02-01,11629,11234,395,3.4
47113,2020-02-01,49247,47363,1884,3.8
47115,2020-02-01,12639,12030,609,4.8
47117,2020-02-01,15648,15021,627,4
47119,2020-02-01,50606,48946,1660,3.3
47121,2020-02-01,5220,4952,268,5.1
47123,2020-02-01,20429,19590,839,4.1
47125,2020-02-01,87583,83967,3616,4.1
47127,2020-02-01,3828,3707,121,3.2
47129,2020-02-01,7912,7521,391,4.9
47131,2020-02-01,12418,11769,649,5.2
47133,2020-02-01,10003,9523,480,4.8
47135,2020-02-01,3155,2973,182,5.8
47137,2020-02-01,2240,2115,125,5.6
47139,2020-02-01,7479,7128,351,4.7
47141,2020-02-01,35435,34061,1374,3.9
47143,2020-02-01,13767,12978,789,5.7
47145,2020-02-01,23661,22554,1107,4.7
47147,2020-02-01,38708,37502,1206,3.1
47149,2020-02-01,188561,183289,5272,2.8
47151,2020-02-01,8313,7893,420,5.1
47153,2020-02-01,6266,5970,296,4.7
47155,2020-02-01,53772,50511,3261,6.1
47157,2020-02-01,445382,425836,19546,4.4
47159,2020-02-01,9631,9302,329,3.4
47161,2020-02-01,5574,5278,296,5.3
47163,2020-02-01,70660,67735,2925,4.1
47165,2020-02-01,104813,101701,3112,3
47167,2020-02-01,28277,27035,1242,4.4
47169,2020-02-01,5588,5404,184,3.3
47171,2020-02-01,7373,6915,458,6.2
47173,2020-02-01,7743,7410,333,4.3
47175,2020-02-01,2037,1928,109,5.4
47177,2020-02-01,17177,16413,764,4.4
47179,2020-02-01,61485,59107,2378,3.9
47181,2020-02-01,6444,6087,357,5.5
47183,2020-02-01,16069,15432,637,4
47185,2020-02-01,12124,11616,508,4.2
47187,2020-02-01,132208,128781,3427,2.6
47189,2020-02-01,79102,76768,2334,3
48001,2020-02-01,23626,22935,691,2.9
48003,2020-02-01,9703,9459,244,2.5
48005,2020-02-01,35906,34419,1487,4.1
48007,2020-02-01,9279,8879,400,4.3
48009,2020-02-01,4018,3900,118,2.9
48011,2020-02-01,941,912,29,3.1
48013,2020-02-01,22011,21210,801,3.6
48015,2020-02-01,14215,13718,497,3.5
48017,2020-02-01,2468,2380,88,3.6
48019,2020-02-01,10162,9837,325,3.2
48021,2020-02-01,43804,42537,1267,2.9
48023,2020-02-01,1782,1736,46,2.6
48025,2020-02-01,10133,9661,472,4.7
48027,2020-02-01,146066,140613,5453,3.7
48029,2020-02-01,954412,924719,29693,3.1
48031,2020-02-01,6755,6600,155,2.3
48033,2020-02-01,452,442,10,2.2
48035,2020-02-01,8407,8112,295,3.5
48037,2020-02-01,39530,37866,1664,4.2
48039,2020-02-01,182878,175036,7842,4.3
48041,2020-02-01,123405,120219,3186,2.6
48043,2020-02-01,4234,4114,120,2.8
48045,2020-02-01,580,558,22,3.8
48047,2020-02-01,2748,2605,143,5.2
48049,2020-02-01,15475,14876,599,3.9
48051,2020-02-01,8638,8336,302,3.5
48053,2020-02-01,24164,23511,653,2.7
48055,2020-02-01,19870,19236,634,3.2
48057,2020-02-01,12179,11780,399,3.3
48059,2020-02-01,6175,5986,189,3.1
48061,2020-02-01,170264,160611,9653,5.7
48063,2020-02-01,5001,4782,219,4.4
48065,2020-02-01,3013,2929,84,2.8
48067,2020-02-01,12261,11721,540,4.4
48069,2020-02-01,3368,3275,93,2.8
48071,2020-02-01,20252,19336,916,4.5
48073,2020-02-01,21261,20416,845,4
48075,2020-02-01,3054,2967,87,2.8
48077,2020-02-01,4905,4765,140,2.9
48079,2020-02-01,1138,1096,42,3.7
48081,2020-02-01,1419,1378,41,2.9
48083,2020-02-01,2886,2758,128,4.4
48085,2020-02-01,582807,565634,17173,2.9
48087,2020-02-01,1093,1055,38,3.5
48089,2020-02-01,9925,9598,327,3.3
48091,2020-02-01,76946,74692,2254,2.9
48093,2020-02-01,5662,5462,200,3.5
48095,2020-02-01,1349,1312,37,2.7
48097,2020-02-01,19840,19217,623,3.1
48099,2020-02-01,24360,23428,932,3.8
48101,2020-02-01,549,525,24,4.4
48103,2020-02-01,1590,1514,76,4.8
48105,2020-02-01,1573,1505,68,4.3
48107,2020-02-01,2465,2378,87,3.5
48109,2020-02-01,1155,1120,35,3
48111,2020-02-01,3808,3725,83,2.2
48113,2020-02-01,NA,NA,45752,3.3
48115,2020-02-01,4575,4374,201,4.4
48117,2020-02-01,8689,8458,231,2.7
48119,2020-02-01,2464,2376,88,3.6
48121,2020-02-01,513205,498553,14652,2.9
48123,2020-02-01,9565,9307,258,2.7
48125,2020-02-01,668,642,26,3.9
48127,2020-02-01,7191,6987,204,2.8
48129,2020-02-01,1465,1420,45,3.1
48131,2020-02-01,4890,4637,253,5.2
48133,2020-02-01,7763,7477,286,3.7
48135,2020-02-01,87888,84990,2898,3.3
48137,2020-02-01,1199,1176,23,1.9
48139,2020-02-01,95900,93054,2846,3
48141,2020-02-01,367700,353816,13884,3.8
48143,2020-02-01,21077,20389,688,3.3
48145,2020-02-01,6581,6355,226,3.4
48147,2020-02-01,17074,16610,464,2.7
48149,2020-02-01,12238,11924,314,2.6
48151,2020-02-01,1626,1584,42,2.6
48153,2020-02-01,2558,2427,131,5.1
48155,2020-02-01,587,572,15,2.6
48157,2020-02-01,406595,392718,13877,3.4
48159,2020-02-01,4838,4680,158,3.3
48161,2020-02-01,6449,6127,322,5
48163,2020-02-01,10225,9934,291,2.8
48165,2020-02-01,10116,9856,260,2.6
48167,2020-02-01,168535,161869,6666,4
48169,2020-02-01,2082,2018,64,3.1
48171,2020-02-01,13719,13379,340,2.5
48173,2020-02-01,877,861,16,1.8
48175,2020-02-01,3236,3114,122,3.8
48177,2020-02-01,9815,9537,278,2.8
48179,2020-02-01,7954,7640,314,3.9
48181,2020-02-01,65345,63299,2046,3.1
48183,2020-02-01,57986,55684,2302,4
48185,2020-02-01,11325,10858,467,4.1
48187,2020-02-01,82659,80319,2340,2.8
48189,2020-02-01,11996,11475,521,4.3
48191,2020-02-01,1078,1030,48,4.5
48193,2020-02-01,3777,3659,118,3.1
48195,2020-02-01,2553,2494,59,2.3
48197,2020-02-01,1750,1702,48,2.7
48199,2020-02-01,25815,24695,1120,4.3
48201,2020-02-01,NA,NA,90342,3.9
48203,2020-02-01,29671,28448,1223,4.1
48205,2020-02-01,2655,2609,46,1.7
48207,2020-02-01,2719,2646,73,2.7
48209,2020-02-01,124113,120810,3303,2.7
48211,2020-02-01,2058,1997,61,3
48213,2020-02-01,37548,36228,1320,3.5
48215,2020-02-01,362022,338102,23920,6.6
48217,2020-02-01,16560,16002,558,3.4
48219,2020-02-01,11354,11014,340,3
48221,2020-02-01,28267,27279,988,3.5
48223,2020-02-01,17743,17189,554,3.1
48225,2020-02-01,10125,9794,331,3.3
48227,2020-02-01,14140,13698,442,3.1
48229,2020-02-01,1881,1803,78,4.1
48231,2020-02-01,44583,43027,1556,3.5
48233,2020-02-01,8510,8109,401,4.7
48235,2020-02-01,772,753,19,2.5
48237,2020-02-01,3457,3314,143,4.1
48239,2020-02-01,7630,7392,238,3.1
48241,2020-02-01,12757,11918,839,6.6
48243,2020-02-01,1031,1000,31,3
48245,2020-02-01,107033,100892,6141,5.7
48247,2020-02-01,1897,1811,86,4.5
48249,2020-02-01,16720,15856,864,5.2
48251,2020-02-01,84810,82101,2709,3.2
48253,2020-02-01,5867,5640,227,3.9
48255,2020-02-01,7602,7412,190,2.5
48257,2020-02-01,68717,66518,2199,3.2
48259,2020-02-01,22941,22315,626,2.7
48261,2020-02-01,231,224,7,3
48263,2020-02-01,458,443,15,3.3
48265,2020-02-01,22282,21576,706,3.2
48267,2020-02-01,1830,1771,59,3.2
48269,2020-02-01,248,243,5,2
48271,2020-02-01,1409,1345,64,4.5
48273,2020-02-01,13625,13029,596,4.4
48275,2020-02-01,1474,1424,50,3.4
48277,2020-02-01,23834,23054,780,3.3
48279,2020-02-01,5299,5102,197,3.7
48281,2020-02-01,9267,8958,309,3.3
48283,2020-02-01,4230,4097,133,3.1
48285,2020-02-01,8586,8347,239,2.8
48287,2020-02-01,9453,9182,271,2.9
48289,2020-02-01,6258,5965,293,4.7
48291,2020-02-01,34157,32331,1826,5.3
48293,2020-02-01,8561,8220,341,4
48295,2020-02-01,1614,1572,42,2.6
48297,2020-02-01,5445,5265,180,3.3
48299,2020-02-01,8645,8351,294,3.4
48301,2020-02-01,339,335,4,1.2
48303,2020-02-01,159424,155111,4313,2.7
48305,2020-02-01,2818,2719,99,3.5
48307,2020-02-01,3320,3169,151,4.5
48309,2020-02-01,120808,116943,3865,3.2
48311,2020-02-01,807,793,14,1.7
48313,2020-02-01,4502,4328,174,3.9
48315,2020-02-01,4280,4087,193,4.5
48317,2020-02-01,2826,2746,80,2.8
48319,2020-02-01,1772,1715,57,3.2
48321,2020-02-01,16823,15867,956,5.7
48323,2020-02-01,24404,22082,2322,9.5
48325,2020-02-01,22050,21341,709,3.2
48327,2020-02-01,898,871,27,3
48329,2020-02-01,107275,104787,2488,2.3
48331,2020-02-01,9818,9385,433,4.4
48333,2020-02-01,1910,1851,59,3.1
48335,2020-02-01,2370,2291,79,3.3
48337,2020-02-01,9469,9170,299,3.2
48339,2020-02-01,294029,283974,10055,3.4
48341,2020-02-01,10754,10498,256,2.4
48343,2020-02-01,4877,4616,261,5.4
48345,2020-02-01,455,439,16,3.5
48347,2020-02-01,28842,27799,1043,3.6
48349,2020-02-01,23905,23074,831,3.5
48351,2020-02-01,5203,4875,328,6.3
48353,2020-02-01,7303,7087,216,3
48355,2020-02-01,166694,159810,6884,4.1
48357,2020-02-01,4286,4145,141,3.3
48359,2020-02-01,920,891,29,3.2
48361,2020-02-01,36778,34974,1804,4.9
48363,2020-02-01,13482,13066,416,3.1
48365,2020-02-01,9623,9163,460,4.8
48367,2020-02-01,70015,67916,2099,3
48369,2020-02-01,4894,4782,112,2.3
48371,2020-02-01,6307,6073,234,3.7
48373,2020-02-01,18432,17497,935,5.1
48375,2020-02-01,54859,53413,1446,2.6
48377,2020-02-01,3267,3004,263,8.1
48379,2020-02-01,6242,6062,180,2.9
48381,2020-02-01,73810,72050,1760,2.4
48383,2020-02-01,1903,1850,53,2.8
48385,2020-02-01,1047,1001,46,4.4
48387,2020-02-01,5139,4904,235,4.6
48389,2020-02-01,10428,10182,246,2.4
48391,2020-02-01,3152,3038,114,3.6
48393,2020-02-01,423,409,14,3.3
48395,2020-02-01,7755,7475,280,3.6
48397,2020-02-01,54523,52923,1600,2.9
48399,2020-02-01,4632,4489,143,3.1
48401,2020-02-01,22908,22005,903,3.9
48403,2020-02-01,3798,3545,253,6.7
48405,2020-02-01,3033,2859,174,5.7
48407,2020-02-01,11929,11383,546,4.6
48409,2020-02-01,29691,28065,1626,5.5
48411,2020-02-01,2440,2350,90,3.7
48413,2020-02-01,1249,1212,37,3
48415,2020-02-01,6462,6210,252,3.9
48417,2020-02-01,1860,1815,45,2.4
48419,2020-02-01,11344,10876,468,4.1
48421,2020-02-01,1366,1333,33,2.4
48423,2020-02-01,109545,105878,3667,3.3
48425,2020-02-01,4448,4287,161,3.6
48427,2020-02-01,26473,23125,3348,12.6
48429,2020-02-01,4082,3954,128,3.1
48431,2020-02-01,568,549,19,3.3
48433,2020-02-01,568,549,19,3.3
48435,2020-02-01,1256,1204,52,4.1
48437,2020-02-01,2583,2486,97,3.8
48439,2020-02-01,NA,NA,34852,3.2
48441,2020-02-01,68051,66129,1922,2.8
48443,2020-02-01,394,380,14,3.6
48445,2020-02-01,4910,4741,169,3.4
48447,2020-02-01,653,631,22,3.4
48449,2020-02-01,13542,13011,531,3.9
48451,2020-02-01,55202,53598,1604,2.9
48453,2020-02-01,757646,738435,19211,2.5
48455,2020-02-01,5353,5086,267,5
48457,2020-02-01,7438,7019,419,5.6
48459,2020-02-01,18021,17278,743,4.1
48461,2020-02-01,1931,1877,54,2.8
48463,2020-02-01,11546,11145,401,3.5
48465,2020-02-01,22330,21420,910,4.1
48467,2020-02-01,26511,25613,898,3.4
48469,2020-02-01,41900,40308,1592,3.8
48471,2020-02-01,24485,23567,918,3.7
48473,2020-02-01,24551,23646,905,3.7
48475,2020-02-01,6773,6568,205,3
48477,2020-02-01,15556,15050,506,3.3
48479,2020-02-01,119899,115252,4647,3.9
48481,2020-02-01,22219,21439,780,3.5
48483,2020-02-01,2246,2175,71,3.2
48485,2020-02-01,56134,54386,1748,3.1
48487,2020-02-01,5023,4826,197,3.9
48489,2020-02-01,6727,6173,554,8.2
48491,2020-02-01,327538,318646,8892,2.7
48493,2020-02-01,25249,24499,750,3
48495,2020-02-01,4356,4221,135,3.1
48497,2020-02-01,32918,31812,1106,3.4
48499,2020-02-01,18129,17404,725,4
48501,2020-02-01,3593,3464,129,3.6
48503,2020-02-01,7894,7661,233,3
48505,2020-02-01,5106,4808,298,5.8
48507,2020-02-01,3601,3300,301,8.4
49001,2020-02-01,2889,2806,83,2.9
49003,2020-02-01,26414,25699,715,2.7
49005,2020-02-01,65786,64402,1384,2.1
49007,2020-02-01,8604,8262,342,4
49009,2020-02-01,326,314,12,3.7
49011,2020-02-01,175963,171742,4221,2.4
49013,2020-02-01,7868,7518,350,4.4
49015,2020-02-01,4274,4060,214,5
49017,2020-02-01,2305,2031,274,11.9
49019,2020-02-01,5673,5245,428,7.5
49021,2020-02-01,25310,24558,752,3
49023,2020-02-01,5969,5812,157,2.6
49025,2020-02-01,3709,3582,127,3.4
49027,2020-02-01,5950,5782,168,2.8
49029,2020-02-01,5606,5468,138,2.5
49031,2020-02-01,482,454,28,5.8
49033,2020-02-01,949,904,45,4.7
49035,2020-02-01,646505,630160,16345,2.5
49037,2020-02-01,5467,5080,387,7.1
49039,2020-02-01,12673,12249,424,3.3
49041,2020-02-01,9773,9426,347,3.6
49043,2020-02-01,27771,27213,558,2
49045,2020-02-01,35513,34554,959,2.7
49047,2020-02-01,13261,12545,716,5.4
49049,2020-02-01,315199,307669,7530,2.4
49051,2020-02-01,16484,16045,439,2.7
49053,2020-02-01,78291,75778,2513,3.2
49055,2020-02-01,1357,1223,134,9.9
49057,2020-02-01,129767,125924,3843,3
50001,2020-02-01,20254,19713,541,2.7
50003,2020-02-01,17932,17370,562,3.1
50005,2020-02-01,14338,13829,509,3.6
50007,2020-02-01,96554,94874,1680,1.7
50009,2020-02-01,2654,2541,113,4.3
50011,2020-02-01,27291,26576,715,2.6
50013,2020-02-01,4173,4030,143,3.4
50015,2020-02-01,14050,13534,516,3.7
50017,2020-02-01,15910,15403,507,3.2
50019,2020-02-01,13386,12625,761,5.7
50021,2020-02-01,30236,29389,847,2.8
50023,2020-02-01,34833,33967,866,2.5
50025,2020-02-01,21974,21458,516,2.3
50027,2020-02-01,29497,28915,582,2
51001,2020-02-01,16172,15530,642,4
51003,2020-02-01,58809,57623,1186,2
51005,2020-02-01,7017,6752,265,3.8
51007,2020-02-01,6394,6211,183,2.9
51009,2020-02-01,15220,14769,451,3
51011,2020-02-01,7307,7054,253,3.5
51013,2020-02-01,157201,154641,2560,1.6
51015,2020-02-01,38021,37225,796,2.1
51017,2020-02-01,2456,2393,63,2.6
51019,2020-02-01,39120,38100,1020,2.6
51021,2020-02-01,2856,2772,84,2.9
51023,2020-02-01,17817,17404,413,2.3
51025,2020-02-01,6035,5780,255,4.2
51027,2020-02-01,6889,6466,423,6.1
51029,2020-02-01,6651,6370,281,4.2
51031,2020-02-01,26337,25569,768,2.9
51033,2020-02-01,15412,14946,466,3
51035,2020-02-01,13396,12797,599,4.5
51036,2020-02-01,3705,3593,112,3
51037,2020-02-01,5234,5057,177,3.4
51041,2020-02-01,191822,187256,4566,2.4
51043,2020-02-01,7776,7616,160,2.1
51045,2020-02-01,2365,2304,61,2.6
51047,2020-02-01,25468,24835,633,2.5
51049,2020-02-01,4714,4577,137,2.9
51051,2020-02-01,4791,4522,269,5.6
51053,2020-02-01,13795,13391,404,2.9
51057,2020-02-01,5613,5408,205,3.7
51059,2020-02-01,646203,633749,12454,1.9
51061,2020-02-01,38213,37406,807,2.1
51063,2020-02-01,8469,8244,225,2.7
51065,2020-02-01,14511,14216,295,2
51067,2020-02-01,26825,26067,758,2.8
51069,2020-02-01,49596,48567,1029,2.1
51071,2020-02-01,8164,7893,271,3.3
51073,2020-02-01,19844,19371,473,2.4
51075,2020-02-01,11556,11291,265,2.3
51077,2020-02-01,8150,7881,269,3.3
51079,2020-02-01,10761,10543,218,2
51081,2020-02-01,4332,4203,129,3
51083,2020-02-01,15283,14673,610,4
51085,2020-02-01,60165,58908,1257,2.1
51087,2020-02-01,184825,180397,4428,2.4
51089,2020-02-01,23804,23072,732,3.1
51091,2020-02-01,1239,1206,33,2.7
51093,2020-02-01,19754,19264,490,2.5
51095,2020-02-01,37172,36264,908,2.4
51097,2020-02-01,3933,3841,92,2.3
51099,2020-02-01,13893,13560,333,2.4
51101,2020-02-01,9368,9134,234,2.5
51103,2020-02-01,5391,5074,317,5.9
51105,2020-02-01,8391,8039,352,4.2
51107,2020-02-01,230822,226317,4505,2
51109,2020-02-01,20263,19736,527,2.6
51111,2020-02-01,5328,5183,145,2.7
51113,2020-02-01,7543,7400,143,1.9
51115,2020-02-01,4212,4101,111,2.6
51117,2020-02-01,12844,12377,467,3.6
51119,2020-02-01,5187,5046,141,2.7
51121,2020-02-01,51857,50636,1221,2.4
51125,2020-02-01,7638,7459,179,2.3
51127,2020-02-01,12999,12734,265,2
51131,2020-02-01,5312,5056,256,4.8
51133,2020-02-01,5703,5374,329,5.8
51135,2020-02-01,7352,7167,185,2.5
51137,2020-02-01,17366,16908,458,2.6
51139,2020-02-01,12062,11476,586,4.9
51141,2020-02-01,7323,7080,243,3.3
51143,2020-02-01,30372,29333,1039,3.4
51145,2020-02-01,14545,14197,348,2.4
51147,2020-02-01,10375,10029,346,3.3
51149,2020-02-01,15348,14894,454,3
51153,2020-02-01,252003,246391,5612,2.2
51155,2020-02-01,16918,16182,736,4.4
51157,2020-02-01,3811,3730,81,2.1
51159,2020-02-01,4109,3994,115,2.8
51161,2020-02-01,50427,49240,1187,2.4
51163,2020-02-01,10833,10570,263,2.4
51165,2020-02-01,43664,42791,873,2
51167,2020-02-01,11495,10979,516,4.5
51169,2020-02-01,9252,8960,292,3.2
51171,2020-02-01,22437,21925,512,2.3
51173,2020-02-01,13565,13056,509,3.8
51175,2020-02-01,9171,8941,230,2.5
51177,2020-02-01,69373,67639,1734,2.5
51179,2020-02-01,74944,73185,1759,2.3
51181,2020-02-01,3693,3577,116,3.1
51183,2020-02-01,3798,3638,160,4.2
51185,2020-02-01,15775,15056,719,4.6
51187,2020-02-01,20929,20392,537,2.6
51191,2020-02-01,26703,25851,852,3.2
51193,2020-02-01,9566,9215,351,3.7
51195,2020-02-01,13496,12904,592,4.4
51197,2020-02-01,14033,13469,564,4
51199,2020-02-01,33409,32644,765,2.3
51510,2020-02-01,102828,100883,1945,1.9
51520,2020-02-01,7388,7133,255,3.5
51530,2020-02-01,3162,3088,74,2.3
51540,2020-02-01,26581,26062,519,2
51550,2020-02-01,125362,122278,3084,2.5
51570,2020-02-01,8649,8424,225,2.6
51580,2020-02-01,2437,2309,128,5.3
51590,2020-02-01,19339,18380,959,5
51595,2020-02-01,2311,2215,96,4.2
51600,2020-02-01,13422,13172,250,1.9
51610,2020-02-01,8677,8534,143,1.6
51620,2020-02-01,3599,3474,125,3.5
51630,2020-02-01,14355,13962,393,2.7
51640,2020-02-01,2916,2827,89,3.1
51650,2020-02-01,65297,63086,2211,3.4
51660,2020-02-01,25332,24711,621,2.5
51670,2020-02-01,9746,9376,370,3.8
51678,2020-02-01,2142,2069,73,3.4
51680,2020-02-01,36799,35640,1159,3.1
51683,2020-02-01,22237,21725,512,2.3
51685,2020-02-01,9664,9453,211,2.2
51690,2020-02-01,5520,5289,231,4.2
51700,2020-02-01,90409,87502,2907,3.2
51710,2020-02-01,112424,109018,3406,3
51720,2020-02-01,1709,1639,70,4.1
51730,2020-02-01,13102,12391,711,5.4
51735,2020-02-01,6502,6370,132,2
51740,2020-02-01,44725,43167,1558,3.5
51750,2020-02-01,8941,8676,265,3
51760,2020-02-01,120470,116939,3531,2.9
51770,2020-02-01,49756,48349,1407,2.8
51775,2020-02-01,13057,12728,329,2.5
51790,2020-02-01,12429,12129,300,2.4
51800,2020-02-01,45663,44454,1209,2.6
51810,2020-02-01,236017,230456,5561,2.4
51820,2020-02-01,10858,10576,282,2.6
51830,2020-02-01,6799,6566,233,3.4
51840,2020-02-01,15050,14683,367,2.4
53001,2020-02-01,8674,8009,665,7.7
53003,2020-02-01,10533,10065,468,4.4
53005,2020-02-01,103371,97132,6239,6
53007,2020-02-01,43339,40606,2733,6.3
53009,2020-02-01,29392,27353,2039,6.9
53011,2020-02-01,251505,239271,12234,4.9
53013,2020-02-01,1752,1638,114,6.5
53015,2020-02-01,49013,45897,3116,6.4
53017,2020-02-01,21059,19524,1535,7.3
53019,2020-02-01,2586,2230,356,13.8
53021,2020-02-01,41907,38595,3312,7.9
53023,2020-02-01,783,722,61,7.8
53025,2020-02-01,46012,41868,4144,9
53027,2020-02-01,29229,26973,2256,7.7
53029,2020-02-01,36910,34963,1947,5.3
53031,2020-02-01,13023,12226,797,6.1
53033,2020-02-01,NA,NA,32611,2.5
53035,2020-02-01,132110,126048,6062,4.6
53037,2020-02-01,23009,21532,1477,6.4
53039,2020-02-01,9697,8999,698,7.2
53041,2020-02-01,35523,33100,2423,6.8
53043,2020-02-01,4757,4446,311,6.5
53045,2020-02-01,25616,23835,1781,7
53047,2020-02-01,19075,17285,1790,9.4
53049,2020-02-01,8475,7861,614,7.2
53051,2020-02-01,5175,4661,514,9.9
53053,2020-02-01,457917,433337,24580,5.4
53055,2020-02-01,8108,7715,393,4.8
53057,2020-02-01,63511,59597,3914,6.2
53059,2020-02-01,5730,5393,337,5.9
53061,2020-02-01,448607,436066,12541,2.8
53063,2020-02-01,263730,247797,15933,6
53065,2020-02-01,19446,17656,1790,9.2
53067,2020-02-01,147423,139912,7511,5.1
53069,2020-02-01,1365,1265,100,7.3
53071,2020-02-01,30397,28818,1579,5.2
53073,2020-02-01,118345,111978,6367,5.4
53075,2020-02-01,24238,23217,1021,4.2
53077,2020-02-01,129441,118240,11201,8.7
54001,2020-02-01,7558,7021,537,7.1
54003,2020-02-01,58814,56790,2024,3.4
54005,2020-02-01,7573,7053,520,6.9
54007,2020-02-01,5406,4819,587,10.9
54009,2020-02-01,10053,9472,581,5.8
54011,2020-02-01,42016,40218,1798,4.3
54013,2020-02-01,2718,2152,566,20.8
54015,2020-02-01,3336,2907,429,12.9
54017,2020-02-01,3958,3735,223,5.6
54019,2020-02-01,16419,15168,1251,7.6
54021,2020-02-01,2476,2253,223,9
54023,2020-02-01,6060,5693,367,6.1
54025,2020-02-01,15903,14977,926,5.8
54027,2020-02-01,10950,10506,444,4.1
54029,2020-02-01,13178,12431,747,5.7
54031,2020-02-01,5934,5597,337,5.7
54033,2020-02-01,34619,32722,1897,5.5
54035,2020-02-01,12603,11735,868,6.9
54037,2020-02-01,30624,29715,909,3
54039,2020-02-01,83724,79575,4149,5
54041,2020-02-01,6383,5824,559,8.8
54043,2020-02-01,7444,6838,606,8.1
54045,2020-02-01,11349,10434,915,8.1
54047,2020-02-01,4537,3996,541,11.9
54049,2020-02-01,26184,24771,1413,5.4
54051,2020-02-01,13968,12793,1175,8.4
54053,2020-02-01,10467,9739,728,7
54055,2020-02-01,21210,19950,1260,5.9
54057,2020-02-01,12626,11867,759,6
54059,2020-02-01,6926,6194,732,10.6
54061,2020-02-01,56367,54370,1997,3.5
54063,2020-02-01,6181,5820,361,5.8
54065,2020-02-01,8311,7975,336,4
54067,2020-02-01,9533,8647,886,9.3
54069,2020-02-01,20576,19531,1045,5.1
54071,2020-02-01,3721,3554,167,4.5
54073,2020-02-01,2797,2527,270,9.7
54075,2020-02-01,4318,4074,244,5.7
54077,2020-02-01,16109,15237,872,5.4
54079,2020-02-01,27449,26127,1322,4.8
54081,2020-02-01,30509,28810,1699,5.6
54083,2020-02-01,12665,11773,892,7
54085,2020-02-01,4539,4189,350,7.7
54087,2020-02-01,5298,4638,660,12.5
54089,2020-02-01,4376,4072,304,6.9
54091,2020-02-01,8005,7544,461,5.8
54093,2020-02-01,3451,3218,233,6.8
54095,2020-02-01,3256,2952,304,9.3
54097,2020-02-01,9887,9174,713,7.2
54099,2020-02-01,16151,15121,1030,6.4
54101,2020-02-01,3347,3019,328,9.8
54103,2020-02-01,6824,6182,642,9.4
54105,2020-02-01,2401,2133,268,11.2
54107,2020-02-01,37093,34819,2274,6.1
54109,2020-02-01,6988,6392,596,8.5
55001,2020-02-01,8020,7477,543,6.8
55003,2020-02-01,7434,7039,395,5.3
55005,2020-02-01,23812,22591,1221,5.1
55007,2020-02-01,7191,6685,506,7
55009,2020-02-01,139799,135531,4268,3.1
55011,2020-02-01,6259,5924,335,5.4
55013,2020-02-01,6953,6465,488,7
55015,2020-02-01,27248,26479,769,2.8
55017,2020-02-01,33368,31714,1654,5
55019,2020-02-01,17144,16439,705,4.1
55021,2020-02-01,31742,30588,1154,3.6
55023,2020-02-01,7411,6942,469,6.3
55025,2020-02-01,323631,316614,7017,2.2
55027,2020-02-01,46672,45131,1541,3.3
55029,2020-02-01,13868,13168,700,5
55031,2020-02-01,23192,21971,1221,5.3
55033,2020-02-01,24528,23514,1014,4.1
55035,2020-02-01,58341,56618,1723,3
55037,2020-02-01,2133,2023,110,5.2
55039,2020-02-01,55876,54181,1695,3
55041,2020-02-01,3962,3745,217,5.5
55043,2020-02-01,27789,26714,1075,3.9
55045,2020-02-01,20969,20255,714,3.4
55047,2020-02-01,8913,8447,466,5.2
55049,2020-02-01,13582,13070,512,3.8
55051,2020-02-01,2498,2336,162,6.5
55053,2020-02-01,9750,9198,552,5.7
55055,2020-02-01,45443,43842,1601,3.5
55057,2020-02-01,13186,12600,586,4.4
55059,2020-02-01,88622,85018,3604,4.1
55061,2020-02-01,10719,10365,354,3.3
55063,2020-02-01,66065,64191,1874,2.8
55065,2020-02-01,9883,9567,316,3.2
55067,2020-02-01,9129,8682,447,4.9
55069,2020-02-01,14626,13924,702,4.8
55071,2020-02-01,40388,38846,1542,3.8
55073,2020-02-01,72101,70012,2089,2.9
55075,2020-02-01,19248,18283,965,5
55077,2020-02-01,7686,7254,432,5.6
55078,2020-02-01,1525,1437,88,5.8
55079,2020-02-01,461262,443894,17368,3.8
55081,2020-02-01,22986,22217,769,3.3
55083,2020-02-01,20335,19362,973,4.8
55085,2020-02-01,17309,16350,959,5.5
55087,2020-02-01,102826,99872,2954,2.9
55089,2020-02-01,48323,47118,1205,2.5
55091,2020-02-01,3987,3791,196,4.9
55093,2020-02-01,25280,24176,1104,4.4
55095,2020-02-01,24841,23388,1453,5.8
55097,2020-02-01,38468,37156,1312,3.4
55099,2020-02-01,6105,5765,340,5.6
55101,2020-02-01,96860,92649,4211,4.3
55103,2020-02-01,8926,8599,327,3.7
55105,2020-02-01,84643,81221,3422,4
55107,2020-02-01,6664,6256,408,6.1
55109,2020-02-01,50667,48554,2113,4.2
55111,2020-02-01,34371,33188,1183,3.4
55113,2020-02-01,7721,7233,488,6.3
55115,2020-02-01,20758,19941,817,3.9
55117,2020-02-01,60490,58807,1683,2.8
55119,2020-02-01,10814,10221,593,5.5
55121,2020-02-01,15738,15045,693,4.4
55123,2020-02-01,14935,14311,624,4.2
55125,2020-02-01,9703,9187,516,5.3
55127,2020-02-01,56954,54896,2058,3.6
55129,2020-02-01,7588,7201,387,5.1
55131,2020-02-01,76647,74444,2203,2.9
55133,2020-02-01,223213,217042,6171,2.8
55135,2020-02-01,25397,24532,865,3.4
55137,2020-02-01,11086,10543,543,4.9
55139,2020-02-01,91152,88642,2510,2.8
55141,2020-02-01,33976,32566,1410,4.1
56001,2020-02-01,20626,19887,739,3.6
56003,2020-02-01,5142,4809,333,6.5
56005,2020-02-01,23853,22798,1055,4.4
56007,2020-02-01,7566,7162,404,5.3
56009,2020-02-01,8777,8450,327,3.7
56011,2020-02-01,3745,3608,137,3.7
56013,2020-02-01,19306,18133,1173,6.1
56015,2020-02-01,6516,6247,269,4.1
56017,2020-02-01,2219,2111,108,4.9
56019,2020-02-01,4055,3856,199,4.9
56021,2020-02-01,50954,48652,2302,4.5
56023,2020-02-01,9246,8818,428,4.6
56025,2020-02-01,40892,38769,2123,5.2
56027,2020-02-01,1245,1195,50,4
56029,2020-02-01,14689,13849,840,5.7
56031,2020-02-01,4561,4314,247,5.4
56033,2020-02-01,15967,15182,785,4.9
56035,2020-02-01,4019,3724,295,7.3
56037,2020-02-01,21221,19895,1326,6.2
56039,2020-02-01,15695,15227,468,3
56041,2020-02-01,9178,8716,462,5
56043,2020-02-01,3979,3752,227,5.7
56045,2020-02-01,3911,3770,141,3.6
72001,2020-02-01,4217,3442,775,18.4
72003,2020-02-01,11562,10449,1113,9.6
72005,2020-02-01,13932,12668,1264,9.1
72007,2020-02-01,6343,5772,571,9
72009,2020-02-01,6200,5610,590,9.5
72011,2020-02-01,8608,7905,703,8.2
72013,2020-02-01,23205,21085,2120,9.1
72015,2020-02-01,4647,4012,635,13.7
72017,2020-02-01,5775,5152,623,10.8
72019,2020-02-01,7078,6526,552,7.8
72021,2020-02-01,62581,59046,3535,5.6
72023,2020-02-01,13107,12014,1093,8.3
72025,2020-02-01,46150,43342,2808,6.1
72027,2020-02-01,9199,8444,755,8.2
72029,2020-02-01,15642,14688,954,6.1
72031,2020-02-01,59013,55951,3062,5.2
72033,2020-02-01,7501,7031,470,6.3
72035,2020-02-01,15592,14587,1005,6.4
72037,2020-02-01,3494,3211,283,8.1
72039,2020-02-01,3530,3168,362,10.3
72041,2020-02-01,14916,14050,866,5.8
72043,2020-02-01,9647,8527,1120,11.6
72045,2020-02-01,4779,4333,446,9.3
72047,2020-02-01,8533,7835,698,8.2
72049,2020-02-01,860,834,26,3
72051,2020-02-01,12858,12187,671,5.2
72053,2020-02-01,10321,9458,863,8.4
72054,2020-02-01,3212,2876,336,10.5
72055,2020-02-01,4038,3376,662,16.4
72057,2020-02-01,10708,9598,1110,10.4
72059,2020-02-01,4715,4012,703,14.9
72061,2020-02-01,36407,35047,1360,3.7
72063,2020-02-01,17880,16916,964,5.4
72065,2020-02-01,13705,11722,1983,14.5
72067,2020-02-01,5169,4766,403,7.8
72069,2020-02-01,16631,15075,1556,9.4
72071,2020-02-01,11405,10395,1010,8.9
72073,2020-02-01,4153,3633,520,12.5
72075,2020-02-01,14948,13655,1293,8.6
72077,2020-02-01,11943,11044,899,7.5
72079,2020-02-01,5000,4381,619,12.4
72081,2020-02-01,6917,5773,1144,16.5
72083,2020-02-01,2433,2136,297,12.2
72085,2020-02-01,11021,10141,880,8
72087,2020-02-01,8135,7514,621,7.6
72089,2020-02-01,5953,5478,475,8
72091,2020-02-01,11075,10267,808,7.3
72093,2020-02-01,1936,1629,307,15.9
72095,2020-02-01,2938,2422,516,17.6
72097,2020-02-01,20770,18789,1981,9.5
72099,2020-02-01,10134,9112,1022,10.1
72101,2020-02-01,7728,7095,633,8.2
72103,2020-02-01,7957,7324,633,8
72105,2020-02-01,6835,6293,542,7.9
72107,2020-02-01,4799,4271,528,11
72109,2020-02-01,4258,3570,688,16.2
72111,2020-02-01,5580,4865,715,12.8
72113,2020-02-01,43229,39507,3722,8.6
72115,2020-02-01,5909,5259,650,11
72117,2020-02-01,4868,4012,856,17.6
72119,2020-02-01,16327,15279,1048,6.4
72121,2020-02-01,5898,5104,794,13.5
72123,2020-02-01,6747,5855,892,13.2
72125,2020-02-01,9284,8284,1000,10.8
72127,2020-02-01,128613,122258,6355,4.9
72129,2020-02-01,11377,10389,988,8.7
72131,2020-02-01,10018,8546,1472,14.7
72133,2020-02-01,9234,8464,770,8.3
72135,2020-02-01,26474,25136,1338,5.1
72137,2020-02-01,28049,26584,1465,5.2
72139,2020-02-01,26118,24974,1144,4.4
72141,2020-02-01,6513,5714,799,12.3
72143,2020-02-01,9471,8730,741,7.8
72145,2020-02-01,12689,11596,1093,8.6
72147,2020-02-01,2543,2394,149,5.9
72149,2020-02-01,7418,6066,1352,18.2
72151,2020-02-01,8570,7491,1079,12.6
72153,2020-02-01,9828,8121,1707,17.4
01001,2020-03-01,26085,25422,663,2.5
01003,2020-03-01,96986,94568,2418,2.5
01005,2020-03-01,8510,8222,288,3.4
01007,2020-03-01,8550,8304,246,2.9
01009,2020-03-01,24919,24296,623,2.5
01011,2020-03-01,4659,4516,143,3.1
01013,2020-03-01,8986,8652,334,3.7
01015,2020-03-01,45990,44515,1475,3.2
01017,2020-03-01,15730,15288,442,2.8
01019,2020-03-01,11634,11328,306,2.6
01021,2020-03-01,19588,19109,479,2.4
01023,2020-03-01,4497,4289,208,4.6
01025,2020-03-01,7591,7184,407,5.4
01027,2020-03-01,6123,5962,161,2.6
01029,2020-03-01,5752,5578,174,3
01031,2020-03-01,21555,20993,562,2.6
01033,2020-03-01,23567,22790,777,3.3
01035,2020-03-01,4436,4281,155,3.5
01037,2020-03-01,4423,4298,125,2.8
01039,2020-03-01,15081,14608,473,3.1
01041,2020-03-01,6269,6095,174,2.8
01043,2020-03-01,38495,37574,921,2.4
01045,2020-03-01,20450,19905,545,2.7
01047,2020-03-01,14350,13663,687,4.8
01049,2020-03-01,30848,30043,805,2.6
01051,2020-03-01,36987,36085,902,2.4
01053,2020-03-01,14467,13985,482,3.3
01055,2020-03-01,41527,39968,1559,3.8
01057,2020-03-01,6551,6376,175,2.7
01059,2020-03-01,14537,14163,374,2.6
01061,2020-03-01,10791,10503,288,2.7
01063,2020-03-01,2965,2821,144,4.9
01065,2020-03-01,6021,5783,238,4
01067,2020-03-01,6808,6592,216,3.2
01069,2020-03-01,45977,44728,1249,2.7
01071,2020-03-01,22954,22246,708,3.1
01073,2020-03-01,313814,305572,8242,2.6
01075,2020-03-01,5699,5532,167,2.9
01077,2020-03-01,42207,41017,1190,2.8
01079,2020-03-01,14289,13907,382,2.7
01081,2020-03-01,75701,73766,1935,2.6
01083,2020-03-01,44796,43726,1070,2.4
01085,2020-03-01,3431,3269,162,4.7
01087,2020-03-01,7824,7529,295,3.8
01089,2020-03-01,187365,183067,4298,2.3
01091,2020-03-01,7688,7429,259,3.4
01093,2020-03-01,12826,12424,402,3.1
01095,2020-03-01,44194,43191,1003,2.3
01097,2020-03-01,188033,181486,6547,3.5
01099,2020-03-01,7382,7051,331,4.5
01101,2020-03-01,105385,102296,3089,2.9
01103,2020-03-01,58764,57423,1341,2.3
01105,2020-03-01,3290,3140,150,4.6
01107,2020-03-01,7898,7601,297,3.8
01109,2020-03-01,15432,14986,446,2.9
01111,2020-03-01,9479,9217,262,2.8
01113,2020-03-01,23871,23188,683,2.9
01115,2020-03-01,40281,39307,974,2.4
01117,2020-03-01,115409,113071,2338,2
01119,2020-03-01,4659,4480,179,3.8
01121,2020-03-01,35633,34515,1118,3.1
01123,2020-03-01,18043,17506,537,3
01125,2020-03-01,104708,102239,2469,2.4
01127,2020-03-01,24916,24135,781,3.1
01129,2020-03-01,6612,6334,278,4.2
01131,2020-03-01,2679,2465,214,8
01133,2020-03-01,10165,9860,305,3
02013,2020-03-01,2876,2806,70,2.4
02016,2020-03-01,4903,4804,99,2
02020,2020-03-01,148587,141117,7470,5
02050,2020-03-01,7368,6499,869,11.8
02060,2020-03-01,223,189,34,15.2
02068,2020-03-01,596,490,106,17.8
02070,2020-03-01,1682,1541,141,8.4
02090,2020-03-01,45115,42748,2367,5.2
02100,2020-03-01,958,811,147,15.3
02105,2020-03-01,1027,872,155,15.1
02110,2020-03-01,16576,15843,733,4.4
02122,2020-03-01,25893,23923,1970,7.6
02130,2020-03-01,6423,5927,496,7.7
02150,2020-03-01,6091,5820,271,4.4
02158,2020-03-01,2366,1859,507,21.4
02164,2020-03-01,603,533,70,11.6
02170,2020-03-01,48486,44974,3512,7.2
02180,2020-03-01,4053,3622,431,10.6
02185,2020-03-01,3845,3668,177,4.6
02188,2020-03-01,2899,2522,377,13
02195,2020-03-01,1401,1264,137,9.8
02198,2020-03-01,2804,2519,285,10.2
02220,2020-03-01,4029,3841,188,4.7
02230,2020-03-01,556,446,110,19.8
02240,2020-03-01,2923,2679,244,8.3
02261,2020-03-01,4140,3697,443,10.7
02275,2020-03-01,986,911,75,7.6
02282,2020-03-01,251,226,25,10
02290,2020-03-01,2324,2003,321,13.8
04001,2020-03-01,20855,18403,2452,11.8
04003,2020-03-01,52122,48963,3159,6.1
04005,2020-03-01,77285,72012,5273,6.8
04007,2020-03-01,20757,19407,1350,6.5
04009,2020-03-01,16078,15204,874,5.4
04011,2020-03-01,4586,4391,195,4.3
04012,2020-03-01,9803,9166,637,6.5
04013,2020-03-01,NA,NA,105646,4.5
04015,2020-03-01,87760,82037,5723,6.5
04017,2020-03-01,40313,36704,3609,9
04019,2020-03-01,500907,475882,25025,5
04021,2020-03-01,193855,183226,10629,5.5
04023,2020-03-01,20033,18269,1764,8.8
04025,2020-03-01,106658,101392,5266,4.9
04027,2020-03-01,102359,87812,14547,14.2
05001,2020-03-01,9490,9168,322,3.4
05003,2020-03-01,7192,6609,583,8.1
05005,2020-03-01,16589,15854,735,4.4
05007,2020-03-01,141979,137758,4221,3
05009,2020-03-01,16053,15445,608,3.8
05011,2020-03-01,4393,4186,207,4.7
05013,2020-03-01,2455,2323,132,5.4
05015,2020-03-01,12767,12291,476,3.7
05017,2020-03-01,3185,2903,282,8.9
05019,2020-03-01,9520,9128,392,4.1
05021,2020-03-01,5603,5251,352,6.3
05023,2020-03-01,9208,8672,536,5.8
05025,2020-03-01,3231,3062,169,5.2
05027,2020-03-01,9078,8612,466,5.1
05029,2020-03-01,8384,7978,406,4.8
05031,2020-03-01,56538,54667,1871,3.3
05033,2020-03-01,26561,25552,1009,3.8
05035,2020-03-01,21048,20060,988,4.7
05037,2020-03-01,7409,7077,332,4.5
05039,2020-03-01,2773,2639,134,4.8
05041,2020-03-01,5419,5127,292,5.4
05043,2020-03-01,7783,7311,472,6.1
05045,2020-03-01,62722,60482,2240,3.6
05047,2020-03-01,7453,7146,307,4.1
05049,2020-03-01,5139,4922,217,4.2
05051,2020-03-01,41923,40163,1760,4.2
05053,2020-03-01,8415,8073,342,4.1
05055,2020-03-01,19774,18933,841,4.3
05057,2020-03-01,9777,9328,449,4.6
05059,2020-03-01,14216,13647,569,4
05061,2020-03-01,5561,5327,234,4.2
05063,2020-03-01,16737,15994,743,4.4
05065,2020-03-01,4782,4432,350,7.3
05067,2020-03-01,5834,5422,412,7.1
05069,2020-03-01,27349,25615,1734,6.3
05071,2020-03-01,10340,9864,476,4.6
05073,2020-03-01,2409,2275,134,5.6
05075,2020-03-01,6965,6648,317,4.6
05077,2020-03-01,2768,2584,184,6.6
05079,2020-03-01,3878,3671,207,5.3
05081,2020-03-01,5501,5217,284,5.2
05083,2020-03-01,8647,8242,405,4.7
05085,2020-03-01,34306,32841,1465,4.3
05087,2020-03-01,7561,7334,227,3
05089,2020-03-01,6449,6135,314,4.9
05091,2020-03-01,19659,18710,949,4.8
05093,2020-03-01,17438,16350,1088,6.2
05095,2020-03-01,2728,2588,140,5.1
05097,2020-03-01,2972,2792,180,6.1
05099,2020-03-01,3594,3430,164,4.6
05101,2020-03-01,3333,3190,143,4.3
05103,2020-03-01,9869,9319,550,5.6
05105,2020-03-01,4294,4105,189,4.4
05107,2020-03-01,6384,5932,452,7.1
05109,2020-03-01,4220,4023,197,4.7
05111,2020-03-01,10122,9693,429,4.2
05113,2020-03-01,8100,7615,485,6
05115,2020-03-01,28264,27030,1234,4.4
05117,2020-03-01,3674,3485,189,5.1
05119,2020-03-01,189348,181346,8002,4.2
05121,2020-03-01,7434,7084,350,4.7
05123,2020-03-01,8074,7605,469,5.8
05125,2020-03-01,59259,57289,1970,3.3
05127,2020-03-01,4383,4221,162,3.7
05129,2020-03-01,2899,2730,169,5.8
05131,2020-03-01,56180,53989,2191,3.9
05133,2020-03-01,5573,5257,316,5.7
05135,2020-03-01,5806,5466,340,5.9
05137,2020-03-01,4568,4315,253,5.5
05139,2020-03-01,15714,14680,1034,6.6
05141,2020-03-01,5764,5431,333,5.8
05143,2020-03-01,127490,123954,3536,2.8
05145,2020-03-01,34424,32534,1890,5.5
05147,2020-03-01,2842,2685,157,5.5
05149,2020-03-01,8186,7841,345,4.2
06001,2020-03-01,836794,807475,29319,3.5
06003,2020-03-01,635,600,35,5.5
06005,2020-03-01,14829,14104,725,4.9
06007,2020-03-01,97618,91671,5947,6.1
06009,2020-03-01,21520,20462,1058,4.9
06011,2020-03-01,11262,8853,2409,21.4
06013,2020-03-01,556452,536153,20299,3.6
06015,2020-03-01,9658,8996,662,6.9
06017,2020-03-01,92302,88424,3878,4.2
06019,2020-03-01,456060,411184,44876,9.8
06021,2020-03-01,13187,12128,1059,8
06023,2020-03-01,61972,59226,2746,4.4
06025,2020-03-01,72740,58154,14586,20.1
06027,2020-03-01,8575,8196,379,4.4
06029,2020-03-01,386184,343734,42450,11
06031,2020-03-01,58171,51599,6572,11.3
06033,2020-03-01,28729,26844,1885,6.6
06035,2020-03-01,9490,8863,627,6.6
06037,2020-03-01,NA,NA,276380,5.6
06039,2020-03-01,62882,56859,6023,9.6
06041,2020-03-01,136518,132678,3840,2.8
06043,2020-03-01,7524,7018,506,6.7
06045,2020-03-01,38576,36529,2047,5.3
06047,2020-03-01,118777,105021,13756,11.6
06049,2020-03-01,3219,2890,329,10.2
06051,2020-03-01,8741,8353,388,4.4
06053,2020-03-01,214867,190898,23969,11.2
06055,2020-03-01,71732,69066,2666,3.7
06057,2020-03-01,48239,46217,2022,4.2
06059,2020-03-01,NA,NA,52690,3.3
06061,2020-03-01,188877,181996,6881,3.6
06063,2020-03-01,7655,6745,910,11.9
06065,2020-03-01,NA,NA,52935,4.7
06067,2020-03-01,712334,681588,30746,4.3
06069,2020-03-01,32499,30239,2260,7
06071,2020-03-01,975656,932533,43123,4.4
06073,2020-03-01,NA,NA,59209,3.8
06075,2020-03-01,579164,563046,16118,2.8
06077,2020-03-01,330476,305740,24736,7.5
06079,2020-03-01,138870,134010,4860,3.5
06081,2020-03-01,455106,443654,11452,2.5
06083,2020-03-01,222676,211697,10979,4.9
06085,2020-03-01,NA,NA,31437,3
06087,2020-03-01,139057,128799,10258,7.4
06089,2020-03-01,73347,68823,4524,6.2
06091,2020-03-01,1303,1202,101,7.8
06093,2020-03-01,17091,15521,1570,9.2
06095,2020-03-01,206981,197507,9474,4.6
06097,2020-03-01,254505,246009,8496,3.3
06099,2020-03-01,244322,225817,18505,7.6
06101,2020-03-01,46674,41886,4788,10.3
06103,2020-03-01,26103,24313,1790,6.9
06105,2020-03-01,4503,4135,368,8.2
06107,2020-03-01,206179,178986,27193,13.2
06109,2020-03-01,20485,19276,1209,5.9
06111,2020-03-01,421354,403490,17864,4.2
06113,2020-03-01,108570,102733,5837,5.4
06115,2020-03-01,30638,28229,2409,7.9
08001,2020-03-01,270244,255659,14585,5.4
08003,2020-03-01,8087,7551,536,6.6
08005,2020-03-01,360457,343008,17449,4.8
08007,2020-03-01,6565,6158,407,6.2
08009,2020-03-01,1934,1863,71,3.7
08011,2020-03-01,1702,1616,86,5.1
08013,2020-03-01,193451,185575,7876,4.1
08014,2020-03-01,39923,38119,1804,4.5
08015,2020-03-01,9237,8828,409,4.4
08017,2020-03-01,1005,975,30,3
08019,2020-03-01,5970,5703,267,4.5
08021,2020-03-01,3926,3613,313,8
08023,2020-03-01,1735,1621,114,6.6
08025,2020-03-01,1496,1384,112,7.5
08027,2020-03-01,2000,1886,114,5.7
08029,2020-03-01,13508,12527,981,7.3
08031,2020-03-01,415027,394709,20318,4.9
08033,2020-03-01,1019,948,71,7
08035,2020-03-01,194146,186103,8043,4.1
08037,2020-03-01,36797,35493,1304,3.5
08039,2020-03-01,14845,14215,630,4.2
08041,2020-03-01,339157,319634,19523,5.8
08043,2020-03-01,14575,13388,1187,8.1
08045,2020-03-01,32398,30616,1782,5.5
08047,2020-03-01,3756,3611,145,3.9
08049,2020-03-01,10109,9733,376,3.7
08051,2020-03-01,11278,10856,422,3.7
08053,2020-03-01,383,363,20,5.2
08055,2020-03-01,2564,2269,295,11.5
08057,2020-03-01,826,778,48,5.8
08059,2020-03-01,329511,314530,14981,4.5
08061,2020-03-01,838,815,23,2.7
08063,2020-03-01,3885,3755,130,3.3
08065,2020-03-01,5065,4892,173,3.4
08067,2020-03-01,30596,29048,1548,5.1
08069,2020-03-01,200202,191338,8864,4.4
08071,2020-03-01,6196,5756,440,7.1
08073,2020-03-01,2207,2095,112,5.1
08075,2020-03-01,10420,9973,447,4.3
08077,2020-03-01,75042,70188,4854,6.5
08079,2020-03-01,538,520,18,3.3
08081,2020-03-01,7178,6649,529,7.4
08083,2020-03-01,12329,11211,1118,9.1
08085,2020-03-01,20800,19356,1444,6.9
08087,2020-03-01,15295,14576,719,4.7
08089,2020-03-01,7843,7297,546,7
08091,2020-03-01,2269,2129,140,6.2
08093,2020-03-01,11043,10573,470,4.3
08095,2020-03-01,2217,2153,64,2.9
08097,2020-03-01,10901,10456,445,4.1
08099,2020-03-01,5828,5569,259,4.4
08101,2020-03-01,76877,71550,5327,6.9
08103,2020-03-01,2838,2642,196,6.9
08105,2020-03-01,5002,4560,442,8.8
08107,2020-03-01,16378,15776,602,3.7
08109,2020-03-01,3226,2949,277,8.6
08111,2020-03-01,498,468,30,6
08113,2020-03-01,5963,5760,203,3.4
08115,2020-03-01,1070,1029,41,3.8
08117,2020-03-01,24589,23923,666,2.7
08119,2020-03-01,12734,12058,676,5.3
08121,2020-03-01,2630,2536,94,3.6
08123,2020-03-01,164607,156655,7952,4.8
08125,2020-03-01,4942,4779,163,3.3
09001,2020-03-01,475773,455894,19879,4.2
09003,2020-03-01,483429,462722,20707,4.3
09005,2020-03-01,103999,99575,4424,4.3
09007,2020-03-01,93989,90491,3498,3.7
09009,2020-03-01,461032,440498,20534,4.5
09011,2020-03-01,134361,128569,5792,4.3
09013,2020-03-01,87082,83893,3189,3.7
09015,2020-03-01,63988,61053,2935,4.6
10001,2020-03-01,79448,74816,4632,5.8
10003,2020-03-01,299400,284645,14755,4.9
10005,2020-03-01,103196,97290,5906,5.7
11001,2020-03-01,420428,397484,22944,5.5
12001,2020-03-01,142645,136097,6548,4.6
12003,2020-03-01,12242,11659,583,4.8
12005,2020-03-01,85997,81748,4249,4.9
12007,2020-03-01,11287,10559,728,6.4
12009,2020-03-01,290746,275523,15223,5.2
12011,2020-03-01,NA,NA,63142,5.9
12013,2020-03-01,4950,4668,282,5.7
12015,2020-03-01,74827,70503,4324,5.8
12017,2020-03-01,48742,44934,3808,7.8
12019,2020-03-01,109715,104317,5398,4.9
12021,2020-03-01,189817,180585,9232,4.9
12023,2020-03-01,30467,28853,1614,5.3
12027,2020-03-01,15441,14547,894,5.8
12029,2020-03-01,6043,5680,363,6
12031,2020-03-01,499889,472332,27557,5.5
12033,2020-03-01,149662,141602,8060,5.4
12035,2020-03-01,49165,46170,2995,6.1
12037,2020-03-01,4860,4628,232,4.8
12039,2020-03-01,19221,17924,1297,6.7
12041,2020-03-01,7517,7122,395,5.3
12043,2020-03-01,5582,5248,334,6
12045,2020-03-01,5268,4969,299,5.7
12047,2020-03-01,4317,4012,305,7.1
12049,2020-03-01,8888,8252,636,7.2
12051,2020-03-01,16654,15310,1344,8.1
12053,2020-03-01,74796,69514,5282,7.1
12055,2020-03-01,36748,33982,2766,7.5
12057,2020-03-01,783833,741375,42458,5.4
12059,2020-03-01,7100,6691,409,5.8
12061,2020-03-01,68049,63945,4104,6
12063,2020-03-01,17655,16706,949,5.4
12065,2020-03-01,5632,5324,308,5.5
12067,2020-03-01,2902,2768,134,4.6
12069,2020-03-01,166285,157299,8986,5.4
12071,2020-03-01,364016,345186,18830,5.2
12073,2020-03-01,157989,150095,7894,5
12075,2020-03-01,17131,16124,1007,5.9
12077,2020-03-01,2755,2604,151,5.5
12079,2020-03-01,7777,7333,444,5.7
12081,2020-03-01,186126,176406,9720,5.2
12083,2020-03-01,143537,134583,8954,6.2
12085,2020-03-01,75878,72134,3744,4.9
12086,2020-03-01,NA,NA,29164,2.2
12087,2020-03-01,48644,47001,1643,3.4
12089,2020-03-01,42754,40705,2049,4.8
12091,2020-03-01,98873,94531,4342,4.4
12093,2020-03-01,18068,17139,929,5.1
12095,2020-03-01,778591,739468,39123,5
12097,2020-03-01,190744,180064,10680,5.6
12099,2020-03-01,759487,718463,41024,5.4
12101,2020-03-01,248049,233697,14352,5.8
12103,2020-03-01,501479,475643,25836,5.2
12105,2020-03-01,320814,301743,19071,5.9
12107,2020-03-01,27314,25184,2130,7.8
12109,2020-03-01,138716,132717,5999,4.3
12111,2020-03-01,152618,142765,9853,6.5
12113,2020-03-01,86163,82123,4040,4.7
12115,2020-03-01,194127,184326,9801,5
12117,2020-03-01,260066,247392,12674,4.9
12119,2020-03-01,34598,32009,2589,7.5
12121,2020-03-01,18424,17408,1016,5.5
12123,2020-03-01,8426,7967,459,5.4
12125,2020-03-01,4720,4505,215,4.6
12127,2020-03-01,262320,246970,15350,5.9
12129,2020-03-01,15717,15006,711,4.5
12131,2020-03-01,32897,31408,1489,4.5
12133,2020-03-01,9980,9437,543,5.4
13001,2020-03-01,9349,8988,361,3.9
13003,2020-03-01,4479,4330,149,3.3
13005,2020-03-01,4845,4643,202,4.2
13007,2020-03-01,1199,1144,55,4.6
13009,2020-03-01,18020,17182,838,4.7
13011,2020-03-01,10004,9703,301,3
13013,2020-03-01,41649,40417,1232,3
13015,2020-03-01,51307,49504,1803,3.5
13017,2020-03-01,5557,5242,315,5.7
13019,2020-03-01,7608,7272,336,4.4
13021,2020-03-01,68414,65570,2844,4.2
13023,2020-03-01,4685,4439,246,5.3
13025,2020-03-01,7229,6959,270,3.7
13027,2020-03-01,7076,6785,291,4.1
13029,2020-03-01,19561,18951,610,3.1
13031,2020-03-01,38179,36530,1649,4.3
13033,2020-03-01,9273,8838,435,4.7
13035,2020-03-01,11107,10703,404,3.6
13037,2020-03-01,2347,2254,93,4
13039,2020-03-01,21416,20679,737,3.4
13043,2020-03-01,5716,5547,169,3
13045,2020-03-01,56239,54120,2119,3.8
13047,2020-03-01,33639,32680,959,2.9
13049,2020-03-01,5003,4833,170,3.4
13051,2020-03-01,144250,138926,5324,3.7
13053,2020-03-01,2074,1976,98,4.7
13055,2020-03-01,9971,9509,462,4.6
13057,2020-03-01,138205,134270,3935,2.8
13059,2020-03-01,59881,57596,2285,3.8
13061,2020-03-01,887,831,56,6.3
13063,2020-03-01,140445,133157,7288,5.2
13065,2020-03-01,2994,2889,105,3.5
13067,2020-03-01,427685,413697,13988,3.3
13069,2020-03-01,18971,18110,861,4.5
13071,2020-03-01,22135,21336,799,3.6
13073,2020-03-01,77217,74949,2268,2.9
13075,2020-03-01,8255,7980,275,3.3
13077,2020-03-01,76097,73686,2411,3.2
13079,2020-03-01,5676,5485,191,3.4
13081,2020-03-01,9690,9220,470,4.9
13083,2020-03-01,8114,7865,249,3.1
13085,2020-03-01,12793,12433,360,2.8
13087,2020-03-01,11563,11144,419,3.6
13089,2020-03-01,402981,386586,16395,4.1
13091,2020-03-01,7080,6715,365,5.2
13093,2020-03-01,5002,4798,204,4.1
13095,2020-03-01,38230,36327,1903,5
13097,2020-03-01,73928,71032,2896,3.9
13099,2020-03-01,4504,4309,195,4.3
13101,2020-03-01,1978,1919,59,3
13103,2020-03-01,32868,31921,947,2.9
13105,2020-03-01,8120,7766,354,4.4
13107,2020-03-01,8524,8070,454,5.3
13109,2020-03-01,5037,4846,191,3.8
13111,2020-03-01,11241,10848,393,3.5
13113,2020-03-01,58601,56692,1909,3.3
13115,2020-03-01,44038,42416,1622,3.7
13117,2020-03-01,125985,122454,3531,2.8
13119,2020-03-01,10217,9797,420,4.1
13121,2020-03-01,567554,544096,23458,4.1
13123,2020-03-01,12224,11815,409,3.3
13125,2020-03-01,1296,1247,49,3.8
13127,2020-03-01,38847,37527,1320,3.4
13129,2020-03-01,28873,27963,910,3.2
13131,2020-03-01,10903,10562,341,3.1
13133,2020-03-01,7170,6879,291,4.1
13135,2020-03-01,494574,478274,16300,3.3
13137,2020-03-01,19422,18704,718,3.7
13139,2020-03-01,104362,101487,2875,2.8
13141,2020-03-01,2591,2435,156,6
13143,2020-03-01,12681,12220,461,3.6
13145,2020-03-01,17167,16657,510,3
13147,2020-03-01,11556,11086,470,4.1
13149,2020-03-01,5285,5093,192,3.6
13151,2020-03-01,118121,113550,4571,3.9
13153,2020-03-01,72148,69763,2385,3.3
13155,2020-03-01,3562,3398,164,4.6
13157,2020-03-01,39672,38570,1102,2.8
13159,2020-03-01,7041,6815,226,3.2
13161,2020-03-01,6286,6015,271,4.3
13163,2020-03-01,6769,6442,327,4.8
13165,2020-03-01,3235,3069,166,5.1
13167,2020-03-01,4054,3897,157,3.9
13169,2020-03-01,13835,13394,441,3.2
13171,2020-03-01,8283,7923,360,4.3
13173,2020-03-01,3827,3675,152,4
13175,2020-03-01,19477,18456,1021,5.2
13177,2020-03-01,15312,14839,473,3.1
13179,2020-03-01,26256,25229,1027,3.9
13181,2020-03-01,3628,3489,139,3.8
13183,2020-03-01,8441,8142,299,3.5
13185,2020-03-01,52489,50499,1990,3.8
13187,2020-03-01,17170,16624,546,3.2
13189,2020-03-01,8890,8439,451,5.1
13191,2020-03-01,6148,5926,222,3.6
13193,2020-03-01,4751,4519,232,4.9
13195,2020-03-01,13426,12992,434,3.2
13197,2020-03-01,3340,3198,142,4.3
13199,2020-03-01,8947,8550,397,4.4
13201,2020-03-01,2922,2797,125,4.3
13205,2020-03-01,8656,8252,404,4.7
13207,2020-03-01,13106,12661,445,3.4
13209,2020-03-01,4009,3849,160,4
13211,2020-03-01,9461,9162,299,3.2
13213,2020-03-01,15659,14944,715,4.6
13215,2020-03-01,78722,75239,3483,4.4
13217,2020-03-01,53441,51184,2257,4.2
13219,2020-03-01,20043,19526,517,2.6
13221,2020-03-01,7057,6845,212,3
13223,2020-03-01,88502,85732,2770,3.1
13225,2020-03-01,12061,11589,472,3.9
13227,2020-03-01,15593,15085,508,3.3
13229,2020-03-01,8736,8465,271,3.1
13231,2020-03-01,9074,8773,301,3.3
13233,2020-03-01,18701,17981,720,3.9
13235,2020-03-01,4125,3971,154,3.7
13237,2020-03-01,8416,8045,371,4.4
13239,2020-03-01,823,785,38,4.6
13241,2020-03-01,7287,7013,274,3.8
13243,2020-03-01,2620,2505,115,4.4
13245,2020-03-01,86664,82813,3851,4.4
13247,2020-03-01,45075,43152,1923,4.3
13249,2020-03-01,2235,2158,77,3.4
13251,2020-03-01,5167,4913,254,4.9
13253,2020-03-01,3215,3077,138,4.3
13255,2020-03-01,29076,27768,1308,4.5
13257,2020-03-01,10634,10225,409,3.8
13259,2020-03-01,2564,2460,104,4.1
13261,2020-03-01,12895,12222,673,5.2
13263,2020-03-01,2799,2694,105,3.8
13265,2020-03-01,537,508,29,5.4
13267,2020-03-01,10074,9679,395,3.9
13269,2020-03-01,2821,2700,121,4.3
13271,2020-03-01,3893,3532,361,9.3
13273,2020-03-01,3565,3411,154,4.3
13275,2020-03-01,17359,16669,690,4
13277,2020-03-01,20849,20138,711,3.4
13279,2020-03-01,12341,11788,553,4.5
13281,2020-03-01,3950,3756,194,4.9
13283,2020-03-01,2736,2605,131,4.8
13285,2020-03-01,38277,37023,1254,3.3
13287,2020-03-01,3262,3115,147,4.5
13289,2020-03-01,2891,2724,167,5.8
13291,2020-03-01,10582,10249,333,3.1
13293,2020-03-01,11655,11208,447,3.8
13295,2020-03-01,31503,30507,996,3.2
13297,2020-03-01,46647,45109,1538,3.3
13299,2020-03-01,15656,15059,597,3.8
13301,2020-03-01,2658,2537,121,4.6
13303,2020-03-01,7078,6783,295,4.2
13305,2020-03-01,11618,11096,522,4.5
13307,2020-03-01,1053,1002,51,4.8
13309,2020-03-01,1667,1546,121,7.3
13311,2020-03-01,16656,16183,473,2.8
13313,2020-03-01,43972,42250,1722,3.9
13315,2020-03-01,2804,2675,129,4.6
13317,2020-03-01,3785,3588,197,5.2
13319,2020-03-01,3887,3741,146,3.8
13321,2020-03-01,9238,8835,403,4.4
15001,2020-03-01,91621,89195,2426,2.6
15003,2020-03-01,455618,446492,9126,2
15007,2020-03-01,36666,35838,828,2.3
15009,2020-03-01,87053,85236,1817,2.1
16001,2020-03-01,257119,250529,6590,2.6
16003,2020-03-01,1719,1553,166,9.7
16005,2020-03-01,42712,41350,1362,3.2
16007,2020-03-01,2979,2871,108,3.6
16009,2020-03-01,4096,3751,345,8.4
16011,2020-03-01,23231,22524,707,3
16013,2020-03-01,12689,12247,442,3.5
16015,2020-03-01,3620,3411,209,5.8
16017,2020-03-01,20684,19480,1204,5.8
16019,2020-03-01,56962,55352,1610,2.8
16021,2020-03-01,5373,5026,347,6.5
16023,2020-03-01,1339,1306,33,2.5
16025,2020-03-01,675,654,21,3.1
16027,2020-03-01,105505,102004,3501,3.3
16029,2020-03-01,4063,3932,131,3.2
16031,2020-03-01,11952,11645,307,2.6
16033,2020-03-01,361,342,19,5.3
16035,2020-03-01,3049,2748,301,9.9
16037,2020-03-01,1993,1893,100,5
16039,2020-03-01,11585,11162,423,3.7
16041,2020-03-01,7084,6902,182,2.6
16043,2020-03-01,7871,7625,246,3.1
16045,2020-03-01,8382,8065,317,3.8
16047,2020-03-01,8183,7949,234,2.9
16049,2020-03-01,6499,6112,387,6
16051,2020-03-01,13785,13416,369,2.7
16053,2020-03-01,12206,11842,364,3
16055,2020-03-01,79596,76054,3542,4.4
16057,2020-03-01,20611,19990,621,3
16059,2020-03-01,3509,3270,239,6.8
16061,2020-03-01,1591,1474,117,7.4
16063,2020-03-01,2668,2541,127,4.8
16065,2020-03-01,22589,22157,432,1.9
16067,2020-03-01,11306,10991,315,2.8
16069,2020-03-01,20868,20177,691,3.3
16071,2020-03-01,2350,2271,79,3.4
16073,2020-03-01,5434,5220,214,3.9
16075,2020-03-01,11763,11331,432,3.7
16077,2020-03-01,3886,3761,125,3.2
16079,2020-03-01,5462,5075,387,7.1
16081,2020-03-01,6214,6062,152,2.4
16083,2020-03-01,41074,39765,1309,3.2
16085,2020-03-01,5389,5120,269,5
16087,2020-03-01,4680,4471,209,4.5
17001,2020-03-01,30889,29949,940,3
17003,2020-03-01,1915,1797,118,6.2
17005,2020-03-01,7438,7194,244,3.3
17007,2020-03-01,25231,23789,1442,5.7
17009,2020-03-01,3037,2972,65,2.1
17011,2020-03-01,16095,15305,790,4.9
17013,2020-03-01,2228,2138,90,4
17015,2020-03-01,7042,6745,297,4.2
17017,2020-03-01,5796,5573,223,3.8
17019,2020-03-01,109417,106198,3219,2.9
17021,2020-03-01,13468,12830,638,4.7
17023,2020-03-01,7211,6887,324,4.5
17025,2020-03-01,6088,5809,279,4.6
17027,2020-03-01,19894,19353,541,2.7
17029,2020-03-01,23441,22683,758,3.2
17031,2020-03-01,NA,NA,104133,4.1
17033,2020-03-01,8448,8119,329,3.9
17035,2020-03-01,5953,5768,185,3.1
17037,2020-03-01,53485,51360,2125,4
17039,2020-03-01,7171,6909,262,3.7
17041,2020-03-01,10123,9835,288,2.8
17043,2020-03-01,501824,486425,15399,3.1
17045,2020-03-01,8646,8345,301,3.5
17047,2020-03-01,2558,2441,117,4.6
17049,2020-03-01,19337,18792,545,2.8
17051,2020-03-01,9492,9105,387,4.1
17053,2020-03-01,6217,5985,232,3.7
17055,2020-03-01,15703,14913,790,5
17057,2020-03-01,14744,13895,849,5.8
17059,2020-03-01,2002,1889,113,5.6
17061,2020-03-01,5865,5651,214,3.6
17063,2020-03-01,25299,24074,1225,4.8
17065,2020-03-01,4347,4194,153,3.5
17067,2020-03-01,8013,7633,380,4.7
17069,2020-03-01,1262,1185,77,6.1
17071,2020-03-01,3449,3284,165,4.8
17073,2020-03-01,24006,22892,1114,4.6
17075,2020-03-01,13430,12855,575,4.3
17077,2020-03-01,27274,26401,873,3.2
17079,2020-03-01,4473,4300,173,3.9
17081,2020-03-01,16891,16249,642,3.8
17083,2020-03-01,10724,10326,398,3.7
17085,2020-03-01,10268,9750,518,5
17087,2020-03-01,4161,3936,225,5.4
17089,2020-03-01,263525,251241,12284,4.7
17091,2020-03-01,54190,51511,2679,4.9
17093,2020-03-01,68577,66065,2512,3.7
17095,2020-03-01,20702,19699,1003,4.8
17097,2020-03-01,364881,349457,15424,4.2
17099,2020-03-01,52345,49554,2791,5.3
17101,2020-03-01,5696,5445,251,4.4
17103,2020-03-01,16817,16221,596,3.5
17105,2020-03-01,15632,15014,618,4
17107,2020-03-01,12155,11695,460,3.8
17109,2020-03-01,13195,12579,616,4.7
17111,2020-03-01,164395,158286,6109,3.7
17113,2020-03-01,85616,82912,2704,3.2
17115,2020-03-01,46528,44130,2398,5.2
17117,2020-03-01,22281,21418,863,3.9
17119,2020-03-01,131102,126770,4332,3.3
17121,2020-03-01,16683,16027,656,3.9
17123,2020-03-01,5117,4864,253,4.9
17125,2020-03-01,5866,5562,304,5.2
17127,2020-03-01,5370,5109,261,4.9
17129,2020-03-01,6183,5956,227,3.7
17131,2020-03-01,7730,7307,423,5.5
17133,2020-03-01,18581,18110,471,2.5
17135,2020-03-01,11406,10809,597,5.2
17137,2020-03-01,15930,15325,605,3.8
17139,2020-03-01,7345,7146,199,2.7
17141,2020-03-01,24668,23575,1093,4.4
17143,2020-03-01,82125,78045,4080,5
17145,2020-03-01,7942,7608,334,4.2
17147,2020-03-01,8529,8288,241,2.8
17149,2020-03-01,6687,6395,292,4.4
17151,2020-03-01,1629,1548,81,5
17153,2020-03-01,1715,1580,135,7.9
17155,2020-03-01,2876,2714,162,5.6
17157,2020-03-01,13534,13111,423,3.1
17159,2020-03-01,7206,6950,256,3.6
17161,2020-03-01,68552,65344,3208,4.7
17163,2020-03-01,123726,119130,4596,3.7
17165,2020-03-01,9399,8902,497,5.3
17167,2020-03-01,96774,93276,3498,3.6
17169,2020-03-01,3079,2951,128,4.2
17171,2020-03-01,2385,2268,117,4.9
17173,2020-03-01,10131,9783,348,3.4
17175,2020-03-01,2369,2244,125,5.3
17177,2020-03-01,20884,20007,877,4.2
17179,2020-03-01,61710,59087,2623,4.3
17181,2020-03-01,7326,6903,423,5.8
17183,2020-03-01,32106,30716,1390,4.3
17185,2020-03-01,5565,5364,201,3.6
17187,2020-03-01,8160,7859,301,3.7
17189,2020-03-01,9498,9298,200,2.1
17191,2020-03-01,6758,6473,285,4.2
17193,2020-03-01,6145,5915,230,3.7
17195,2020-03-01,27556,26497,1059,3.8
17197,2020-03-01,354144,338967,15177,4.3
17199,2020-03-01,31548,30268,1280,4.1
17201,2020-03-01,133324,126326,6998,5.2
17203,2020-03-01,18141,17523,618,3.4
18001,2020-03-01,16511,16011,500,3
18003,2020-03-01,183075,176486,6589,3.6
18005,2020-03-01,44477,43264,1213,2.7
18007,2020-03-01,4310,4170,140,3.2
18009,2020-03-01,4771,4546,225,4.7
18011,2020-03-01,35743,34785,958,2.7
18013,2020-03-01,7454,7184,270,3.6
18015,2020-03-01,9826,9456,370,3.8
18017,2020-03-01,17327,16589,738,4.3
18019,2020-03-01,61468,59319,2149,3.5
18021,2020-03-01,11490,10992,498,4.3
18023,2020-03-01,16909,16423,486,2.9
18025,2020-03-01,4833,4586,247,5.1
18027,2020-03-01,16382,15896,486,3
18029,2020-03-01,25417,24385,1032,4.1
18031,2020-03-01,14917,14431,486,3.3
18033,2020-03-01,22016,21306,710,3.2
18035,2020-03-01,53326,51013,2313,4.3
18037,2020-03-01,22462,21879,583,2.6
18039,2020-03-01,109792,106409,3383,3.1
18041,2020-03-01,8438,8002,436,5.2
18043,2020-03-01,41552,40157,1395,3.4
18045,2020-03-01,7708,7414,294,3.8
18047,2020-03-01,11106,10655,451,4.1
18049,2020-03-01,9375,8990,385,4.1
18051,2020-03-01,19439,18877,562,2.9
18053,2020-03-01,32049,30759,1290,4
18055,2020-03-01,13385,12728,657,4.9
18057,2020-03-01,184179,179311,4868,2.6
18059,2020-03-01,40274,39016,1258,3.1
18061,2020-03-01,20141,19420,721,3.6
18063,2020-03-01,89917,87366,2551,2.8
18065,2020-03-01,21709,20910,799,3.7
18067,2020-03-01,35570,33943,1627,4.6
18069,2020-03-01,17990,17335,655,3.6
18071,2020-03-01,22864,22228,636,2.8
18073,2020-03-01,15748,14949,799,5.1
18075,2020-03-01,8691,8371,320,3.7
18077,2020-03-01,14944,14391,553,3.7
18079,2020-03-01,13441,12928,513,3.8
18081,2020-03-01,82187,79777,2410,2.9
18083,2020-03-01,18104,17513,591,3.3
18085,2020-03-01,41191,39893,1298,3.2
18087,2020-03-01,18934,18412,522,2.8
18089,2020-03-01,224752,211447,13305,5.9
18091,2020-03-01,46336,44006,2330,5
18093,2020-03-01,20921,20093,828,4
18095,2020-03-01,58111,55490,2621,4.5
18097,2020-03-01,486810,469346,17464,3.6
18099,2020-03-01,22394,21625,769,3.4
18101,2020-03-01,5276,5122,154,2.9
18103,2020-03-01,14620,13908,712,4.9
18105,2020-03-01,70554,68053,2501,3.5
18107,2020-03-01,18433,17831,602,3.3
18109,2020-03-01,35682,34475,1207,3.4
18111,2020-03-01,6644,6286,358,5.4
18113,2020-03-01,22709,21921,788,3.5
18115,2020-03-01,3166,3045,121,3.8
18117,2020-03-01,8799,8462,337,3.8
18119,2020-03-01,9237,8836,401,4.3
18121,2020-03-01,6563,6297,266,4.1
18123,2020-03-01,9173,8860,313,3.4
18125,2020-03-01,5954,5728,226,3.8
18127,2020-03-01,84608,80750,3858,4.6
18129,2020-03-01,12923,12536,387,3
18131,2020-03-01,6294,6047,247,3.9
18133,2020-03-01,16247,15635,612,3.8
18135,2020-03-01,11100,10621,479,4.3
18137,2020-03-01,13944,13425,519,3.7
18139,2020-03-01,8546,8273,273,3.2
18141,2020-03-01,133829,128266,5563,4.2
18143,2020-03-01,10424,10039,385,3.7
18145,2020-03-01,22768,21945,823,3.6
18147,2020-03-01,10084,9714,370,3.7
18149,2020-03-01,9590,9078,512,5.3
18151,2020-03-01,19992,19427,565,2.8
18153,2020-03-01,7925,7529,396,5
18155,2020-03-01,4867,4679,188,3.9
18157,2020-03-01,97698,94388,3310,3.4
18159,2020-03-01,8979,8702,277,3.1
18161,2020-03-01,3476,3353,123,3.5
18163,2020-03-01,91493,88366,3127,3.4
18165,2020-03-01,6613,6231,382,5.8
18167,2020-03-01,45793,43672,2121,4.6
18169,2020-03-01,14530,14022,508,3.5
18171,2020-03-01,4045,3907,138,3.4
18173,2020-03-01,32012,31022,990,3.1
18175,2020-03-01,13378,12846,532,4
18177,2020-03-01,30278,29047,1231,4.1
18179,2020-03-01,13951,13500,451,3.2
18181,2020-03-01,13157,12751,406,3.1
18183,2020-03-01,17181,16621,560,3.3
19001,2020-03-01,4228,4094,134,3.2
19003,2020-03-01,2121,2073,48,2.3
19005,2020-03-01,7328,6915,413,5.6
19007,2020-03-01,5958,5714,244,4.1
19009,2020-03-01,3044,2952,92,3
19011,2020-03-01,13439,12966,473,3.5
19013,2020-03-01,69058,66256,2802,4.1
19015,2020-03-01,14868,14454,414,2.8
19017,2020-03-01,14030,13609,421,3
19019,2020-03-01,11405,10982,423,3.7
19021,2020-03-01,12127,11808,319,2.6
19023,2020-03-01,7892,7537,355,4.5
19025,2020-03-01,4211,4077,134,3.2
19027,2020-03-01,10733,10480,253,2.4
19029,2020-03-01,6892,6650,242,3.5
19031,2020-03-01,10705,10330,375,3.5
19033,2020-03-01,23327,22516,811,3.5
19035,2020-03-01,6229,6025,204,3.3
19037,2020-03-01,6378,6097,281,4.4
19039,2020-03-01,4873,4674,199,4.1
19041,2020-03-01,8455,8153,302,3.6
19043,2020-03-01,9940,9307,633,6.4
19045,2020-03-01,22558,21558,1000,4.4
19047,2020-03-01,8227,7794,433,5.3
19049,2020-03-01,50848,49646,1202,2.4
19051,2020-03-01,4208,4074,134,3.2
19053,2020-03-01,4436,4313,123,2.8
19055,2020-03-01,10603,10252,351,3.3
19057,2020-03-01,18911,17835,1076,5.7
19059,2020-03-01,9508,9080,428,4.5
19061,2020-03-01,56108,53995,2113,3.8
19063,2020-03-01,5120,4938,182,3.6
19065,2020-03-01,10784,10231,553,5.1
19067,2020-03-01,8513,8018,495,5.8
19069,2020-03-01,5691,5496,195,3.4
19071,2020-03-01,3861,3775,86,2.2
19073,2020-03-01,5443,5313,130,2.4
19075,2020-03-01,6527,6300,227,3.5
19077,2020-03-01,5602,5370,232,4.1
19079,2020-03-01,6980,6730,250,3.6
19081,2020-03-01,5864,5676,188,3.2
19083,2020-03-01,7998,7712,286,3.6
19085,2020-03-01,7264,7034,230,3.2
19087,2020-03-01,9810,9462,348,3.5
19089,2020-03-01,5183,4960,223,4.3
19091,2020-03-01,5041,4850,191,3.8
19093,2020-03-01,4069,3940,129,3.2
19095,2020-03-01,10409,10065,344,3.3
19097,2020-03-01,10892,10389,503,4.6
19099,2020-03-01,19579,18867,712,3.6
19101,2020-03-01,10145,9829,316,3.1
19103,2020-03-01,86528,84425,2103,2.4
19105,2020-03-01,10754,10215,539,5
19107,2020-03-01,5249,5017,232,4.4
19109,2020-03-01,8375,8118,257,3.1
19111,2020-03-01,15971,15237,734,4.6
19113,2020-03-01,122150,117541,4609,3.8
19115,2020-03-01,6100,5856,244,4
19117,2020-03-01,4695,4554,141,3
19119,2020-03-01,7000,6825,175,2.5
19121,2020-03-01,8582,8207,375,4.4
19123,2020-03-01,11962,11572,390,3.3
19125,2020-03-01,18248,17749,499,2.7
19127,2020-03-01,18346,17033,1313,7.2
19129,2020-03-01,7318,7126,192,2.6
19131,2020-03-01,6028,5868,160,2.7
19133,2020-03-01,4438,4260,178,4
19135,2020-03-01,3999,3842,157,3.9
19137,2020-03-01,4947,4790,157,3.2
19139,2020-03-01,21664,20897,767,3.5
19141,2020-03-01,8203,7980,223,2.7
19143,2020-03-01,3558,3473,85,2.4
19145,2020-03-01,6282,6086,196,3.1
19147,2020-03-01,4762,4599,163,3.4
19149,2020-03-01,14738,14370,368,2.5
19151,2020-03-01,4253,4146,107,2.5
19153,2020-03-01,268874,259429,9445,3.5
19155,2020-03-01,47870,46390,1480,3.1
19157,2020-03-01,10373,9989,384,3.7
19159,2020-03-01,2458,2381,77,3.1
19161,2020-03-01,5292,5139,153,2.9
19163,2020-03-01,88397,84824,3573,4
19165,2020-03-01,6485,6302,183,2.8
19167,2020-03-01,21374,20775,599,2.8
19169,2020-03-01,59824,58636,1188,2
19171,2020-03-01,9619,9168,451,4.7
19173,2020-03-01,3119,3045,74,2.4
19175,2020-03-01,6421,6166,255,4
19177,2020-03-01,3710,3582,128,3.5
19179,2020-03-01,17567,16837,730,4.2
19181,2020-03-01,28345,27433,912,3.2
19183,2020-03-01,12020,11625,395,3.3
19185,2020-03-01,2832,2749,83,2.9
19187,2020-03-01,19005,18290,715,3.8
19189,2020-03-01,5087,4912,175,3.4
19191,2020-03-01,11805,11265,540,4.6
19193,2020-03-01,55691,53781,1910,3.4
19195,2020-03-01,4188,4029,159,3.8
19197,2020-03-01,7290,7059,231,3.2
20001,2020-03-01,6342,6100,242,3.8
20003,2020-03-01,4195,4048,147,3.5
20005,2020-03-01,6807,6412,395,5.8
20007,2020-03-01,2300,2239,61,2.7
20009,2020-03-01,13813,13328,485,3.5
20011,2020-03-01,6780,6484,296,4.4
20013,2020-03-01,5074,4900,174,3.4
20015,2020-03-01,32787,31619,1168,3.6
20017,2020-03-01,1449,1394,55,3.8
20019,2020-03-01,1446,1391,55,3.8
20021,2020-03-01,9870,9526,344,3.5
20023,2020-03-01,1256,1220,36,2.9
20025,2020-03-01,1127,1098,29,2.6
20027,2020-03-01,3694,3574,120,3.2
20029,2020-03-01,3766,3650,116,3.1
20031,2020-03-01,3894,3711,183,4.7
20033,2020-03-01,832,807,25,3
20035,2020-03-01,16673,16047,626,3.8
20037,2020-03-01,18900,18142,758,4
20039,2020-03-01,1193,1153,40,3.4
20041,2020-03-01,8816,8379,437,5
20043,2020-03-01,4118,3961,157,3.8
20045,2020-03-01,64968,62828,2140,3.3
20047,2020-03-01,1412,1376,36,2.5
20049,2020-03-01,1191,1153,38,3.2
20051,2020-03-01,17157,16779,378,2.2
20053,2020-03-01,2648,2572,76,2.9
20055,2020-03-01,20446,19973,473,2.3
20057,2020-03-01,17095,16660,435,2.5
20059,2020-03-01,14134,13619,515,3.6
20061,2020-03-01,11700,11108,592,5.1
20063,2020-03-01,1409,1373,36,2.6
20065,2020-03-01,1166,1134,32,2.7
20067,2020-03-01,3119,3031,88,2.8
20069,2020-03-01,3173,3099,74,2.3
20071,2020-03-01,792,777,15,1.9
20073,2020-03-01,3116,2990,126,4
20075,2020-03-01,1586,1554,32,2
20077,2020-03-01,2771,2685,86,3.1
20079,2020-03-01,17210,16649,561,3.3
20081,2020-03-01,2218,2172,46,2.1
20083,2020-03-01,972,941,31,3.2
20085,2020-03-01,7123,6869,254,3.6
20087,2020-03-01,10131,9774,357,3.5
20089,2020-03-01,1195,1159,36,3
20091,2020-03-01,339277,329089,10188,3
20093,2020-03-01,2010,1970,40,2
20095,2020-03-01,3352,3245,107,3.2
20097,2020-03-01,1238,1206,32,2.6
20099,2020-03-01,9632,9182,450,4.7
20101,2020-03-01,712,687,25,3.5
20103,2020-03-01,36549,35070,1479,4
20105,2020-03-01,1690,1648,42,2.5
20107,2020-03-01,4427,4108,319,7.2
20109,2020-03-01,1655,1623,32,1.9
20111,2020-03-01,16738,16139,599,3.6
20113,2020-03-01,17258,16827,431,2.5
20115,2020-03-01,6098,5917,181,3
20117,2020-03-01,5403,5248,155,2.9
20119,2020-03-01,2100,2048,52,2.5
20121,2020-03-01,17694,17016,678,3.8
20123,2020-03-01,3328,3252,76,2.3
20125,2020-03-01,14814,14100,714,4.8
20127,2020-03-01,3017,2912,105,3.5
20129,2020-03-01,1124,1093,31,2.8
20131,2020-03-01,5439,5286,153,2.8
20133,2020-03-01,6098,5806,292,4.8
20135,2020-03-01,1313,1271,42,3.2
20137,2020-03-01,2641,2576,65,2.5
20139,2020-03-01,7966,7651,315,4
20141,2020-03-01,1934,1881,53,2.7
20143,2020-03-01,2916,2824,92,3.2
20145,2020-03-01,2759,2654,105,3.8
20147,2020-03-01,2615,2544,71,2.7
20149,2020-03-01,12373,11989,384,3.1
20151,2020-03-01,4913,4779,134,2.7
20153,2020-03-01,1525,1491,34,2.2
20155,2020-03-01,29398,28379,1019,3.5
20157,2020-03-01,2256,2195,61,2.7
20159,2020-03-01,4982,4827,155,3.1
20161,2020-03-01,34982,33984,998,2.9
20163,2020-03-01,2469,2385,84,3.4
20165,2020-03-01,1611,1540,71,4.4
20167,2020-03-01,3281,3186,95,2.9
20169,2020-03-01,29130,28052,1078,3.7
20171,2020-03-01,2698,2643,55,2
20173,2020-03-01,254908,244645,10263,4
20175,2020-03-01,9671,9379,292,3
20177,2020-03-01,90097,86789,3308,3.7
20179,2020-03-01,1385,1356,29,2.1
20181,2020-03-01,2816,2730,86,3.1
20183,2020-03-01,1986,1929,57,2.9
20185,2020-03-01,1974,1907,67,3.4
20187,2020-03-01,1038,1009,29,2.8
20189,2020-03-01,2758,2684,74,2.7
20191,2020-03-01,10907,10481,426,3.9
20193,2020-03-01,4233,4130,103,2.4
20195,2020-03-01,1453,1400,53,3.6
20197,2020-03-01,3655,3518,137,3.7
20199,2020-03-01,810,791,19,2.3
20201,2020-03-01,2964,2895,69,2.3
20203,2020-03-01,1311,1284,27,2.1
20205,2020-03-01,3861,3657,204,5.3
20207,2020-03-01,1536,1467,69,4.5
20209,2020-03-01,76812,73285,3527,4.6
21001,2020-03-01,7157,6719,438,6.1
21003,2020-03-01,8975,8571,404,4.5
21005,2020-03-01,12014,11464,550,4.6
21007,2020-03-01,3425,3219,206,6
21009,2020-03-01,18792,17832,960,5.1
21011,2020-03-01,4675,4302,373,8
21013,2020-03-01,8459,7826,633,7.5
21015,2020-03-01,72054,69329,2725,3.8
21017,2020-03-01,9462,9029,433,4.6
21019,2020-03-01,17965,16853,1112,6.2
21021,2020-03-01,12798,12170,628,4.9
21023,2020-03-01,3880,3652,228,5.9
21025,2020-03-01,3405,3025,380,11.2
21027,2020-03-01,7992,7457,535,6.7
21029,2020-03-01,43127,41257,1870,4.3
21031,2020-03-01,5183,4901,282,5.4
21033,2020-03-01,5632,5296,336,6
21035,2020-03-01,18707,17665,1042,5.6
21037,2020-03-01,51140,49132,2008,3.9
21039,2020-03-01,2205,2100,105,4.8
21041,2020-03-01,5407,5172,235,4.3
21043,2020-03-01,9713,8910,803,8.3
21045,2020-03-01,6823,6390,433,6.3
21047,2020-03-01,24835,23327,1508,6.1
21049,2020-03-01,17369,16565,804,4.6
21051,2020-03-01,5308,4901,407,7.7
21053,2020-03-01,4024,3792,232,5.8
21055,2020-03-01,3755,3560,195,5.2
21057,2020-03-01,3340,3155,185,5.5
21059,2020-03-01,46878,44804,2074,4.4
21061,2020-03-01,4776,4489,287,6
21063,2020-03-01,2036,1829,207,10.2
21065,2020-03-01,5355,5021,334,6.2
21067,2020-03-01,175717,169267,6450,3.7
21069,2020-03-01,6141,5762,379,6.2
21071,2020-03-01,11090,10207,883,8
21073,2020-03-01,25096,24034,1062,4.2
21075,2020-03-01,1999,1887,112,5.6
21077,2020-03-01,4093,3907,186,4.5
21079,2020-03-01,7719,7312,407,5.3
21081,2020-03-01,11725,11175,550,4.7
21083,2020-03-01,15833,15042,791,5
21085,2020-03-01,11014,10352,662,6
21087,2020-03-01,5309,5081,228,4.3
21089,2020-03-01,13655,12602,1053,7.7
21091,2020-03-01,3891,3728,163,4.2
21093,2020-03-01,49053,46684,2369,4.8
21095,2020-03-01,7022,6187,835,11.9
21097,2020-03-01,8820,8412,408,4.6
21099,2020-03-01,7996,7487,509,6.4
21101,2020-03-01,21354,20399,955,4.5
21103,2020-03-01,8222,7879,343,4.2
21105,2020-03-01,1703,1613,90,5.3
21107,2020-03-01,18695,17610,1085,5.8
21109,2020-03-01,4178,3890,288,6.9
21111,2020-03-01,399256,381980,17276,4.3
21113,2020-03-01,26862,25812,1050,3.9
21115,2020-03-01,6735,6197,538,8
21117,2020-03-01,88414,84865,3549,4
21119,2020-03-01,4520,4130,390,8.6
21121,2020-03-01,10215,9624,591,5.8
21123,2020-03-01,6016,5708,308,5.1
21125,2020-03-01,25713,24360,1353,5.3
21127,2020-03-01,5347,4903,444,8.3
21129,2020-03-01,2107,1953,154,7.3
21131,2020-03-01,2750,2439,311,11.3
21133,2020-03-01,6307,5696,611,9.7
21135,2020-03-01,4788,4333,455,9.5
21137,2020-03-01,9505,8961,544,5.7
21139,2020-03-01,3602,3365,237,6.6
21141,2020-03-01,12437,11866,571,4.6
21143,2020-03-01,3106,2943,163,5.2
21145,2020-03-01,28940,27380,1560,5.4
21147,2020-03-01,4873,4539,334,6.9
21149,2020-03-01,4103,3903,200,4.9
21151,2020-03-01,47501,45431,2070,4.4
21153,2020-03-01,3323,2788,535,16.1
21155,2020-03-01,9509,9144,365,3.8
21157,2020-03-01,15361,14574,787,5.1
21159,2020-03-01,2616,2325,291,11.1
21161,2020-03-01,7022,6611,411,5.9
21163,2020-03-01,12141,11477,664,5.5
21165,2020-03-01,2348,2140,208,8.9
21167,2020-03-01,10124,9605,519,5.1
21169,2020-03-01,4114,3874,240,5.8
21171,2020-03-01,4625,4411,214,4.6
21173,2020-03-01,11603,10896,707,6.1
21175,2020-03-01,4440,4122,318,7.2
21177,2020-03-01,10685,9906,779,7.3
21179,2020-03-01,23286,22210,1076,4.6
21181,2020-03-01,3306,3132,174,5.3
21183,2020-03-01,9681,9061,620,6.4
21185,2020-03-01,33464,32318,1146,3.4
21187,2020-03-01,5118,4890,228,4.5
21189,2020-03-01,1077,988,89,8.3
21191,2020-03-01,7078,6736,342,4.8
21193,2020-03-01,8469,7781,688,8.1
21195,2020-03-01,20172,18665,1507,7.5
21197,2020-03-01,5170,4828,342,6.6
21199,2020-03-01,26515,25066,1449,5.5
21201,2020-03-01,793,746,47,5.9
21203,2020-03-01,6664,6288,376,5.6
21205,2020-03-01,10490,9853,637,6.1
21207,2020-03-01,6252,5860,392,6.3
21209,2020-03-01,29787,28647,1140,3.8
21211,2020-03-01,25721,24757,964,3.7
21213,2020-03-01,8853,8429,424,4.8
21215,2020-03-01,10536,10129,407,3.9
21217,2020-03-01,13081,12519,562,4.3
21219,2020-03-01,5464,5223,241,4.4
21221,2020-03-01,6065,5709,356,5.9
21223,2020-03-01,3845,3671,174,4.5
21225,2020-03-01,6073,5751,322,5.3
21227,2020-03-01,65645,62660,2985,4.5
21229,2020-03-01,6182,5920,262,4.2
21231,2020-03-01,7389,6931,458,6.2
21233,2020-03-01,5590,5285,305,5.5
21235,2020-03-01,14239,13466,773,5.4
21237,2020-03-01,2178,2009,169,7.8
21239,2020-03-01,14870,14317,553,3.7
22001,2020-03-01,24514,23127,1387,5.7
22003,2020-03-01,9103,8531,572,6.3
22005,2020-03-01,66610,63421,3189,4.8
22007,2020-03-01,9032,8333,699,7.7
22009,2020-03-01,15493,14495,998,6.4
22011,2020-03-01,15030,14108,922,6.1
22013,2020-03-01,5571,5181,390,7
22015,2020-03-01,59001,56291,2710,4.6
22017,2020-03-01,104903,98877,6026,5.7
22019,2020-03-01,105810,100631,5179,4.9
22021,2020-03-01,3851,3545,306,7.9
22023,2020-03-01,3914,3745,169,4.3
22025,2020-03-01,3519,3300,219,6.2
22027,2020-03-01,5723,5326,397,6.9
22029,2020-03-01,7208,6661,547,7.6
22031,2020-03-01,11186,10449,737,6.6
22033,2020-03-01,235641,223925,11716,5
22035,2020-03-01,1889,1655,234,12.4
22037,2020-03-01,8072,7675,397,4.9
22039,2020-03-01,12462,11721,741,5.9
22041,2020-03-01,7649,7041,608,7.9
22043,2020-03-01,8384,7844,540,6.4
22045,2020-03-01,28585,26795,1790,6.3
22047,2020-03-01,14411,13394,1017,7.1
22049,2020-03-01,7057,6677,380,5.4
22051,2020-03-01,218374,208471,9903,4.5
22053,2020-03-01,13424,12732,692,5.2
22055,2020-03-01,117558,111967,5591,4.8
22057,2020-03-01,42816,40727,2089,4.9
22059,2020-03-01,6984,6665,319,4.6
22061,2020-03-01,22312,21090,1222,5.5
22063,2020-03-01,70830,67702,3128,4.4
22065,2020-03-01,3657,3349,308,8.4
22067,2020-03-01,10497,9503,994,9.5
22069,2020-03-01,17144,16131,1013,5.9
22071,2020-03-01,182974,173329,9645,5.3
22073,2020-03-01,71665,67478,4187,5.8
22075,2020-03-01,10227,9769,458,4.5
22077,2020-03-01,9999,9438,561,5.6
22079,2020-03-01,56107,53167,2940,5.2
22081,2020-03-01,3804,3570,234,6.2
22083,2020-03-01,8401,7781,620,7.4
22085,2020-03-01,9593,9093,500,5.2
22087,2020-03-01,20597,19500,1097,5.3
22089,2020-03-01,25882,24681,1201,4.6
22091,2020-03-01,4315,4036,279,6.5
22093,2020-03-01,9576,8909,667,7
22095,2020-03-01,20042,18809,1233,6.2
22097,2020-03-01,33121,30892,2229,6.7
22099,2020-03-01,22800,21544,1256,5.5
22101,2020-03-01,20092,18802,1290,6.4
22103,2020-03-01,123188,117753,5435,4.4
22105,2020-03-01,56870,53542,3328,5.9
22107,2020-03-01,1466,1316,150,10.2
22109,2020-03-01,47262,44871,2391,5.1
22111,2020-03-01,9345,8725,620,6.6
22113,2020-03-01,24649,23269,1380,5.6
22115,2020-03-01,16135,14858,1277,7.9
22117,2020-03-01,16970,15930,1040,6.1
22119,2020-03-01,14756,13751,1005,6.8
22121,2020-03-01,13955,13286,669,4.8
22123,2020-03-01,3917,3408,509,13
22125,2020-03-01,5541,5296,245,4.4
22127,2020-03-01,5010,4651,359,7.2
23001,2020-03-01,55500,53408,2092,3.8
23003,2020-03-01,30114,28491,1623,5.4
23005,2020-03-01,164920,159083,5837,3.5
23007,2020-03-01,14363,13731,632,4.4
23009,2020-03-01,27297,25577,1720,6.3
23011,2020-03-01,62749,60206,2543,4.1
23013,2020-03-01,19786,18807,979,4.9
23015,2020-03-01,16293,15506,787,4.8
23017,2020-03-01,27010,25755,1255,4.6
23019,2020-03-01,77596,74193,3403,4.4
23021,2020-03-01,7237,6875,362,5
23023,2020-03-01,19740,19061,679,3.4
23025,2020-03-01,22436,21126,1310,5.8
23027,2020-03-01,20349,19397,952,4.7
23029,2020-03-01,13596,12593,1003,7.4
23031,2020-03-01,113630,109321,4309,3.8
24001,2020-03-01,32211,30302,1909,5.9
24003,2020-03-01,321896,311489,10407,3.2
24005,2020-03-01,460678,442411,18267,4
24009,2020-03-01,51205,49585,1620,3.2
24011,2020-03-01,18359,17635,724,3.9
24013,2020-03-01,97467,94493,2974,3.1
24015,2020-03-01,54431,52082,2349,4.3
24017,2020-03-01,90080,86543,3537,3.9
24019,2020-03-01,17109,16225,884,5.2
24021,2020-03-01,138619,134030,4589,3.3
24023,2020-03-01,16340,15431,909,5.6
24025,2020-03-01,144171,138967,5204,3.6
24027,2020-03-01,191705,186327,5378,2.8
24029,2020-03-01,10351,9868,483,4.7
24031,2020-03-01,567052,549461,17591,3.1
24033,2020-03-01,520176,498848,21328,4.1
24035,2020-03-01,28607,27662,945,3.3
24037,2020-03-01,59118,57078,2040,3.5
24039,2020-03-01,9052,8447,605,6.7
24041,2020-03-01,18506,17737,769,4.2
24043,2020-03-01,75063,71722,3341,4.5
24045,2020-03-01,50117,47401,2716,5.4
24047,2020-03-01,25870,23169,2701,10.4
24510,2020-03-01,288887,273115,15772,5.5
25001,2020-03-01,105020,99199,5821,5.5
25003,2020-03-01,62059,59531,2528,4.1
25005,2020-03-01,296568,284100,12468,4.2
25007,2020-03-01,8232,7710,522,6.3
25009,2020-03-01,418429,405030,13399,3.2
25011,2020-03-01,40528,39294,1234,3
25013,2020-03-01,222689,213743,8946,4
25015,2020-03-01,88495,86058,2437,2.8
25017,2020-03-01,905991,884255,21736,2.4
25019,2020-03-01,6308,5715,593,9.4
25021,2020-03-01,387936,377488,10448,2.7
25023,2020-03-01,280533,270797,9736,3.5
25025,2020-03-01,449694,437310,12384,2.8
25027,2020-03-01,439650,424996,14654,3.3
26001,2020-03-01,3755,3454,301,8
26003,2020-03-01,3023,2760,263,8.7
26005,2020-03-01,61941,59844,2097,3.4
26007,2020-03-01,13311,12634,677,5.1
26009,2020-03-01,9787,9157,630,6.4
26011,2020-03-01,5897,5423,474,8
26013,2020-03-01,3162,2938,224,7.1
26015,2020-03-01,31869,30674,1195,3.7
26017,2020-03-01,49711,47124,2587,5.2
26019,2020-03-01,8540,7972,568,6.7
26021,2020-03-01,72897,69961,2936,4
26023,2020-03-01,19226,18523,703,3.7
26025,2020-03-01,61787,59213,2574,4.2
26027,2020-03-01,24091,23144,947,3.9
26029,2020-03-01,12113,11398,715,5.9
26031,2020-03-01,9873,8376,1497,15.2
26033,2020-03-01,15943,14825,1118,7
26035,2020-03-01,11656,10801,855,7.3
26037,2020-03-01,41431,40184,1247,3
26039,2020-03-01,5480,5098,382,7
26041,2020-03-01,16703,15713,990,5.9
26043,2020-03-01,12051,11449,602,5
26045,2020-03-01,57877,55853,2024,3.5
26047,2020-03-01,16620,15456,1164,7
26049,2020-03-01,179316,170501,8815,4.9
26051,2020-03-01,9705,9076,629,6.5
26053,2020-03-01,5982,5701,281,4.7
26055,2020-03-01,47725,45723,2002,4.2
26057,2020-03-01,17837,17043,794,4.5
26059,2020-03-01,20161,19264,897,4.4
26061,2020-03-01,16154,15316,838,5.2
26063,2020-03-01,15022,14244,778,5.2
26065,2020-03-01,151779,146676,5103,3.4
26067,2020-03-01,30232,29186,1046,3.5
26069,2020-03-01,9976,9201,775,7.8
26071,2020-03-01,4927,4577,350,7.1
26073,2020-03-01,33963,32492,1471,4.3
26075,2020-03-01,75236,72336,2900,3.9
26077,2020-03-01,134435,130067,4368,3.2
26079,2020-03-01,7703,7161,542,7
26081,2020-03-01,360595,350112,10483,2.9
26083,2020-03-01,888,830,58,6.5
26085,2020-03-01,3875,3631,244,6.3
26087,2020-03-01,41240,38388,2852,6.9
26089,2020-03-01,10063,9572,491,4.9
26091,2020-03-01,45600,43740,1860,4.1
26093,2020-03-01,103482,99472,4010,3.9
26095,2020-03-01,2202,2049,153,6.9
26097,2020-03-01,4410,3586,824,18.7
26099,2020-03-01,446291,424766,21525,4.8
26101,2020-03-01,9879,9211,668,6.8
26103,2020-03-01,32470,30737,1733,5.3
26105,2020-03-01,13088,12329,759,5.8
26107,2020-03-01,18850,17885,965,5.1
26109,2020-03-01,10641,10166,475,4.5
26111,2020-03-01,39556,37814,1742,4.4
26113,2020-03-01,6797,6401,396,5.8
26115,2020-03-01,75054,72234,2820,3.8
26117,2020-03-01,28210,27004,1206,4.3
26119,2020-03-01,2963,2671,292,9.9
26121,2020-03-01,76418,72900,3518,4.6
26123,2020-03-01,23197,22158,1039,4.5
26125,2020-03-01,671363,645591,25772,3.8
26127,2020-03-01,11351,10520,831,7.3
26129,2020-03-01,7786,7125,661,8.5
26131,2020-03-01,2054,1896,158,7.7
26133,2020-03-01,11498,11002,496,4.3
26135,2020-03-01,2722,2503,219,8
26137,2020-03-01,11313,10647,666,5.9
26139,2020-03-01,161168,156671,4497,2.8
26141,2020-03-01,4858,4351,507,10.4
26143,2020-03-01,7399,6720,679,9.2
26145,2020-03-01,85404,81098,4306,5
26147,2020-03-01,75703,71225,4478,5.9
26149,2020-03-01,28164,27124,1040,3.7
26151,2020-03-01,19304,18264,1040,5.4
26153,2020-03-01,3249,2967,282,8.7
26155,2020-03-01,33275,31792,1483,4.5
26157,2020-03-01,23566,22242,1324,5.6
26159,2020-03-01,35328,33626,1702,4.8
26161,2020-03-01,200254,194901,5353,2.7
26163,2020-03-01,799923,754695,45228,5.7
26165,2020-03-01,14648,13859,789,5.4
27001,2020-03-01,7464,6790,674,9
27003,2020-03-01,201264,192810,8454,4.2
27005,2020-03-01,18714,17582,1132,6
27007,2020-03-01,24691,23216,1475,6
27009,2020-03-01,22232,20889,1343,6
27011,2020-03-01,2420,2244,176,7.3
27013,2020-03-01,40865,39309,1556,3.8
27015,2020-03-01,14115,13277,838,5.9
27017,2020-03-01,18181,17034,1147,6.3
27019,2020-03-01,59603,57424,2179,3.7
27021,2020-03-01,13997,12742,1255,9
27023,2020-03-01,6739,6388,351,5.2
27025,2020-03-01,30903,29005,1898,6.1
27027,2020-03-01,36659,35090,1569,4.3
27029,2020-03-01,4564,3950,614,13.5
27031,2020-03-01,2863,2669,194,6.8
27033,2020-03-01,5983,5710,273,4.6
27035,2020-03-01,31795,29651,2144,6.7
27037,2020-03-01,245578,236166,9412,3.8
27039,2020-03-01,11970,11369,601,5
27041,2020-03-01,20916,19943,973,4.7
27043,2020-03-01,6791,6366,425,6.3
27045,2020-03-01,11464,10856,608,5.3
27047,2020-03-01,16005,15249,756,4.7
27049,2020-03-01,26668,25482,1186,4.4
27051,2020-03-01,3206,2999,207,6.5
27053,2020-03-01,713580,688646,24934,3.5
27055,2020-03-01,10468,9963,505,4.8
27057,2020-03-01,9613,8821,792,8.2
27059,2020-03-01,22101,20665,1436,6.5
27061,2020-03-01,22263,20391,1872,8.4
27063,2020-03-01,5500,5252,248,4.5
27065,2020-03-01,9306,8382,924,9.9
27067,2020-03-01,24109,22860,1249,5.2
27069,2020-03-01,2274,2162,112,4.9
27071,2020-03-01,5874,5397,477,8.1
27073,2020-03-01,3407,3207,200,5.9
27075,2020-03-01,5244,4968,276,5.3
27077,2020-03-01,2466,2349,117,4.7
27079,2020-03-01,16665,15425,1240,7.4
27081,2020-03-01,2987,2780,207,6.9
27083,2020-03-01,14226,13553,673,4.7
27085,2020-03-01,19173,18137,1036,5.4
27087,2020-03-01,2341,2167,174,7.4
27089,2020-03-01,5318,4815,503,9.5
27091,2020-03-01,9674,9212,462,4.8
27093,2020-03-01,13219,12416,803,6.1
27095,2020-03-01,13353,12200,1153,8.6
27097,2020-03-01,17828,16385,1443,8.1
27099,2020-03-01,20695,19831,864,4.2
27101,2020-03-01,4602,4272,330,7.2
27103,2020-03-01,20938,20211,727,3.5
27105,2020-03-01,11194,10782,412,3.7
27107,2020-03-01,3137,2908,229,7.3
27109,2020-03-01,90546,87431,3115,3.4
27111,2020-03-01,30655,28674,1981,6.5
27113,2020-03-01,8783,8173,610,6.9
27115,2020-03-01,15178,13838,1340,8.8
27117,2020-03-01,4425,4165,260,5.9
27119,2020-03-01,16446,15481,965,5.9
27121,2020-03-01,6283,6002,281,4.5
27123,2020-03-01,291810,280281,11529,4
27125,2020-03-01,2208,2031,177,8
27127,2020-03-01,7466,7068,398,5.3
27129,2020-03-01,8293,7698,595,7.2
27131,2020-03-01,37628,35919,1709,4.5
27133,2020-03-01,5497,5340,157,2.9
27135,2020-03-01,7853,7478,375,4.8
27137,2020-03-01,103227,97617,5610,5.4
27139,2020-03-01,85047,81922,3125,3.7
27141,2020-03-01,53826,51045,2781,5.2
27143,2020-03-01,8307,7843,464,5.6
27145,2020-03-01,90893,86701,4192,4.6
27147,2020-03-01,20325,19396,929,4.6
27149,2020-03-01,5237,5020,217,4.1
27151,2020-03-01,4668,4373,295,6.3
27153,2020-03-01,13554,12710,844,6.2
27155,2020-03-01,1653,1548,105,6.4
27157,2020-03-01,12226,11598,628,5.1
27159,2020-03-01,6084,5510,574,9.4
27161,2020-03-01,8853,8305,548,6.2
27163,2020-03-01,146266,140647,5619,3.8
27165,2020-03-01,6350,6009,341,5.4
27167,2020-03-01,3326,3182,144,4.3
27169,2020-03-01,28223,27085,1138,4
27171,2020-03-01,77564,73868,3696,4.8
27173,2020-03-01,5139,4885,254,4.9
28001,2020-03-01,10883,10003,880,8.1
28003,2020-03-01,15981,15206,775,4.8
28005,2020-03-01,4494,4189,305,6.8
28007,2020-03-01,7102,6638,464,6.5
28009,2020-03-01,3021,2834,187,6.2
28011,2020-03-01,11998,11071,927,7.7
28013,2020-03-01,5714,5348,366,6.4
28015,2020-03-01,3588,3352,236,6.6
28017,2020-03-01,6936,6471,465,6.7
28019,2020-03-01,3719,3509,210,5.6
28021,2020-03-01,3154,2813,341,10.8
28023,2020-03-01,5962,5574,388,6.5
28025,2020-03-01,7903,7243,660,8.4
28027,2020-03-01,8571,7776,795,9.3
28029,2020-03-01,10981,10241,740,6.7
28031,2020-03-01,8316,7864,452,5.4
28033,2020-03-01,91993,87776,4217,4.6
28035,2020-03-01,33162,31138,2024,6.1
28037,2020-03-01,2795,2611,184,6.6
28039,2020-03-01,9035,8368,667,7.4
28041,2020-03-01,4366,4036,330,7.6
28043,2020-03-01,9542,9039,503,5.3
28045,2020-03-01,19197,17976,1221,6.4
28047,2020-03-01,89167,82941,6226,7
28049,2020-03-01,105274,97794,7480,7.1
28051,2020-03-01,5690,5083,607,10.7
28053,2020-03-01,2288,2002,286,12.5
28055,2020-03-01,363,332,31,8.5
28057,2020-03-01,10588,10041,547,5.2
28059,2020-03-01,59605,55341,4264,7.2
28061,2020-03-01,6204,5741,463,7.5
28063,2020-03-01,1993,1711,282,14.1
28065,2020-03-01,4123,3803,320,7.8
28067,2020-03-01,26085,24583,1502,5.8
28069,2020-03-01,3529,3230,299,8.5
28071,2020-03-01,28022,26649,1373,4.9
28073,2020-03-01,31022,29445,1577,5.1
28075,2020-03-01,30290,28378,1912,6.3
28077,2020-03-01,4746,4403,343,7.2
28079,2020-03-01,8144,7680,464,5.7
28081,2020-03-01,41822,39535,2287,5.5
28083,2020-03-01,10035,9216,819,8.2
28085,2020-03-01,14653,13799,854,5.8
28087,2020-03-01,25684,24118,1566,6.1
28089,2020-03-01,53569,50601,2968,5.5
28091,2020-03-01,10054,9482,572,5.7
28093,2020-03-01,14301,13506,795,5.6
28095,2020-03-01,15727,14802,925,5.9
28097,2020-03-01,3984,3720,264,6.6
28099,2020-03-01,10272,9627,645,6.3
28101,2020-03-01,8253,7783,470,5.7
28103,2020-03-01,3877,3563,314,8.1
28105,2020-03-01,22897,21470,1427,6.2
28107,2020-03-01,12680,11743,937,7.4
28109,2020-03-01,23788,22526,1262,5.3
28111,2020-03-01,4310,3992,318,7.4
28113,2020-03-01,14629,13627,1002,6.8
28115,2020-03-01,15125,14363,762,5
28117,2020-03-01,11437,10804,633,5.5
28119,2020-03-01,2386,2192,194,8.1
28121,2020-03-01,76196,72777,3419,4.5
28123,2020-03-01,12673,12095,578,4.6
28125,2020-03-01,1533,1387,146,9.5
28127,2020-03-01,10700,10092,608,5.7
28129,2020-03-01,6887,6518,369,5.4
28131,2020-03-01,7181,6713,468,6.5
28133,2020-03-01,7579,6887,692,9.1
28135,2020-03-01,5369,5025,344,6.4
28137,2020-03-01,12203,11475,728,6
28139,2020-03-01,9429,8910,519,5.5
28141,2020-03-01,8600,8143,457,5.3
28143,2020-03-01,4440,4059,381,8.6
28145,2020-03-01,14437,13732,705,4.9
28147,2020-03-01,5077,4727,350,6.9
28149,2020-03-01,20854,19482,1372,6.6
28151,2020-03-01,16245,14897,1348,8.3
28153,2020-03-01,7625,7152,473,6.2
28155,2020-03-01,3985,3719,266,6.7
28157,2020-03-01,2770,2500,270,9.7
28159,2020-03-01,7551,7083,468,6.2
28161,2020-03-01,5021,4723,298,5.9
28163,2020-03-01,10084,9306,778,7.7
29001,2020-03-01,10248,9800,448,4.4
29003,2020-03-01,9814,9459,355,3.6
29005,2020-03-01,2743,2650,93,3.4
29007,2020-03-01,10440,9998,442,4.2
29009,2020-03-01,15885,14955,930,5.9
29011,2020-03-01,5133,4907,226,4.4
29013,2020-03-01,7805,7397,408,5.2
29015,2020-03-01,7181,6715,466,6.5
29017,2020-03-01,5459,5197,262,4.8
29019,2020-03-01,98876,96028,2848,2.9
29021,2020-03-01,44164,42339,1825,4.1
29023,2020-03-01,18255,17225,1030,5.6
29025,2020-03-01,4325,4121,204,4.7
29027,2020-03-01,21423,20606,817,3.8
29029,2020-03-01,18349,17088,1261,6.9
29031,2020-03-01,40987,39309,1678,4.1
29033,2020-03-01,4649,4438,211,4.5
29035,2020-03-01,2513,2333,180,7.2
29037,2020-03-01,55016,52754,2262,4.1
29039,2020-03-01,5711,5453,258,4.5
29041,2020-03-01,3836,3670,166,4.3
29043,2020-03-01,45658,44004,1654,3.6
29045,2020-03-01,3160,3005,155,4.9
29047,2020-03-01,137471,132401,5070,3.7
29049,2020-03-01,10614,10208,406,3.8
29051,2020-03-01,39212,37847,1365,3.5
29053,2020-03-01,7334,7017,317,4.3
29055,2020-03-01,10903,10286,617,5.7
29057,2020-03-01,3568,3415,153,4.3
29059,2020-03-01,7084,6727,357,5
29061,2020-03-01,4093,3924,169,4.1
29063,2020-03-01,4829,4620,209,4.3
29065,2020-03-01,6385,6085,300,4.7
29067,2020-03-01,4983,4692,291,5.8
29069,2020-03-01,11658,10723,935,8
29071,2020-03-01,53704,51251,2453,4.6
29073,2020-03-01,7550,7250,300,4
29075,2020-03-01,3395,3284,111,3.3
29077,2020-03-01,151864,146259,5605,3.7
29079,2020-03-01,4363,4194,169,3.9
29081,2020-03-01,3783,3594,189,5
29083,2020-03-01,9614,9179,435,4.5
29085,2020-03-01,3859,3648,211,5.5
29087,2020-03-01,2555,2475,80,3.1
29089,2020-03-01,4937,4764,173,3.5
29091,2020-03-01,16354,15528,826,5.1
29093,2020-03-01,3580,3325,255,7.1
29095,2020-03-01,363083,345406,17677,4.9
29097,2020-03-01,56170,53952,2218,3.9
29099,2020-03-01,119200,113917,5283,4.4
29101,2020-03-01,23418,22279,1139,4.9
29103,2020-03-01,1753,1680,73,4.2
29105,2020-03-01,16938,15784,1154,6.8
29107,2020-03-01,16837,16127,710,4.2
29109,2020-03-01,17807,16864,943,5.3
29111,2020-03-01,5012,4817,195,3.9
29113,2020-03-01,29191,27912,1279,4.4
29115,2020-03-01,5111,4802,309,6
29117,2020-03-01,7344,7100,244,3.3
29119,2020-03-01,10747,10256,491,4.6
29121,2020-03-01,7481,7113,368,4.9
29123,2020-03-01,5562,5242,320,5.8
29125,2020-03-01,3905,3743,162,4.1
29127,2020-03-01,14292,13682,610,4.3
29129,2020-03-01,1880,1809,71,3.8
29131,2020-03-01,12269,11468,801,6.5
29133,2020-03-01,5706,5360,346,6.1
29135,2020-03-01,7386,7077,309,4.2
29137,2020-03-01,3774,3570,204,5.4
29139,2020-03-01,5769,5529,240,4.2
29141,2020-03-01,8122,7631,491,6
29143,2020-03-01,8363,7868,495,5.9
29145,2020-03-01,26729,25579,1150,4.3
29147,2020-03-01,10711,10291,420,3.9
29149,2020-03-01,3970,3708,262,6.6
29151,2020-03-01,7090,6852,238,3.4
29153,2020-03-01,3463,3257,206,5.9
29155,2020-03-01,6292,5870,422,6.7
29157,2020-03-01,9856,9514,342,3.5
29159,2020-03-01,21128,19847,1281,6.1
29161,2020-03-01,19911,19054,857,4.3
29163,2020-03-01,7601,7261,340,4.5
29165,2020-03-01,59037,57081,1956,3.3
29167,2020-03-01,14424,13860,564,3.9
29169,2020-03-01,14842,14143,699,4.7
29171,2020-03-01,2259,2164,95,4.2
29173,2020-03-01,5601,5388,213,3.8
29175,2020-03-01,10295,9796,499,4.8
29177,2020-03-01,10987,10519,468,4.3
29179,2020-03-01,2944,2784,160,5.4
29181,2020-03-01,4971,4698,273,5.5
29183,2020-03-01,229086,221261,7825,3.4
29185,2020-03-01,3596,3407,189,5.3
29186,2020-03-01,9174,8788,386,4.2
29187,2020-03-01,26702,25175,1527,5.7
29189,2020-03-01,532279,511204,21075,4
29195,2020-03-01,10809,10372,437,4
29197,2020-03-01,1970,1861,109,5.5
29199,2020-03-01,2355,2271,84,3.6
29201,2020-03-01,19935,18956,979,4.9
29203,2020-03-01,3306,3051,255,7.7
29205,2020-03-01,3113,2942,171,5.5
29207,2020-03-01,13430,12595,835,6.2
29209,2020-03-01,13476,12417,1059,7.9
29211,2020-03-01,2810,2663,147,5.2
29213,2020-03-01,26434,24116,2318,8.8
29215,2020-03-01,8938,8405,533,6
29217,2020-03-01,9379,8968,411,4.4
29219,2020-03-01,18544,17776,768,4.1
29221,2020-03-01,10419,9718,701,6.7
29223,2020-03-01,5116,4823,293,5.7
29225,2020-03-01,17474,16688,786,4.5
29227,2020-03-01,1180,1138,42,3.6
29229,2020-03-01,7334,6863,471,6.4
29510,2020-03-01,152691,144884,7807,5.1
30001,2020-03-01,5083,4885,198,3.9
30003,2020-03-01,4971,4561,410,8.2
30005,2020-03-01,2330,2209,121,5.2
30007,2020-03-01,2608,2464,144,5.5
30009,2020-03-01,5587,5309,278,5
30011,2020-03-01,669,648,21,3.1
30013,2020-03-01,38132,36526,1606,4.2
30015,2020-03-01,2525,2431,94,3.7
30017,2020-03-01,6254,5989,265,4.2
30019,2020-03-01,906,875,31,3.4
30021,2020-03-01,4601,4442,159,3.5
30023,2020-03-01,5026,4793,233,4.6
30025,2020-03-01,1684,1641,43,2.6
30027,2020-03-01,5777,5482,295,5.1
30029,2020-03-01,48675,45323,3352,6.9
30031,2020-03-01,69371,67328,2043,2.9
30033,2020-03-01,760,733,27,3.6
30035,2020-03-01,5580,5074,506,9.1
30037,2020-03-01,371,352,19,5.1
30039,2020-03-01,1711,1570,141,8.2
30041,2020-03-01,7608,7292,316,4.2
30043,2020-03-01,5776,5505,271,4.7
30045,2020-03-01,1024,976,48,4.7
30047,2020-03-01,13716,12930,786,5.7
30049,2020-03-01,36099,34697,1402,3.9
30051,2020-03-01,990,957,33,3.3
30053,2020-03-01,8212,7224,988,12
30055,2020-03-01,943,921,22,2.3
30057,2020-03-01,5267,5044,223,4.2
30059,2020-03-01,1001,965,36,3.6
30061,2020-03-01,1751,1536,215,12.3
30063,2020-03-01,64824,61892,2932,4.5
30065,2020-03-01,2349,2219,130,5.5
30067,2020-03-01,8759,8282,477,5.4
30069,2020-03-01,274,262,12,4.4
30071,2020-03-01,1902,1811,91,4.8
30073,2020-03-01,2683,2571,112,4.2
30075,2020-03-01,971,935,36,3.7
30077,2020-03-01,2850,2693,157,5.5
30079,2020-03-01,457,433,24,5.3
30081,2020-03-01,20651,19520,1131,5.5
30083,2020-03-01,5853,5638,215,3.7
30085,2020-03-01,4464,4213,251,5.6
30087,2020-03-01,3760,3558,202,5.4
30089,2020-03-01,5094,4678,416,8.2
30091,2020-03-01,1807,1746,61,3.4
30093,2020-03-01,17151,16252,899,5.2
30095,2020-03-01,5347,5146,201,3.8
30097,2020-03-01,1812,1749,63,3.5
30099,2020-03-01,2787,2663,124,4.4
30101,2020-03-01,2079,1998,81,3.9
30103,2020-03-01,348,339,9,2.6
30105,2020-03-01,4032,3857,175,4.3
30107,2020-03-01,760,717,43,5.7
30109,2020-03-01,455,437,18,4
30111,2020-03-01,82979,79616,3363,4.1
31001,2020-03-01,16787,16174,613,3.7
31003,2020-03-01,3954,3852,102,2.6
31005,2020-03-01,240,225,15,6.3
31007,2020-03-01,396,383,13,3.3
31009,2020-03-01,274,259,15,5.5
31011,2020-03-01,2998,2911,87,2.9
31013,2020-03-01,5408,5197,211,3.9
31015,2020-03-01,1100,1063,37,3.4
31017,2020-03-01,1413,1361,52,3.7
31019,2020-03-01,28046,27214,832,3
31021,2020-03-01,3608,3462,146,4
31023,2020-03-01,4611,4455,156,3.4
31025,2020-03-01,13545,13002,543,4
31027,2020-03-01,4544,4412,132,2.9
31029,2020-03-01,2341,2282,59,2.5
31031,2020-03-01,3340,3240,100,3
31033,2020-03-01,4290,4112,178,4.1
31035,2020-03-01,3268,3148,120,3.7
31037,2020-03-01,5656,5493,163,2.9
31039,2020-03-01,4913,4767,146,3
31041,2020-03-01,6470,6292,178,2.8
31043,2020-03-01,10753,10255,498,4.6
31045,2020-03-01,4953,4799,154,3.1
31047,2020-03-01,13373,12936,437,3.3
31049,2020-03-01,974,941,33,3.4
31051,2020-03-01,3059,2942,117,3.8
31053,2020-03-01,20196,19511,685,3.4
31055,2020-03-01,298795,287145,11650,3.9
31057,2020-03-01,1193,1162,31,2.6
31059,2020-03-01,3232,3136,96,3
31061,2020-03-01,1517,1469,48,3.2
31063,2020-03-01,1636,1575,61,3.7
31065,2020-03-01,2620,2540,80,3.1
31067,2020-03-01,10969,10549,420,3.8
31069,2020-03-01,1078,1026,52,4.8
31071,2020-03-01,1157,1124,33,2.9
31073,2020-03-01,1066,1035,31,2.9
31075,2020-03-01,429,418,11,2.6
31077,2020-03-01,1279,1236,43,3.4
31079,2020-03-01,31735,30464,1271,4
31081,2020-03-01,4850,4680,170,3.5
31083,2020-03-01,1746,1681,65,3.7
31085,2020-03-01,645,623,22,3.4
31087,2020-03-01,1312,1262,50,3.8
31089,2020-03-01,5815,5652,163,2.8
31091,2020-03-01,383,370,13,3.4
31093,2020-03-01,3370,3255,115,3.4
31095,2020-03-01,4179,4057,122,2.9
31097,2020-03-01,2077,1994,83,4
31099,2020-03-01,3858,3754,104,2.7
31101,2020-03-01,4513,4365,148,3.3
31103,2020-03-01,639,620,19,3
31105,2020-03-01,1999,1927,72,3.6
31107,2020-03-01,4692,4525,167,3.6
31109,2020-03-01,178420,172830,5590,3.1
31111,2020-03-01,18210,17523,687,3.8
31113,2020-03-01,485,470,15,3.1
31115,2020-03-01,420,398,22,5.2
31117,2020-03-01,448,431,17,3.8
31119,2020-03-01,19606,18941,665,3.4
31121,2020-03-01,4046,3924,122,3
31123,2020-03-01,2638,2538,100,3.8
31125,2020-03-01,1986,1917,69,3.5
31127,2020-03-01,3666,3534,132,3.6
31129,2020-03-01,2477,2390,87,3.5
31131,2020-03-01,8357,8066,291,3.5
31133,2020-03-01,1512,1471,41,2.7
31135,2020-03-01,1865,1819,46,2.5
31137,2020-03-01,5024,4885,139,2.8
31139,2020-03-01,4127,4001,126,3.1
31141,2020-03-01,17809,17242,567,3.2
31143,2020-03-01,2986,2892,94,3.1
31145,2020-03-01,5856,5673,183,3.1
31147,2020-03-01,4290,4147,143,3.3
31149,2020-03-01,873,847,26,3
31151,2020-03-01,7498,7198,300,4
31153,2020-03-01,96930,93570,3360,3.5
31155,2020-03-01,11287,10905,382,3.4
31157,2020-03-01,18112,17375,737,4.1
31159,2020-03-01,9039,8730,309,3.4
31161,2020-03-01,2793,2708,85,3
31163,2020-03-01,1680,1626,54,3.2
31165,2020-03-01,763,741,22,2.9
31167,2020-03-01,3540,3423,117,3.3
31169,2020-03-01,2794,2713,81,2.9
31171,2020-03-01,453,425,28,6.2
31173,2020-03-01,3084,2956,128,4.2
31175,2020-03-01,2173,2101,72,3.3
31177,2020-03-01,11267,10865,402,3.6
31179,2020-03-01,5899,5721,178,3
31181,2020-03-01,1665,1593,72,4.3
31183,2020-03-01,611,596,15,2.5
31185,2020-03-01,7318,7098,220,3
32001,2020-03-01,11545,10878,667,5.8
32003,2020-03-01,NA,NA,81130,6.9
32005,2020-03-01,23411,21859,1552,6.6
32007,2020-03-01,27731,26394,1337,4.8
32009,2020-03-01,459,433,26,5.7
32011,2020-03-01,1195,1150,45,3.8
32013,2020-03-01,8495,8078,417,4.9
32015,2020-03-01,3280,3096,184,5.6
32017,2020-03-01,2137,2011,126,5.9
32019,2020-03-01,23908,22027,1881,7.9
32021,2020-03-01,2195,2071,124,5.6
32023,2020-03-01,18313,16845,1468,8
32027,2020-03-01,2742,2570,172,6.3
32029,2020-03-01,2090,1957,133,6.4
32031,2020-03-01,259372,245173,14199,5.5
32033,2020-03-01,4681,4445,236,5
32510,2020-03-01,26675,24840,1835,6.9
33001,2020-03-01,30627,29616,1011,3.3
33003,2020-03-01,23029,22244,785,3.4
33005,2020-03-01,40446,39173,1273,3.1
33007,2020-03-01,14328,13752,576,4
33009,2020-03-01,48517,47211,1306,2.7
33011,2020-03-01,242036,234165,7871,3.3
33013,2020-03-01,83211,80938,2273,2.7
33015,2020-03-01,186865,180519,6346,3.4
33017,2020-03-01,74300,72222,2078,2.8
33019,2020-03-01,23045,22417,628,2.7
34001,2020-03-01,122921,115281,7640,6.2
34003,2020-03-01,490503,473936,16567,3.4
34005,2020-03-01,235067,226533,8534,3.6
34007,2020-03-01,258247,246657,11590,4.5
34009,2020-03-01,41300,36228,5072,12.3
34011,2020-03-01,66428,62004,4424,6.7
34013,2020-03-01,376603,357114,19489,5.2
34015,2020-03-01,153148,146746,6402,4.2
34017,2020-03-01,367652,353806,13846,3.8
34019,2020-03-01,65339,63212,2127,3.3
34021,2020-03-01,206544,199199,7345,3.6
34023,2020-03-01,441000,425337,15663,3.6
34025,2020-03-01,330445,318206,12239,3.7
34027,2020-03-01,260185,251780,8405,3.2
34029,2020-03-01,280840,268532,12308,4.4
34031,2020-03-01,248031,235202,12829,5.2
34033,2020-03-01,29457,27750,1707,5.8
34035,2020-03-01,173394,167442,5952,3.4
34037,2020-03-01,75376,72112,3264,4.3
34039,2020-03-01,281503,269304,12199,4.3
34041,2020-03-01,56358,54061,2297,4.1
35001,2020-03-01,334596,318260,16336,4.9
35003,2020-03-01,1089,1001,88,8.1
35005,2020-03-01,27680,26202,1478,5.3
35006,2020-03-01,8967,8352,615,6.9
35007,2020-03-01,5258,4986,272,5.2
35009,2020-03-01,22151,21233,918,4.1
35011,2020-03-01,719,685,34,4.7
35013,2020-03-01,98794,91867,6927,7
35015,2020-03-01,35205,33949,1256,3.6
35017,2020-03-01,12205,11583,622,5.1
35019,2020-03-01,1546,1470,76,4.9
35021,2020-03-01,273,262,11,4
35023,2020-03-01,1924,1821,103,5.4
35025,2020-03-01,30850,29306,1544,5
35027,2020-03-01,8708,8238,470,5.4
35028,2020-03-01,9776,9451,325,3.3
35029,2020-03-01,10325,8380,1945,18.8
35031,2020-03-01,24323,22464,1859,7.6
35033,2020-03-01,2069,1910,159,7.7
35035,2020-03-01,25731,24398,1333,5.2
35037,2020-03-01,3084,2911,173,5.6
35039,2020-03-01,16661,15639,1022,6.1
35041,2020-03-01,8157,7749,408,5
35043,2020-03-01,66914,63437,3477,5.2
35045,2020-03-01,51173,47656,3517,6.9
35047,2020-03-01,10827,10144,683,6.3
35049,2020-03-01,72779,69564,3215,4.4
35051,2020-03-01,4068,3723,345,8.5
35053,2020-03-01,6360,5989,371,5.8
35055,2020-03-01,15649,14630,1019,6.5
35057,2020-03-01,5382,4988,394,7.3
35059,2020-03-01,1643,1569,74,4.5
35061,2020-03-01,30706,28929,1777,5.8
36001,2020-03-01,155877,149740,6137,3.9
36003,2020-03-01,19473,18182,1291,6.6
36005,2020-03-01,597283,563084,34199,5.7
36007,2020-03-01,82316,77632,4684,5.7
36009,2020-03-01,33807,31576,2231,6.6
36011,2020-03-01,34845,32997,1848,5.3
36013,2020-03-01,53216,49968,3248,6.1
36015,2020-03-01,35377,33644,1733,4.9
36017,2020-03-01,21673,20422,1251,5.8
36019,2020-03-01,35637,33699,1938,5.4
36021,2020-03-01,30006,28802,1204,4
36023,2020-03-01,22815,21441,1374,6
36025,2020-03-01,18489,17434,1055,5.7
36027,2020-03-01,142571,136785,5786,4.1
36029,2020-03-01,438863,416889,21974,5
36031,2020-03-01,16656,15558,1098,6.6
36033,2020-03-01,19246,18072,1174,6.1
36035,2020-03-01,22540,21166,1374,6.1
36037,2020-03-01,28747,27261,1486,5.2
36039,2020-03-01,20021,18977,1044,5.2
36041,2020-03-01,2114,1915,199,9.4
36043,2020-03-01,27541,25853,1688,6.1
36045,2020-03-01,42636,39447,3189,7.5
36047,2020-03-01,NA,NA,51806,4.3
36049,2020-03-01,11403,10512,891,7.8
36051,2020-03-01,30078,28533,1545,5.1
36053,2020-03-01,32409,30623,1786,5.5
36055,2020-03-01,358601,341849,16752,4.7
36057,2020-03-01,21900,20487,1413,6.5
36059,2020-03-01,699846,673197,26649,3.8
36061,2020-03-01,920500,886332,34168,3.7
36063,2020-03-01,98044,91987,6057,6.2
36065,2020-03-01,99925,95064,4861,4.9
36067,2020-03-01,218545,208669,9876,4.5
36069,2020-03-01,54872,52254,2618,4.8
36071,2020-03-01,184316,176441,7875,4.3
36073,2020-03-01,17011,16053,958,5.6
36075,2020-03-01,52389,49015,3374,6.4
36077,2020-03-01,27296,25802,1494,5.5
36079,2020-03-01,50541,48392,2149,4.3
36081,2020-03-01,NA,NA,41941,3.7
36083,2020-03-01,80579,77051,3528,4.4
36085,2020-03-01,223468,214732,8736,3.9
36087,2020-03-01,154449,148391,6058,3.9
36089,2020-03-01,42630,39783,2847,6.7
36091,2020-03-01,118455,113842,4613,3.9
36093,2020-03-01,75794,72533,3261,4.3
36095,2020-03-01,14493,13621,872,6
36097,2020-03-01,7868,7342,526,6.7
36099,2020-03-01,15410,14615,795,5.2
36101,2020-03-01,41740,39432,2308,5.5
36103,2020-03-01,767610,734777,32833,4.3
36105,2020-03-01,35678,33905,1773,5
36107,2020-03-01,22291,21102,1189,5.3
36109,2020-03-01,49243,47451,1792,3.6
36111,2020-03-01,86076,82329,3747,4.4
36113,2020-03-01,30374,28555,1819,6
36115,2020-03-01,26678,25298,1380,5.2
36117,2020-03-01,43073,40852,2221,5.2
36119,2020-03-01,482803,462656,20147,4.2
36121,2020-03-01,17338,16247,1091,6.3
36123,2020-03-01,11534,10934,600,5.2
37001,2020-03-01,79533,76470,3063,3.9
37003,2020-03-01,17359,16802,557,3.2
37005,2020-03-01,4180,3948,232,5.6
37007,2020-03-01,10454,9967,487,4.7
37009,2020-03-01,12490,11988,502,4
37011,2020-03-01,6948,6658,290,4.2
37013,2020-03-01,19064,18205,859,4.5
37015,2020-03-01,7572,7172,400,5.3
37017,2020-03-01,14404,13704,700,4.9
37019,2020-03-01,51711,48878,2833,5.5
37021,2020-03-01,134776,130468,4308,3.2
37023,2020-03-01,39423,37932,1491,3.8
37025,2020-03-01,107231,103335,3896,3.6
37027,2020-03-01,35100,33743,1357,3.9
37029,2020-03-01,4577,4403,174,3.8
37031,2020-03-01,30736,29430,1306,4.2
37033,2020-03-01,9601,9150,451,4.7
37035,2020-03-01,76326,73533,2793,3.7
37037,2020-03-01,35127,33881,1246,3.5
37039,2020-03-01,11064,10571,493,4.5
37041,2020-03-01,5402,5177,225,4.2
37043,2020-03-01,4033,3849,184,4.6
37045,2020-03-01,47866,45820,2046,4.3
37047,2020-03-01,22082,20967,1115,5
37049,2020-03-01,39943,38357,1586,4
37051,2020-03-01,124107,117559,6548,5.3
37053,2020-03-01,13783,13255,528,3.8
37055,2020-03-01,17766,16554,1212,6.8
37057,2020-03-01,78488,75427,3061,3.9
37059,2020-03-01,19950,19257,693,3.5
37061,2020-03-01,24730,23735,995,4
37063,2020-03-01,168498,162821,5677,3.4
37065,2020-03-01,20105,18925,1180,5.9
37067,2020-03-01,182417,175536,6881,3.8
37069,2020-03-01,30829,29569,1260,4.1
37071,2020-03-01,107674,103216,4458,4.1
37073,2020-03-01,5104,4889,215,4.2
37075,2020-03-01,3036,2858,178,5.9
37077,2020-03-01,29444,28449,995,3.4
37079,2020-03-01,9488,9147,341,3.6
37081,2020-03-01,254179,243565,10614,4.2
37083,2020-03-01,19895,18713,1182,5.9
37085,2020-03-01,52121,49789,2332,4.5
37087,2020-03-01,28702,27660,1042,3.6
37089,2020-03-01,52853,50927,1926,3.6
37091,2020-03-01,9023,8560,463,5.1
37093,2020-03-01,19498,18523,975,5
37095,2020-03-01,1695,1490,205,12.1
37097,2020-03-01,87546,84305,3241,3.7
37099,2020-03-01,19051,18223,828,4.3
37101,2020-03-01,97693,94109,3584,3.7
37103,2020-03-01,4136,3981,155,3.7
37105,2020-03-01,25854,24710,1144,4.4
37107,2020-03-01,27209,26174,1035,3.8
37109,2020-03-01,42873,41306,1567,3.7
37111,2020-03-01,20276,19480,796,3.9
37113,2020-03-01,14808,14192,616,4.2
37115,2020-03-01,9673,9313,360,3.7
37117,2020-03-01,8839,8416,423,4.8
37119,2020-03-01,605834,583225,22609,3.7
37121,2020-03-01,5876,5593,283,4.8
37123,2020-03-01,11223,10786,437,3.9
37125,2020-03-01,40439,38882,1557,3.9
37127,2020-03-01,41394,39427,1967,4.8
37129,2020-03-01,119166,114826,4340,3.6
37131,2020-03-01,7581,7152,429,5.7
37133,2020-03-01,62645,59809,2836,4.5
37135,2020-03-01,77750,75076,2674,3.4
37137,2020-03-01,5178,4982,196,3.8
37139,2020-03-01,16347,15591,756,4.6
37141,2020-03-01,27898,26783,1115,4
37143,2020-03-01,4828,4587,241,5
37145,2020-03-01,17859,17137,722,4
37147,2020-03-01,86662,83102,3560,4.1
37149,2020-03-01,8825,8502,323,3.7
37151,2020-03-01,63877,61405,2472,3.9
37153,2020-03-01,16198,15315,883,5.5
37155,2020-03-01,49199,46571,2628,5.3
37157,2020-03-01,38730,36993,1737,4.5
37159,2020-03-01,63940,61283,2657,4.2
37161,2020-03-01,24143,22862,1281,5.3
37163,2020-03-01,28556,27427,1129,4
37165,2020-03-01,11123,10339,784,7
37167,2020-03-01,29445,28274,1171,4
37169,2020-03-01,20950,20170,780,3.7
37171,2020-03-01,32400,31136,1264,3.9
37173,2020-03-01,6660,6348,312,4.7
37175,2020-03-01,14023,13497,526,3.8
37177,2020-03-01,1265,1176,89,7
37179,2020-03-01,120809,116498,4311,3.6
37181,2020-03-01,16752,15794,958,5.7
37183,2020-03-01,578883,559015,19868,3.4
37185,2020-03-01,6315,5943,372,5.9
37187,2020-03-01,4339,4059,280,6.5
37189,2020-03-01,27619,26651,968,3.5
37191,2020-03-01,50343,48275,2068,4.1
37193,2020-03-01,28192,26988,1204,4.3
37195,2020-03-01,33986,32070,1916,5.6
37197,2020-03-01,17153,16542,611,3.6
37199,2020-03-01,8027,7692,335,4.2
38001,2020-03-01,997,966,31,3.1
38003,2020-03-01,5150,5000,150,2.9
38005,2020-03-01,2360,2229,131,5.6
38007,2020-03-01,384,371,13,3.4
38009,2020-03-01,2871,2727,144,5
38011,2020-03-01,1576,1539,37,2.3
38013,2020-03-01,1012,971,41,4.1
38015,2020-03-01,48946,47388,1558,3.2
38017,2020-03-01,102991,100217,2774,2.7
38019,2020-03-01,1878,1809,69,3.7
38021,2020-03-01,2246,2196,50,2.2
38023,2020-03-01,1412,1391,21,1.5
38025,2020-03-01,3230,3168,62,1.9
38027,2020-03-01,1242,1179,63,5.1
38029,2020-03-01,1494,1397,97,6.5
38031,2020-03-01,1523,1470,53,3.5
38033,2020-03-01,849,831,18,2.1
38035,2020-03-01,36530,35475,1055,2.9
38037,2020-03-01,1163,1139,24,2.1
38039,2020-03-01,1013,982,31,3.1
38041,2020-03-01,1352,1303,49,3.6
38043,2020-03-01,1275,1209,66,5.2
38045,2020-03-01,2030,1984,46,2.3
38047,2020-03-01,842,817,25,3
38049,2020-03-01,3058,2886,172,5.6
38051,2020-03-01,1091,1050,41,3.8
38053,2020-03-01,10005,9708,297,3
38055,2020-03-01,4764,4548,216,4.5
38057,2020-03-01,3488,3307,181,5.2
38059,2020-03-01,16290,15636,654,4
38061,2020-03-01,6971,6834,137,2
38063,2020-03-01,1389,1326,63,4.5
38065,2020-03-01,873,826,47,5.4
38067,2020-03-01,3291,3134,157,4.8
38069,2020-03-01,1673,1600,73,4.4
38071,2020-03-01,5590,5386,204,3.6
38073,2020-03-01,2804,2744,60,2.1
38075,2020-03-01,1207,1160,47,3.9
38077,2020-03-01,8430,8201,229,2.7
38079,2020-03-01,4623,4151,472,10.2
38081,2020-03-01,2720,2667,53,1.9
38083,2020-03-01,670,619,51,7.6
38085,2020-03-01,1175,1137,38,3.2
38087,2020-03-01,397,388,9,2.3
38089,2020-03-01,18315,17789,526,2.9
38091,2020-03-01,938,920,18,1.9
38093,2020-03-01,10302,10018,284,2.8
38095,2020-03-01,1128,1102,26,2.3
38097,2020-03-01,4348,4173,175,4
38099,2020-03-01,5025,4824,201,4
38101,2020-03-01,31139,30057,1082,3.5
38103,2020-03-01,1907,1804,103,5.4
38105,2020-03-01,24038,23416,622,2.6
39001,2020-03-01,11316,10189,1127,10
39003,2020-03-01,48746,45791,2955,6.1
39005,2020-03-01,27217,25655,1562,5.7
39007,2020-03-01,45080,41892,3188,7.1
39009,2020-03-01,29825,27838,1987,6.7
39011,2020-03-01,25118,24034,1084,4.3
39013,2020-03-01,29715,26923,2792,9.4
39015,2020-03-01,19945,18478,1467,7.4
39017,2020-03-01,197287,187468,9819,5
39019,2020-03-01,13219,12182,1037,7.8
39021,2020-03-01,20300,19245,1055,5.2
39023,2020-03-01,63562,59694,3868,6.1
39025,2020-03-01,108348,102877,5471,5
39027,2020-03-01,17849,16683,1166,6.5
39029,2020-03-01,48137,44687,3450,7.2
39031,2020-03-01,14486,13245,1241,8.6
39033,2020-03-01,18685,17484,1201,6.4
39035,2020-03-01,590053,552414,37639,6.4
39037,2020-03-01,26338,24929,1409,5.3
39039,2020-03-01,18077,17073,1004,5.6
39041,2020-03-01,112596,108034,4562,4.1
39043,2020-03-01,36687,34058,2629,7.2
39045,2020-03-01,79348,75390,3958,5
39047,2020-03-01,14260,13496,764,5.4
39049,2020-03-01,702060,669493,32567,4.6
39051,2020-03-01,22941,21494,1447,6.3
39053,2020-03-01,12716,11688,1028,8.1
39055,2020-03-01,47351,44740,2611,5.5
39057,2020-03-01,84505,80489,4016,4.8
39059,2020-03-01,18744,17116,1628,8.7
39061,2020-03-01,419706,398850,20856,5
39063,2020-03-01,42366,40569,1797,4.2
39065,2020-03-01,14354,13538,816,5.7
39067,2020-03-01,6964,6342,622,8.9
39069,2020-03-01,13269,12280,989,7.5
39071,2020-03-01,17470,16170,1300,7.4
39073,2020-03-01,13180,12292,888,6.7
39075,2020-03-01,21348,20495,853,4
39077,2020-03-01,28651,25939,2712,9.5
39079,2020-03-01,13522,12249,1273,9.4
39081,2020-03-01,27977,25611,2366,8.5
39083,2020-03-01,32030,30289,1741,5.4
39085,2020-03-01,122403,115236,7167,5.9
39087,2020-03-01,24283,22659,1624,6.7
39089,2020-03-01,91599,86923,4676,5.1
39091,2020-03-01,22825,21642,1183,5.2
39093,2020-03-01,149735,139878,9857,6.6
39095,2020-03-01,212354,198857,13497,6.4
39097,2020-03-01,21160,20194,966,4.6
39099,2020-03-01,103548,95289,8259,8
39101,2020-03-01,28538,27083,1455,5.1
39103,2020-03-01,94659,89741,4918,5.2
39105,2020-03-01,9458,8483,975,10.3
39107,2020-03-01,23813,22943,870,3.7
39109,2020-03-01,55284,52508,2776,5
39111,2020-03-01,5817,5092,725,12.5
39113,2020-03-01,254935,241013,13922,5.5
39115,2020-03-01,7029,6279,750,10.7
39117,2020-03-01,17092,16082,1010,5.9
39119,2020-03-01,40986,37957,3029,7.4
39121,2020-03-01,4796,4279,517,10.8
39123,2020-03-01,20577,18595,1982,9.6
39125,2020-03-01,8928,8477,451,5.1
39127,2020-03-01,16323,15029,1294,7.9
39129,2020-03-01,26925,25406,1519,5.6
39131,2020-03-01,11115,10083,1032,9.3
39133,2020-03-01,88530,83125,5405,6.1
39135,2020-03-01,21581,20421,1160,5.4
39137,2020-03-01,19141,18308,833,4.4
39139,2020-03-01,52699,49340,3359,6.4
39141,2020-03-01,36154,33834,2320,6.4
39143,2020-03-01,30640,28773,1867,6.1
39145,2020-03-01,30054,27441,2613,8.7
39147,2020-03-01,27611,26037,1574,5.7
39149,2020-03-01,24259,23056,1203,5
39151,2020-03-01,187734,175541,12193,6.5
39153,2020-03-01,276001,259400,16601,6
39155,2020-03-01,87014,79863,7151,8.2
39157,2020-03-01,45139,42139,3000,6.6
39159,2020-03-01,29663,28449,1214,4.1
39161,2020-03-01,15006,14287,719,4.8
39163,2020-03-01,5869,5288,581,9.9
39165,2020-03-01,121250,115748,5502,4.5
39167,2020-03-01,27392,25206,2186,8
39169,2020-03-01,62176,59435,2741,4.4
39171,2020-03-01,19197,18296,901,4.7
39173,2020-03-01,71900,68420,3480,4.8
39175,2020-03-01,13308,12725,583,4.4
40001,2020-03-01,8226,7881,345,4.2
40003,2020-03-01,2749,2688,61,2.2
40005,2020-03-01,4910,4668,242,4.9
40007,2020-03-01,2643,2587,56,2.1
40009,2020-03-01,9953,9499,454,4.6
40011,2020-03-01,4396,4269,127,2.9
40013,2020-03-01,21795,21116,679,3.1
40015,2020-03-01,11954,11501,453,3.8
40017,2020-03-01,75558,73267,2291,3
40019,2020-03-01,21075,20335,740,3.5
40021,2020-03-01,19081,18327,754,4
40023,2020-03-01,5466,5172,294,5.4
40025,2020-03-01,1330,1305,25,1.9
40027,2020-03-01,142420,138413,4007,2.8
40029,2020-03-01,2302,2181,121,5.3
40031,2020-03-01,47959,46332,1627,3.4
40033,2020-03-01,2656,2570,86,3.2
40035,2020-03-01,5729,5508,221,3.9
40037,2020-03-01,31305,30138,1167,3.7
40039,2020-03-01,15194,14714,480,3.2
40041,2020-03-01,18302,17614,688,3.8
40043,2020-03-01,2765,2694,71,2.6
40045,2020-03-01,2108,2051,57,2.7
40047,2020-03-01,26723,25809,914,3.4
40049,2020-03-01,12701,12226,475,3.7
40051,2020-03-01,26435,25510,925,3.5
40053,2020-03-01,2765,2700,65,2.4
40055,2020-03-01,1793,1722,71,4
40057,2020-03-01,1153,1119,34,2.9
40059,2020-03-01,1763,1714,49,2.8
40061,2020-03-01,4166,3918,248,6
40063,2020-03-01,5272,4987,285,5.4
40065,2020-03-01,10507,10195,312,3
40067,2020-03-01,2475,2386,89,3.6
40069,2020-03-01,3715,3529,186,5
40071,2020-03-01,18189,17416,773,4.2
40073,2020-03-01,8903,8690,213,2.4
40075,2020-03-01,3293,3181,112,3.4
40077,2020-03-01,3131,2900,231,7.4
40079,2020-03-01,18795,17944,851,4.5
40081,2020-03-01,15606,15030,576,3.7
40083,2020-03-01,22225,21539,686,3.1
40085,2020-03-01,6452,6306,146,2.3
40087,2020-03-01,19689,19114,575,2.9
40089,2020-03-01,14862,14138,724,4.9
40091,2020-03-01,6984,6536,448,6.4
40093,2020-03-01,3634,3543,91,2.5
40095,2020-03-01,6716,6443,273,4.1
40097,2020-03-01,19274,18687,587,3
40099,2020-03-01,6153,5946,207,3.4
40101,2020-03-01,28815,27659,1156,4
40103,2020-03-01,5505,5355,150,2.7
40105,2020-03-01,4544,4396,148,3.3
40107,2020-03-01,4486,4245,241,5.4
40109,2020-03-01,382737,370801,11936,3.1
40111,2020-03-01,15627,14857,770,4.9
40113,2020-03-01,20547,19721,826,4
40115,2020-03-01,14493,14033,460,3.2
40117,2020-03-01,7285,7000,285,3.9
40119,2020-03-01,37911,36788,1123,3
40121,2020-03-01,16840,16050,790,4.7
40123,2020-03-01,18882,18307,575,3
40125,2020-03-01,32450,31308,1142,3.5
40127,2020-03-01,4389,4157,232,5.3
40129,2020-03-01,1820,1756,64,3.5
40131,2020-03-01,45008,43594,1414,3.1
40133,2020-03-01,9337,8875,462,4.9
40135,2020-03-01,16201,15512,689,4.3
40137,2020-03-01,18721,17891,830,4.4
40139,2020-03-01,11236,11007,229,2
40141,2020-03-01,3009,2903,106,3.5
40143,2020-03-01,322427,311939,10488,3.3
40145,2020-03-01,38257,36999,1258,3.3
40147,2020-03-01,22273,21500,773,3.5
40149,2020-03-01,5061,4853,208,4.1
40151,2020-03-01,4538,4442,96,2.1
40153,2020-03-01,9017,8697,320,3.5
41001,2020-03-01,7067,6663,404,5.7
41003,2020-03-01,47759,46162,1597,3.3
41005,2020-03-01,219206,210701,8505,3.9
41007,2020-03-01,18824,17978,846,4.5
41009,2020-03-01,24344,23137,1207,5
41011,2020-03-01,26281,24893,1388,5.3
41013,2020-03-01,9942,9349,593,6
41015,2020-03-01,8703,8165,538,6.2
41017,2020-03-01,96547,92331,4216,4.4
41019,2020-03-01,46437,43915,2522,5.4
41021,2020-03-01,941,892,49,5.2
41023,2020-03-01,3135,2833,302,9.6
41025,2020-03-01,3529,3311,218,6.2
41027,2020-03-01,13815,13355,460,3.3
41029,2020-03-01,104001,98780,5221,5
41031,2020-03-01,10171,9586,585,5.8
41033,2020-03-01,35647,33632,2015,5.7
41035,2020-03-01,29295,27054,2241,7.6
41037,2020-03-01,3507,3313,194,5.5
41039,2020-03-01,181253,173180,8073,4.5
41041,2020-03-01,20263,19211,1052,5.2
41043,2020-03-01,58635,55687,2948,5
41045,2020-03-01,12396,11870,526,4.2
41047,2020-03-01,161134,153980,7154,4.4
41049,2020-03-01,5731,5462,269,4.7
41051,2020-03-01,453489,436289,17200,3.8
41053,2020-03-01,39970,38193,1777,4.4
41055,2020-03-01,969,915,54,5.6
41057,2020-03-01,11590,11064,526,4.5
41059,2020-03-01,36175,34339,1836,5.1
41061,2020-03-01,11994,11280,714,6
41063,2020-03-01,3301,3039,262,7.9
41065,2020-03-01,12545,11898,647,5.2
41067,2020-03-01,325105,314003,11102,3.4
41069,2020-03-01,702,676,26,3.7
41071,2020-03-01,54480,52356,2124,3.9
42001,2020-03-01,55348,53252,2096,3.8
42003,2020-03-01,644520,610355,34165,5.3
42005,2020-03-01,32276,29797,2479,7.7
42007,2020-03-01,83745,78474,5271,6.3
42009,2020-03-01,23445,21868,1577,6.7
42011,2020-03-01,214327,202507,11820,5.5
42013,2020-03-01,59388,56006,3382,5.7
42015,2020-03-01,28055,26374,1681,6
42017,2020-03-01,343903,327375,16528,4.8
42019,2020-03-01,99509,94191,5318,5.3
42021,2020-03-01,57422,53304,4118,7.2
42023,2020-03-01,2022,1835,187,9.2
42025,2020-03-01,32258,29989,2269,7
42027,2020-03-01,79691,76396,3295,4.1
42029,2020-03-01,284759,274031,10728,3.8
42031,2020-03-01,17203,16018,1185,6.9
42033,2020-03-01,35892,33245,2647,7.4
42035,2020-03-01,18086,16719,1367,7.6
42037,2020-03-01,33899,31801,2098,6.2
42039,2020-03-01,38378,35932,2446,6.4
42041,2020-03-01,131613,126328,5285,4
42043,2020-03-01,143808,136723,7085,4.9
42045,2020-03-01,299568,285010,14558,4.9
42047,2020-03-01,15502,14348,1154,7.4
42049,2020-03-01,129057,120921,8136,6.3
42051,2020-03-01,57306,52339,4967,8.7
42053,2020-03-01,1781,1612,169,9.5
42055,2020-03-01,77330,73447,3883,5
42057,2020-03-01,7759,7224,535,6.9
42059,2020-03-01,16546,15302,1244,7.5
42061,2020-03-01,19996,18264,1732,8.7
42063,2020-03-01,38789,36170,2619,6.8
42065,2020-03-01,20085,18757,1328,6.6
42067,2020-03-01,12737,11995,742,5.8
42069,2020-03-01,105332,98795,6537,6.2
42071,2020-03-01,284207,272596,11611,4.1
42073,2020-03-01,40708,37340,3368,8.3
42075,2020-03-01,71880,68422,3458,4.8
42077,2020-03-01,193124,182261,10863,5.6
42079,2020-03-01,159172,147499,11673,7.3
42081,2020-03-01,56316,52477,3839,6.8
42083,2020-03-01,17248,15867,1381,8
42085,2020-03-01,48138,45014,3124,6.5
42087,2020-03-01,20983,19647,1336,6.4
42089,2020-03-01,83189,77474,5715,6.9
42091,2020-03-01,455053,435574,19479,4.3
42093,2020-03-01,9239,8818,421,4.6
42095,2020-03-01,161298,152369,8929,5.5
42097,2020-03-01,42484,39281,3203,7.5
42099,2020-03-01,24280,23143,1137,4.7
42101,2020-03-01,732383,683396,48987,6.7
42103,2020-03-01,25384,23507,1877,7.4
42105,2020-03-01,7135,6441,694,9.7
42107,2020-03-01,66399,62057,4342,6.5
42109,2020-03-01,19597,18348,1249,6.4
42111,2020-03-01,33237,30670,2567,7.7
42113,2020-03-01,2558,2359,199,7.8
42115,2020-03-01,20108,18822,1286,6.4
42117,2020-03-01,19108,17612,1496,7.8
42119,2020-03-01,19792,18862,930,4.7
42121,2020-03-01,22125,20561,1564,7.1
42123,2020-03-01,18539,17281,1258,6.8
42125,2020-03-01,106938,100265,6673,6.2
42127,2020-03-01,21876,20242,1634,7.5
42129,2020-03-01,180021,169106,10915,6.1
42131,2020-03-01,13596,12680,916,6.7
42133,2020-03-01,234159,223347,10812,4.6
44001,2020-03-01,25935,24897,1038,4
44003,2020-03-01,91279,87209,4070,4.5
44005,2020-03-01,44299,42258,2041,4.6
44007,2020-03-01,328311,311378,16933,5.2
44009,2020-03-01,68368,65433,2935,4.3
45001,2020-03-01,10056,9670,386,3.8
45003,2020-03-01,75310,73043,2267,3
45005,2020-03-01,2586,2408,178,6.9
45007,2020-03-01,90207,87552,2655,2.9
45009,2020-03-01,4821,4502,319,6.6
45011,2020-03-01,7823,7432,391,5
45013,2020-03-01,76240,74076,2164,2.8
45015,2020-03-01,105151,102234,2917,2.8
45017,2020-03-01,6463,6223,240,3.7
45019,2020-03-01,209943,204722,5221,2.5
45021,2020-03-01,24862,23970,892,3.6
45023,2020-03-01,13347,12679,668,5
45025,2020-03-01,21458,20773,685,3.2
45027,2020-03-01,12481,11955,526,4.2
45029,2020-03-01,16518,15956,562,3.4
45031,2020-03-01,29834,28805,1029,3.4
45033,2020-03-01,12744,12198,546,4.3
45035,2020-03-01,77574,75504,2070,2.7
45037,2020-03-01,10714,10388,326,3
45039,2020-03-01,9415,8963,452,4.8
45041,2020-03-01,66272,64135,2137,3.2
45043,2020-03-01,25516,24435,1081,4.2
45045,2020-03-01,254021,247328,6693,2.6
45047,2020-03-01,31356,30262,1094,3.5
45049,2020-03-01,8079,7842,237,2.9
45051,2020-03-01,144583,138654,5929,4.1
45053,2020-03-01,12645,12302,343,2.7
45055,2020-03-01,29179,28202,977,3.3
45057,2020-03-01,42041,40431,1610,3.8
45059,2020-03-01,29756,28768,988,3.3
45061,2020-03-01,6573,6220,353,5.4
45063,2020-03-01,149184,145480,3704,2.5
45065,2020-03-01,3325,3188,137,4.1
45067,2020-03-01,12694,12103,591,4.7
45069,2020-03-01,8752,8308,444,5.1
45071,2020-03-01,18684,18147,537,2.9
45073,2020-03-01,34425,33420,1005,2.9
45075,2020-03-01,34101,32353,1748,5.1
45077,2020-03-01,57121,55397,1724,3
45079,2020-03-01,196291,190467,5824,3
45081,2020-03-01,8569,8313,256,3
45083,2020-03-01,155249,150923,4326,2.8
45085,2020-03-01,42855,41144,1711,4
45087,2020-03-01,11602,11123,479,4.1
45089,2020-03-01,11731,11125,606,5.2
45091,2020-03-01,142264,138088,4176,2.9
46003,2020-03-01,1487,1448,39,2.6
46005,2020-03-01,9331,9030,301,3.2
46007,2020-03-01,1072,1023,49,4.6
46009,2020-03-01,2844,2755,89,3.1
46011,2020-03-01,18515,17921,594,3.2
46013,2020-03-01,20474,19820,654,3.2
46015,2020-03-01,2456,2379,77,3.1
46017,2020-03-01,621,589,32,5.2
46019,2020-03-01,4922,4738,184,3.7
46021,2020-03-01,786,749,37,4.7
46023,2020-03-01,3699,3570,129,3.5
46025,2020-03-01,2032,1938,94,4.6
46027,2020-03-01,7381,7156,225,3
46029,2020-03-01,15487,14975,512,3.3
46031,2020-03-01,1376,1311,65,4.7
46033,2020-03-01,4050,3839,211,5.2
46035,2020-03-01,10894,10526,368,3.4
46037,2020-03-01,2674,2505,169,6.3
46039,2020-03-01,2172,2029,143,6.6
46041,2020-03-01,2205,2060,145,6.6
46043,2020-03-01,1575,1526,49,3.1
46045,2020-03-01,2030,1969,61,3
46047,2020-03-01,2928,2782,146,5
46049,2020-03-01,1042,1005,37,3.6
46051,2020-03-01,4470,4259,211,4.7
46053,2020-03-01,2013,1941,72,3.6
46055,2020-03-01,1078,1046,32,3
46057,2020-03-01,3316,3202,114,3.4
46059,2020-03-01,1747,1701,46,2.6
46061,2020-03-01,1783,1679,104,5.8
46063,2020-03-01,731,712,19,2.6
46065,2020-03-01,9629,9343,286,3
46067,2020-03-01,3656,3508,148,4
46069,2020-03-01,709,689,20,2.8
46071,2020-03-01,1194,1133,61,5.1
46073,2020-03-01,1157,1131,26,2.2
46075,2020-03-01,503,488,15,3
46077,2020-03-01,2655,2558,97,3.7
46079,2020-03-01,6585,6367,218,3.3
46081,2020-03-01,13214,12816,398,3
46083,2020-03-01,35567,34632,935,2.6
46085,2020-03-01,1647,1567,80,4.9
46087,2020-03-01,3105,3003,102,3.3
46089,2020-03-01,1023,974,49,4.8
46091,2020-03-01,2406,2289,117,4.9
46093,2020-03-01,13612,13118,494,3.6
46095,2020-03-01,741,698,43,5.8
46097,2020-03-01,1166,1134,32,2.7
46099,2020-03-01,112266,108655,3611,3.2
46101,2020-03-01,4033,3876,157,3.9
46102,2020-03-01,3529,3257,272,7.7
46103,2020-03-01,55526,53503,2023,3.6
46105,2020-03-01,1392,1351,41,2.9
46107,2020-03-01,1008,976,32,3.2
46109,2020-03-01,4737,4444,293,6.2
46111,2020-03-01,1189,1145,44,3.7
46115,2020-03-01,3136,2995,141,4.5
46117,2020-03-01,1866,1794,72,3.9
46119,2020-03-01,797,773,24,3
46121,2020-03-01,3082,2893,189,6.1
46123,2020-03-01,3023,2938,85,2.8
46125,2020-03-01,4693,4526,167,3.6
46127,2020-03-01,8559,8276,283,3.3
46129,2020-03-01,2089,1944,145,6.9
46135,2020-03-01,11777,11421,356,3
46137,2020-03-01,931,895,36,3.9
47001,2020-03-01,34654,33187,1467,4.2
47003,2020-03-01,20804,19832,972,4.7
47005,2020-03-01,6880,6415,465,6.8
47007,2020-03-01,4361,4055,306,7
47009,2020-03-01,64029,61445,2584,4
47011,2020-03-01,51268,48958,2310,4.5
47013,2020-03-01,14895,14050,845,5.7
47015,2020-03-01,6609,6359,250,3.8
47017,2020-03-01,11810,11101,709,6
47019,2020-03-01,24128,22949,1179,4.9
47021,2020-03-01,21739,21017,722,3.3
47023,2020-03-01,8488,8156,332,3.9
47025,2020-03-01,12962,12266,696,5.4
47027,2020-03-01,2718,2498,220,8.1
47029,2020-03-01,14551,13637,914,6.3
47031,2020-03-01,25527,24385,1142,4.5
47033,2020-03-01,6927,6569,358,5.2
47035,2020-03-01,23030,21565,1465,6.4
47037,2020-03-01,401339,388074,13265,3.3
47039,2020-03-01,4533,4210,323,7.1
47041,2020-03-01,7509,7106,403,5.4
47043,2020-03-01,27008,25993,1015,3.8
47045,2020-03-01,15921,14979,942,5.9
47047,2020-03-01,19124,18299,825,4.3
47049,2020-03-01,7461,7069,392,5.3
47051,2020-03-01,20206,19269,937,4.6
47053,2020-03-01,21593,20494,1099,5.1
47055,2020-03-01,14827,14010,817,5.5
47057,2020-03-01,9559,9044,515,5.4
47059,2020-03-01,29013,27388,1625,5.6
47061,2020-03-01,5058,4784,274,5.4
47063,2020-03-01,28086,26737,1349,4.8
47065,2020-03-01,183786,176171,7615,4.1
47067,2020-03-01,2144,2006,138,6.4
47069,2020-03-01,9333,8775,558,6
47071,2020-03-01,10252,9634,618,6
47073,2020-03-01,23787,22516,1271,5.3
47075,2020-03-01,7632,7197,435,5.7
47077,2020-03-01,12084,11418,666,5.5
47079,2020-03-01,13819,13024,795,5.8
47081,2020-03-01,11365,10915,450,4
47083,2020-03-01,3305,3070,235,7.1
47085,2020-03-01,8842,8368,474,5.4
47087,2020-03-01,4706,4432,274,5.8
47089,2020-03-01,24631,23472,1159,4.7
47091,2020-03-01,7776,7416,360,4.6
47093,2020-03-01,245121,236372,8749,3.6
47095,2020-03-01,1656,1537,119,7.2
47097,2020-03-01,9706,9070,636,6.6
47099,2020-03-01,18872,17939,933,4.9
47101,2020-03-01,5222,4998,224,4.3
47103,2020-03-01,16149,14822,1327,8.2
47105,2020-03-01,23790,22730,1060,4.5
47107,2020-03-01,23817,22677,1140,4.8
47109,2020-03-01,8311,7753,558,6.7
47111,2020-03-01,11227,10785,442,3.9
47113,2020-03-01,48983,46932,2051,4.2
47115,2020-03-01,12491,11860,631,5.1
47117,2020-03-01,15502,14800,702,4.5
47119,2020-03-01,49944,48056,1888,3.8
47121,2020-03-01,5182,4865,317,6.1
47123,2020-03-01,20190,19225,965,4.8
47125,2020-03-01,86721,82577,4144,4.8
47127,2020-03-01,3733,3595,138,3.7
47129,2020-03-01,7812,7390,422,5.4
47131,2020-03-01,12311,11600,711,5.8
47133,2020-03-01,9745,9245,500,5.1
47135,2020-03-01,3028,2851,177,5.8
47137,2020-03-01,2218,2095,123,5.5
47139,2020-03-01,7268,6906,362,5
47141,2020-03-01,35111,33605,1506,4.3
47143,2020-03-01,13647,12740,907,6.6
47145,2020-03-01,23460,22249,1211,5.2
47147,2020-03-01,37934,36579,1355,3.6
47149,2020-03-01,186253,180331,5922,3.2
47151,2020-03-01,8290,7682,608,7.3
47153,2020-03-01,6192,5869,323,5.2
47155,2020-03-01,53864,51397,2467,4.6
47157,2020-03-01,442390,419943,22447,5.1
47159,2020-03-01,9475,9081,394,4.2
47161,2020-03-01,5463,5153,310,5.7
47163,2020-03-01,70146,66918,3228,4.6
47165,2020-03-01,103603,100024,3579,3.5
47167,2020-03-01,27920,26517,1403,5
47169,2020-03-01,5495,5284,211,3.8
47171,2020-03-01,7199,6731,468,6.5
47173,2020-03-01,7675,7313,362,4.7
47175,2020-03-01,2036,1909,127,6.2
47177,2020-03-01,16802,15972,830,4.9
47179,2020-03-01,61040,58461,2579,4.2
47181,2020-03-01,6339,5975,364,5.7
47183,2020-03-01,15845,15175,670,4.2
47185,2020-03-01,12063,11496,567,4.7
47187,2020-03-01,130778,126550,4228,3.2
47189,2020-03-01,78001,75335,2666,3.4
48001,2020-03-01,23203,22243,960,4.1
48003,2020-03-01,9460,9126,334,3.5
48005,2020-03-01,35267,33215,2052,5.8
48007,2020-03-01,9144,8581,563,6.2
48009,2020-03-01,3939,3782,157,4
48011,2020-03-01,924,887,37,4
48013,2020-03-01,21557,20433,1124,5.2
48015,2020-03-01,13910,13210,700,5
48017,2020-03-01,2454,2331,123,5
48019,2020-03-01,9927,9470,457,4.6
48021,2020-03-01,42733,40978,1755,4.1
48023,2020-03-01,1770,1710,60,3.4
48025,2020-03-01,10015,9359,656,6.6
48027,2020-03-01,143080,135602,7478,5.2
48029,2020-03-01,931622,889643,41979,4.5
48031,2020-03-01,6618,6400,218,3.3
48033,2020-03-01,442,426,16,3.6
48035,2020-03-01,8275,7869,406,4.9
48037,2020-03-01,38826,36624,2202,5.7
48039,2020-03-01,179272,168347,10925,6.1
48041,2020-03-01,119635,115179,4456,3.7
48043,2020-03-01,4049,3878,171,4.2
48045,2020-03-01,583,551,32,5.5
48047,2020-03-01,2732,2510,222,8.1
48049,2020-03-01,15244,14356,888,5.8
48051,2020-03-01,8412,7995,417,5
48053,2020-03-01,23580,22692,888,3.8
48055,2020-03-01,19419,18529,890,4.6
48057,2020-03-01,11885,11343,542,4.6
48059,2020-03-01,6021,5757,264,4.4
48061,2020-03-01,168585,155564,13021,7.7
48063,2020-03-01,4924,4637,287,5.8
48065,2020-03-01,2956,2845,111,3.8
48067,2020-03-01,12139,11376,763,6.3
48069,2020-03-01,3361,3236,125,3.7
48071,2020-03-01,19878,18592,1286,6.5
48073,2020-03-01,20935,19797,1138,5.4
48075,2020-03-01,3065,2949,116,3.8
48077,2020-03-01,4834,4628,206,4.3
48079,2020-03-01,1133,1078,55,4.9
48081,2020-03-01,1405,1347,58,4.1
48083,2020-03-01,2849,2659,190,6.7
48085,2020-03-01,567942,543490,24452,4.3
48087,2020-03-01,1077,1024,53,4.9
48089,2020-03-01,9789,9334,455,4.6
48091,2020-03-01,75153,71815,3338,4.4
48093,2020-03-01,5611,5317,294,5.2
48095,2020-03-01,1335,1282,53,4
48097,2020-03-01,19405,18540,865,4.5
48099,2020-03-01,23879,22597,1282,5.4
48101,2020-03-01,551,518,33,6
48103,2020-03-01,1556,1449,107,6.9
48105,2020-03-01,1573,1480,93,5.9
48107,2020-03-01,2435,2319,116,4.8
48109,2020-03-01,1144,1098,46,4
48111,2020-03-01,3755,3642,113,3
48113,2020-03-01,NA,NA,64818,4.8
48115,2020-03-01,4510,4239,271,6
48117,2020-03-01,8635,8320,315,3.6
48119,2020-03-01,2407,2291,116,4.8
48121,2020-03-01,500051,479118,20933,4.2
48123,2020-03-01,9367,9006,361,3.9
48125,2020-03-01,677,640,37,5.5
48127,2020-03-01,6987,6721,266,3.8
48129,2020-03-01,1445,1380,65,4.5
48131,2020-03-01,4830,4480,350,7.2
48133,2020-03-01,7613,7217,396,5.2
48135,2020-03-01,85687,81632,4055,4.7
48137,2020-03-01,1164,1131,33,2.8
48139,2020-03-01,93512,89416,4096,4.4
48141,2020-03-01,360545,341691,18854,5.2
48143,2020-03-01,20587,19648,939,4.6
48145,2020-03-01,6471,6156,315,4.9
48147,2020-03-01,16675,16035,640,3.8
48149,2020-03-01,11948,11501,447,3.7
48151,2020-03-01,1629,1571,58,3.6
48153,2020-03-01,2554,2371,183,7.2
48155,2020-03-01,575,554,21,3.7
48157,2020-03-01,397145,377533,19612,4.9
48159,2020-03-01,4715,4502,213,4.5
48161,2020-03-01,6430,5975,455,7.1
48163,2020-03-01,10039,9642,397,4
48165,2020-03-01,9765,9399,366,3.7
48167,2020-03-01,164987,155649,9338,5.7
48169,2020-03-01,2061,1971,90,4.4
48171,2020-03-01,13423,12945,478,3.6
48173,2020-03-01,884,859,25,2.8
48175,2020-03-01,3178,3006,172,5.4
48177,2020-03-01,9730,9343,387,4
48179,2020-03-01,7801,7365,436,5.6
48181,2020-03-01,63815,60947,2868,4.5
48183,2020-03-01,56976,53803,3173,5.6
48185,2020-03-01,11185,10478,707,6.3
48187,2020-03-01,80626,77316,3310,4.1
48189,2020-03-01,11868,11156,712,6
48191,2020-03-01,1082,1015,67,6.2
48193,2020-03-01,3739,3581,158,4.2
48195,2020-03-01,2522,2439,83,3.3
48197,2020-03-01,1719,1650,69,4
48199,2020-03-01,25342,23710,1632,6.4
48201,2020-03-01,NA,NA,128091,5.6
48203,2020-03-01,29190,27468,1722,5.9
48205,2020-03-01,2637,2574,63,2.4
48207,2020-03-01,2611,2511,100,3.8
48209,2020-03-01,120942,116311,4631,3.8
48211,2020-03-01,2042,1965,77,3.8
48213,2020-03-01,36905,35023,1882,5.1
48215,2020-03-01,359125,326667,32458,9
48217,2020-03-01,16302,15530,772,4.7
48219,2020-03-01,11133,10656,477,4.3
48221,2020-03-01,27631,26289,1342,4.9
48223,2020-03-01,17385,16632,753,4.3
48225,2020-03-01,10029,9533,496,4.9
48227,2020-03-01,13791,13151,640,4.6
48229,2020-03-01,1857,1757,100,5.4
48231,2020-03-01,43564,41353,2211,5.1
48233,2020-03-01,8434,7908,526,6.2
48235,2020-03-01,755,727,28,3.7
48237,2020-03-01,3451,3261,190,5.5
48239,2020-03-01,7520,7189,331,4.4
48241,2020-03-01,12819,11644,1175,9.2
48243,2020-03-01,1021,974,47,4.6
48245,2020-03-01,105821,96859,8962,8.5
48247,2020-03-01,1858,1744,114,6.1
48249,2020-03-01,16535,15246,1289,7.8
48251,2020-03-01,82920,79141,3779,4.6
48253,2020-03-01,5779,5448,331,5.7
48255,2020-03-01,7434,7167,267,3.6
48257,2020-03-01,66952,63936,3016,4.5
48259,2020-03-01,22350,21487,863,3.9
48261,2020-03-01,230,219,11,4.8
48263,2020-03-01,479,453,26,5.4
48265,2020-03-01,21762,20800,962,4.4
48267,2020-03-01,1796,1713,83,4.6
48269,2020-03-01,239,232,7,2.9
48271,2020-03-01,1389,1305,84,6
48273,2020-03-01,13489,12654,835,6.2
48275,2020-03-01,1472,1398,74,5
48277,2020-03-01,23215,22179,1036,4.5
48279,2020-03-01,5252,4978,274,5.2
48281,2020-03-01,9062,8642,420,4.6
48283,2020-03-01,4105,3927,178,4.3
48285,2020-03-01,8421,8078,343,4.1
48287,2020-03-01,9284,8885,399,4.3
48289,2020-03-01,6207,5806,401,6.5
48291,2020-03-01,33667,31103,2564,7.6
48293,2020-03-01,8454,7990,464,5.5
48295,2020-03-01,1596,1540,56,3.5
48297,2020-03-01,5371,5121,250,4.7
48299,2020-03-01,8561,8146,415,4.8
48301,2020-03-01,298,293,5,1.7
48303,2020-03-01,155450,149511,5939,3.8
48305,2020-03-01,2781,2649,132,4.7
48307,2020-03-01,3300,3098,202,6.1
48309,2020-03-01,118433,112819,5614,4.7
48311,2020-03-01,790,774,16,2
48313,2020-03-01,4450,4200,250,5.6
48315,2020-03-01,4242,3964,278,6.6
48317,2020-03-01,2762,2658,104,3.8
48319,2020-03-01,1771,1688,83,4.7
48321,2020-03-01,17022,15722,1300,7.6
48323,2020-03-01,24414,21396,3018,12.4
48325,2020-03-01,21572,20573,999,4.6
48327,2020-03-01,897,860,37,4.1
48329,2020-03-01,104321,100818,3503,3.4
48331,2020-03-01,9716,9134,582,6
48333,2020-03-01,1915,1836,79,4.1
48335,2020-03-01,2347,2241,106,4.5
48337,2020-03-01,9266,8851,415,4.5
48339,2020-03-01,287022,272928,14094,4.9
48341,2020-03-01,10433,10083,350,3.4
48343,2020-03-01,4798,4457,341,7.1
48345,2020-03-01,451,426,25,5.5
48347,2020-03-01,28217,26708,1509,5.3
48349,2020-03-01,23260,22080,1180,5.1
48351,2020-03-01,5176,4687,489,9.4
48353,2020-03-01,7142,6845,297,4.2
48355,2020-03-01,164034,154476,9558,5.8
48357,2020-03-01,4191,3994,197,4.7
48359,2020-03-01,901,868,33,3.7
48361,2020-03-01,36209,33562,2647,7.3
48363,2020-03-01,13260,12673,587,4.4
48365,2020-03-01,9522,8892,630,6.6
48367,2020-03-01,68404,65469,2935,4.3
48369,2020-03-01,4807,4659,148,3.1
48371,2020-03-01,6280,5953,327,5.2
48373,2020-03-01,18182,16914,1268,7
48375,2020-03-01,53562,51587,1975,3.7
48377,2020-03-01,3234,2895,339,10.5
48379,2020-03-01,5979,5729,250,4.2
48381,2020-03-01,72132,69689,2443,3.4
48383,2020-03-01,1868,1789,79,4.2
48385,2020-03-01,1061,992,69,6.5
48387,2020-03-01,5095,4785,310,6.1
48389,2020-03-01,10061,9686,375,3.7
48391,2020-03-01,3091,2927,164,5.3
48393,2020-03-01,422,401,21,5
48395,2020-03-01,7572,7182,390,5.2
48397,2020-03-01,53058,50840,2218,4.2
48399,2020-03-01,4577,4375,202,4.4
48401,2020-03-01,22495,21271,1224,5.4
48403,2020-03-01,3799,3449,350,9.2
48405,2020-03-01,3040,2797,243,8
48407,2020-03-01,11712,10982,730,6.2
48409,2020-03-01,29384,27168,2216,7.5
48411,2020-03-01,2388,2263,125,5.2
48413,2020-03-01,1227,1171,56,4.6
48415,2020-03-01,6337,5991,346,5.5
48417,2020-03-01,1867,1798,69,3.7
48419,2020-03-01,11167,10534,633,5.7
48421,2020-03-01,1345,1296,49,3.6
48423,2020-03-01,107191,102094,5097,4.8
48425,2020-03-01,4343,4132,211,4.9
48427,2020-03-01,26232,21747,4485,17.1
48429,2020-03-01,4016,3838,178,4.4
48431,2020-03-01,573,547,26,4.5
48433,2020-03-01,559,534,25,4.5
48435,2020-03-01,1243,1169,74,6
48437,2020-03-01,2544,2419,125,4.9
48439,2020-03-01,NA,NA,50132,4.7
48441,2020-03-01,66316,63634,2682,4
48443,2020-03-01,385,366,19,4.9
48445,2020-03-01,4889,4639,250,5.1
48447,2020-03-01,644,616,28,4.3
48449,2020-03-01,13291,12554,737,5.5
48451,2020-03-01,53899,51664,2235,4.1
48453,2020-03-01,737872,710622,27250,3.7
48455,2020-03-01,5270,4913,357,6.8
48457,2020-03-01,7370,6793,577,7.8
48459,2020-03-01,17687,16702,985,5.6
48461,2020-03-01,1847,1777,70,3.8
48463,2020-03-01,11439,10892,547,4.8
48465,2020-03-01,21911,20662,1249,5.7
48467,2020-03-01,25897,24680,1217,4.7
48469,2020-03-01,41121,38884,2237,5.4
48471,2020-03-01,23994,22663,1331,5.5
48473,2020-03-01,24050,22768,1282,5.3
48475,2020-03-01,6559,6260,299,4.6
48477,2020-03-01,15322,14550,772,5
48479,2020-03-01,117054,110716,6338,5.4
48481,2020-03-01,21752,20642,1110,5.1
48483,2020-03-01,2214,2116,98,4.4
48485,2020-03-01,55025,52603,2422,4.4
48487,2020-03-01,4908,4648,260,5.3
48489,2020-03-01,6771,6034,737,10.9
48491,2020-03-01,319321,306842,12479,3.9
48493,2020-03-01,24621,23585,1036,4.2
48495,2020-03-01,4276,4081,195,4.6
48497,2020-03-01,32383,30682,1701,5.3
48499,2020-03-01,17782,16780,1002,5.6
48501,2020-03-01,3515,3336,179,5.1
48503,2020-03-01,7692,7354,338,4.4
48505,2020-03-01,5050,4646,404,8
48507,2020-03-01,3523,3119,404,11.5
49001,2020-03-01,2908,2821,87,3
49003,2020-03-01,26307,25544,763,2.9
49005,2020-03-01,66332,64875,1457,2.2
49007,2020-03-01,8599,8242,357,4.2
49009,2020-03-01,358,342,16,4.5
49011,2020-03-01,174399,169772,4627,2.7
49013,2020-03-01,7838,7448,390,5
49015,2020-03-01,4348,4137,211,4.9
49017,2020-03-01,2491,2245,246,9.9
49019,2020-03-01,6150,5834,316,5.1
49021,2020-03-01,25140,24358,782,3.1
49023,2020-03-01,5879,5720,159,2.7
49025,2020-03-01,3767,3629,138,3.7
49027,2020-03-01,6158,5985,173,2.8
49029,2020-03-01,5558,5415,143,2.6
49031,2020-03-01,473,446,27,5.7
49033,2020-03-01,953,910,43,4.5
49035,2020-03-01,639601,621551,18050,2.8
49037,2020-03-01,5524,5135,389,7
49039,2020-03-01,12708,12268,440,3.5
49041,2020-03-01,9747,9382,365,3.7
49043,2020-03-01,26961,26304,657,2.4
49045,2020-03-01,35148,34085,1063,3
49047,2020-03-01,13308,12549,759,5.7
49049,2020-03-01,310898,302697,8201,2.6
49051,2020-03-01,16143,15643,500,3.1
49053,2020-03-01,78260,75718,2542,3.2
49055,2020-03-01,1401,1279,122,8.7
49057,2020-03-01,128698,124564,4134,3.2
50001,2020-03-01,20202,19611,591,2.9
50003,2020-03-01,18132,17511,621,3.4
50005,2020-03-01,14366,13841,525,3.7
50007,2020-03-01,94895,92896,1999,2.1
50009,2020-03-01,2668,2542,126,4.7
50011,2020-03-01,26892,26139,753,2.8
50013,2020-03-01,4105,3945,160,3.9
50015,2020-03-01,13975,13409,566,4.1
50017,2020-03-01,15807,15268,539,3.4
50019,2020-03-01,13436,12633,803,6
50021,2020-03-01,30155,29234,921,3.1
50023,2020-03-01,34698,33741,957,2.8
50025,2020-03-01,21895,21328,567,2.6
50027,2020-03-01,29190,28544,646,2.2
51001,2020-03-01,16091,15438,653,4.1
51003,2020-03-01,57867,56499,1368,2.4
51005,2020-03-01,6927,6672,255,3.7
51007,2020-03-01,6283,6097,186,3
51009,2020-03-01,15050,14563,487,3.2
51011,2020-03-01,7194,6934,260,3.6
51013,2020-03-01,156585,153734,2851,1.8
51015,2020-03-01,37573,36667,906,2.4
51017,2020-03-01,2436,2373,63,2.6
51019,2020-03-01,38699,37574,1125,2.9
51021,2020-03-01,2847,2749,98,3.4
51023,2020-03-01,17721,17273,448,2.5
51025,2020-03-01,5953,5689,264,4.4
51027,2020-03-01,6869,6412,457,6.7
51029,2020-03-01,6510,6220,290,4.5
51031,2020-03-01,26074,25249,825,3.2
51033,2020-03-01,15303,14809,494,3.2
51035,2020-03-01,13451,12753,698,5.2
51036,2020-03-01,3656,3534,122,3.3
51037,2020-03-01,5108,4911,197,3.9
51041,2020-03-01,191085,185994,5091,2.7
51043,2020-03-01,7650,7473,177,2.3
51045,2020-03-01,2350,2282,68,2.9
51047,2020-03-01,25161,24491,670,2.7
51049,2020-03-01,4612,4477,135,2.9
51051,2020-03-01,4871,4575,296,6.1
51053,2020-03-01,13669,13211,458,3.4
51057,2020-03-01,5520,5310,210,3.8
51059,2020-03-01,643716,629474,14242,2.2
51061,2020-03-01,37713,36819,894,2.4
51063,2020-03-01,8185,7951,234,2.9
51065,2020-03-01,14318,13977,341,2.4
51067,2020-03-01,26579,25774,805,3
51069,2020-03-01,49445,48311,1134,2.3
51071,2020-03-01,8017,7714,303,3.8
51073,2020-03-01,19642,19146,496,2.5
51075,2020-03-01,11441,11150,291,2.5
51077,2020-03-01,7996,7628,368,4.6
51079,2020-03-01,10577,10338,239,2.3
51081,2020-03-01,4302,4162,140,3.3
51083,2020-03-01,15199,14556,643,4.2
51085,2020-03-01,59821,58409,1412,2.4
51087,2020-03-01,184294,179318,4976,2.7
51089,2020-03-01,23538,22724,814,3.5
51091,2020-03-01,1155,1119,36,3.1
51093,2020-03-01,19548,19022,526,2.7
51095,2020-03-01,36930,35958,972,2.6
51097,2020-03-01,3879,3780,99,2.6
51099,2020-03-01,13917,13542,375,2.7
51101,2020-03-01,9273,9018,255,2.7
51103,2020-03-01,5342,5018,324,6.1
51105,2020-03-01,8405,8054,351,4.2
51107,2020-03-01,229850,224780,5070,2.2
51109,2020-03-01,20220,19678,542,2.7
51111,2020-03-01,5241,5089,152,2.9
51113,2020-03-01,7396,7243,153,2.1
51115,2020-03-01,4178,4058,120,2.9
51117,2020-03-01,12658,12165,493,3.9
51119,2020-03-01,5137,4994,143,2.8
51121,2020-03-01,51183,49761,1422,2.8
51125,2020-03-01,7443,7240,203,2.7
51127,2020-03-01,12891,12613,278,2.2
51131,2020-03-01,5088,4836,252,5
51133,2020-03-01,5606,5273,333,5.9
51135,2020-03-01,7332,7138,194,2.6
51137,2020-03-01,17190,16700,490,2.9
51139,2020-03-01,11960,11371,589,4.9
51141,2020-03-01,7253,6978,275,3.8
51143,2020-03-01,30106,29025,1081,3.6
51145,2020-03-01,14431,14068,363,2.5
51147,2020-03-01,10125,9718,407,4
51149,2020-03-01,15273,14786,487,3.2
51153,2020-03-01,251204,244944,6260,2.5
51155,2020-03-01,16714,15894,820,4.9
51157,2020-03-01,3730,3641,89,2.4
51159,2020-03-01,4056,3934,122,3
51161,2020-03-01,50316,49023,1293,2.6
51163,2020-03-01,10734,10447,287,2.7
51165,2020-03-01,42415,41433,982,2.3
51167,2020-03-01,11433,10886,547,4.8
51169,2020-03-01,9181,8876,305,3.3
51171,2020-03-01,22334,21745,589,2.6
51173,2020-03-01,13457,12918,539,4
51175,2020-03-01,9034,8771,263,2.9
51177,2020-03-01,69031,67142,1889,2.7
51179,2020-03-01,74758,72797,1961,2.6
51181,2020-03-01,3720,3601,119,3.2
51183,2020-03-01,3672,3508,164,4.5
51185,2020-03-01,15818,15078,740,4.7
51187,2020-03-01,20762,20194,568,2.7
51191,2020-03-01,26546,25669,877,3.3
51193,2020-03-01,9458,9093,365,3.9
51195,2020-03-01,13480,12792,688,5.1
51197,2020-03-01,13909,13319,590,4.2
51199,2020-03-01,33288,32435,853,2.6
51510,2020-03-01,102438,100268,2170,2.1
51520,2020-03-01,7362,7092,270,3.7
51530,2020-03-01,3161,3071,90,2.8
51540,2020-03-01,26262,25669,593,2.3
51550,2020-03-01,124978,121503,3475,2.8
51570,2020-03-01,8625,8370,255,3
51580,2020-03-01,2417,2288,129,5.3
51590,2020-03-01,19240,18217,1023,5.3
51595,2020-03-01,2284,2185,99,4.3
51600,2020-03-01,13361,13083,278,2.1
51610,2020-03-01,8647,8477,170,2
51620,2020-03-01,3591,3468,123,3.4
51630,2020-03-01,14339,13897,442,3.1
51640,2020-03-01,2958,2794,164,5.5
51650,2020-03-01,65086,62710,2376,3.7
51660,2020-03-01,24923,24147,776,3.1
51670,2020-03-01,9731,9325,406,4.2
51678,2020-03-01,2146,2059,87,4.1
51680,2020-03-01,36596,35268,1328,3.6
51683,2020-03-01,22151,21594,557,2.5
51685,2020-03-01,9613,9383,230,2.4
51690,2020-03-01,5475,5238,237,4.3
51700,2020-03-01,90186,87032,3154,3.5
51710,2020-03-01,112216,108439,3777,3.4
51720,2020-03-01,1691,1616,75,4.4
51730,2020-03-01,13055,12316,739,5.7
51735,2020-03-01,6440,6287,153,2.4
51740,2020-03-01,44632,42924,1708,3.8
51750,2020-03-01,8875,8545,330,3.7
51760,2020-03-01,120042,116154,3888,3.2
51770,2020-03-01,49692,48153,1539,3.1
51775,2020-03-01,13068,12693,375,2.9
51790,2020-03-01,12352,12032,320,2.6
51800,2020-03-01,45509,44165,1344,3
51810,2020-03-01,235133,228939,6194,2.6
51820,2020-03-01,10803,10509,294,2.7
51830,2020-03-01,6792,6526,266,3.9
51840,2020-03-01,14964,14554,410,2.7
53001,2020-03-01,8845,8278,567,6.4
53003,2020-03-01,10450,10002,448,4.3
53005,2020-03-01,103505,97012,6493,6.3
53007,2020-03-01,43290,40544,2746,6.3
53009,2020-03-01,29078,27033,2045,7
53011,2020-03-01,248483,235572,12911,5.2
53013,2020-03-01,1749,1629,120,6.9
53015,2020-03-01,48756,45456,3300,6.8
53017,2020-03-01,21215,19735,1480,7
53019,2020-03-01,2580,2266,314,12.2
53021,2020-03-01,41623,38649,2974,7.1
53023,2020-03-01,782,726,56,7.2
53025,2020-03-01,45765,42227,3538,7.7
53027,2020-03-01,28784,26464,2320,8.1
53029,2020-03-01,36643,34572,2071,5.7
53031,2020-03-01,12873,12057,816,6.3
53033,2020-03-01,NA,NA,67664,5.3
53035,2020-03-01,130853,124063,6790,5.2
53037,2020-03-01,23531,21822,1709,7.3
53039,2020-03-01,9701,9094,607,6.3
53041,2020-03-01,35230,32645,2585,7.3
53043,2020-03-01,4729,4403,326,6.9
53045,2020-03-01,25221,23402,1819,7.2
53047,2020-03-01,19058,17436,1622,8.5
53049,2020-03-01,8193,7541,652,8
53051,2020-03-01,5073,4624,449,8.9
53053,2020-03-01,456672,428716,27956,6.1
53055,2020-03-01,8116,7692,424,5.2
53057,2020-03-01,62929,59050,3879,6.2
53059,2020-03-01,5643,5320,323,5.7
53061,2020-03-01,435884,412735,23149,5.3
53063,2020-03-01,263063,246432,16631,6.3
53065,2020-03-01,19325,17580,1745,9
53067,2020-03-01,147279,138361,8918,6.1
53069,2020-03-01,1337,1230,107,8
53071,2020-03-01,30554,28818,1736,5.7
53073,2020-03-01,117972,110986,6986,5.9
53075,2020-03-01,24215,22944,1271,5.2
53077,2020-03-01,128463,118418,10045,7.8
54001,2020-03-01,7461,6902,559,7.5
54003,2020-03-01,58173,55994,2179,3.7
54005,2020-03-01,7483,6908,575,7.7
54007,2020-03-01,5415,4777,638,11.8
54009,2020-03-01,9903,9232,671,6.8
54011,2020-03-01,41560,39644,1916,4.6
54013,2020-03-01,2679,2138,541,20.2
54015,2020-03-01,3266,2844,422,12.9
54017,2020-03-01,3911,3686,225,5.8
54019,2020-03-01,16287,14960,1327,8.1
54021,2020-03-01,2431,2191,240,9.9
54023,2020-03-01,5994,5624,370,6.2
54025,2020-03-01,15704,14724,980,6.2
54027,2020-03-01,10813,10343,470,4.3
54029,2020-03-01,12951,12118,833,6.4
54031,2020-03-01,5852,5497,355,6.1
54033,2020-03-01,34101,32119,1982,5.8
54035,2020-03-01,12429,11534,895,7.2
54037,2020-03-01,30261,29263,998,3.3
54039,2020-03-01,82440,77954,4486,5.4
54041,2020-03-01,6276,5712,564,9
54043,2020-03-01,7359,6744,615,8.4
54045,2020-03-01,11310,10285,1025,9.1
54047,2020-03-01,4554,4001,553,12.1
54049,2020-03-01,25647,24115,1532,6
54051,2020-03-01,13820,12558,1262,9.1
54053,2020-03-01,10265,9495,770,7.5
54055,2020-03-01,21232,19802,1430,6.7
54057,2020-03-01,12449,11664,785,6.3
54059,2020-03-01,6940,6111,829,11.9
54061,2020-03-01,55494,53327,2167,3.9
54063,2020-03-01,6057,5667,390,6.4
54065,2020-03-01,8207,7852,355,4.3
54067,2020-03-01,9417,8486,931,9.9
54069,2020-03-01,20369,19173,1196,5.9
54071,2020-03-01,3657,3494,163,4.5
54073,2020-03-01,2774,2503,271,9.8
54075,2020-03-01,4243,3981,262,6.2
54077,2020-03-01,15850,14935,915,5.8
54079,2020-03-01,27101,25730,1371,5.1
54081,2020-03-01,30234,28408,1826,6
54083,2020-03-01,12472,11581,891,7.1
54085,2020-03-01,4471,4104,367,8.2
54087,2020-03-01,5232,4591,641,12.3
54089,2020-03-01,4353,4031,322,7.4
54091,2020-03-01,7894,7404,490,6.2
54093,2020-03-01,3395,3158,237,7
54095,2020-03-01,3232,2910,322,10
54097,2020-03-01,9753,9026,727,7.5
54099,2020-03-01,15981,14900,1081,6.8
54101,2020-03-01,3327,3000,327,9.8
54103,2020-03-01,6745,6116,629,9.3
54105,2020-03-01,2338,2076,262,11.2
54107,2020-03-01,36396,34015,2381,6.5
54109,2020-03-01,7008,6409,599,8.5
55001,2020-03-01,7951,7384,567,7.1
55003,2020-03-01,7387,6953,434,5.9
55005,2020-03-01,23713,22463,1250,5.3
55007,2020-03-01,7152,6623,529,7.4
55009,2020-03-01,138302,133699,4603,3.3
55011,2020-03-01,6290,5907,383,6.1
55013,2020-03-01,6993,6458,535,7.7
55015,2020-03-01,26964,26171,793,2.9
55017,2020-03-01,33325,31550,1775,5.3
55019,2020-03-01,17260,16574,686,4
55021,2020-03-01,31332,30174,1158,3.7
55023,2020-03-01,7413,6954,459,6.2
55025,2020-03-01,319340,311568,7772,2.4
55027,2020-03-01,46485,44849,1636,3.5
55029,2020-03-01,13828,13065,763,5.5
55031,2020-03-01,22874,21537,1337,5.8
55033,2020-03-01,24373,23249,1124,4.6
55035,2020-03-01,58080,56178,1902,3.3
55037,2020-03-01,2146,2027,119,5.5
55039,2020-03-01,55411,53511,1900,3.4
55041,2020-03-01,3960,3703,257,6.5
55043,2020-03-01,27779,26684,1095,3.9
55045,2020-03-01,20786,20048,738,3.6
55047,2020-03-01,8909,8439,470,5.3
55049,2020-03-01,13529,12979,550,4.1
55051,2020-03-01,2482,2304,178,7.2
55053,2020-03-01,9754,9201,553,5.7
55055,2020-03-01,44798,43136,1662,3.7
55057,2020-03-01,13102,12509,593,4.5
55059,2020-03-01,87575,83728,3847,4.4
55061,2020-03-01,10711,10314,397,3.7
55063,2020-03-01,65354,63388,1966,3
55065,2020-03-01,9847,9509,338,3.4
55067,2020-03-01,9115,8630,485,5.3
55069,2020-03-01,14515,13780,735,5.1
55071,2020-03-01,40348,38726,1622,4
55073,2020-03-01,71683,69415,2268,3.2
55075,2020-03-01,19189,18099,1090,5.7
55077,2020-03-01,7600,7200,400,5.3
55078,2020-03-01,1530,1426,104,6.8
55079,2020-03-01,455680,436689,18991,4.2
55081,2020-03-01,23004,22215,789,3.4
55083,2020-03-01,20203,19187,1016,5
55085,2020-03-01,17204,16175,1029,6
55087,2020-03-01,101587,98404,3183,3.1
55089,2020-03-01,47800,46461,1339,2.8
55091,2020-03-01,4022,3826,196,4.9
55093,2020-03-01,24952,23804,1148,4.6
55095,2020-03-01,24584,23041,1543,6.3
55097,2020-03-01,38169,36696,1473,3.9
55099,2020-03-01,6084,5755,329,5.4
55101,2020-03-01,95815,91310,4505,4.7
55103,2020-03-01,8930,8581,349,3.9
55105,2020-03-01,83909,80277,3632,4.3
55107,2020-03-01,6564,6181,383,5.8
55109,2020-03-01,49982,47717,2265,4.5
55111,2020-03-01,34275,33002,1273,3.7
55113,2020-03-01,7570,7083,487,6.4
55115,2020-03-01,20657,19815,842,4.1
55117,2020-03-01,59912,58016,1896,3.2
55119,2020-03-01,10778,10206,572,5.3
55121,2020-03-01,15775,15004,771,4.9
55123,2020-03-01,14943,14280,663,4.4
55125,2020-03-01,9673,9084,589,6.1
55127,2020-03-01,56068,53956,2112,3.8
55129,2020-03-01,7668,7213,455,5.9
55131,2020-03-01,75696,73324,2372,3.1
55133,2020-03-01,220323,213597,6726,3.1
55135,2020-03-01,25175,24195,980,3.9
55137,2020-03-01,10953,10371,582,5.3
55139,2020-03-01,90146,87400,2746,3
55141,2020-03-01,33986,32420,1566,4.6
56001,2020-03-01,20645,19693,952,4.6
56003,2020-03-01,5141,4750,391,7.6
56005,2020-03-01,23916,22571,1345,5.6
56007,2020-03-01,7556,7108,448,5.9
56009,2020-03-01,8771,8356,415,4.7
56011,2020-03-01,3678,3493,185,5
56013,2020-03-01,19447,18061,1386,7.1
56015,2020-03-01,6468,6127,341,5.3
56017,2020-03-01,2241,2109,132,5.9
56019,2020-03-01,3963,3709,254,6.4
56021,2020-03-01,51042,48373,2669,5.2
56023,2020-03-01,9261,8700,561,6.1
56025,2020-03-01,41123,38610,2513,6.1
56027,2020-03-01,1207,1157,50,4.1
56029,2020-03-01,14713,13679,1034,7
56031,2020-03-01,4531,4258,273,6
56033,2020-03-01,15958,14982,976,6.1
56035,2020-03-01,3962,3590,372,9.4
56037,2020-03-01,21512,19879,1633,7.6
56039,2020-03-01,15372,14763,609,4
56041,2020-03-01,9316,8712,604,6.5
56043,2020-03-01,3915,3642,273,7
56045,2020-03-01,3865,3695,170,4.4
72001,2020-03-01,NA,NA,NA,NA
72003,2020-03-01,NA,NA,NA,NA
72005,2020-03-01,NA,NA,NA,NA
72007,2020-03-01,NA,NA,NA,NA
72009,2020-03-01,NA,NA,NA,NA
72011,2020-03-01,NA,NA,NA,NA
72013,2020-03-01,NA,NA,NA,NA
72015,2020-03-01,NA,NA,NA,NA
72017,2020-03-01,NA,NA,NA,NA
72019,2020-03-01,NA,NA,NA,NA
72021,2020-03-01,NA,NA,NA,NA
72023,2020-03-01,NA,NA,NA,NA
72025,2020-03-01,NA,NA,NA,NA
72027,2020-03-01,NA,NA,NA,NA
72029,2020-03-01,NA,NA,NA,NA
72031,2020-03-01,NA,NA,NA,NA
72033,2020-03-01,NA,NA,NA,NA
72035,2020-03-01,NA,NA,NA,NA
72037,2020-03-01,NA,NA,NA,NA
72039,2020-03-01,NA,NA,NA,NA
72041,2020-03-01,NA,NA,NA,NA
72043,2020-03-01,NA,NA,NA,NA
72045,2020-03-01,NA,NA,NA,NA
72047,2020-03-01,NA,NA,NA,NA
72049,2020-03-01,NA,NA,NA,NA
72051,2020-03-01,NA,NA,NA,NA
72053,2020-03-01,NA,NA,NA,NA
72054,2020-03-01,NA,NA,NA,NA
72055,2020-03-01,NA,NA,NA,NA
72057,2020-03-01,NA,NA,NA,NA
72059,2020-03-01,NA,NA,NA,NA
72061,2020-03-01,NA,NA,NA,NA
72063,2020-03-01,NA,NA,NA,NA
72065,2020-03-01,NA,NA,NA,NA
72067,2020-03-01,NA,NA,NA,NA
72069,2020-03-01,NA,NA,NA,NA
72071,2020-03-01,NA,NA,NA,NA
72073,2020-03-01,NA,NA,NA,NA
72075,2020-03-01,NA,NA,NA,NA
72077,2020-03-01,NA,NA,NA,NA
72079,2020-03-01,NA,NA,NA,NA
72081,2020-03-01,NA,NA,NA,NA
72083,2020-03-01,NA,NA,NA,NA
72085,2020-03-01,NA,NA,NA,NA
72087,2020-03-01,NA,NA,NA,NA
72089,2020-03-01,NA,NA,NA,NA
72091,2020-03-01,NA,NA,NA,NA
72093,2020-03-01,NA,NA,NA,NA
72095,2020-03-01,NA,NA,NA,NA
72097,2020-03-01,NA,NA,NA,NA
72099,2020-03-01,NA,NA,NA,NA
72101,2020-03-01,NA,NA,NA,NA
72103,2020-03-01,NA,NA,NA,NA
72105,2020-03-01,NA,NA,NA,NA
72107,2020-03-01,NA,NA,NA,NA
72109,2020-03-01,NA,NA,NA,NA
72111,2020-03-01,NA,NA,NA,NA
72113,2020-03-01,NA,NA,NA,NA
72115,2020-03-01,NA,NA,NA,NA
72117,2020-03-01,NA,NA,NA,NA
72119,2020-03-01,NA,NA,NA,NA
72121,2020-03-01,NA,NA,NA,NA
72123,2020-03-01,NA,NA,NA,NA
72125,2020-03-01,NA,NA,NA,NA
72127,2020-03-01,NA,NA,NA,NA
72129,2020-03-01,NA,NA,NA,NA
72131,2020-03-01,NA,NA,NA,NA
72133,2020-03-01,NA,NA,NA,NA
72135,2020-03-01,NA,NA,NA,NA
72137,2020-03-01,NA,NA,NA,NA
72139,2020-03-01,NA,NA,NA,NA
72141,2020-03-01,NA,NA,NA,NA
72143,2020-03-01,NA,NA,NA,NA
72145,2020-03-01,NA,NA,NA,NA
72147,2020-03-01,NA,NA,NA,NA
72149,2020-03-01,NA,NA,NA,NA
72151,2020-03-01,NA,NA,NA,NA
72153,2020-03-01,NA,NA,NA,NA
01001,2020-04-01,25040,22310,2730,10.9
01003,2020-04-01,94023,80391,13632,14.5
01005,2020-04-01,8308,7536,772,9.3
01007,2020-04-01,8854,7341,1513,17.1
01009,2020-04-01,23587,21448,2139,9.1
01011,2020-04-01,4522,4150,372,8.2
01013,2020-04-01,8948,7156,1792,20
01015,2020-04-01,46591,38338,8253,17.7
01017,2020-04-01,15517,13079,2438,15.7
01019,2020-04-01,10871,9516,1355,12.5
01021,2020-04-01,19115,16893,2222,11.6
01023,2020-04-01,4551,4049,502,11
01025,2020-04-01,7732,6678,1054,13.6
01027,2020-04-01,5953,5449,504,8.5
01029,2020-04-01,5673,5009,664,11.7
01031,2020-04-01,20741,18934,1807,8.7
01033,2020-04-01,23422,19717,3705,15.8
01035,2020-04-01,4410,3787,623,14.1
01037,2020-04-01,4252,3707,545,12.8
01039,2020-04-01,14565,13107,1458,10
01041,2020-04-01,5791,4841,950,16.4
01043,2020-04-01,36942,32740,4202,11.4
01045,2020-04-01,20105,18357,1748,8.7
01047,2020-04-01,14774,11724,3050,20.6
01049,2020-04-01,30210,26882,3328,11
01051,2020-04-01,35468,31663,3805,10.7
01053,2020-04-01,14171,12656,1515,10.7
01055,2020-04-01,40856,33031,7825,19.2
01057,2020-04-01,6449,5787,662,10.3
01059,2020-04-01,14311,12796,1515,10.6
01061,2020-04-01,10171,9401,770,7.6
01063,2020-04-01,3100,2450,650,21
01065,2020-04-01,5967,4708,1259,21.1
01067,2020-04-01,6460,5898,562,8.7
01069,2020-04-01,44714,40132,4582,10.2
01071,2020-04-01,22352,19496,2856,12.8
01073,2020-04-01,307556,270052,37504,12.2
01075,2020-04-01,5631,5010,621,11
01077,2020-04-01,41213,35452,5761,14
01079,2020-04-01,14036,12549,1487,10.6
01081,2020-04-01,71495,62669,8826,12.3
01083,2020-04-01,43443,38791,4652,10.7
01085,2020-04-01,3856,2874,982,25.5
01087,2020-04-01,8117,6643,1474,18.2
01089,2020-04-01,180149,162403,17746,9.9
01091,2020-04-01,7657,6829,828,10.8
01093,2020-04-01,12583,11268,1315,10.5
01095,2020-04-01,42831,38378,4453,10.4
01097,2020-04-01,188676,161867,26809,14.2
01099,2020-04-01,7446,6339,1107,14.9
01101,2020-04-01,105077,89855,15222,14.5
01103,2020-04-01,57723,51890,5833,10.1
01105,2020-04-01,3557,2862,695,19.5
01107,2020-04-01,7193,6152,1041,14.5
01109,2020-04-01,15020,13753,1267,8.4
01111,2020-04-01,9306,8184,1122,12.1
01113,2020-04-01,22816,20441,2375,10.4
01115,2020-04-01,39704,34717,4987,12.6
01117,2020-04-01,109539,99903,9636,8.8
01119,2020-04-01,4684,4099,585,12.5
01121,2020-04-01,37509,30397,7112,19
01123,2020-04-01,17150,14199,2951,17.2
01125,2020-04-01,99231,82345,16886,17
01127,2020-04-01,24326,21295,3031,12.5
01129,2020-04-01,6643,5867,776,11.7
01131,2020-04-01,2968,2340,628,21.2
01133,2020-04-01,9843,8876,967,9.8
02013,2020-04-01,2609,2405,204,7.8
02016,2020-04-01,4188,4031,157,3.7
02020,2020-04-01,146093,127936,18157,12.4
02050,2020-04-01,6782,5964,818,12.1
02060,2020-04-01,300,260,40,13.3
02068,2020-04-01,623,464,159,25.5
02070,2020-04-01,1663,1500,163,9.8
02090,2020-04-01,43589,39225,4364,10
02100,2020-04-01,1025,762,263,25.7
02105,2020-04-01,988,821,167,16.9
02110,2020-04-01,16064,14443,1621,10.1
02122,2020-04-01,25549,21719,3830,15
02130,2020-04-01,6407,5403,1004,15.7
02150,2020-04-01,5899,5375,524,8.9
02158,2020-04-01,2071,1580,491,23.7
02164,2020-04-01,614,529,85,13.8
02170,2020-04-01,47390,40805,6585,13.9
02180,2020-04-01,3763,3289,474,12.6
02185,2020-04-01,3515,3346,169,4.8
02188,2020-04-01,2878,2498,380,13.2
02195,2020-04-01,1410,1225,185,13.1
02198,2020-04-01,2760,2421,339,12.3
02220,2020-04-01,3905,3429,476,12.2
02230,2020-04-01,615,414,201,32.7
02240,2020-04-01,2893,2638,255,8.8
02261,2020-04-01,4170,3598,572,13.7
02275,2020-04-01,1003,874,129,12.9
02282,2020-04-01,257,232,25,9.7
02290,2020-04-01,2199,1863,336,15.3
04001,2020-04-01,20336,16952,3384,16.6
04003,2020-04-01,50687,44722,5965,11.8
04005,2020-04-01,73402,60028,13374,18.2
04007,2020-04-01,20820,18153,2667,12.8
04009,2020-04-01,15379,14110,1269,8.3
04011,2020-04-01,4484,4223,261,5.8
04012,2020-04-01,8551,7701,850,9.9
04013,2020-04-01,NA,NA,310426,13.5
04015,2020-04-01,89892,71600,18292,20.3
04017,2020-04-01,39760,33587,6173,15.5
04019,2020-04-01,492397,424014,68383,13.9
04021,2020-04-01,185725,161902,23823,12.8
04023,2020-04-01,19417,16129,3288,16.9
04025,2020-04-01,105257,88546,16711,15.9
04027,2020-04-01,99665,74785,24880,25
05001,2020-04-01,9460,9006,454,4.8
05003,2020-04-01,7300,6416,884,12.1
05005,2020-04-01,16608,14966,1642,9.9
05007,2020-04-01,139284,128956,10328,7.4
05009,2020-04-01,16081,14430,1651,10.3
05011,2020-04-01,4676,4213,463,9.9
05013,2020-04-01,2470,2300,170,6.9
05015,2020-04-01,12690,11387,1303,10.3
05017,2020-04-01,3345,2928,417,12.5
05019,2020-04-01,9397,8562,835,8.9
05021,2020-04-01,5522,5072,450,8.1
05023,2020-04-01,9052,7619,1433,15.8
05025,2020-04-01,3220,2956,264,8.2
05027,2020-04-01,9343,8503,840,9
05029,2020-04-01,8566,7689,877,10.2
05031,2020-04-01,55547,50639,4908,8.8
05033,2020-04-01,26637,24274,2363,8.9
05035,2020-04-01,21734,18871,2863,13.2
05037,2020-04-01,7372,6624,748,10.1
05039,2020-04-01,2848,2601,247,8.7
05041,2020-04-01,5506,5019,487,8.8
05043,2020-04-01,8021,7217,804,10
05045,2020-04-01,62844,56530,6314,10
05047,2020-04-01,7624,7012,612,8
05049,2020-04-01,5017,4669,348,6.9
05051,2020-04-01,40882,34738,6144,15
05053,2020-04-01,8210,7563,647,7.9
05055,2020-04-01,19433,17429,2004,10.3
05057,2020-04-01,10026,9243,783,7.8
05059,2020-04-01,14272,12876,1396,9.8
05061,2020-04-01,5545,5121,424,7.6
05063,2020-04-01,17709,15820,1889,10.7
05065,2020-04-01,4864,4229,635,13.1
05067,2020-04-01,6028,5487,541,9
05069,2020-04-01,27570,24829,2741,9.9
05071,2020-04-01,10208,9110,1098,10.8
05073,2020-04-01,2517,2270,247,9.8
05075,2020-04-01,6944,6335,609,8.8
05077,2020-04-01,2828,2570,258,9.1
05079,2020-04-01,3869,3539,330,8.5
05081,2020-04-01,5298,4760,538,10.2
05083,2020-04-01,8707,7727,980,11.3
05085,2020-04-01,33705,30720,2985,8.9
05087,2020-04-01,7255,6860,395,5.4
05089,2020-04-01,6481,5918,563,8.7
05091,2020-04-01,19646,17037,2609,13.3
05093,2020-04-01,17827,15664,2163,12.1
05095,2020-04-01,2769,2551,218,7.9
05097,2020-04-01,2936,2650,286,9.7
05099,2020-04-01,3704,3402,302,8.2
05101,2020-04-01,3259,2974,285,8.7
05103,2020-04-01,10149,9250,899,8.9
05105,2020-04-01,4216,3829,387,9.2
05107,2020-04-01,6635,5814,821,12.4
05109,2020-04-01,4314,3958,356,8.3
05111,2020-04-01,9740,8990,750,7.7
05113,2020-04-01,8158,7372,786,9.6
05115,2020-04-01,28206,25609,2597,9.2
05117,2020-04-01,3595,3342,253,7
05119,2020-04-01,191521,169576,21945,11.5
05121,2020-04-01,7515,6838,677,9
05123,2020-04-01,8188,7274,914,11.2
05125,2020-04-01,58470,53557,4913,8.4
05127,2020-04-01,4428,4175,253,5.7
05129,2020-04-01,2845,2550,295,10.4
05131,2020-04-01,57175,51276,5899,10.3
05133,2020-04-01,5663,5237,426,7.5
05135,2020-04-01,5911,5292,619,10.5
05137,2020-04-01,4597,4068,529,11.5
05139,2020-04-01,16086,14283,1803,11.2
05141,2020-04-01,5820,5191,629,10.8
05143,2020-04-01,125784,115971,9813,7.8
05145,2020-04-01,34591,31402,3189,9.2
05147,2020-04-01,2844,2643,201,7.1
05149,2020-04-01,7994,7429,565,7.1
06001,2020-04-01,798953,681973,116980,14.6
06003,2020-04-01,463,357,106,22.9
06005,2020-04-01,14210,12053,2157,15.2
06007,2020-04-01,92137,77447,14690,15.9
06009,2020-04-01,20512,17710,2802,13.7
06011,2020-04-01,10891,8095,2796,25.7
06013,2020-04-01,533284,452777,80507,15.1
06015,2020-04-01,9254,7916,1338,14.5
06017,2020-04-01,90805,76707,14098,15.5
06019,2020-04-01,445117,368876,76241,17.1
06021,2020-04-01,12629,10809,1820,14.4
06023,2020-04-01,58920,49968,8952,15.2
06025,2020-04-01,72869,52015,20854,28.6
06027,2020-04-01,7935,6756,1179,14.9
06029,2020-04-01,374498,304803,69695,18.6
06031,2020-04-01,57166,47508,9658,16.9
06033,2020-04-01,27959,23476,4483,16
06035,2020-04-01,9332,8257,1075,11.5
06037,2020-04-01,NA,NA,866928,18.2
06039,2020-04-01,59914,49479,10435,17.4
06041,2020-04-01,123478,108597,14881,12.1
06043,2020-04-01,7148,5689,1459,20.4
06045,2020-04-01,36595,30898,5697,15.6
06047,2020-04-01,116892,95300,21592,18.5
06049,2020-04-01,3171,2753,418,13.2
06051,2020-04-01,6673,4788,1885,28.2
06053,2020-04-01,215561,174378,41183,19.1
06055,2020-04-01,66343,54554,11789,17.8
06057,2020-04-01,44235,37405,6830,15.4
06059,2020-04-01,NA,NA,219551,14.4
06061,2020-04-01,182099,157991,24108,13.2
06063,2020-04-01,7381,5998,1383,18.7
06065,2020-04-01,NA,914293,174266,16
06067,2020-04-01,695803,592049,103754,14.9
06069,2020-04-01,32649,26520,6129,18.8
06071,2020-04-01,935015,802175,132840,14.2
06073,2020-04-01,NA,NA,240383,15.9
06075,2020-04-01,550493,478744,71749,13
06077,2020-04-01,329544,270709,58835,17.9
06079,2020-04-01,129536,110322,19214,14.8
06081,2020-04-01,427462,377213,50249,11.8
06083,2020-04-01,214288,184348,29940,14
06085,2020-04-01,NA,884639,122539,12.2
06087,2020-04-01,132150,108939,23211,17.6
06089,2020-04-01,72463,61061,11402,15.7
06091,2020-04-01,1208,1035,173,14.3
06093,2020-04-01,16713,14105,2608,15.6
06095,2020-04-01,200434,168901,31533,15.7
06097,2020-04-01,240967,203834,37133,15.4
06099,2020-04-01,240047,198648,41399,17.2
06101,2020-04-01,46160,37963,8197,17.8
06103,2020-04-01,25422,21683,3739,14.7
06105,2020-04-01,4371,3796,575,13.2
06107,2020-04-01,201485,163924,37561,18.6
06109,2020-04-01,19682,15763,3919,19.9
06111,2020-04-01,404736,346057,58679,14.5
06113,2020-04-01,101783,89781,12002,11.8
06115,2020-04-01,30091,25165,4926,16.4
08001,2020-04-01,260964,227899,33065,12.7
08003,2020-04-01,8100,7400,700,8.6
08005,2020-04-01,348344,304691,43653,12.5
08007,2020-04-01,6705,5693,1012,15.1
08009,2020-04-01,2047,1998,49,2.4
08011,2020-04-01,1737,1655,82,4.7
08013,2020-04-01,182720,164383,18337,10
08014,2020-04-01,38098,33883,4215,11.1
08015,2020-04-01,8705,7566,1139,13.1
08017,2020-04-01,1066,1041,25,2.3
08019,2020-04-01,6032,5077,955,15.8
08021,2020-04-01,3929,3630,299,7.6
08023,2020-04-01,1724,1593,131,7.6
08025,2020-04-01,1475,1393,82,5.6
08027,2020-04-01,1938,1807,131,6.8
08029,2020-04-01,13829,12536,1293,9.3
08031,2020-04-01,405075,350689,54386,13.4
08033,2020-04-01,1083,952,131,12.1
08035,2020-04-01,183803,165415,18388,10
08037,2020-04-01,32720,25144,7576,23.2
08039,2020-04-01,13992,12933,1059,7.6
08041,2020-04-01,325340,284718,40622,12.5
08043,2020-04-01,14680,13009,1671,11.4
08045,2020-04-01,28942,25019,3923,13.6
08047,2020-04-01,4178,3210,968,23.2
08049,2020-04-01,7947,6209,1738,21.9
08051,2020-04-01,10477,8800,1677,16
08053,2020-04-01,398,373,25,6.3
08055,2020-04-01,2513,2237,276,11
08057,2020-04-01,867,802,65,7.5
08059,2020-04-01,318333,279552,38781,12.2
08061,2020-04-01,900,878,22,2.4
08063,2020-04-01,4052,3906,146,3.6
08065,2020-04-01,4575,3771,804,17.6
08067,2020-04-01,29223,25414,3809,13
08069,2020-04-01,191968,170129,21839,11.4
08071,2020-04-01,6189,5589,600,9.7
08073,2020-04-01,2262,2139,123,5.4
08075,2020-04-01,10632,9975,657,6.2
08077,2020-04-01,71326,62203,9123,12.8
08079,2020-04-01,430,381,49,11.4
08081,2020-04-01,6781,6124,657,9.7
08083,2020-04-01,12097,10773,1324,10.9
08085,2020-04-01,20640,18308,2332,11.3
08087,2020-04-01,15340,14387,953,6.2
08089,2020-04-01,7977,7429,548,6.9
08091,2020-04-01,2260,1853,407,18
08093,2020-04-01,10504,9446,1058,10.1
08095,2020-04-01,2389,2305,84,3.5
08097,2020-04-01,11141,8501,2640,23.7
08099,2020-04-01,6007,5739,268,4.5
08101,2020-04-01,73586,65235,8351,11.3
08103,2020-04-01,2818,2629,189,6.7
08105,2020-04-01,5171,4660,511,9.9
08107,2020-04-01,14691,11917,2774,18.9
08109,2020-04-01,3252,3033,219,6.7
08111,2020-04-01,414,352,62,15
08113,2020-04-01,4869,3547,1322,27.2
08115,2020-04-01,1110,1070,40,3.6
08117,2020-04-01,18907,13948,4959,26.2
08119,2020-04-01,12587,10703,1884,15
08121,2020-04-01,2755,2666,89,3.2
08123,2020-04-01,159436,143479,15957,10
08125,2020-04-01,5459,5293,166,3
09001,2020-04-01,444981,408590,36391,8.2
09003,2020-04-01,464764,426471,38293,8.2
09005,2020-04-01,99251,91573,7678,7.7
09007,2020-04-01,90041,83581,6460,7.2
09009,2020-04-01,438973,403102,35871,8.2
09011,2020-04-01,123226,107625,15601,12.7
09013,2020-04-01,83016,77378,5638,6.8
09015,2020-04-01,60810,55656,5154,8.5
10001,2020-04-01,79510,68150,11360,14.3
10003,2020-04-01,294732,257621,37111,12.6
10005,2020-04-01,99484,84847,14637,14.7
11001,2020-04-01,405479,362532,42947,10.6
12001,2020-04-01,128757,116827,11930,9.3
12003,2020-04-01,10754,9984,770,7.2
12005,2020-04-01,78745,68004,10741,13.6
12007,2020-04-01,10201,9274,927,9.1
12009,2020-04-01,271094,235320,35774,13.2
12011,2020-04-01,985109,823964,161145,16.4
12013,2020-04-01,4597,4265,332,7.2
12015,2020-04-01,68093,57714,10379,15.2
12017,2020-04-01,44820,37888,6932,15.5
12019,2020-04-01,99194,89328,9866,9.9
12021,2020-04-01,167457,143548,23909,14.3
12023,2020-04-01,27692,25033,2659,9.6
12027,2020-04-01,14074,13054,1020,7.2
12029,2020-04-01,5524,5123,401,7.3
12031,2020-04-01,459188,404198,54990,12
12033,2020-04-01,139408,121639,17769,12.7
12035,2020-04-01,45105,38202,6903,15.3
12037,2020-04-01,4324,3820,504,11.7
12039,2020-04-01,17092,15689,1403,8.2
12041,2020-04-01,6586,6094,492,7.5
12043,2020-04-01,5032,4700,332,6.6
12045,2020-04-01,4585,4138,447,9.7
12047,2020-04-01,3928,3572,356,9.1
12049,2020-04-01,8169,7559,610,7.5
12051,2020-04-01,14787,13339,1448,9.8
12053,2020-04-01,69388,58860,10528,15.2
12055,2020-04-01,32968,29220,3748,11.4
12057,2020-04-01,723787,628506,95281,13.2
12059,2020-04-01,6576,6035,541,8.2
12061,2020-04-01,61964,53090,8874,14.3
12063,2020-04-01,16655,15421,1234,7.4
12065,2020-04-01,5027,4637,390,7.8
12067,2020-04-01,2644,2532,112,4.2
12069,2020-04-01,152820,129407,23413,15.3
12071,2020-04-01,331925,282047,49878,15
12073,2020-04-01,143237,130340,12897,9
12075,2020-04-01,15853,14142,1711,10.8
12077,2020-04-01,2514,2357,157,6.2
12079,2020-04-01,7148,6632,516,7.2
12081,2020-04-01,167663,144224,23439,14
12083,2020-04-01,132993,116279,16714,12.6
12085,2020-04-01,68565,60108,8457,12.3
12086,2020-04-01,NA,NA,123408,10.3
12087,2020-04-01,42132,32809,9323,22.1
12089,2020-04-01,39543,34829,4714,11.9
12091,2020-04-01,91365,78867,12498,13.7
12093,2020-04-01,16196,14931,1265,7.8
12095,2020-04-01,741391,605583,135808,18.3
12097,2020-04-01,190406,147534,42872,22.5
12099,2020-04-01,680750,580783,99967,14.7
12101,2020-04-01,230728,198396,32332,14
12103,2020-04-01,472700,403441,69259,14.7
12105,2020-04-01,308041,264416,43625,14.2
12107,2020-04-01,25145,22327,2818,11.2
12109,2020-04-01,128034,113378,14656,11.4
12111,2020-04-01,139234,118861,20373,14.6
12113,2020-04-01,78732,70549,8183,10.4
12115,2020-04-01,177048,150366,26682,15.1
12117,2020-04-01,234421,202506,31915,13.6
12119,2020-04-01,30935,26968,3967,12.8
12121,2020-04-01,16888,15527,1361,8.1
12123,2020-04-01,7731,7121,610,7.9
12125,2020-04-01,4541,4236,305,6.7
12127,2020-04-01,241260,204764,36496,15.1
12129,2020-04-01,14121,13079,1042,7.4
12131,2020-04-01,30714,26140,4574,14.9
12133,2020-04-01,9036,8158,878,9.7
13001,2020-04-01,9053,8383,670,7.4
13003,2020-04-01,4245,3914,331,7.8
13005,2020-04-01,4645,4276,369,7.9
13007,2020-04-01,1118,1027,91,8.1
13009,2020-04-01,17339,15458,1881,10.8
13011,2020-04-01,9425,8553,872,9.3
13013,2020-04-01,39261,34839,4422,11.3
13015,2020-04-01,49797,42694,7103,14.3
13017,2020-04-01,5473,4891,582,10.6
13019,2020-04-01,7048,6022,1026,14.6
13021,2020-04-01,65751,57642,8109,12.3
13023,2020-04-01,4367,3956,411,9.4
13025,2020-04-01,6513,5818,695,10.7
13027,2020-04-01,6612,6109,503,7.6
13029,2020-04-01,17964,15868,2096,11.7
13031,2020-04-01,35625,31500,4125,11.6
13033,2020-04-01,8657,7759,898,10.4
13035,2020-04-01,10402,9230,1172,11.3
13037,2020-04-01,2246,2110,136,6.1
13039,2020-04-01,20484,18578,1906,9.3
13043,2020-04-01,5582,5209,373,6.7
13045,2020-04-01,53412,46703,6709,12.6
13047,2020-04-01,31780,28711,3069,9.7
13049,2020-04-01,4650,4387,263,5.7
13051,2020-04-01,138301,116167,22134,16
13053,2020-04-01,1950,1751,199,10.2
13055,2020-04-01,9831,8146,1685,17.1
13057,2020-04-01,129690,115768,13922,10.7
13059,2020-04-01,56812,49861,6951,12.2
13061,2020-04-01,895,732,163,18.2
13063,2020-04-01,136867,114739,22128,16.2
13065,2020-04-01,2912,2735,177,6.1
13067,2020-04-01,402321,356609,45712,11.4
13069,2020-04-01,19222,17378,1844,9.6
13071,2020-04-01,21606,19996,1610,7.5
13073,2020-04-01,71754,65634,6120,8.5
13075,2020-04-01,7945,7317,628,7.9
13077,2020-04-01,72788,63520,9268,12.7
13079,2020-04-01,5327,4834,493,9.3
13081,2020-04-01,9212,8154,1058,11.5
13083,2020-04-01,7504,6927,577,7.7
13085,2020-04-01,12096,10744,1352,11.2
13087,2020-04-01,11132,10328,804,7.2
13089,2020-04-01,384870,333112,51758,13.4
13091,2020-04-01,6746,6160,586,8.7
13093,2020-04-01,5144,4347,797,15.5
13095,2020-04-01,36910,32134,4776,12.9
13097,2020-04-01,70242,61215,9027,12.9
13099,2020-04-01,4352,4108,244,5.6
13101,2020-04-01,1840,1733,107,5.8
13103,2020-04-01,29995,26684,3311,11
13105,2020-04-01,8000,7012,988,12.4
13107,2020-04-01,8340,7590,750,9
13109,2020-04-01,4881,4503,378,7.7
13111,2020-04-01,10332,9211,1121,10.8
13113,2020-04-01,54472,48850,5622,10.3
13115,2020-04-01,42770,36884,5886,13.8
13117,2020-04-01,117270,105582,11688,10
13119,2020-04-01,9732,8571,1161,11.9
13121,2020-04-01,544238,468979,75259,13.8
13123,2020-04-01,11697,10497,1200,10.3
13125,2020-04-01,1205,1125,80,6.6
13127,2020-04-01,37152,30941,6211,16.7
13129,2020-04-01,27529,23954,3575,13
13131,2020-04-01,10352,9485,867,8.4
13133,2020-04-01,7080,6360,720,10.2
13135,2020-04-01,470855,412364,58491,12.4
13137,2020-04-01,18618,16617,2001,10.7
13139,2020-04-01,99570,89215,10355,10.4
13141,2020-04-01,2500,2199,301,12
13143,2020-04-01,11979,10541,1438,12
13145,2020-04-01,16328,14746,1582,9.7
13147,2020-04-01,11207,10102,1105,9.9
13149,2020-04-01,5150,4399,751,14.6
13151,2020-04-01,112706,97789,14917,13.2
13153,2020-04-01,68012,61311,6701,9.9
13155,2020-04-01,3426,3136,290,8.5
13157,2020-04-01,37895,33978,3917,10.3
13159,2020-04-01,6490,5892,598,9.2
13161,2020-04-01,6070,5584,486,8
13163,2020-04-01,6600,5982,618,9.4
13165,2020-04-01,3042,2782,260,8.5
13167,2020-04-01,3818,3517,301,7.9
13169,2020-04-01,12847,11791,1056,8.2
13171,2020-04-01,7649,6837,812,10.6
13173,2020-04-01,3644,3293,351,9.6
13175,2020-04-01,18856,16633,2223,11.8
13177,2020-04-01,14420,13131,1289,8.9
13179,2020-04-01,25224,22515,2709,10.7
13181,2020-04-01,3374,3070,304,9
13183,2020-04-01,7846,7285,561,7.2
13185,2020-04-01,50329,45193,5136,10.2
13187,2020-04-01,15765,14019,1746,11.1
13189,2020-04-01,8566,7391,1175,13.7
13191,2020-04-01,5558,4932,626,11.3
13193,2020-04-01,4559,4136,423,9.3
13195,2020-04-01,12636,11264,1372,10.9
13197,2020-04-01,3061,2833,228,7.4
13199,2020-04-01,8788,7394,1394,15.9
13201,2020-04-01,2681,2531,150,5.6
13205,2020-04-01,8187,7490,697,8.5
13207,2020-04-01,12284,11151,1133,9.2
13209,2020-04-01,3700,3380,320,8.6
13211,2020-04-01,8946,7945,1001,11.2
13213,2020-04-01,15635,12606,3029,19.4
13215,2020-04-01,76453,66523,9930,13
13217,2020-04-01,50337,44136,6201,12.3
13219,2020-04-01,18516,16928,1588,8.6
13221,2020-04-01,6608,5951,657,9.9
13223,2020-04-01,82885,73891,8994,10.9
13225,2020-04-01,11458,10221,1237,10.8
13227,2020-04-01,14476,13001,1475,10.2
13229,2020-04-01,8152,7464,688,8.4
13231,2020-04-01,8403,7578,825,9.8
13233,2020-04-01,17959,15812,2147,12
13235,2020-04-01,3773,3505,268,7.1
13237,2020-04-01,8148,7186,962,11.8
13239,2020-04-01,776,720,56,7.2
13241,2020-04-01,6654,5781,873,13.1
13243,2020-04-01,2451,2277,174,7.1
13245,2020-04-01,82586,72466,10120,12.3
13247,2020-04-01,42668,37192,5476,12.8
13249,2020-04-01,2084,1955,129,6.2
13251,2020-04-01,5051,4382,669,13.2
13253,2020-04-01,3015,2799,216,7.2
13255,2020-04-01,27452,23947,3505,12.8
13257,2020-04-01,10276,8995,1281,12.5
13259,2020-04-01,2483,2305,178,7.2
13261,2020-04-01,12338,11078,1260,10.2
13263,2020-04-01,2721,2390,331,12.2
13265,2020-04-01,525,469,56,10.7
13267,2020-04-01,9522,8943,579,6.1
13269,2020-04-01,2714,2415,299,11
13271,2020-04-01,3752,3308,444,11.8
13273,2020-04-01,3337,3022,315,9.4
13275,2020-04-01,16643,14892,1751,10.5
13277,2020-04-01,19777,17998,1779,9
13279,2020-04-01,11800,10358,1442,12.2
13281,2020-04-01,3586,3059,527,14.7
13283,2020-04-01,2664,2390,274,10.3
13285,2020-04-01,37043,30931,6112,16.5
13287,2020-04-01,3149,2815,334,10.6
13289,2020-04-01,2708,2394,314,11.6
13291,2020-04-01,10174,9234,940,9.2
13293,2020-04-01,11128,9752,1376,12.4
13295,2020-04-01,29954,26817,3137,10.5
13297,2020-04-01,44106,38885,5221,11.8
13299,2020-04-01,14863,13266,1597,10.7
13301,2020-04-01,2588,2292,296,11.4
13303,2020-04-01,6945,6333,612,8.8
13305,2020-04-01,11328,10182,1146,10.1
13307,2020-04-01,990,930,60,6.1
13309,2020-04-01,1595,1441,154,9.7
13311,2020-04-01,15469,13708,1761,11.4
13313,2020-04-01,44401,35567,8834,19.9
13315,2020-04-01,2688,2495,193,7.2
13317,2020-04-01,3642,3319,323,8.9
13319,2020-04-01,3549,3275,274,7.7
13321,2020-04-01,8587,7838,749,8.7
15001,2020-04-01,86901,67805,19096,22
15003,2020-04-01,428667,348013,80654,18.8
15007,2020-04-01,35610,24210,11400,32
15009,2020-04-01,84845,56945,27900,32.9
16001,2020-04-01,251757,221348,30409,12.1
16003,2020-04-01,1714,1351,363,21.2
16005,2020-04-01,41095,37138,3957,9.6
16007,2020-04-01,2948,2718,230,7.8
16009,2020-04-01,4297,3576,721,16.8
16011,2020-04-01,23393,21941,1452,6.2
16013,2020-04-01,12314,9369,2945,23.9
16015,2020-04-01,3590,3020,570,15.9
16017,2020-04-01,20468,16939,3529,17.2
16019,2020-04-01,55401,50737,4664,8.4
16021,2020-04-01,5523,4901,622,11.3
16023,2020-04-01,1327,1253,74,5.6
16025,2020-04-01,661,569,92,13.9
16027,2020-04-01,103589,90741,12848,12.4
16029,2020-04-01,4039,3798,241,6
16031,2020-04-01,12052,11228,824,6.8
16033,2020-04-01,371,352,19,5.1
16035,2020-04-01,3049,2526,523,17.2
16037,2020-04-01,1970,1776,194,9.8
16039,2020-04-01,11435,10375,1060,9.3
16041,2020-04-01,7098,6541,557,7.8
16043,2020-04-01,7524,6994,530,7
16045,2020-04-01,8217,7251,966,11.8
16047,2020-04-01,8098,7571,527,6.5
16049,2020-04-01,6492,5663,829,12.8
16051,2020-04-01,13374,12511,863,6.5
16053,2020-04-01,11907,11014,893,7.5
16055,2020-04-01,80320,67115,13205,16.4
16057,2020-04-01,19449,17545,1904,9.8
16059,2020-04-01,3471,3076,395,11.4
16061,2020-04-01,1664,1416,248,14.9
16063,2020-04-01,2479,2124,355,14.3
16065,2020-04-01,20573,19638,935,4.5
16067,2020-04-01,11387,10633,754,6.6
16069,2020-04-01,20635,18366,2269,11
16071,2020-04-01,2305,2140,165,7.2
16073,2020-04-01,5474,4876,598,10.9
16075,2020-04-01,11629,10532,1097,9.4
16077,2020-04-01,4113,3881,232,5.6
16079,2020-04-01,5302,4258,1044,19.7
16081,2020-04-01,6138,5105,1033,16.8
16083,2020-04-01,40494,35929,4565,11.3
16085,2020-04-01,5138,3892,1246,24.3
16087,2020-04-01,4626,4210,416,9
17001,2020-04-01,29466,25732,3734,12.7
17003,2020-04-01,1773,1488,285,16.1
17005,2020-04-01,6858,5982,876,12.8
17007,2020-04-01,25312,19415,5897,23.3
17009,2020-04-01,2804,2588,216,7.7
17011,2020-04-01,15401,13161,2240,14.5
17013,2020-04-01,2132,1770,362,17
17015,2020-04-01,7019,5839,1180,16.8
17017,2020-04-01,5476,4887,589,10.8
17019,2020-04-01,102645,91353,11292,11
17021,2020-04-01,12691,10803,1888,14.9
17023,2020-04-01,6968,5467,1501,21.5
17025,2020-04-01,6533,5054,1479,22.6
17027,2020-04-01,18593,16053,2540,13.7
17029,2020-04-01,21927,19074,2853,13
17031,2020-04-01,NA,NA,417387,17.1
17033,2020-04-01,8173,6846,1327,16.2
17035,2020-04-01,5538,4940,598,10.8
17037,2020-04-01,49642,42150,7492,15.1
17039,2020-04-01,6556,5811,745,11.4
17041,2020-04-01,9418,8414,1004,10.7
17043,2020-04-01,461475,398567,62908,13.6
17045,2020-04-01,8860,7507,1353,15.3
17047,2020-04-01,2868,2237,631,22
17049,2020-04-01,18056,15384,2672,14.8
17051,2020-04-01,9098,7796,1302,14.3
17053,2020-04-01,5843,5145,698,11.9
17055,2020-04-01,16309,12289,4020,24.6
17057,2020-04-01,13948,11660,2288,16.4
17059,2020-04-01,1952,1619,333,17.1
17061,2020-04-01,5451,4808,643,11.8
17063,2020-04-01,23323,19755,3568,15.3
17065,2020-04-01,3923,3222,701,17.9
17067,2020-04-01,7791,6615,1176,15.1
17069,2020-04-01,1233,1051,182,14.8
17071,2020-04-01,3393,2852,541,15.9
17073,2020-04-01,22402,18924,3478,15.5
17075,2020-04-01,12708,11271,1437,11.3
17077,2020-04-01,25546,21774,3772,14.8
17079,2020-04-01,4199,3721,478,11.4
17081,2020-04-01,16739,12178,4561,27.2
17083,2020-04-01,10085,8535,1550,15.4
17085,2020-04-01,9608,7793,1815,18.9
17087,2020-04-01,4060,3362,698,17.2
17089,2020-04-01,248850,206225,42625,17.1
17091,2020-04-01,51384,43072,8312,16.2
17093,2020-04-01,63882,54338,9544,14.9
17095,2020-04-01,20243,17217,3026,14.9
17097,2020-04-01,339315,288594,50721,14.9
17099,2020-04-01,49944,40340,9604,19.2
17101,2020-04-01,5591,4188,1403,25.1
17103,2020-04-01,16306,14172,2134,13.1
17105,2020-04-01,15112,13238,1874,12.4
17107,2020-04-01,11285,9901,1384,12.3
17109,2020-04-01,12402,10927,1475,11.9
17111,2020-04-01,152734,129730,23004,15.1
17113,2020-04-01,80287,69793,10494,13.1
17115,2020-04-01,44496,37623,6873,15.4
17117,2020-04-01,20608,17742,2866,13.9
17119,2020-04-01,123493,104981,18512,15
17121,2020-04-01,17377,13399,3978,22.9
17123,2020-04-01,4705,4046,659,14
17125,2020-04-01,5546,4771,775,14
17127,2020-04-01,5230,4051,1179,22.5
17129,2020-04-01,5615,4889,726,12.9
17131,2020-04-01,7189,6045,1144,15.9
17133,2020-04-01,17151,15013,2138,12.5
17135,2020-04-01,10917,9098,1819,16.7
17137,2020-04-01,14717,12973,1744,11.9
17139,2020-04-01,6810,6255,555,8.1
17141,2020-04-01,22858,19299,3559,15.6
17143,2020-04-01,80205,65059,15146,18.9
17145,2020-04-01,8267,6414,1853,22.4
17147,2020-04-01,7912,7130,782,9.9
17149,2020-04-01,6334,5607,727,11.5
17151,2020-04-01,1532,1299,233,15.2
17153,2020-04-01,1701,1354,347,20.4
17155,2020-04-01,2754,2269,485,17.6
17157,2020-04-01,13379,11178,2201,16.5
17159,2020-04-01,7276,6159,1117,15.4
17161,2020-04-01,66160,53879,12281,18.6
17163,2020-04-01,117701,98593,19108,16.2
17165,2020-04-01,9460,7696,1764,18.6
17167,2020-04-01,90006,76468,13538,15
17169,2020-04-01,3021,2671,350,11.6
17171,2020-04-01,2139,1893,246,11.5
17173,2020-04-01,9639,8507,1132,11.7
17175,2020-04-01,2166,1877,289,13.3
17177,2020-04-01,19558,16935,2623,13.4
17179,2020-04-01,59119,49298,9821,16.6
17181,2020-04-01,6962,5960,1002,14.4
17183,2020-04-01,31503,26138,5365,17
17185,2020-04-01,6165,4531,1634,26.5
17187,2020-04-01,7623,6827,796,10.4
17189,2020-04-01,8427,6944,1483,17.6
17191,2020-04-01,6763,5388,1375,20.3
17193,2020-04-01,6026,4874,1152,19.1
17195,2020-04-01,26587,22245,4342,16.3
17197,2020-04-01,331708,278572,53136,16
17199,2020-04-01,31084,24964,6120,19.7
17201,2020-04-01,132591,102968,29623,22.3
17203,2020-04-01,16608,14616,1992,12
18001,2020-04-01,15936,12704,3232,20.3
18003,2020-04-01,179706,144723,34983,19.5
18005,2020-04-01,41498,34248,7250,17.5
18007,2020-04-01,3850,3440,410,10.6
18009,2020-04-01,4874,3839,1035,21.2
18011,2020-04-01,32764,29937,2827,8.6
18013,2020-04-01,7313,6177,1136,15.5
18015,2020-04-01,9074,7726,1348,14.9
18017,2020-04-01,17551,14743,2808,16
18019,2020-04-01,59573,49425,10148,17
18021,2020-04-01,10991,9517,1474,13.4
18023,2020-04-01,15743,13713,2030,12.9
18025,2020-04-01,4718,4013,705,14.9
18027,2020-04-01,15683,14511,1172,7.5
18029,2020-04-01,24755,20491,4264,17.2
18031,2020-04-01,14574,10876,3698,25.4
18033,2020-04-01,21939,17308,4631,21.1
18035,2020-04-01,51364,43162,8202,16
18037,2020-04-01,21763,19655,2108,9.7
18039,2020-04-01,100845,69770,31075,30.8
18041,2020-04-01,8940,6837,2103,23.5
18043,2020-04-01,39581,33474,6107,15.4
18045,2020-04-01,7306,5974,1332,18.2
18047,2020-04-01,10844,8990,1854,17.1
18049,2020-04-01,9651,8149,1502,15.6
18051,2020-04-01,18806,15242,3564,19
18053,2020-04-01,31427,27131,4296,13.7
18055,2020-04-01,12670,11156,1514,11.9
18057,2020-04-01,170511,153945,16566,9.7
18059,2020-04-01,38638,33545,5093,13.2
18061,2020-04-01,19192,16204,2988,15.6
18063,2020-04-01,83454,74988,8466,10.1
18065,2020-04-01,21914,18429,3485,15.9
18067,2020-04-01,41837,28865,12972,31
18069,2020-04-01,17691,14348,3343,18.9
18071,2020-04-01,21921,17010,4911,22.4
18073,2020-04-01,15008,12651,2357,15.7
18075,2020-04-01,8699,6976,1723,19.8
18077,2020-04-01,14849,11670,3179,21.4
18079,2020-04-01,13557,10525,3032,22.4
18081,2020-04-01,78591,68549,10042,12.8
18083,2020-04-01,17428,14790,2638,15.1
18085,2020-04-01,41456,34050,7406,17.9
18087,2020-04-01,17654,11888,5766,32.7
18089,2020-04-01,222338,177274,45064,20.3
18091,2020-04-01,47675,38052,9623,20.2
18093,2020-04-01,20315,16933,3382,16.6
18095,2020-04-01,57914,47710,10204,17.6
18097,2020-04-01,467819,402675,65144,13.9
18099,2020-04-01,22601,18729,3872,17.1
18101,2020-04-01,5184,4783,401,7.7
18103,2020-04-01,15550,12207,3343,21.5
18105,2020-04-01,65472,59056,6416,9.8
18107,2020-04-01,17879,15979,1900,10.6
18109,2020-04-01,33355,29635,3720,11.2
18111,2020-04-01,6288,5332,956,15.2
18113,2020-04-01,23737,16877,6860,28.9
18115,2020-04-01,3063,2554,509,16.6
18117,2020-04-01,8223,6002,2221,27
18119,2020-04-01,8713,7697,1016,11.7
18121,2020-04-01,6337,5635,702,11.1
18123,2020-04-01,8836,7382,1454,16.5
18125,2020-04-01,5932,5123,809,13.6
18127,2020-04-01,82121,67727,14394,17.5
18129,2020-04-01,11985,10605,1380,11.5
18131,2020-04-01,6352,5451,901,14.2
18133,2020-04-01,15575,13467,2108,13.5
18135,2020-04-01,11114,9322,1792,16.1
18137,2020-04-01,13943,11581,2362,16.9
18139,2020-04-01,8581,7060,1521,17.7
18141,2020-04-01,129310,103747,25563,19.8
18143,2020-04-01,10751,8371,2380,22.1
18145,2020-04-01,23136,18878,4258,18.4
18147,2020-04-01,9921,8656,1265,12.8
18149,2020-04-01,9379,7626,1753,18.7
18151,2020-04-01,18859,15048,3811,20.2
18153,2020-04-01,7685,6544,1141,14.8
18155,2020-04-01,4946,4059,887,17.9
18157,2020-04-01,86668,75827,10841,12.5
18159,2020-04-01,8709,7041,1668,19.2
18161,2020-04-01,3321,2833,488,14.7
18163,2020-04-01,88364,74293,14071,15.9
18165,2020-04-01,6453,5412,1041,16.1
18167,2020-04-01,45176,37700,7476,16.5
18169,2020-04-01,14253,12009,2244,15.7
18171,2020-04-01,3675,3216,459,12.5
18173,2020-04-01,30060,26097,3963,13.2
18175,2020-04-01,13120,10825,2295,17.5
18177,2020-04-01,29151,25073,4078,14
18179,2020-04-01,13279,11157,2122,16
18181,2020-04-01,12356,10974,1382,11.2
18183,2020-04-01,16465,13671,2794,17
19001,2020-04-01,4192,3815,377,9
19003,2020-04-01,2068,1919,149,7.2
19005,2020-04-01,7227,6481,746,10.3
19007,2020-04-01,6062,5427,635,10.5
19009,2020-04-01,3024,2828,196,6.5
19011,2020-04-01,13118,11709,1409,10.7
19013,2020-04-01,69308,60615,8693,12.5
19015,2020-04-01,14856,13563,1293,8.7
19017,2020-04-01,13605,12412,1193,8.8
19019,2020-04-01,11328,10320,1008,8.9
19021,2020-04-01,11829,11112,717,6.1
19023,2020-04-01,7784,7048,736,9.5
19025,2020-04-01,4154,3829,325,7.8
19027,2020-04-01,10695,9723,972,9.1
19029,2020-04-01,6768,6261,507,7.5
19031,2020-04-01,10638,9675,963,9.1
19033,2020-04-01,23547,20751,2796,11.9
19035,2020-04-01,6273,5780,493,7.9
19037,2020-04-01,6560,5746,814,12.4
19039,2020-04-01,4813,4276,537,11.2
19041,2020-04-01,8531,7626,905,10.6
19043,2020-04-01,9786,8705,1081,11
19045,2020-04-01,22707,19601,3106,13.7
19047,2020-04-01,8092,7387,705,8.7
19049,2020-04-01,49087,45226,3861,7.9
19051,2020-04-01,4184,3870,314,7.5
19053,2020-04-01,4281,3954,327,7.6
19055,2020-04-01,10435,9521,914,8.8
19057,2020-04-01,19301,16339,2962,15.3
19059,2020-04-01,9638,8378,1260,13.1
19061,2020-04-01,56543,49429,7114,12.6
19063,2020-04-01,5253,4746,507,9.7
19065,2020-04-01,10794,9675,1119,10.4
19067,2020-04-01,8541,7406,1135,13.3
19069,2020-04-01,5626,5223,403,7.2
19071,2020-04-01,3652,3446,206,5.6
19073,2020-04-01,5340,4793,547,10.2
19075,2020-04-01,6317,5727,590,9.3
19077,2020-04-01,5442,4867,575,10.6
19079,2020-04-01,6991,6359,632,9
19081,2020-04-01,6045,5368,677,11.2
19083,2020-04-01,7923,7236,687,8.7
19085,2020-04-01,7051,6492,559,7.9
19087,2020-04-01,10122,8951,1171,11.6
19089,2020-04-01,5283,4691,592,11.2
19091,2020-04-01,5095,4626,469,9.2
19093,2020-04-01,4061,3806,255,6.3
19095,2020-04-01,10362,9305,1057,10.2
19097,2020-04-01,10920,9682,1238,11.3
19099,2020-04-01,19742,17613,2129,10.8
19101,2020-04-01,9441,8409,1032,10.9
19103,2020-04-01,86000,77334,8666,10.1
19105,2020-04-01,10406,9217,1189,11.4
19107,2020-04-01,5299,4780,519,9.8
19109,2020-04-01,8221,7496,725,8.8
19111,2020-04-01,16461,14216,2245,13.6
19113,2020-04-01,122462,106490,15972,13
19115,2020-04-01,5262,4703,559,10.6
19117,2020-04-01,4715,4372,343,7.3
19119,2020-04-01,6867,6550,317,4.6
19121,2020-04-01,8532,7467,1065,12.5
19123,2020-04-01,11931,10756,1175,9.8
19125,2020-04-01,17961,16414,1547,8.6
19127,2020-04-01,17936,15877,2059,11.5
19129,2020-04-01,7168,6588,580,8.1
19131,2020-04-01,6092,5604,488,8
19133,2020-04-01,4458,3964,494,11.1
19135,2020-04-01,4030,3631,399,9.9
19137,2020-04-01,4941,4528,413,8.4
19139,2020-04-01,21698,19147,2551,11.8
19141,2020-04-01,8140,7584,556,6.8
19143,2020-04-01,3564,3360,204,5.7
19145,2020-04-01,6341,5681,660,10.4
19147,2020-04-01,4682,4165,517,11
19149,2020-04-01,14337,13242,1095,7.6
19151,2020-04-01,4233,3960,273,6.4
19153,2020-04-01,272148,236533,35615,13.1
19155,2020-04-01,48484,43041,5443,11.2
19157,2020-04-01,10037,9028,1009,10.1
19159,2020-04-01,2338,2155,183,7.8
19161,2020-04-01,5193,4830,363,7
19163,2020-04-01,88824,76299,12525,14.1
19165,2020-04-01,6452,5935,517,8
19167,2020-04-01,21032,19871,1161,5.5
19169,2020-04-01,58651,53899,4752,8.1
19171,2020-04-01,9471,8684,787,8.3
19173,2020-04-01,3137,2935,202,6.4
19175,2020-04-01,6268,5475,793,12.7
19177,2020-04-01,3791,3408,383,10.1
19179,2020-04-01,17717,15728,1989,11.2
19181,2020-04-01,27822,25016,2806,10.1
19183,2020-04-01,11566,10609,957,8.3
19185,2020-04-01,2838,2567,271,9.5
19187,2020-04-01,19039,17084,1955,10.3
19189,2020-04-01,5449,4481,968,17.8
19191,2020-04-01,10872,9713,1159,10.7
19193,2020-04-01,55667,49797,5870,10.5
19195,2020-04-01,4380,3777,603,13.8
19197,2020-04-01,7122,6593,529,7.4
20001,2020-04-01,6344,5755,589,9.3
20003,2020-04-01,4027,3752,275,6.8
20005,2020-04-01,6857,5989,868,12.7
20007,2020-04-01,2197,2084,113,5.1
20009,2020-04-01,13394,12303,1091,8.1
20011,2020-04-01,6601,5981,620,9.4
20013,2020-04-01,4932,4451,481,9.8
20015,2020-04-01,32594,27548,5046,15.5
20017,2020-04-01,1453,1276,177,12.2
20019,2020-04-01,1448,1302,146,10.1
20021,2020-04-01,9957,8851,1106,11.1
20023,2020-04-01,1174,1135,39,3.3
20025,2020-04-01,1078,1051,27,2.5
20027,2020-04-01,3594,3292,302,8.4
20029,2020-04-01,3673,3450,223,6.1
20031,2020-04-01,3920,3576,344,8.8
20033,2020-04-01,807,769,38,4.7
20035,2020-04-01,17055,14509,2546,14.9
20037,2020-04-01,18692,16866,1826,9.8
20039,2020-04-01,1094,1031,63,5.8
20041,2020-04-01,8569,7832,737,8.6
20043,2020-04-01,4056,3670,386,9.5
20045,2020-04-01,63804,55774,8030,12.6
20047,2020-04-01,1365,1310,55,4
20049,2020-04-01,1151,1039,112,9.7
20051,2020-04-01,16271,14989,1282,7.9
20053,2020-04-01,2543,2424,119,4.7
20055,2020-04-01,19697,18430,1267,6.4
20057,2020-04-01,16737,15927,810,4.8
20059,2020-04-01,13711,12301,1410,10.3
20061,2020-04-01,11648,10313,1335,11.5
20063,2020-04-01,1351,1282,69,5.1
20065,2020-04-01,1073,1015,58,5.4
20067,2020-04-01,2841,2712,129,4.5
20069,2020-04-01,2974,2891,83,2.8
20071,2020-04-01,755,739,16,2.1
20073,2020-04-01,3040,2726,314,10.3
20075,2020-04-01,1458,1430,28,1.9
20077,2020-04-01,2697,2516,181,6.7
20079,2020-04-01,16510,14503,2007,12.2
20081,2020-04-01,2089,2025,64,3.1
20083,2020-04-01,929,893,36,3.9
20085,2020-04-01,7203,6253,950,13.2
20087,2020-04-01,9949,8891,1058,10.6
20089,2020-04-01,1148,1096,52,4.5
20091,2020-04-01,331314,293817,37497,11.3
20093,2020-04-01,1872,1778,94,5
20095,2020-04-01,3160,2819,341,10.8
20097,2020-04-01,1183,1125,58,4.9
20099,2020-04-01,9483,8637,846,8.9
20101,2020-04-01,713,688,25,3.5
20103,2020-04-01,35711,31300,4411,12.4
20105,2020-04-01,1527,1466,61,4
20107,2020-04-01,4103,3660,443,10.8
20109,2020-04-01,1513,1442,71,4.7
20111,2020-04-01,16013,14659,1354,8.5
20113,2020-04-01,16506,15463,1043,6.3
20115,2020-04-01,5708,5235,473,8.3
20117,2020-04-01,5242,4966,276,5.3
20119,2020-04-01,1981,1893,88,4.4
20121,2020-04-01,16827,15186,1641,9.8
20123,2020-04-01,3188,3073,115,3.6
20125,2020-04-01,15373,13210,2163,14.1
20127,2020-04-01,2888,2684,204,7.1
20129,2020-04-01,1069,1034,35,3.3
20131,2020-04-01,5310,5035,275,5.2
20133,2020-04-01,6159,5521,638,10.4
20135,2020-04-01,1276,1207,69,5.4
20137,2020-04-01,2494,2404,90,3.6
20139,2020-04-01,7775,6955,820,10.5
20141,2020-04-01,1839,1751,88,4.8
20143,2020-04-01,2813,2621,192,6.8
20145,2020-04-01,2648,2507,141,5.3
20147,2020-04-01,2582,2405,177,6.9
20149,2020-04-01,11824,10883,941,8
20151,2020-04-01,4736,4444,292,6.2
20153,2020-04-01,1424,1371,53,3.7
20155,2020-04-01,29510,26223,3287,11.1
20157,2020-04-01,2148,2052,96,4.5
20159,2020-04-01,4867,4467,400,8.2
20161,2020-04-01,33980,30907,3073,9
20163,2020-04-01,2363,2220,143,6.1
20165,2020-04-01,1543,1394,149,9.7
20167,2020-04-01,3186,2936,250,7.8
20169,2020-04-01,28978,25873,3105,10.7
20171,2020-04-01,2604,2503,101,3.9
20173,2020-04-01,266452,213237,53215,20
20175,2020-04-01,9428,8848,580,6.2
20177,2020-04-01,90857,79152,11705,12.9
20179,2020-04-01,1322,1281,41,3.1
20181,2020-04-01,2709,2577,132,4.9
20183,2020-04-01,1842,1773,69,3.7
20185,2020-04-01,1893,1791,102,5.4
20187,2020-04-01,967,945,22,2.3
20189,2020-04-01,2614,2529,85,3.3
20191,2020-04-01,11226,9120,2106,18.8
20193,2020-04-01,3899,3720,179,4.6
20195,2020-04-01,1401,1311,90,6.4
20197,2020-04-01,3462,3187,275,7.9
20199,2020-04-01,734,714,20,2.7
20201,2020-04-01,2854,2736,118,4.1
20203,2020-04-01,1144,1114,30,2.6
20205,2020-04-01,3828,2983,845,22.1
20207,2020-04-01,1575,1424,151,9.6
20209,2020-04-01,77912,65419,12493,16
21001,2020-04-01,7368,6110,1258,17.1
21003,2020-04-01,8459,7285,1174,13.9
21005,2020-04-01,12113,10220,1893,15.6
21007,2020-04-01,3369,2848,521,15.5
21009,2020-04-01,18879,15244,3635,19.3
21011,2020-04-01,4619,3720,899,19.5
21013,2020-04-01,8689,7272,1417,16.3
21015,2020-04-01,70265,60938,9327,13.3
21017,2020-04-01,9665,7990,1675,17.3
21019,2020-04-01,18523,15029,3494,18.9
21021,2020-04-01,13323,10682,2641,19.8
21023,2020-04-01,3728,3212,516,13.8
21025,2020-04-01,3545,2892,653,18.4
21027,2020-04-01,8271,6822,1449,17.5
21029,2020-04-01,43978,36039,7939,18.1
21031,2020-04-01,5040,4134,906,18
21033,2020-04-01,5581,4742,839,15
21035,2020-04-01,18285,15712,2573,14.1
21037,2020-04-01,49905,43154,6751,13.5
21039,2020-04-01,2120,1921,199,9.4
21041,2020-04-01,5580,4820,760,13.6
21043,2020-04-01,10189,8118,2071,20.3
21045,2020-04-01,6498,5231,1267,19.5
21047,2020-04-01,25694,20796,4898,19.1
21049,2020-04-01,17478,14484,2994,17.1
21051,2020-04-01,5567,4592,975,17.5
21053,2020-04-01,3937,3602,335,8.5
21055,2020-04-01,3691,3217,474,12.8
21057,2020-04-01,3210,2906,304,9.5
21059,2020-04-01,46711,39520,7191,15.4
21061,2020-04-01,4787,3787,1000,20.9
21063,2020-04-01,2123,1713,410,19.3
21065,2020-04-01,5389,4441,948,17.6
21067,2020-04-01,173688,148060,25628,14.8
21069,2020-04-01,6336,5115,1221,19.3
21071,2020-04-01,11243,9270,1973,17.5
21073,2020-04-01,25607,21420,4187,16.4
21075,2020-04-01,2007,1766,241,12
21077,2020-04-01,4058,3442,616,15.2
21079,2020-04-01,7758,6544,1214,15.6
21081,2020-04-01,12128,9825,2303,19
21083,2020-04-01,16103,13961,2142,13.3
21085,2020-04-01,11354,9140,2214,19.5
21087,2020-04-01,5400,4637,763,14.1
21089,2020-04-01,13873,11245,2628,18.9
21091,2020-04-01,3996,3290,706,17.7
21093,2020-04-01,50556,40850,9706,19.2
21095,2020-04-01,7180,5821,1359,18.9
21097,2020-04-01,9369,7618,1751,18.7
21099,2020-04-01,8107,6904,1203,14.8
21101,2020-04-01,21675,17979,3696,17.1
21103,2020-04-01,8248,6904,1344,16.3
21105,2020-04-01,1709,1519,190,11.1
21107,2020-04-01,18669,14970,3699,19.8
21109,2020-04-01,4407,3543,864,19.6
21111,2020-04-01,401620,333453,68167,17
21113,2020-04-01,26300,22551,3749,14.3
21115,2020-04-01,6958,5831,1127,16.2
21117,2020-04-01,86672,74578,12094,14
21119,2020-04-01,4603,3920,683,14.8
21121,2020-04-01,10338,8403,1935,18.7
21123,2020-04-01,6284,4991,1293,20.6
21125,2020-04-01,26030,21270,4760,18.3
21127,2020-04-01,5476,4607,869,15.9
21129,2020-04-01,2201,1912,289,13.1
21131,2020-04-01,2851,2311,540,18.9
21133,2020-04-01,6568,5402,1166,17.8
21135,2020-04-01,5014,4018,996,19.9
21137,2020-04-01,9930,7873,2057,20.7
21139,2020-04-01,3569,2976,593,16.6
21141,2020-04-01,12441,10522,1919,15.4
21143,2020-04-01,3018,2658,360,11.9
21145,2020-04-01,29409,24172,5237,17.8
21147,2020-04-01,4890,4118,772,15.8
21149,2020-04-01,3961,3455,506,12.8
21151,2020-04-01,47400,40074,7326,15.5
21153,2020-04-01,3543,2524,1019,28.8
21155,2020-04-01,9186,6512,2674,29.1
21157,2020-04-01,15135,12887,2248,14.9
21159,2020-04-01,2687,2145,542,20.2
21161,2020-04-01,7241,5759,1482,20.5
21163,2020-04-01,12260,10057,2203,18
21165,2020-04-01,2245,1841,404,18
21167,2020-04-01,10666,8584,2082,19.5
21169,2020-04-01,4214,3327,887,21
21171,2020-04-01,4758,4142,616,12.9
21173,2020-04-01,11880,9374,2506,21.1
21175,2020-04-01,4544,3968,576,12.7
21177,2020-04-01,10662,8806,1856,17.4
21179,2020-04-01,23547,18579,4968,21.1
21181,2020-04-01,3426,2789,637,18.6
21183,2020-04-01,9724,8236,1488,15.3
21185,2020-04-01,32627,28233,4394,13.5
21187,2020-04-01,5263,4404,859,16.3
21189,2020-04-01,1096,961,135,12.3
21191,2020-04-01,6756,5918,838,12.4
21193,2020-04-01,8838,7377,1461,16.5
21195,2020-04-01,19973,16688,3285,16.4
21197,2020-04-01,5166,4292,874,16.9
21199,2020-04-01,26156,21203,4953,18.9
21201,2020-04-01,795,683,112,14.1
21203,2020-04-01,6649,5549,1100,16.5
21205,2020-04-01,10544,8620,1924,18.2
21207,2020-04-01,6329,4896,1433,22.6
21209,2020-04-01,32403,25069,7334,22.6
21211,2020-04-01,25724,21672,4052,15.8
21213,2020-04-01,8629,6748,1881,21.8
21215,2020-04-01,10716,8846,1870,17.5
21217,2020-04-01,13592,11163,2429,17.9
21219,2020-04-01,5427,4794,633,11.7
21221,2020-04-01,6191,5105,1086,17.5
21223,2020-04-01,4007,3214,793,19.8
21225,2020-04-01,5709,4591,1118,19.6
21227,2020-04-01,64560,52771,11789,18.3
21229,2020-04-01,6108,4802,1306,21.4
21231,2020-04-01,7421,6325,1096,14.8
21233,2020-04-01,5620,4714,906,16.1
21235,2020-04-01,14051,11766,2285,16.3
21237,2020-04-01,2137,1801,336,15.7
21239,2020-04-01,14629,12635,1994,13.6
22001,2020-04-01,22769,20552,2217,9.7
22003,2020-04-01,9052,7880,1172,12.9
22005,2020-04-01,62119,55026,7093,11.4
22007,2020-04-01,8779,7485,1294,14.7
22009,2020-04-01,14684,12810,1874,12.8
22011,2020-04-01,14461,13182,1279,8.8
22013,2020-04-01,5204,4780,424,8.1
22015,2020-04-01,55306,49573,5733,10.4
22017,2020-04-01,99607,87101,12506,12.6
22019,2020-04-01,99944,87376,12568,12.6
22021,2020-04-01,3558,3255,303,8.5
22023,2020-04-01,3518,3249,269,7.6
22025,2020-04-01,3372,3091,281,8.3
22027,2020-04-01,5309,4949,360,6.8
22029,2020-04-01,6761,6089,672,9.9
22031,2020-04-01,10133,9195,938,9.3
22033,2020-04-01,220671,194308,26363,11.9
22035,2020-04-01,1727,1558,169,9.8
22037,2020-04-01,7382,6665,717,9.7
22039,2020-04-01,11950,10847,1103,9.2
22041,2020-04-01,7160,6525,635,8.9
22043,2020-04-01,7856,7188,668,8.5
22045,2020-04-01,27217,23848,3369,12.4
22047,2020-04-01,13326,11604,1722,12.9
22049,2020-04-01,6519,6131,388,6
22051,2020-04-01,209751,174969,34782,16.6
22053,2020-04-01,12692,11332,1360,10.7
22055,2020-04-01,112479,99758,12721,11.3
22057,2020-04-01,40720,36695,4025,9.9
22059,2020-04-01,6811,6415,396,5.8
22061,2020-04-01,20104,18551,1553,7.7
22063,2020-04-01,66430,58765,7665,11.5
22065,2020-04-01,3502,3158,344,9.8
22067,2020-04-01,9714,8659,1055,10.9
22069,2020-04-01,15630,14363,1267,8.1
22071,2020-04-01,181256,145596,35660,19.7
22073,2020-04-01,66969,59899,7070,10.6
22075,2020-04-01,9438,8192,1246,13.2
22077,2020-04-01,9231,8184,1047,11.3
22079,2020-04-01,53306,48724,4582,8.6
22081,2020-04-01,3470,3250,220,6.3
22083,2020-04-01,7884,7168,716,9.1
22085,2020-04-01,9152,8560,592,6.5
22087,2020-04-01,19798,16398,3400,17.2
22089,2020-04-01,23980,20708,3272,13.6
22091,2020-04-01,4098,3502,596,14.5
22093,2020-04-01,8559,7459,1100,12.9
22095,2020-04-01,18815,15766,3049,16.2
22097,2020-04-01,31786,28280,3506,11
22099,2020-04-01,21696,19156,2540,11.7
22101,2020-04-01,19418,17008,2410,12.4
22103,2020-04-01,113840,98976,14864,13.1
22105,2020-04-01,55164,46919,8245,14.9
22107,2020-04-01,1301,1198,103,7.9
22109,2020-04-01,45835,40394,5441,11.9
22111,2020-04-01,8429,7726,703,8.3
22113,2020-04-01,23260,20727,2533,10.9
22115,2020-04-01,15280,13852,1428,9.3
22117,2020-04-01,15948,14311,1637,10.3
22119,2020-04-01,13516,12107,1409,10.4
22121,2020-04-01,12951,11528,1423,11
22123,2020-04-01,3565,3157,408,11.4
22125,2020-04-01,4991,4593,398,8
22127,2020-04-01,4494,4149,345,7.7
23001,2020-04-01,52903,48033,4870,9.2
23003,2020-04-01,28467,26065,2402,8.4
23005,2020-04-01,154471,138869,15602,10.1
23007,2020-04-01,13230,11833,1397,10.6
23009,2020-04-01,25867,23138,2729,10.6
23011,2020-04-01,59982,54620,5362,8.9
23013,2020-04-01,18366,16350,2016,11
23015,2020-04-01,15378,13804,1574,10.2
23017,2020-04-01,24102,21316,2786,11.6
23019,2020-04-01,72846,65980,6866,9.4
23021,2020-04-01,6732,6126,606,9
23023,2020-04-01,18303,16499,1804,9.9
23025,2020-04-01,21100,18718,2382,11.3
23027,2020-04-01,18985,17276,1709,9
23029,2020-04-01,12836,11577,1259,9.8
23031,2020-04-01,105252,95284,9968,9.5
24001,2020-04-01,30417,26780,3637,12
24003,2020-04-01,304726,278485,26241,8.6
24005,2020-04-01,436234,395505,40729,9.3
24009,2020-04-01,48092,44588,3504,7.3
24011,2020-04-01,17307,15982,1325,7.7
24013,2020-04-01,91923,84633,7290,7.9
24015,2020-04-01,50812,46576,4236,8.3
24017,2020-04-01,84835,77879,6956,8.2
24019,2020-04-01,16227,14885,1342,8.3
24021,2020-04-01,132097,120869,11228,8.5
24023,2020-04-01,14808,13129,1679,11.3
24025,2020-04-01,136354,124347,12007,8.8
24027,2020-04-01,179316,166535,12781,7.1
24029,2020-04-01,9686,8863,823,8.5
24031,2020-04-01,534946,494019,40927,7.7
24033,2020-04-01,492623,448701,43922,8.9
24035,2020-04-01,27209,24832,2377,8.7
24037,2020-04-01,56699,53201,3498,6.2
24039,2020-04-01,8149,7312,837,10.3
24041,2020-04-01,17093,15468,1625,9.5
24043,2020-04-01,71454,64097,7357,10.3
24045,2020-04-01,46001,40490,5511,12
24047,2020-04-01,24738,19828,4910,19.8
24510,2020-04-01,272586,244205,28381,10.4
25001,2020-04-01,96836,75701,21135,21.8
25003,2020-04-01,56445,46718,9727,17.2
25005,2020-04-01,275751,217967,57784,21
25007,2020-04-01,8504,6574,1930,22.7
25009,2020-04-01,385081,315368,69713,18.1
25011,2020-04-01,36282,31123,5159,14.2
25013,2020-04-01,205401,168516,36885,18
25015,2020-04-01,77554,67846,9708,12.5
25017,2020-04-01,806013,702014,103999,12.9
25019,2020-04-01,7019,5046,1973,28.1
25021,2020-04-01,353881,299141,54740,15.5
25023,2020-04-01,260662,213023,47639,18.3
25025,2020-04-01,413353,347098,66255,16
25027,2020-04-01,400051,336610,63441,15.9
26001,2020-04-01,3556,2728,828,23.3
26003,2020-04-01,2881,2211,670,23.3
26005,2020-04-01,59882,47113,12769,21.3
26007,2020-04-01,12485,10201,2284,18.3
26009,2020-04-01,9149,6612,2537,27.7
26011,2020-04-01,5733,3946,1787,31.2
26013,2020-04-01,3297,2451,846,25.7
26015,2020-04-01,29895,23469,6426,21.5
26017,2020-04-01,47716,35760,11956,25.1
26019,2020-04-01,8199,5918,2281,27.8
26021,2020-04-01,68626,54883,13743,20
26023,2020-04-01,19365,15192,4173,21.5
26025,2020-04-01,59697,45232,14465,24.2
26027,2020-04-01,24842,18476,6366,25.6
26029,2020-04-01,11512,7889,3623,31.5
26031,2020-04-01,9841,5936,3905,39.7
26033,2020-04-01,15284,12142,3142,20.6
26035,2020-04-01,11509,8109,3400,29.5
26037,2020-04-01,38618,31433,7185,18.6
26039,2020-04-01,5448,3992,1456,26.7
26041,2020-04-01,16194,12456,3738,23.1
26043,2020-04-01,11522,9570,1952,16.9
26045,2020-04-01,55155,43427,11728,21.3
26047,2020-04-01,15652,10509,5143,32.9
26049,2020-04-01,174414,120540,53874,30.9
26051,2020-04-01,9289,6911,2378,25.6
26053,2020-04-01,5483,4494,989,18
26055,2020-04-01,45292,33799,11493,25.4
26057,2020-04-01,17305,13545,3760,21.7
26059,2020-04-01,18983,13782,5201,27.4
26061,2020-04-01,14593,12182,2411,16.5
26063,2020-04-01,14794,10819,3975,26.9
26065,2020-04-01,139156,114030,25126,18.1
26067,2020-04-01,29026,21806,7220,24.9
26069,2020-04-01,9549,7051,2498,26.2
26071,2020-04-01,4689,3791,898,19.2
26073,2020-04-01,30292,23064,7228,23.9
26075,2020-04-01,72995,55744,17251,23.6
26077,2020-04-01,122138,101466,20672,16.9
26079,2020-04-01,7545,5293,2252,29.8
26081,2020-04-01,336190,266353,69837,20.8
26083,2020-04-01,833,664,169,20.3
26085,2020-04-01,3756,2775,981,26.1
26087,2020-04-01,39349,27201,12148,30.9
26089,2020-04-01,9336,7165,2171,23.3
26091,2020-04-01,44552,32650,11902,26.7
26093,2020-04-01,89957,70217,19740,21.9
26095,2020-04-01,2147,1714,433,20.2
26097,2020-04-01,4474,2877,1597,35.7
26099,2020-04-01,412072,298625,113447,27.5
26101,2020-04-01,10235,7449,2786,27.2
26103,2020-04-01,29662,23337,6325,21.3
26105,2020-04-01,12451,9380,3071,24.7
26107,2020-04-01,18361,14025,4336,23.6
26109,2020-04-01,9577,8101,1476,15.4
26111,2020-04-01,37675,30208,7467,19.8
26113,2020-04-01,6514,4743,1771,27.2
26115,2020-04-01,74020,54654,19366,26.2
26117,2020-04-01,27978,20677,7301,26.1
26119,2020-04-01,3007,2101,906,30.1
26121,2020-04-01,76234,53724,22510,29.5
26123,2020-04-01,22699,17298,5401,23.8
26125,2020-04-01,567613,454534,113079,19.9
26127,2020-04-01,11458,8569,2889,25.2
26129,2020-04-01,7710,5531,2179,28.3
26131,2020-04-01,1921,1421,500,26
26133,2020-04-01,10753,7904,2849,26.5
26135,2020-04-01,2792,1898,894,32
26137,2020-04-01,11151,7897,3254,29.2
26139,2020-04-01,150233,119660,30573,20.4
26141,2020-04-01,4767,3539,1228,25.8
26143,2020-04-01,7454,5121,2333,31.3
26145,2020-04-01,79880,58947,20933,26.2
26147,2020-04-01,71306,50295,21011,29.5
26149,2020-04-01,29669,21091,8578,28.9
26151,2020-04-01,19005,13343,5662,29.8
26153,2020-04-01,3143,2451,692,22
26155,2020-04-01,32394,23385,9009,27.8
26157,2020-04-01,23819,16836,6983,29.3
26159,2020-04-01,33478,26624,6854,20.5
26161,2020-04-01,180823,153984,26839,14.8
26163,2020-04-01,733625,542510,191115,26.1
26165,2020-04-01,14347,9908,4439,30.9
27001,2020-04-01,7064,6214,850,12
27003,2020-04-01,192489,174096,18393,9.6
27005,2020-04-01,18260,16293,1967,10.8
27007,2020-04-01,23679,21361,2318,9.8
27009,2020-04-01,21787,19609,2178,10
27011,2020-04-01,2426,2254,172,7.1
27013,2020-04-01,39574,36277,3297,8.3
27015,2020-04-01,13848,12881,967,7
27017,2020-04-01,17415,15471,1944,11.2
27019,2020-04-01,56499,52154,4345,7.7
27021,2020-04-01,13140,11155,1985,15.1
27023,2020-04-01,6598,6052,546,8.3
27025,2020-04-01,29195,26296,2899,9.9
27027,2020-04-01,35039,32805,2234,6.4
27029,2020-04-01,4363,3719,644,14.8
27031,2020-04-01,2719,2220,499,18.4
27033,2020-04-01,6268,5974,294,4.7
27035,2020-04-01,30548,26867,3681,12
27037,2020-04-01,235644,213200,22444,9.5
27039,2020-04-01,11687,10915,772,6.6
27041,2020-04-01,20081,18445,1636,8.1
27043,2020-04-01,6843,6229,614,9
27045,2020-04-01,11396,10612,784,6.9
27047,2020-04-01,16034,14687,1347,8.4
27049,2020-04-01,25505,23099,2406,9.4
27051,2020-04-01,3277,3051,226,6.9
27053,2020-04-01,685892,620955,64937,9.5
27055,2020-04-01,9829,9193,636,6.5
27057,2020-04-01,9244,8182,1062,11.5
27059,2020-04-01,20821,18729,2092,10
27061,2020-04-01,20807,18279,2528,12.1
27063,2020-04-01,5705,5391,314,5.5
27065,2020-04-01,8808,7800,1008,11.4
27067,2020-04-01,23967,22466,1501,6.3
27069,2020-04-01,2414,2259,155,6.4
27071,2020-04-01,5605,4973,632,11.3
27073,2020-04-01,3511,3293,218,6.2
27075,2020-04-01,5087,4541,546,10.7
27077,2020-04-01,2287,2014,273,11.9
27079,2020-04-01,15771,14161,1610,10.2
27081,2020-04-01,3063,2904,159,5.2
27083,2020-04-01,14268,13431,837,5.9
27085,2020-04-01,18888,17455,1433,7.6
27087,2020-04-01,2055,1594,461,22.4
27089,2020-04-01,5299,4805,494,9.3
27091,2020-04-01,9710,9032,678,7
27093,2020-04-01,12810,11914,896,7
27095,2020-04-01,12611,11102,1509,12
27097,2020-04-01,17642,16000,1642,9.3
27099,2020-04-01,20664,19391,1273,6.2
27101,2020-04-01,4819,4521,298,6.2
27103,2020-04-01,20207,18737,1470,7.3
27105,2020-04-01,11433,10924,509,4.5
27107,2020-04-01,3264,2964,300,9.2
27109,2020-04-01,88528,82222,6306,7.1
27111,2020-04-01,30078,27555,2523,8.4
27113,2020-04-01,8324,7427,897,10.8
27115,2020-04-01,13652,11775,1877,13.7
27117,2020-04-01,4572,4349,223,4.9
27119,2020-04-01,15781,14537,1244,7.9
27121,2020-04-01,6242,5844,398,6.4
27123,2020-04-01,280387,252917,27470,9.8
27125,2020-04-01,2161,1942,219,10.1
27127,2020-04-01,7822,7113,709,9.1
27129,2020-04-01,8036,7425,611,7.6
27131,2020-04-01,35966,33348,2618,7.3
27133,2020-04-01,5585,5368,217,3.9
27135,2020-04-01,7885,7197,688,8.7
27137,2020-04-01,99287,88391,10896,11
27139,2020-04-01,81810,73989,7821,9.6
27141,2020-04-01,50969,46205,4764,9.3
27143,2020-04-01,8124,7493,631,7.8
27145,2020-04-01,89114,81693,7421,8.3
27147,2020-04-01,19551,18032,1519,7.8
27149,2020-04-01,5247,5041,206,3.9
27151,2020-04-01,4805,4396,409,8.5
27153,2020-04-01,13539,12680,859,6.3
27155,2020-04-01,1777,1672,105,5.9
27157,2020-04-01,12221,11276,945,7.7
27159,2020-04-01,5905,5195,710,12
27161,2020-04-01,8846,8103,743,8.4
27163,2020-04-01,139211,127136,12075,8.7
27165,2020-04-01,6671,6310,361,5.4
27167,2020-04-01,3384,3174,210,6.2
27169,2020-04-01,27217,25074,2143,7.9
27171,2020-04-01,73341,66992,6349,8.7
27173,2020-04-01,5312,4897,415,7.8
28001,2020-04-01,9959,8219,1740,17.5
28003,2020-04-01,14480,12643,1837,12.7
28005,2020-04-01,4261,3796,465,10.9
28007,2020-04-01,6892,6042,850,12.3
28009,2020-04-01,2889,2482,407,14.1
28011,2020-04-01,11170,9934,1236,11.1
28013,2020-04-01,5927,4740,1187,20
28015,2020-04-01,3402,2971,431,12.7
28017,2020-04-01,7158,4886,2272,31.7
28019,2020-04-01,3462,3137,325,9.4
28021,2020-04-01,3080,2464,616,20
28023,2020-04-01,5581,4868,713,12.8
28025,2020-04-01,7948,6071,1877,23.6
28027,2020-04-01,8704,6947,1757,20.2
28029,2020-04-01,10049,8811,1238,12.3
28031,2020-04-01,7948,7218,730,9.2
28033,2020-04-01,85820,76622,9198,10.7
28035,2020-04-01,31119,26789,4330,13.9
28037,2020-04-01,2663,2360,303,11.4
28039,2020-04-01,8754,7529,1225,14
28041,2020-04-01,4272,3698,574,13.4
28043,2020-04-01,8885,7767,1118,12.6
28045,2020-04-01,17692,14557,3135,17.7
28047,2020-04-01,86681,67265,19416,22.4
28049,2020-04-01,100690,83212,17478,17.4
28051,2020-04-01,5878,4248,1630,27.7
28053,2020-04-01,2340,1937,403,17.2
28055,2020-04-01,343,307,36,10.5
28057,2020-04-01,9868,7840,2028,20.6
28059,2020-04-01,56611,44903,11708,20.7
28061,2020-04-01,5937,5304,633,10.7
28063,2020-04-01,1952,1555,397,20.3
28065,2020-04-01,3900,3401,499,12.8
28067,2020-04-01,24973,22547,2426,9.7
28069,2020-04-01,3324,2875,449,13.5
28071,2020-04-01,23996,21084,2912,12.1
28073,2020-04-01,28447,25289,3158,11.1
28075,2020-04-01,28261,24703,3558,12.6
28077,2020-04-01,4589,3997,592,12.9
28079,2020-04-01,7935,6882,1053,13.3
28081,2020-04-01,39221,30522,8699,22.2
28083,2020-04-01,9790,8154,1636,16.7
28085,2020-04-01,14010,12262,1748,12.5
28087,2020-04-01,24220,20513,3707,15.3
28089,2020-04-01,50042,43028,7014,14
28091,2020-04-01,9610,8597,1013,10.5
28093,2020-04-01,13196,11796,1400,10.6
28095,2020-04-01,15402,12011,3391,22
28097,2020-04-01,3871,3377,494,12.8
28099,2020-04-01,10714,8959,1755,16.4
28101,2020-04-01,7783,6722,1061,13.6
28103,2020-04-01,3965,3340,625,15.8
28105,2020-04-01,20221,17372,2849,14.1
28107,2020-04-01,12316,10394,1922,15.6
28109,2020-04-01,21704,19070,2634,12.1
28111,2020-04-01,3986,3453,533,13.4
28113,2020-04-01,13960,12169,1791,12.8
28115,2020-04-01,14793,11153,3640,24.6
28117,2020-04-01,10935,9109,1826,16.7
28119,2020-04-01,2445,2064,381,15.6
28121,2020-04-01,69716,61952,7764,11.1
28123,2020-04-01,12175,11021,1154,9.5
28125,2020-04-01,1505,1312,193,12.8
28127,2020-04-01,9635,8664,971,10.1
28129,2020-04-01,6413,5938,475,7.4
28131,2020-04-01,6636,5707,929,14
28133,2020-04-01,7516,6484,1032,13.7
28135,2020-04-01,5187,4715,472,9.1
28137,2020-04-01,11461,10098,1363,11.9
28139,2020-04-01,9246,7593,1653,17.9
28141,2020-04-01,8202,7073,1129,13.8
28143,2020-04-01,5107,3627,1480,29
28145,2020-04-01,14111,11253,2858,20.3
28147,2020-04-01,4751,4198,553,11.6
28149,2020-04-01,20190,17009,3181,15.8
28151,2020-04-01,15983,13477,2506,15.7
28153,2020-04-01,7389,6608,781,10.6
28155,2020-04-01,3728,3252,476,12.8
28157,2020-04-01,2600,2233,367,14.1
28159,2020-04-01,7455,6465,990,13.3
28161,2020-04-01,4661,3935,726,15.6
28163,2020-04-01,9721,8072,1649,17
29001,2020-04-01,9794,8923,871,8.9
29003,2020-04-01,9477,8777,700,7.4
29005,2020-04-01,2914,2711,203,7
29007,2020-04-01,10342,8957,1385,13.4
29009,2020-04-01,16022,14292,1730,10.8
29011,2020-04-01,5154,4599,555,10.8
29013,2020-04-01,7310,6684,626,8.6
29015,2020-04-01,7130,6271,859,12
29017,2020-04-01,5316,4685,631,11.9
29019,2020-04-01,91240,83529,7711,8.5
29021,2020-04-01,42802,38916,3886,9.1
29023,2020-04-01,18032,15631,2401,13.3
29025,2020-04-01,4252,3750,502,11.8
29027,2020-04-01,20715,18971,1744,8.4
29029,2020-04-01,17492,14399,3093,17.7
29031,2020-04-01,39061,34459,4602,11.8
29033,2020-04-01,4689,4266,423,9
29035,2020-04-01,2425,2167,258,10.6
29037,2020-04-01,51732,46080,5652,10.9
29039,2020-04-01,5566,5212,354,6.4
29041,2020-04-01,3712,3474,238,6.4
29043,2020-04-01,43404,38546,4858,11.2
29045,2020-04-01,3267,2848,419,12.8
29047,2020-04-01,136051,115063,20988,15.4
29049,2020-04-01,10631,9064,1567,14.7
29051,2020-04-01,37724,34582,3142,8.3
29053,2020-04-01,7296,6464,832,11.4
29055,2020-04-01,10565,9289,1276,12.1
29057,2020-04-01,3569,3330,239,6.7
29059,2020-04-01,6852,6081,771,11.3
29061,2020-04-01,4217,3923,294,7
29063,2020-04-01,4752,4387,365,7.7
29065,2020-04-01,6224,5759,465,7.5
29067,2020-04-01,5487,4574,913,16.6
29069,2020-04-01,11940,10679,1261,10.6
29071,2020-04-01,51583,44727,6856,13.3
29073,2020-04-01,7476,6563,913,12.2
29075,2020-04-01,3532,3334,198,5.6
29077,2020-04-01,145775,128241,17534,12
29079,2020-04-01,4441,4062,379,8.5
29081,2020-04-01,3864,3606,258,6.7
29083,2020-04-01,9360,8439,921,9.8
29085,2020-04-01,3605,3282,323,9
29087,2020-04-01,2663,2507,156,5.9
29089,2020-04-01,4692,4375,317,6.8
29091,2020-04-01,15976,14051,1925,12
29093,2020-04-01,3468,3107,361,10.4
29095,2020-04-01,348939,299351,49588,14.2
29097,2020-04-01,55422,48444,6978,12.6
29099,2020-04-01,113220,98652,14568,12.9
29101,2020-04-01,22769,20374,2395,10.5
29103,2020-04-01,1768,1682,86,4.9
29105,2020-04-01,17287,14004,3283,19
29107,2020-04-01,16118,14382,1736,10.8
29109,2020-04-01,17533,15658,1875,10.7
29111,2020-04-01,4977,4520,457,9.2
29113,2020-04-01,28843,24482,4361,15.1
29115,2020-04-01,4941,4420,521,10.5
29117,2020-04-01,7304,6758,546,7.5
29119,2020-04-01,10125,9252,873,8.6
29121,2020-04-01,7206,6646,560,7.8
29123,2020-04-01,5391,4688,703,13
29125,2020-04-01,3799,3537,262,6.9
29127,2020-04-01,13861,12644,1217,8.8
29129,2020-04-01,2016,1926,90,4.5
29131,2020-04-01,11747,9939,1808,15.4
29133,2020-04-01,5659,5278,381,6.7
29135,2020-04-01,7221,6717,504,7
29137,2020-04-01,3842,3438,404,10.5
29139,2020-04-01,5768,5195,573,9.9
29141,2020-04-01,8123,7115,1008,12.4
29143,2020-04-01,8563,7784,779,9.1
29145,2020-04-01,26712,23213,3499,13.1
29147,2020-04-01,11043,9726,1317,11.9
29149,2020-04-01,3957,3534,423,10.7
29151,2020-04-01,6842,6417,425,6.2
29153,2020-04-01,3589,3135,454,12.6
29155,2020-04-01,6315,5609,706,11.2
29157,2020-04-01,9773,7819,1954,20
29159,2020-04-01,20349,17696,2653,13
29161,2020-04-01,18882,17306,1576,8.3
29163,2020-04-01,7566,6814,752,9.9
29165,2020-04-01,56672,49672,7000,12.4
29167,2020-04-01,13452,12396,1056,7.9
29169,2020-04-01,14389,13021,1368,9.5
29171,2020-04-01,2315,2170,145,6.3
29173,2020-04-01,5496,5039,457,8.3
29175,2020-04-01,10061,8956,1105,11
29177,2020-04-01,11338,9226,2112,18.6
29179,2020-04-01,2973,2711,262,8.8
29181,2020-04-01,5189,4405,784,15.1
29183,2020-04-01,218595,192594,26001,11.9
29185,2020-04-01,3808,3446,362,9.5
29186,2020-04-01,9019,8059,960,10.6
29187,2020-04-01,25672,22430,3242,12.6
29189,2020-04-01,501093,443438,57655,11.5
29195,2020-04-01,10414,9799,615,5.9
29197,2020-04-01,1940,1784,156,8
29199,2020-04-01,2386,2252,134,5.6
29201,2020-04-01,19613,17765,1848,9.4
29203,2020-04-01,3254,2785,469,14.4
29205,2020-04-01,3048,2888,160,5.2
29207,2020-04-01,13250,11567,1683,12.7
29209,2020-04-01,12033,9111,2922,24.3
29211,2020-04-01,2840,2645,195,6.9
29213,2020-04-01,26949,17497,9452,35.1
29215,2020-04-01,8916,8117,799,9
29217,2020-04-01,9301,8746,555,6
29219,2020-04-01,17889,15571,2318,13
29221,2020-04-01,9950,8651,1299,13.1
29223,2020-04-01,5040,4526,514,10.2
29225,2020-04-01,16866,14954,1912,11.3
29227,2020-04-01,1262,1156,106,8.4
29229,2020-04-01,7850,6750,1100,14
29510,2020-04-01,147448,125665,21783,14.8
30001,2020-04-01,5045,4687,358,7.1
30003,2020-04-01,5035,4554,481,9.6
30005,2020-04-01,2378,2247,131,5.5
30007,2020-04-01,2590,2299,291,11.2
30009,2020-04-01,5664,4959,705,12.4
30011,2020-04-01,660,638,22,3.3
30013,2020-04-01,37620,32906,4714,12.5
30015,2020-04-01,2481,2336,145,5.8
30017,2020-04-01,6237,5755,482,7.7
30019,2020-04-01,927,892,35,3.8
30021,2020-04-01,4629,4308,321,6.9
30023,2020-04-01,5063,4535,528,10.4
30025,2020-04-01,1667,1571,96,5.8
30027,2020-04-01,5881,5402,479,8.1
30029,2020-04-01,49411,41079,8332,16.9
30031,2020-04-01,68757,60073,8684,12.6
30033,2020-04-01,788,757,31,3.9
30035,2020-04-01,5520,4809,711,12.9
30037,2020-04-01,361,337,24,6.6
30039,2020-04-01,1533,1232,301,19.6
30041,2020-04-01,7586,6927,659,8.7
30043,2020-04-01,5688,5148,540,9.5
30045,2020-04-01,1042,963,79,7.6
30047,2020-04-01,13629,12365,1264,9.3
30049,2020-04-01,36057,32259,3798,10.5
30051,2020-04-01,1005,976,29,2.9
30053,2020-04-01,8283,6738,1545,18.7
30055,2020-04-01,997,968,29,2.9
30057,2020-04-01,4445,4006,439,9.9
30059,2020-04-01,892,818,74,8.3
30061,2020-04-01,1755,1418,337,19.2
30063,2020-04-01,64624,55675,8949,13.8
30065,2020-04-01,2375,2156,219,9.2
30067,2020-04-01,8935,7310,1625,18.2
30069,2020-04-01,270,263,7,2.6
30071,2020-04-01,1962,1819,143,7.3
30073,2020-04-01,2742,2552,190,6.9
30075,2020-04-01,995,944,51,5.1
30077,2020-04-01,2937,2644,293,10
30079,2020-04-01,482,454,28,5.8
30081,2020-04-01,20632,18431,2201,10.7
30083,2020-04-01,6048,5416,632,10.4
30085,2020-04-01,4481,4141,340,7.6
30087,2020-04-01,3877,3597,280,7.2
30089,2020-04-01,5092,4401,691,13.6
30091,2020-04-01,1765,1620,145,8.2
30093,2020-04-01,17323,14922,2401,13.9
30095,2020-04-01,5383,4865,518,9.6
30097,2020-04-01,1891,1770,121,6.4
30099,2020-04-01,2838,2647,191,6.7
30101,2020-04-01,2166,2000,166,7.7
30103,2020-04-01,361,345,16,4.4
30105,2020-04-01,4044,3747,297,7.3
30107,2020-04-01,815,716,99,12.1
30109,2020-04-01,462,417,45,9.7
30111,2020-04-01,82804,73496,9308,11.2
31001,2020-04-01,17016,15766,1250,7.3
31003,2020-04-01,4102,3994,108,2.6
31005,2020-04-01,247,233,14,5.7
31007,2020-04-01,404,387,17,4.2
31009,2020-04-01,278,270,8,2.9
31011,2020-04-01,3074,2974,100,3.3
31013,2020-04-01,5606,5207,399,7.1
31015,2020-04-01,1120,1082,38,3.4
31017,2020-04-01,1444,1400,44,3
31019,2020-04-01,27941,25280,2661,9.5
31021,2020-04-01,3663,3472,191,5.2
31023,2020-04-01,4734,4477,257,5.4
31025,2020-04-01,13486,12498,988,7.3
31027,2020-04-01,4692,4479,213,4.5
31029,2020-04-01,2400,2348,52,2.2
31031,2020-04-01,3456,3331,125,3.6
31033,2020-04-01,4346,4035,311,7.2
31035,2020-04-01,3389,3220,169,5
31037,2020-04-01,5717,5495,222,3.9
31039,2020-04-01,5035,4847,188,3.7
31041,2020-04-01,6574,6341,233,3.5
31043,2020-04-01,10547,9843,704,6.7
31045,2020-04-01,4873,4683,190,3.9
31047,2020-04-01,13687,13046,641,4.7
31049,2020-04-01,976,930,46,4.7
31051,2020-04-01,3015,2856,159,5.3
31053,2020-04-01,20380,19205,1175,5.8
31055,2020-04-01,302384,275475,26909,8.9
31057,2020-04-01,1211,1183,28,2.3
31059,2020-04-01,3289,3156,133,4
31061,2020-04-01,1543,1469,74,4.8
31063,2020-04-01,1634,1580,54,3.3
31065,2020-04-01,2687,2574,113,4.2
31067,2020-04-01,11251,10426,825,7.3
31069,2020-04-01,1100,1048,52,4.7
31071,2020-04-01,1152,1122,30,2.6
31073,2020-04-01,1085,1045,40,3.7
31075,2020-04-01,444,433,11,2.5
31077,2020-04-01,1311,1260,51,3.9
31079,2020-04-01,32233,29099,3134,9.7
31081,2020-04-01,4790,4506,284,5.9
31083,2020-04-01,1786,1715,71,4
31085,2020-04-01,699,684,15,2.1
31087,2020-04-01,1357,1299,58,4.3
31089,2020-04-01,5993,5785,208,3.5
31091,2020-04-01,382,368,14,3.7
31093,2020-04-01,3388,3135,253,7.5
31095,2020-04-01,4331,4168,163,3.8
31097,2020-04-01,2131,2010,121,5.7
31099,2020-04-01,3935,3691,244,6.2
31101,2020-04-01,4597,4346,251,5.5
31103,2020-04-01,640,625,15,2.3
31105,2020-04-01,2023,1940,83,4.1
31107,2020-04-01,4742,4556,186,3.9
31109,2020-04-01,177981,163582,14399,8.1
31111,2020-04-01,18661,17434,1227,6.6
31113,2020-04-01,500,478,22,4.4
31115,2020-04-01,420,407,13,3.1
31117,2020-04-01,465,450,15,3.2
31119,2020-04-01,20001,18899,1102,5.5
31121,2020-04-01,4053,3780,273,6.7
31123,2020-04-01,2685,2555,130,4.8
31125,2020-04-01,2024,1925,99,4.9
31127,2020-04-01,3643,3454,189,5.2
31129,2020-04-01,2555,2469,86,3.4
31131,2020-04-01,8507,7991,516,6.1
31133,2020-04-01,1549,1488,61,3.9
31135,2020-04-01,1923,1886,37,1.9
31137,2020-04-01,5149,4892,257,5
31139,2020-04-01,4231,4056,175,4.1
31141,2020-04-01,17916,16633,1283,7.2
31143,2020-04-01,3087,2933,154,5
31145,2020-04-01,5892,5626,266,4.5
31147,2020-04-01,4355,4150,205,4.7
31149,2020-04-01,916,884,32,3.5
31151,2020-04-01,7607,7223,384,5
31153,2020-04-01,97303,89787,7516,7.7
31155,2020-04-01,11242,10489,753,6.7
31157,2020-04-01,18173,17006,1167,6.4
31159,2020-04-01,8947,8322,625,7
31161,2020-04-01,2853,2775,78,2.7
31163,2020-04-01,1707,1627,80,4.7
31165,2020-04-01,789,759,30,3.8
31167,2020-04-01,3613,3446,167,4.6
31169,2020-04-01,2934,2802,132,4.5
31171,2020-04-01,439,428,11,2.5
31173,2020-04-01,3117,2844,273,8.8
31175,2020-04-01,2208,2106,102,4.6
31177,2020-04-01,11149,10459,690,6.2
31179,2020-04-01,5763,5529,234,4.1
31181,2020-04-01,1734,1642,92,5.3
31183,2020-04-01,631,617,14,2.2
31185,2020-04-01,7346,6941,405,5.5
32001,2020-04-01,10235,8960,1275,12.5
32003,2020-04-01,NA,739267,369657,33.3
32005,2020-04-01,20771,16157,4614,22.2
32007,2020-04-01,24258,20406,3852,15.9
32009,2020-04-01,383,354,29,7.6
32011,2020-04-01,960,895,65,6.8
32013,2020-04-01,7388,6698,690,9.3
32015,2020-04-01,2844,2599,245,8.6
32017,2020-04-01,1853,1679,174,9.4
32019,2020-04-01,22008,17647,4361,19.8
32021,2020-04-01,1926,1703,223,11.6
32023,2020-04-01,16599,13090,3509,21.1
32027,2020-04-01,2382,2156,226,9.5
32029,2020-04-01,1959,1529,430,21.9
32031,2020-04-01,239616,192050,47566,19.9
32033,2020-04-01,4128,3783,345,8.4
32510,2020-04-01,25001,19782,5219,20.9
33001,2020-04-01,29551,24095,5456,18.5
33003,2020-04-01,21016,16455,4561,21.7
33005,2020-04-01,37762,32500,5262,13.9
33007,2020-04-01,13684,10914,2770,20.2
33009,2020-04-01,44650,37964,6686,15
33011,2020-04-01,232380,194462,37918,16.3
33013,2020-04-01,79316,68121,11195,14.1
33015,2020-04-01,177978,147507,30471,17.1
33017,2020-04-01,69891,59286,10605,15.2
33019,2020-04-01,21917,19261,2656,12.1
34001,2020-04-01,122834,80619,42215,34.4
34003,2020-04-01,473081,396929,76152,16.1
34005,2020-04-01,226385,194692,31693,14
34007,2020-04-01,254631,211609,43022,16.9
34009,2020-04-01,41454,29889,11565,27.9
34011,2020-04-01,66976,55616,11360,17
34013,2020-04-01,370449,306203,64246,17.3
34015,2020-04-01,150868,125994,24874,16.5
34017,2020-04-01,355687,296200,59487,16.7
34019,2020-04-01,62271,54509,7762,12.5
34021,2020-04-01,202023,179338,22685,11.2
34023,2020-04-01,422218,360599,61619,14.6
34025,2020-04-01,321432,270007,51425,16
34027,2020-04-01,248985,215993,32992,13.3
34029,2020-04-01,275865,227663,48202,17.5
34031,2020-04-01,247579,197065,50514,20.4
34033,2020-04-01,29219,24892,4327,14.8
34035,2020-04-01,164504,143711,20793,12.6
34037,2020-04-01,75041,62042,12999,17.3
34039,2020-04-01,273974,230938,43036,15.7
34041,2020-04-01,53525,45175,8350,15.6
35001,2020-04-01,317427,284378,33049,10.4
35003,2020-04-01,1059,996,63,5.9
35005,2020-04-01,26624,24397,2227,8.4
35006,2020-04-01,8681,8021,660,7.6
35007,2020-04-01,4675,4279,396,8.5
35009,2020-04-01,21332,20196,1136,5.3
35011,2020-04-01,690,665,25,3.6
35013,2020-04-01,93509,84474,9035,9.7
35015,2020-04-01,33644,31771,1873,5.6
35017,2020-04-01,11651,10966,685,5.9
35019,2020-04-01,1409,1329,80,5.7
35021,2020-04-01,264,258,6,2.3
35023,2020-04-01,1830,1752,78,4.3
35025,2020-04-01,28918,26457,2461,8.5
35027,2020-04-01,8371,7358,1013,12.1
35028,2020-04-01,9612,9225,387,4
35029,2020-04-01,9440,8010,1430,15.1
35031,2020-04-01,22728,20647,2081,9.2
35033,2020-04-01,1964,1818,146,7.4
35035,2020-04-01,25439,22899,2540,10
35037,2020-04-01,2977,2804,173,5.8
35039,2020-04-01,16095,14648,1447,9
35041,2020-04-01,7903,7492,411,5.2
35043,2020-04-01,63675,56706,6969,10.9
35045,2020-04-01,48748,43327,5421,11.1
35047,2020-04-01,10304,9396,908,8.8
35049,2020-04-01,67213,59868,7345,10.9
35051,2020-04-01,3857,3491,366,9.5
35053,2020-04-01,5967,5543,424,7.1
35055,2020-04-01,13376,11167,2209,16.5
35057,2020-04-01,5004,4517,487,9.7
35059,2020-04-01,1612,1533,79,4.9
35061,2020-04-01,28429,25913,2516,8.9
36001,2020-04-01,149846,130255,19591,13.1
36003,2020-04-01,18352,15721,2631,14.3
36005,2020-04-01,550515,448626,101889,18.5
36007,2020-04-01,78935,65384,13551,17.2
36009,2020-04-01,31597,25186,6411,20.3
36011,2020-04-01,33912,28285,5627,16.6
36013,2020-04-01,50301,41290,9011,17.9
36015,2020-04-01,34444,28320,6124,17.8
36017,2020-04-01,20964,18312,2652,12.7
36019,2020-04-01,34026,28194,5832,17.1
36021,2020-04-01,28703,25298,3405,11.9
36023,2020-04-01,21650,18325,3325,15.4
36025,2020-04-01,17684,15302,2382,13.5
36027,2020-04-01,135063,114230,20833,15.4
36029,2020-04-01,423240,337532,85708,20.3
36031,2020-04-01,15326,12430,2896,18.9
36033,2020-04-01,18330,15384,2946,16.1
36035,2020-04-01,21763,18153,3610,16.6
36037,2020-04-01,27549,23156,4393,15.9
36039,2020-04-01,19197,16043,3154,16.4
36041,2020-04-01,1934,1620,314,16.2
36043,2020-04-01,26305,22072,4233,16.1
36045,2020-04-01,41189,33699,7490,18.2
36047,2020-04-01,NA,913477,169844,15.7
36049,2020-04-01,10766,9142,1624,15.1
36051,2020-04-01,28573,24367,4206,14.7
36053,2020-04-01,31491,26134,5357,17
36055,2020-04-01,346182,289849,56333,16.3
36057,2020-04-01,21103,17756,3347,15.9
36059,2020-04-01,652988,541157,111831,17.1
36061,2020-04-01,797369,705517,91852,11.5
36063,2020-04-01,97619,74605,23014,23.6
36065,2020-04-01,96870,80996,15874,16.4
36067,2020-04-01,213701,177064,36637,17.1
36069,2020-04-01,52453,44432,8021,15.3
36071,2020-04-01,173858,144530,29328,16.9
36073,2020-04-01,16569,13778,2791,16.8
36075,2020-04-01,50764,41644,9120,18
36077,2020-04-01,25637,22280,3357,13.1
36079,2020-04-01,47746,40345,7401,15.5
36081,2020-04-01,NA,871965,178866,17
36083,2020-04-01,77280,67017,10263,13.3
36085,2020-04-01,200018,171072,28946,14.5
36087,2020-04-01,143093,121164,21929,15.3
36089,2020-04-01,41805,35349,6456,15.4
36091,2020-04-01,115132,98984,16148,14
36093,2020-04-01,73881,63081,10800,14.6
36095,2020-04-01,13623,11910,1713,12.6
36097,2020-04-01,7680,6248,1432,18.6
36099,2020-04-01,15009,12525,2484,16.6
36101,2020-04-01,41075,34306,6769,16.5
36103,2020-04-01,720320,591161,129159,17.9
36105,2020-04-01,34280,29093,5187,15.1
36107,2020-04-01,21386,17820,3566,16.7
36109,2020-04-01,46630,41489,5141,11
36111,2020-04-01,81757,68118,13639,16.7
36113,2020-04-01,29460,23966,5494,18.6
36115,2020-04-01,25259,21409,3850,15.2
36117,2020-04-01,41125,34925,6200,15.1
36119,2020-04-01,446344,377582,68762,15.4
36121,2020-04-01,17140,14337,2803,16.4
36123,2020-04-01,10944,9432,1512,13.8
37001,2020-04-01,75439,65666,9773,13
37003,2020-04-01,17766,14151,3615,20.3
37005,2020-04-01,3913,3443,470,12
37007,2020-04-01,9658,8796,862,8.9
37009,2020-04-01,11643,10234,1409,12.1
37011,2020-04-01,6470,5683,787,12.2
37013,2020-04-01,18049,16468,1581,8.8
37015,2020-04-01,7192,6694,498,6.9
37017,2020-04-01,13400,12046,1354,10.1
37019,2020-04-01,46948,38562,8386,17.9
37021,2020-04-01,129904,105884,24020,18.5
37023,2020-04-01,37883,31927,5956,15.7
37025,2020-04-01,101647,88789,12858,12.6
37027,2020-04-01,33918,28394,5524,16.3
37029,2020-04-01,4296,3896,400,9.3
37031,2020-04-01,28294,24658,3636,12.9
37033,2020-04-01,9380,8008,1372,14.6
37035,2020-04-01,76203,61816,14387,18.9
37037,2020-04-01,32872,29965,2907,8.8
37039,2020-04-01,10282,8905,1377,13.4
37041,2020-04-01,5107,4666,441,8.6
37043,2020-04-01,3826,3350,476,12.4
37045,2020-04-01,46439,39969,6470,13.9
37047,2020-04-01,21143,18598,2545,12
37049,2020-04-01,38371,34051,4320,11.3
37051,2020-04-01,121996,103330,18666,15.3
37053,2020-04-01,13273,11460,1813,13.7
37055,2020-04-01,17719,12725,4994,28.2
37057,2020-04-01,75301,64814,10487,13.9
37059,2020-04-01,19153,16554,2599,13.6
37061,2020-04-01,23468,21602,1866,8
37063,2020-04-01,160671,144015,16656,10.4
37065,2020-04-01,19665,16899,2766,14.1
37067,2020-04-01,172708,150778,21930,12.7
37069,2020-04-01,28832,25523,3309,11.5
37071,2020-04-01,103627,88662,14965,14.4
37073,2020-04-01,4591,4233,358,7.8
37075,2020-04-01,2956,2467,489,16.5
37077,2020-04-01,28282,25557,2725,9.6
37079,2020-04-01,9005,8263,742,8.2
37081,2020-04-01,244325,207448,36877,15.1
37083,2020-04-01,18812,16548,2264,12
37085,2020-04-01,50340,43924,6416,12.7
37087,2020-04-01,26536,22446,4090,15.4
37089,2020-04-01,48452,41378,7074,14.6
37091,2020-04-01,8547,7899,648,7.6
37093,2020-04-01,18820,16287,2533,13.5
37095,2020-04-01,1682,1415,267,15.9
37097,2020-04-01,84909,72448,12461,14.7
37099,2020-04-01,18353,15813,2540,13.8
37101,2020-04-01,91438,81280,10158,11.1
37103,2020-04-01,3899,3542,357,9.2
37105,2020-04-01,25071,21307,3764,15
37107,2020-04-01,26017,24037,1980,7.6
37109,2020-04-01,40871,35508,5363,13.1
37111,2020-04-01,20210,17644,2566,12.7
37113,2020-04-01,14185,12375,1810,12.8
37115,2020-04-01,8721,7562,1159,13.3
37117,2020-04-01,8265,7512,753,9.1
37119,2020-04-01,578972,500985,77987,13.5
37121,2020-04-01,5676,4884,792,14
37123,2020-04-01,10489,9308,1181,11.3
37125,2020-04-01,37698,32249,5449,14.5
37127,2020-04-01,40390,35190,5200,12.9
37129,2020-04-01,112590,94876,17714,15.7
37131,2020-04-01,6898,6327,571,8.3
37133,2020-04-01,59857,52117,7740,12.9
37135,2020-04-01,72667,66390,6277,8.6
37137,2020-04-01,4846,4425,421,8.7
37139,2020-04-01,15699,13785,1914,12.2
37141,2020-04-01,25503,22191,3312,13
37143,2020-04-01,4555,4060,495,10.9
37145,2020-04-01,17510,15164,2346,13.4
37147,2020-04-01,81553,73351,8202,10.1
37149,2020-04-01,8284,7337,947,11.4
37151,2020-04-01,61730,52353,9377,15.2
37153,2020-04-01,16099,14058,2041,12.7
37155,2020-04-01,47134,41893,5241,11.1
37157,2020-04-01,37477,31534,5943,15.9
37159,2020-04-01,61956,52677,9279,15
37161,2020-04-01,23475,19735,3740,15.9
37163,2020-04-01,27117,24971,2146,7.9
37165,2020-04-01,10907,9150,1757,16.1
37167,2020-04-01,27677,24684,2993,10.8
37169,2020-04-01,19539,17339,2200,11.3
37171,2020-04-01,31367,26916,4451,14.2
37173,2020-04-01,6705,5597,1108,16.5
37175,2020-04-01,12975,11431,1544,11.9
37177,2020-04-01,1119,925,194,17.3
37179,2020-04-01,112150,100155,11995,10.7
37181,2020-04-01,16410,14132,2278,13.9
37183,2020-04-01,544980,482332,62648,11.5
37185,2020-04-01,6265,5421,844,13.5
37187,2020-04-01,4045,3621,424,10.5
37189,2020-04-01,24531,21115,3416,13.9
37191,2020-04-01,47832,43234,4598,9.6
37193,2020-04-01,27392,24005,3387,12.4
37195,2020-04-01,32643,27887,4756,14.6
37197,2020-04-01,16892,14235,2657,15.7
37199,2020-04-01,7719,6839,880,11.4
38001,2020-04-01,990,939,51,5.2
38003,2020-04-01,5113,4755,358,7
38005,2020-04-01,2301,2031,270,11.7
38007,2020-04-01,399,376,23,5.8
38009,2020-04-01,2948,2696,252,8.5
38011,2020-04-01,1641,1534,107,6.5
38013,2020-04-01,1057,975,82,7.8
38015,2020-04-01,49970,45567,4403,8.8
38017,2020-04-01,103728,94507,9221,8.9
38019,2020-04-01,1937,1838,99,5.1
38021,2020-04-01,2441,2224,217,8.9
38023,2020-04-01,1402,1334,68,4.9
38025,2020-04-01,3235,3083,152,4.7
38027,2020-04-01,1217,1126,91,7.5
38029,2020-04-01,1519,1412,107,7
38031,2020-04-01,1571,1479,92,5.9
38033,2020-04-01,864,828,36,4.2
38035,2020-04-01,36080,32777,3303,9.2
38037,2020-04-01,1177,1131,46,3.9
38039,2020-04-01,1031,993,38,3.7
38041,2020-04-01,1410,1344,66,4.7
38043,2020-04-01,1295,1194,101,7.8
38045,2020-04-01,2107,2001,106,5
38047,2020-04-01,851,807,44,5.2
38049,2020-04-01,3150,2880,270,8.6
38051,2020-04-01,1091,1054,37,3.4
38053,2020-04-01,9796,8895,901,9.2
38055,2020-04-01,4911,4616,295,6
38057,2020-04-01,3605,3323,282,7.8
38059,2020-04-01,16683,15045,1638,9.8
38061,2020-04-01,7054,6629,425,6
38063,2020-04-01,1403,1305,98,7
38065,2020-04-01,870,804,66,7.6
38067,2020-04-01,3598,3168,430,12
38069,2020-04-01,1725,1587,138,8
38071,2020-04-01,5625,5156,469,8.3
38073,2020-04-01,2916,2450,466,16
38075,2020-04-01,1238,1152,86,6.9
38077,2020-04-01,8554,7694,860,10.1
38079,2020-04-01,4990,4288,702,14.1
38081,2020-04-01,2368,1809,559,23.6
38083,2020-04-01,695,642,53,7.6
38085,2020-04-01,1143,1103,40,3.5
38087,2020-04-01,393,380,13,3.3
38089,2020-04-01,18674,16880,1794,9.6
38091,2020-04-01,969,929,40,4.1
38093,2020-04-01,10439,9859,580,5.6
38095,2020-04-01,1192,1153,39,3.3
38097,2020-04-01,4369,4106,263,6
38099,2020-04-01,5220,4880,340,6.5
38101,2020-04-01,31508,28300,3208,10.2
38103,2020-04-01,1910,1788,122,6.4
38105,2020-04-01,23932,21317,2615,10.9
39001,2020-04-01,10454,8780,1674,16
39003,2020-04-01,47421,38067,9354,19.7
39005,2020-04-01,25214,22183,3031,12
39007,2020-04-01,41009,34711,6298,15.4
39009,2020-04-01,27381,24583,2798,10.2
39011,2020-04-01,24334,19752,4582,18.8
39013,2020-04-01,27703,22868,4835,17.5
39015,2020-04-01,18411,15653,2758,15
39017,2020-04-01,182879,158130,24749,13.5
39019,2020-04-01,12300,10316,1984,16.1
39021,2020-04-01,20039,16396,3643,18.2
39023,2020-04-01,61149,50581,10568,17.3
39025,2020-04-01,100000,86813,13187,13.2
39027,2020-04-01,17425,14569,2856,16.4
39029,2020-04-01,45520,36569,8951,19.7
39031,2020-04-01,13712,11605,2107,15.4
39033,2020-04-01,18524,14464,4060,21.9
39035,2020-04-01,586349,455078,131271,22.4
39037,2020-04-01,25360,21168,4192,16.5
39039,2020-04-01,17590,13729,3861,21.9
39041,2020-04-01,103169,92465,10704,10.4
39043,2020-04-01,35040,26088,8952,25.5
39045,2020-04-01,74545,64643,9902,13.3
39047,2020-04-01,13695,11583,2112,15.4
39049,2020-04-01,661474,572539,88935,13.4
39051,2020-04-01,21485,17108,4377,20.4
39053,2020-04-01,12103,10547,1556,12.9
39055,2020-04-01,43922,36994,6928,15.8
39057,2020-04-01,77306,67643,9663,12.5
39059,2020-04-01,17335,14814,2521,14.5
39061,2020-04-01,389404,336251,53153,13.6
39063,2020-04-01,40035,33182,6853,17.1
39065,2020-04-01,14368,11569,2799,19.5
39067,2020-04-01,6512,5612,900,13.8
39069,2020-04-01,12973,10460,2513,19.4
39071,2020-04-01,16925,13804,3121,18.4
39073,2020-04-01,12413,10514,1899,15.3
39075,2020-04-01,19698,18461,1237,6.3
39077,2020-04-01,26773,21219,5554,20.7
39079,2020-04-01,12600,10834,1766,14
39081,2020-04-01,26349,21784,4565,17.3
39083,2020-04-01,29694,26181,3513,11.8
39085,2020-04-01,119069,95028,24041,20.2
39087,2020-04-01,23025,19445,3580,15.5
39089,2020-04-01,85327,74526,10801,12.7
39091,2020-04-01,24293,17624,6669,27.5
39093,2020-04-01,151296,115443,35853,23.7
39095,2020-04-01,203637,156423,47214,23.2
39097,2020-04-01,19872,17412,2460,12.4
39099,2020-04-01,96916,77627,19289,19.9
39101,2020-04-01,27852,23212,4640,16.7
39103,2020-04-01,91926,74087,17839,19.4
39105,2020-04-01,8753,7488,1265,14.5
39107,2020-04-01,23154,20058,3096,13.4
39109,2020-04-01,52217,44139,8078,15.5
39111,2020-04-01,5435,4657,778,14.3
39113,2020-04-01,242797,202103,40694,16.8
39115,2020-04-01,6328,5302,1026,16.2
39117,2020-04-01,16302,13799,2503,15.4
39119,2020-04-01,38443,32646,5797,15.1
39121,2020-04-01,4525,3821,704,15.6
39123,2020-04-01,19391,15819,3572,18.4
39125,2020-04-01,8723,7105,1618,18.5
39127,2020-04-01,15372,12901,2471,16.1
39129,2020-04-01,25124,21830,3294,13.1
39131,2020-04-01,10718,8933,1785,16.7
39133,2020-04-01,81269,70151,11118,13.7
39135,2020-04-01,19954,17208,2746,13.8
39137,2020-04-01,17730,15192,2538,14.3
39139,2020-04-01,50135,39990,10145,20.2
39141,2020-04-01,34782,28712,6070,17.5
39143,2020-04-01,29262,23682,5580,19.1
39145,2020-04-01,28114,24151,3963,14.1
39147,2020-04-01,26925,21559,5366,19.9
39149,2020-04-01,24090,19040,5050,21
39151,2020-04-01,175203,147918,27285,15.6
39153,2020-04-01,258533,218715,39818,15.4
39155,2020-04-01,81840,65057,16783,20.5
39157,2020-04-01,42739,36456,6283,14.7
39159,2020-04-01,29049,24501,4548,15.7
39161,2020-04-01,14451,12107,2344,16.2
39163,2020-04-01,5449,4618,831,15.3
39165,2020-04-01,111606,97660,13946,12.5
39167,2020-04-01,25776,21934,3842,14.9
39169,2020-04-01,58533,51814,6719,11.5
39171,2020-04-01,18271,14460,3811,20.9
39173,2020-04-01,64569,53933,10636,16.5
39175,2020-04-01,12091,9572,2519,20.8
40001,2020-04-01,8150,7438,712,8.7
40003,2020-04-01,2759,2610,149,5.4
40005,2020-04-01,5095,4510,585,11.5
40007,2020-04-01,2455,2364,91,3.7
40009,2020-04-01,9978,8736,1242,12.4
40011,2020-04-01,4358,3928,430,9.9
40013,2020-04-01,22020,19751,2269,10.3
40015,2020-04-01,12062,10799,1263,10.5
40017,2020-04-01,74317,64100,10217,13.7
40019,2020-04-01,21087,17531,3556,16.9
40021,2020-04-01,18962,17205,1757,9.3
40023,2020-04-01,5598,4909,689,12.3
40025,2020-04-01,1363,1331,32,2.3
40027,2020-04-01,137722,120499,17223,12.5
40029,2020-04-01,2211,1988,223,10.1
40031,2020-04-01,48419,40349,8070,16.7
40033,2020-04-01,2779,2305,474,17.1
40035,2020-04-01,5803,5233,570,9.8
40037,2020-04-01,30322,26457,3865,12.7
40039,2020-04-01,14795,13435,1360,9.2
40041,2020-04-01,17852,15867,1985,11.1
40043,2020-04-01,2757,2574,183,6.6
40045,2020-04-01,2167,2049,118,5.4
40047,2020-04-01,26275,23622,2653,10.1
40049,2020-04-01,12708,11243,1465,11.5
40051,2020-04-01,25644,22498,3146,12.3
40053,2020-04-01,2775,2634,141,5.1
40055,2020-04-01,1922,1667,255,13.3
40057,2020-04-01,1157,1103,54,4.7
40059,2020-04-01,1767,1694,73,4.1
40061,2020-04-01,4250,3712,538,12.7
40063,2020-04-01,5436,4789,647,11.9
40065,2020-04-01,10293,9510,783,7.6
40067,2020-04-01,2578,2245,333,12.9
40069,2020-04-01,3843,3247,596,15.5
40071,2020-04-01,18056,15619,2437,13.5
40073,2020-04-01,8698,8109,589,6.8
40075,2020-04-01,3524,3203,321,9.1
40077,2020-04-01,3207,2717,490,15.3
40079,2020-04-01,18450,16188,2262,12.3
40081,2020-04-01,14906,13249,1657,11.1
40083,2020-04-01,21168,18922,2246,10.6
40085,2020-04-01,6689,6019,670,10
40087,2020-04-01,19160,16918,2242,11.7
40089,2020-04-01,14810,13266,1544,10.4
40091,2020-04-01,7070,6015,1055,14.9
40093,2020-04-01,3652,3392,260,7.1
40095,2020-04-01,6690,5606,1084,16.2
40097,2020-04-01,18736,17079,1657,8.8
40099,2020-04-01,6134,5451,683,11.1
40101,2020-04-01,28602,25196,3406,11.9
40103,2020-04-01,5341,4887,454,8.5
40105,2020-04-01,4515,4118,397,8.8
40107,2020-04-01,4426,3942,484,10.9
40109,2020-04-01,375483,323111,52372,13.9
40111,2020-04-01,15180,13115,2065,13.6
40113,2020-04-01,19925,17392,2533,12.7
40115,2020-04-01,14685,12538,2147,14.6
40117,2020-04-01,7098,6199,899,12.7
40119,2020-04-01,36464,32280,4184,11.5
40121,2020-04-01,17062,14594,2468,14.5
40123,2020-04-01,19078,16980,2098,11
40125,2020-04-01,31611,27752,3859,12.2
40127,2020-04-01,4428,3951,477,10.8
40129,2020-04-01,1810,1659,151,8.3
40131,2020-04-01,43449,38194,5255,12.1
40133,2020-04-01,9241,8033,1208,13.1
40135,2020-04-01,16318,13987,2331,14.3
40137,2020-04-01,18922,16461,2461,13
40139,2020-04-01,11021,10747,274,2.5
40141,2020-04-01,3165,2566,599,18.9
40143,2020-04-01,317285,273086,44199,13.9
40145,2020-04-01,36964,32439,4525,12.2
40147,2020-04-01,21690,19142,2548,11.7
40149,2020-04-01,5217,4675,542,10.4
40151,2020-04-01,4491,4239,252,5.6
40153,2020-04-01,9111,8151,960,10.5
41001,2020-04-01,7150,6351,799,11.2
41003,2020-04-01,45026,40793,4233,9.4
41005,2020-04-01,211088,185232,25856,12.2
41007,2020-04-01,18255,14288,3967,21.7
41009,2020-04-01,23470,20325,3145,13.4
41011,2020-04-01,26096,21802,4294,16.5
41013,2020-04-01,10015,8475,1540,15.4
41015,2020-04-01,8525,7177,1348,15.8
41017,2020-04-01,93031,77917,15114,16.2
41019,2020-04-01,46708,40057,6651,14.2
41021,2020-04-01,973,890,83,8.5
41023,2020-04-01,3108,2702,406,13.1
41025,2020-04-01,3468,3181,287,8.3
41027,2020-04-01,12546,10880,1666,13.3
41029,2020-04-01,100475,86370,14105,14
41031,2020-04-01,10173,8967,1206,11.9
41033,2020-04-01,34489,29771,4718,13.7
41035,2020-04-01,28585,24665,3920,13.7
41037,2020-04-01,3453,3161,292,8.5
41039,2020-04-01,175135,150454,24681,14.1
41041,2020-04-01,19737,15030,4707,23.8
41043,2020-04-01,57855,49869,7986,13.8
41045,2020-04-01,12071,11211,860,7.1
41047,2020-04-01,156290,138075,18215,11.7
41049,2020-04-01,5557,5189,368,6.6
41051,2020-04-01,445230,382064,63166,14.2
41053,2020-04-01,38434,34180,4254,11.1
41055,2020-04-01,948,849,99,10.4
41057,2020-04-01,11479,9652,1827,15.9
41059,2020-04-01,36602,32140,4462,12.2
41061,2020-04-01,11965,10017,1948,16.3
41063,2020-04-01,3260,2847,413,12.7
41065,2020-04-01,12201,10633,1568,12.9
41067,2020-04-01,308473,275426,33047,10.7
41069,2020-04-01,671,636,35,5.2
41071,2020-04-01,52584,46422,6162,11.7
42001,2020-04-01,50693,42961,7732,15.3
42003,2020-04-01,619685,521317,98368,15.9
42005,2020-04-01,30876,25519,5357,17.4
42007,2020-04-01,82141,67049,15092,18.4
42009,2020-04-01,23103,19032,4071,17.6
42011,2020-04-01,206114,168961,37153,18
42013,2020-04-01,57968,47658,10310,17.8
42015,2020-04-01,27196,23779,3417,12.6
42017,2020-04-01,331159,280935,50224,15.2
42019,2020-04-01,95280,80569,14711,15.4
42021,2020-04-01,55568,45722,9846,17.7
42023,2020-04-01,1902,1373,529,27.8
42025,2020-04-01,31379,25395,5984,19.1
42027,2020-04-01,75259,67561,7698,10.2
42029,2020-04-01,267143,236034,31109,11.6
42031,2020-04-01,16699,13945,2754,16.5
42033,2020-04-01,35526,29501,6025,17
42035,2020-04-01,17247,14582,2665,15.5
42037,2020-04-01,32937,27809,5128,15.6
42039,2020-04-01,38121,32075,6046,15.9
42041,2020-04-01,127299,111751,15548,12.2
42043,2020-04-01,142038,120804,21234,14.9
42045,2020-04-01,287085,243554,43531,15.2
42047,2020-04-01,15151,11097,4054,26.8
42049,2020-04-01,122768,101578,21190,17.3
42051,2020-04-01,56087,44772,11315,20.2
42053,2020-04-01,1839,1516,323,17.6
42055,2020-04-01,75196,65374,9822,13.1
42057,2020-04-01,7543,6175,1368,18.1
42059,2020-04-01,15782,13547,2235,14.2
42061,2020-04-01,19385,16075,3310,17.1
42063,2020-04-01,37034,31370,5664,15.3
42065,2020-04-01,19868,16637,3231,16.3
42067,2020-04-01,12040,9856,2184,18.1
42069,2020-04-01,102157,84571,17586,17.2
42071,2020-04-01,272614,232115,40499,14.9
42073,2020-04-01,39644,32349,7295,18.4
42075,2020-04-01,69755,59732,10023,14.4
42077,2020-04-01,185999,154297,31702,17
42079,2020-04-01,154936,126288,28648,18.5
42081,2020-04-01,55175,46360,8815,16
42083,2020-04-01,16810,13680,3130,18.6
42085,2020-04-01,46968,38666,8302,17.7
42087,2020-04-01,21037,17717,3320,15.8
42089,2020-04-01,78492,61692,16800,21.4
42091,2020-04-01,432867,373530,59337,13.7
42093,2020-04-01,8717,7709,1008,11.6
42095,2020-04-01,154240,128985,25255,16.4
42097,2020-04-01,41083,33975,7108,17.3
42099,2020-04-01,23658,20536,3122,13.2
42101,2020-04-01,722086,595575,126511,17.5
42103,2020-04-01,25415,20682,4733,18.6
42105,2020-04-01,7039,6003,1036,14.7
42107,2020-04-01,66167,55432,10735,16.2
42109,2020-04-01,18492,15080,3412,18.5
42111,2020-04-01,32015,26317,5698,17.8
42113,2020-04-01,2441,2072,369,15.1
42115,2020-04-01,18747,16297,2450,13.1
42117,2020-04-01,18491,15845,2646,14.3
42119,2020-04-01,18723,16184,2539,13.6
42121,2020-04-01,21502,18267,3235,15
42123,2020-04-01,18064,15721,2343,13
42125,2020-04-01,103283,85733,17550,17
42127,2020-04-01,21495,17587,3908,18.2
42129,2020-04-01,174921,144646,30275,17.3
42131,2020-04-01,12895,10906,1989,15.4
42133,2020-04-01,226122,190740,35382,15.6
44001,2020-04-01,24288,20809,3479,14.3
44003,2020-04-01,88589,72889,15700,17.7
44005,2020-04-01,42005,35320,6685,15.9
44007,2020-04-01,318750,260250,58500,18.4
44009,2020-04-01,63940,53986,9954,15.6
45001,2020-04-01,10309,9059,1250,12.1
45003,2020-04-01,74410,67641,6769,9.1
45005,2020-04-01,2633,2336,297,11.3
45007,2020-04-01,89347,79005,10342,11.6
45009,2020-04-01,4907,4403,504,10.3
45011,2020-04-01,8025,7310,715,8.9
45013,2020-04-01,73400,65267,8133,11.1
45015,2020-04-01,100342,90598,9744,9.7
45017,2020-04-01,6375,5878,497,7.8
45019,2020-04-01,206063,181451,24612,11.9
45021,2020-04-01,25418,21501,3917,15.4
45023,2020-04-01,13406,11664,1742,13
45025,2020-04-01,21813,19712,2101,9.6
45027,2020-04-01,12854,11562,1292,10.1
45029,2020-04-01,16156,14833,1323,8.2
45031,2020-04-01,29939,27172,2767,9.2
45033,2020-04-01,13335,12297,1038,7.8
45035,2020-04-01,74563,66942,7621,10.2
45037,2020-04-01,10704,9681,1023,9.6
45039,2020-04-01,9462,8453,1009,10.7
45041,2020-04-01,65235,60146,5089,7.8
45043,2020-04-01,25558,22056,3502,13.7
45045,2020-04-01,251312,223042,28270,11.2
45047,2020-04-01,31559,28462,3097,9.8
45049,2020-04-01,8098,7585,513,6.3
45051,2020-04-01,145564,116307,29257,20.1
45053,2020-04-01,11883,10854,1029,8.7
45055,2020-04-01,28960,26582,2378,8.2
45057,2020-04-01,41859,37126,4733,11.3
45059,2020-04-01,29914,26007,3907,13.1
45061,2020-04-01,6846,6131,715,10.4
45063,2020-04-01,146818,136808,10010,6.8
45065,2020-04-01,3416,3076,340,10
45067,2020-04-01,12828,11497,1331,10.4
45069,2020-04-01,9646,8157,1489,15.4
45071,2020-04-01,18724,17252,1472,7.9
45073,2020-04-01,35220,31469,3751,10.7
45075,2020-04-01,35002,30798,4204,12
45077,2020-04-01,55521,49932,5589,10.1
45079,2020-04-01,194797,178774,16023,8.2
45081,2020-04-01,8557,7999,558,6.5
45083,2020-04-01,160484,138939,21545,13.4
45085,2020-04-01,42875,38361,4514,10.5
45087,2020-04-01,12299,10238,2061,16.8
45089,2020-04-01,12057,10756,1301,10.8
45091,2020-04-01,141299,126516,14783,10.5
46003,2020-04-01,1449,1378,71,4.9
46005,2020-04-01,9427,8829,598,6.3
46007,2020-04-01,1068,1011,57,5.3
46009,2020-04-01,2917,2704,213,7.3
46011,2020-04-01,18722,17277,1445,7.7
46013,2020-04-01,20749,18898,1851,8.9
46015,2020-04-01,2510,2269,241,9.6
46017,2020-04-01,656,565,91,13.9
46019,2020-04-01,5005,4442,563,11.2
46021,2020-04-01,767,722,45,5.9
46023,2020-04-01,3801,3436,365,9.6
46025,2020-04-01,2065,1926,139,6.7
46027,2020-04-01,7418,6854,564,7.6
46029,2020-04-01,15879,14052,1827,11.5
46031,2020-04-01,1341,1276,65,4.8
46033,2020-04-01,4096,3619,477,11.6
46035,2020-04-01,10918,10121,797,7.3
46037,2020-04-01,2715,2390,325,12
46039,2020-04-01,2253,2025,228,10.1
46041,2020-04-01,2261,2096,165,7.3
46043,2020-04-01,1571,1519,52,3.3
46045,2020-04-01,1944,1866,78,4
46047,2020-04-01,3045,2778,267,8.8
46049,2020-04-01,1012,965,47,4.6
46051,2020-04-01,4423,4087,336,7.6
46053,2020-04-01,2080,1962,118,5.7
46055,2020-04-01,1048,1011,37,3.5
46057,2020-04-01,3347,3140,207,6.2
46059,2020-04-01,1735,1664,71,4.1
46061,2020-04-01,1730,1597,133,7.7
46063,2020-04-01,719,679,40,5.6
46065,2020-04-01,9596,8961,635,6.6
46067,2020-04-01,3652,3443,209,5.7
46069,2020-04-01,666,643,23,3.5
46071,2020-04-01,1167,1114,53,4.5
46073,2020-04-01,1166,1126,40,3.4
46075,2020-04-01,508,481,27,5.3
46077,2020-04-01,2628,2478,150,5.7
46079,2020-04-01,6490,6094,396,6.1
46081,2020-04-01,13814,10958,2856,20.7
46083,2020-04-01,35718,33022,2696,7.5
46085,2020-04-01,1584,1440,144,9.1
46087,2020-04-01,3050,2856,194,6.4
46089,2020-04-01,1027,948,79,7.7
46091,2020-04-01,2494,2260,234,9.4
46093,2020-04-01,13975,12371,1604,11.5
46095,2020-04-01,698,643,55,7.9
46097,2020-04-01,1147,1069,78,6.8
46099,2020-04-01,114587,103614,10973,9.6
46101,2020-04-01,4010,3570,440,11
46102,2020-04-01,3575,3271,304,8.5
46103,2020-04-01,57205,50323,6882,12
46105,2020-04-01,1365,1308,57,4.2
46107,2020-04-01,987,940,47,4.8
46109,2020-04-01,5081,4303,778,15.3
46111,2020-04-01,1140,1064,76,6.7
46115,2020-04-01,3134,2930,204,6.5
46117,2020-04-01,1850,1708,142,7.7
46119,2020-04-01,763,726,37,4.8
46121,2020-04-01,3128,2892,236,7.5
46123,2020-04-01,2951,2812,139,4.7
46125,2020-04-01,4640,4328,312,6.7
46127,2020-04-01,8754,7816,938,10.7
46129,2020-04-01,2143,1943,200,9.3
46135,2020-04-01,12090,10790,1300,10.8
46137,2020-04-01,940,901,39,4.1
47001,2020-04-01,33443,28360,5083,15.2
47003,2020-04-01,21140,17032,4108,19.4
47005,2020-04-01,6501,5477,1024,15.8
47007,2020-04-01,4206,3461,745,17.7
47009,2020-04-01,61591,52613,8978,14.6
47011,2020-04-01,49931,43050,6881,13.8
47013,2020-04-01,14489,12034,2455,16.9
47015,2020-04-01,6323,5287,1036,16.4
47017,2020-04-01,11413,9792,1621,14.2
47019,2020-04-01,22571,19624,2947,13.1
47021,2020-04-01,19884,17471,2413,12.1
47023,2020-04-01,7773,6923,850,10.9
47025,2020-04-01,11525,9581,1944,16.9
47027,2020-04-01,2600,2230,370,14.2
47029,2020-04-01,15544,11462,4082,26.3
47031,2020-04-01,25790,20439,5351,20.7
47033,2020-04-01,6319,5645,674,10.7
47035,2020-04-01,21608,18697,2911,13.5
47037,2020-04-01,386060,320969,65091,16.9
47039,2020-04-01,4471,3801,670,15
47041,2020-04-01,7444,5692,1752,23.5
47043,2020-04-01,25132,21535,3597,14.3
47045,2020-04-01,15456,13126,2330,15.1
47047,2020-04-01,17597,15908,1689,9.6
47049,2020-04-01,7106,6375,731,10.3
47051,2020-04-01,20118,15463,4655,23.1
47053,2020-04-01,21052,18466,2586,12.3
47055,2020-04-01,14515,11447,3068,21.1
47057,2020-04-01,9129,7788,1341,14.7
47059,2020-04-01,28199,23076,5123,18.2
47061,2020-04-01,5562,4130,1432,25.7
47063,2020-04-01,27591,23326,4265,15.5
47065,2020-04-01,175910,148631,27279,15.5
47067,2020-04-01,2063,1797,266,12.9
47069,2020-04-01,8871,7957,914,10.3
47071,2020-04-01,9642,8480,1162,12.1
47073,2020-04-01,22968,19380,3588,15.6
47075,2020-04-01,7355,6414,941,12.8
47077,2020-04-01,11641,9654,1987,17.1
47079,2020-04-01,13311,11232,2079,15.6
47081,2020-04-01,10437,9088,1349,12.9
47083,2020-04-01,3109,2675,434,14
47085,2020-04-01,8440,7393,1047,12.4
47087,2020-04-01,4552,3750,802,17.6
47089,2020-04-01,24833,20481,4352,17.5
47091,2020-04-01,6978,6045,933,13.4
47093,2020-04-01,232708,202033,30675,13.2
47095,2020-04-01,1664,1432,232,13.9
47097,2020-04-01,9430,8063,1367,14.5
47099,2020-04-01,19092,15384,3708,19.4
47101,2020-04-01,5448,4369,1079,19.8
47103,2020-04-01,15415,12787,2628,17
47105,2020-04-01,23116,19554,3562,15.4
47107,2020-04-01,22868,18573,4295,18.8
47109,2020-04-01,8084,7000,1084,13.4
47111,2020-04-01,10600,9089,1511,14.3
47113,2020-04-01,46246,39631,6615,14.3
47115,2020-04-01,11859,10014,1845,15.6
47117,2020-04-01,15800,11743,4057,25.7
47119,2020-04-01,51357,39818,11539,22.5
47121,2020-04-01,5123,4121,1002,19.6
47123,2020-04-01,19878,15121,4757,23.9
47125,2020-04-01,81834,68627,13207,16.1
47127,2020-04-01,3556,3107,449,12.6
47129,2020-04-01,7112,6335,777,10.9
47131,2020-04-01,11677,10387,1290,11
47133,2020-04-01,9289,7941,1348,14.5
47135,2020-04-01,2876,2182,694,24.1
47137,2020-04-01,2100,1862,238,11.3
47139,2020-04-01,7069,6084,985,13.9
47141,2020-04-01,33521,28386,5135,15.3
47143,2020-04-01,12577,9172,3405,27.1
47145,2020-04-01,21705,19042,2663,12.3
47147,2020-04-01,35130,30438,4692,13.4
47149,2020-04-01,179865,149062,30803,17.1
47151,2020-04-01,8086,6600,1486,18.4
47153,2020-04-01,6038,4973,1065,17.6
47155,2020-04-01,55228,38409,16819,30.5
47157,2020-04-01,419068,361777,57291,13.7
47159,2020-04-01,8879,7563,1316,14.8
47161,2020-04-01,5088,4484,604,11.9
47163,2020-04-01,67420,57566,9854,14.6
47165,2020-04-01,97625,82847,14778,15.1
47167,2020-04-01,25747,22917,2830,11
47169,2020-04-01,5012,4392,620,12.4
47171,2020-04-01,6722,5805,917,13.6
47173,2020-04-01,7215,6271,944,13.1
47175,2020-04-01,2003,1577,426,21.3
47177,2020-04-01,17500,13234,4266,24.4
47179,2020-04-01,57799,49914,7885,13.6
47181,2020-04-01,6195,5408,787,12.7
47183,2020-04-01,14437,13024,1413,9.8
47185,2020-04-01,11671,9604,2067,17.7
47187,2020-04-01,117586,104963,12623,10.7
47189,2020-04-01,72805,62422,10383,14.3
48001,2020-04-01,22311,20683,1628,7.3
48003,2020-04-01,8940,7965,975,10.9
48005,2020-04-01,33987,30173,3814,11.2
48007,2020-04-01,8679,7468,1211,14
48009,2020-04-01,3700,3396,304,8.2
48011,2020-04-01,839,787,52,6.2
48013,2020-04-01,20360,17727,2633,12.9
48015,2020-04-01,12768,11569,1199,9.4
48017,2020-04-01,2361,2226,135,5.7
48019,2020-04-01,9029,8199,830,9.2
48021,2020-04-01,39666,35553,4113,10.4
48023,2020-04-01,1600,1539,61,3.8
48025,2020-04-01,9566,8393,1173,12.3
48027,2020-04-01,138464,122993,15471,11.2
48029,2020-04-01,894774,771638,123136,13.8
48031,2020-04-01,6014,5634,380,6.3
48033,2020-04-01,393,379,14,3.6
48035,2020-04-01,7856,7234,622,7.9
48037,2020-04-01,36751,31719,5032,13.7
48039,2020-04-01,169847,147518,22329,13.1
48041,2020-04-01,108946,99291,9655,8.9
48043,2020-04-01,3864,3374,490,12.7
48045,2020-04-01,521,486,35,6.7
48047,2020-04-01,2527,2209,318,12.6
48049,2020-04-01,14474,13133,1341,9.3
48051,2020-04-01,7592,6892,700,9.2
48053,2020-04-01,22112,20309,1803,8.2
48055,2020-04-01,17942,16076,1866,10.4
48057,2020-04-01,11153,10194,959,8.6
48059,2020-04-01,5529,5098,431,7.8
48061,2020-04-01,162372,136124,26248,16.2
48063,2020-04-01,4727,4281,446,9.4
48065,2020-04-01,2689,2523,166,6.2
48067,2020-04-01,11741,10420,1321,11.3
48069,2020-04-01,3201,3079,122,3.8
48071,2020-04-01,18979,16282,2697,14.2
48073,2020-04-01,20552,18155,2397,11.7
48075,2020-04-01,2936,2804,132,4.5
48077,2020-04-01,4531,4162,369,8.1
48079,2020-04-01,1102,1002,100,9.1
48081,2020-04-01,1323,1232,91,6.9
48083,2020-04-01,2714,2423,291,10.7
48085,2020-04-01,541531,477968,63563,11.7
48087,2020-04-01,1026,980,46,4.5
48089,2020-04-01,9029,8414,615,6.8
48091,2020-04-01,70137,62157,7980,11.4
48093,2020-04-01,5155,4818,337,6.5
48095,2020-04-01,1260,1188,72,5.7
48097,2020-04-01,19301,16687,2614,13.5
48099,2020-04-01,22815,20490,2325,10.2
48101,2020-04-01,543,514,29,5.3
48103,2020-04-01,1624,1346,278,17.1
48105,2020-04-01,1521,1350,171,11.2
48107,2020-04-01,2221,2066,155,7
48109,2020-04-01,1083,995,88,8.1
48111,2020-04-01,3553,3449,104,2.9
48113,2020-04-01,NA,NA,168108,13.1
48115,2020-04-01,4318,3865,453,10.5
48117,2020-04-01,8252,7916,336,4.1
48119,2020-04-01,2250,2065,185,8.2
48121,2020-04-01,481217,421610,59607,12.4
48123,2020-04-01,8820,8147,673,7.6
48125,2020-04-01,653,601,52,8
48127,2020-04-01,6389,5917,472,7.4
48129,2020-04-01,1326,1262,64,4.8
48131,2020-04-01,4768,4061,707,14.8
48133,2020-04-01,7153,6534,619,8.7
48135,2020-04-01,81228,70236,10992,13.5
48137,2020-04-01,1084,1049,35,3.2
48139,2020-04-01,87805,78594,9211,10.5
48141,2020-04-01,347937,298138,49799,14.3
48143,2020-04-01,18665,17079,1586,8.5
48145,2020-04-01,6088,5554,534,8.8
48147,2020-04-01,15653,14519,1134,7.2
48149,2020-04-01,11045,10340,705,6.4
48151,2020-04-01,1526,1461,65,4.3
48153,2020-04-01,2417,2239,178,7.4
48155,2020-04-01,550,512,38,6.9
48157,2020-04-01,377642,330431,47211,12.5
48159,2020-04-01,4530,4177,353,7.8
48161,2020-04-01,6040,5431,609,10.1
48163,2020-04-01,9125,8526,599,6.6
48165,2020-04-01,9201,8593,608,6.6
48167,2020-04-01,160753,136264,24489,15.2
48169,2020-04-01,1901,1751,150,7.9
48171,2020-04-01,11936,10715,1221,10.2
48173,2020-04-01,768,735,33,4.3
48175,2020-04-01,2961,2656,305,10.3
48177,2020-04-01,8945,8343,602,6.7
48179,2020-04-01,7509,6768,741,9.9
48181,2020-04-01,60245,54157,6088,10.1
48183,2020-04-01,54725,47745,6980,12.8
48185,2020-04-01,10608,9501,1107,10.4
48187,2020-04-01,75125,67132,7993,10.6
48189,2020-04-01,11287,10299,988,8.8
48191,2020-04-01,1056,987,69,6.5
48193,2020-04-01,3512,3305,207,5.9
48195,2020-04-01,2299,2230,69,3
48197,2020-04-01,1603,1526,77,4.8
48199,2020-04-01,24249,20658,3591,14.8
48201,2020-04-01,NA,NA,319747,14.5
48203,2020-04-01,28158,25131,3027,10.8
48205,2020-04-01,2502,2444,58,2.3
48207,2020-04-01,2506,2379,127,5.1
48209,2020-04-01,115020,100887,14133,12.3
48211,2020-04-01,1750,1659,91,5.2
48213,2020-04-01,34744,31438,3306,9.5
48215,2020-04-01,347439,286749,60690,17.5
48217,2020-04-01,15406,13952,1454,9.4
48219,2020-04-01,10492,9349,1143,10.9
48221,2020-04-01,25633,22918,2715,10.6
48223,2020-04-01,16516,15228,1288,7.8
48225,2020-04-01,9331,8754,577,6.2
48227,2020-04-01,12755,11436,1319,10.3
48229,2020-04-01,1739,1548,191,11
48231,2020-04-01,40718,36340,4378,10.8
48233,2020-04-01,8275,7478,797,9.6
48235,2020-04-01,692,643,49,7.1
48237,2020-04-01,3362,3058,304,9
48239,2020-04-01,7084,6549,535,7.6
48241,2020-04-01,12680,10647,2033,16
48243,2020-04-01,848,771,77,9.1
48245,2020-04-01,103355,84358,18997,18.4
48247,2020-04-01,1781,1587,194,10.9
48249,2020-04-01,16001,13348,2653,16.6
48251,2020-04-01,77813,69163,8650,11.1
48253,2020-04-01,5346,4860,486,9.1
48255,2020-04-01,6911,6438,473,6.8
48257,2020-04-01,63129,56277,6852,10.9
48259,2020-04-01,20428,18605,1823,8.9
48261,2020-04-01,180,170,10,5.6
48263,2020-04-01,443,423,20,4.5
48265,2020-04-01,20568,18285,2283,11.1
48267,2020-04-01,1678,1597,81,4.8
48269,2020-04-01,202,198,4,2
48271,2020-04-01,1263,1175,88,7
48273,2020-04-01,12764,11261,1503,11.8
48275,2020-04-01,1383,1290,93,6.7
48277,2020-04-01,21695,19427,2268,10.5
48279,2020-04-01,5033,4718,315,6.3
48281,2020-04-01,8494,7815,679,8
48283,2020-04-01,3503,3198,305,8.7
48285,2020-04-01,7878,7372,506,6.4
48287,2020-04-01,8851,8232,619,7
48289,2020-04-01,5710,5140,570,10
48291,2020-04-01,31927,27231,4696,14.7
48293,2020-04-01,8080,7401,679,8.4
48295,2020-04-01,1503,1429,74,4.9
48297,2020-04-01,5034,4587,447,8.9
48299,2020-04-01,7682,6963,719,9.4
48301,2020-04-01,250,243,7,2.8
48303,2020-04-01,146244,132039,14205,9.7
48305,2020-04-01,2526,2357,169,6.7
48307,2020-04-01,3049,2764,285,9.3
48309,2020-04-01,112911,101389,11522,10.2
48311,2020-04-01,720,703,17,2.4
48313,2020-04-01,4206,3849,357,8.5
48315,2020-04-01,4065,3583,482,11.9
48317,2020-04-01,2446,2277,169,6.9
48319,2020-04-01,1636,1526,110,6.7
48321,2020-04-01,15996,13725,2271,14.2
48323,2020-04-01,24014,19555,4459,18.6
48325,2020-04-01,19853,17870,1983,10
48327,2020-04-01,803,751,52,6.5
48329,2020-04-01,95567,85726,9841,10.3
48331,2020-04-01,9301,8362,939,10.1
48333,2020-04-01,1757,1679,78,4.4
48335,2020-04-01,2237,2045,192,8.6
48337,2020-04-01,8712,7777,935,10.7
48339,2020-04-01,272890,238603,34287,12.6
48341,2020-04-01,10060,9619,441,4.4
48343,2020-04-01,4779,4182,597,12.5
48345,2020-04-01,421,399,22,5.2
48347,2020-04-01,25752,23167,2585,10
48349,2020-04-01,21956,19845,2111,9.6
48351,2020-04-01,4852,4090,762,15.7
48353,2020-04-01,6683,6282,401,6
48355,2020-04-01,158380,134758,23622,14.9
48357,2020-04-01,3886,3602,284,7.3
48359,2020-04-01,820,772,48,5.9
48361,2020-04-01,35086,29212,5874,16.7
48363,2020-04-01,12731,11455,1276,10
48365,2020-04-01,9155,8218,937,10.2
48367,2020-04-01,63476,57176,6300,9.9
48369,2020-04-01,4613,4504,109,2.4
48371,2020-04-01,6062,5498,564,9.3
48373,2020-04-01,17222,15231,1991,11.6
48375,2020-04-01,50152,45546,4606,9.2
48377,2020-04-01,3197,2555,642,20.1
48379,2020-04-01,5627,5236,391,6.9
48381,2020-04-01,67251,61723,5528,8.2
48383,2020-04-01,1838,1634,204,11.1
48385,2020-04-01,975,898,77,7.9
48387,2020-04-01,4799,4414,385,8
48389,2020-04-01,8608,7995,613,7.1
48391,2020-04-01,2948,2634,314,10.7
48393,2020-04-01,390,370,20,5.1
48395,2020-04-01,6798,6203,595,8.8
48397,2020-04-01,50337,44672,5665,11.3
48399,2020-04-01,4308,4004,304,7.1
48401,2020-04-01,20928,18859,2069,9.9
48403,2020-04-01,3786,3225,561,14.8
48405,2020-04-01,2929,2592,337,11.5
48407,2020-04-01,10956,9799,1157,10.6
48409,2020-04-01,28161,23754,4407,15.6
48411,2020-04-01,1998,1862,136,6.8
48413,2020-04-01,1195,1108,87,7.3
48415,2020-04-01,6037,5424,613,10.2
48417,2020-04-01,1734,1624,110,6.3
48419,2020-04-01,10651,9761,890,8.4
48421,2020-04-01,1264,1232,32,2.5
48423,2020-04-01,103014,90990,12024,11.7
48425,2020-04-01,4003,3605,398,9.9
48427,2020-04-01,26375,20645,5730,21.7
48429,2020-04-01,3804,3584,220,5.8
48431,2020-04-01,534,495,39,7.3
48433,2020-04-01,530,504,26,4.9
48435,2020-04-01,1202,1057,145,12.1
48437,2020-04-01,2420,2255,165,6.8
48439,2020-04-01,NA,894262,134750,13.1
48441,2020-04-01,62078,56631,5447,8.8
48443,2020-04-01,358,339,19,5.3
48445,2020-04-01,4689,4274,415,8.9
48447,2020-04-01,591,569,22,3.7
48449,2020-04-01,12574,11330,1244,9.9
48451,2020-04-01,51077,46002,5075,9.9
48453,2020-04-01,700697,615808,84889,12.1
48455,2020-04-01,5070,4558,512,10.1
48457,2020-04-01,7115,6162,953,13.4
48459,2020-04-01,16647,14808,1839,11
48461,2020-04-01,1791,1677,114,6.4
48463,2020-04-01,10723,9707,1016,9.5
48465,2020-04-01,21103,18346,2757,13.1
48467,2020-04-01,24407,22014,2393,9.8
48469,2020-04-01,40028,34419,5609,14
48471,2020-04-01,23347,20872,2475,10.6
48473,2020-04-01,22531,19954,2577,11.4
48475,2020-04-01,6258,5604,654,10.5
48477,2020-04-01,14353,13303,1050,7.3
48479,2020-04-01,109895,95523,14372,13.1
48481,2020-04-01,20571,18686,1885,9.2
48483,2020-04-01,2120,1983,137,6.5
48485,2020-04-01,52973,47136,5837,11
48487,2020-04-01,4698,4375,323,6.9
48489,2020-04-01,6494,5431,1063,16.4
48491,2020-04-01,300099,266369,33730,11.2
48493,2020-04-01,22380,20459,1921,8.6
48495,2020-04-01,4159,3747,412,9.9
48497,2020-04-01,30104,26804,3300,11
48499,2020-04-01,16758,15086,1672,10
48501,2020-04-01,3601,3012,589,16.4
48503,2020-04-01,7371,6804,567,7.7
48505,2020-04-01,4484,3901,583,13
48507,2020-04-01,3242,2726,516,15.9
49001,2020-04-01,2872,2683,189,6.6
49003,2020-04-01,26483,23759,2724,10.3
49005,2020-04-01,64868,61129,3739,5.8
49007,2020-04-01,8608,7813,795,9.2
49009,2020-04-01,394,360,34,8.6
49011,2020-04-01,172748,157329,15419,8.9
49013,2020-04-01,8010,7029,981,12.2
49015,2020-04-01,4355,3999,356,8.2
49017,2020-04-01,2587,1907,680,26.3
49019,2020-04-01,6087,4267,1820,29.9
49021,2020-04-01,24527,22350,2177,8.9
49023,2020-04-01,5633,5318,315,5.6
49025,2020-04-01,3741,3202,539,14.4
49027,2020-04-01,6048,5721,327,5.4
49029,2020-04-01,5451,5024,427,7.8
49031,2020-04-01,478,427,51,10.7
49033,2020-04-01,954,882,72,7.5
49035,2020-04-01,639247,568966,70281,11
49037,2020-04-01,5576,4610,966,17.3
49039,2020-04-01,12755,12035,720,5.6
49041,2020-04-01,9800,9034,766,7.8
49043,2020-04-01,22845,17964,4881,21.4
49045,2020-04-01,34729,31215,3514,10.1
49047,2020-04-01,13740,11534,2206,16.1
49049,2020-04-01,304792,281239,23553,7.7
49051,2020-04-01,15844,13041,2803,17.7
49053,2020-04-01,77469,68115,9354,12.1
49055,2020-04-01,1416,1191,225,15.9
49057,2020-04-01,129317,115522,13795,10.7
50001,2020-04-01,20966,17940,3026,14.4
50003,2020-04-01,18153,15011,3142,17.3
50005,2020-04-01,14926,12637,2289,15.3
50007,2020-04-01,97308,85231,12077,12.4
50009,2020-04-01,2802,2292,510,18.2
50011,2020-04-01,28157,24289,3868,13.7
50013,2020-04-01,4255,3620,635,14.9
50015,2020-04-01,14691,11293,3398,23.1
50017,2020-04-01,16283,14233,2050,12.6
50019,2020-04-01,13695,10742,2953,21.6
50021,2020-04-01,31506,25274,6232,19.8
50023,2020-04-01,34351,29813,4538,13.2
50025,2020-04-01,22166,18689,3477,15.7
50027,2020-04-01,29107,25052,4055,13.9
51001,2020-04-01,16189,14503,1686,10.4
51003,2020-04-01,55474,50178,5296,9.5
51005,2020-04-01,7096,6225,871,12.3
51007,2020-04-01,6195,5577,618,10
51009,2020-04-01,14637,13252,1385,9.5
51011,2020-04-01,6977,6339,638,9.1
51013,2020-04-01,148601,137958,10643,7.2
51015,2020-04-01,37177,33947,3230,8.7
51017,2020-04-01,2399,1761,638,26.6
51019,2020-04-01,37771,34145,3626,9.6
51021,2020-04-01,2938,2584,354,12
51023,2020-04-01,17154,15695,1459,8.5
51025,2020-04-01,5954,5336,618,10.4
51027,2020-04-01,6673,5702,971,14.6
51029,2020-04-01,6229,5558,671,10.8
51031,2020-04-01,25495,22920,2575,10.1
51033,2020-04-01,15109,13381,1728,11.4
51035,2020-04-01,13700,11160,2540,18.5
51036,2020-04-01,3604,3229,375,10.4
51037,2020-04-01,5042,4600,442,8.8
51041,2020-04-01,187605,167527,20078,10.7
51043,2020-04-01,7435,6818,617,8.3
51045,2020-04-01,2303,2076,227,9.9
51047,2020-04-01,24405,22176,2229,9.1
51049,2020-04-01,4536,4102,434,9.6
51051,2020-04-01,4938,4318,620,12.6
51053,2020-04-01,13315,11992,1323,9.9
51057,2020-04-01,5452,4822,630,11.6
51059,2020-04-01,629414,565165,64249,10.2
51061,2020-04-01,36777,33475,3302,9
51063,2020-04-01,8164,7284,880,10.8
51065,2020-04-01,13666,12361,1305,9.5
51067,2020-04-01,25926,23509,2417,9.3
51069,2020-04-01,48884,44166,4718,9.7
51071,2020-04-01,7980,6937,1043,13.1
51073,2020-04-01,19175,17173,2002,10.4
51075,2020-04-01,11091,10100,991,8.9
51077,2020-04-01,8189,7214,975,11.9
51079,2020-04-01,10236,9177,1059,10.3
51081,2020-04-01,4245,3883,362,8.5
51083,2020-04-01,15648,13809,1839,11.8
51085,2020-04-01,58050,52736,5314,9.2
51087,2020-04-01,181477,161383,20094,11.1
51089,2020-04-01,24627,21238,3389,13.8
51091,2020-04-01,1199,1132,67,5.6
51093,2020-04-01,18661,17082,1579,8.5
51095,2020-04-01,37321,32101,5220,14
51097,2020-04-01,3840,3535,305,7.9
51099,2020-04-01,13803,12736,1067,7.7
51101,2020-04-01,9058,8172,886,9.8
51103,2020-04-01,5269,4621,648,12.3
51105,2020-04-01,8729,7758,971,11.1
51107,2020-04-01,224143,202031,22112,9.9
51109,2020-04-01,19749,17937,1812,9.2
51111,2020-04-01,5302,4913,389,7.3
51113,2020-04-01,7111,6591,520,7.3
51115,2020-04-01,3990,3632,358,9
51117,2020-04-01,12799,11377,1422,11.1
51119,2020-04-01,5048,4592,456,9
51121,2020-04-01,48989,44432,4557,9.3
51125,2020-04-01,7243,6513,730,10.1
51127,2020-04-01,12461,11398,1063,8.5
51131,2020-04-01,5194,4555,639,12.3
51133,2020-04-01,5469,4940,529,9.7
51135,2020-04-01,7229,6681,548,7.6
51137,2020-04-01,17053,15281,1772,10.4
51139,2020-04-01,12297,10489,1808,14.7
51141,2020-04-01,7564,6387,1177,15.6
51143,2020-04-01,31013,26933,4080,13.2
51145,2020-04-01,14030,12695,1335,9.5
51147,2020-04-01,10014,8990,1024,10.2
51149,2020-04-01,14834,13334,1500,10.1
51153,2020-04-01,248178,219863,28315,11.4
51155,2020-04-01,17174,14194,2980,17.4
51157,2020-04-01,3639,3331,308,8.5
51159,2020-04-01,4009,3708,301,7.5
51161,2020-04-01,49189,44344,4845,9.8
51163,2020-04-01,10464,9434,1030,9.8
51165,2020-04-01,42179,38011,4168,9.9
51167,2020-04-01,11626,10361,1265,10.9
51169,2020-04-01,9046,8143,903,10
51171,2020-04-01,22237,19977,2260,10.2
51173,2020-04-01,13764,12262,1502,10.9
51175,2020-04-01,8886,8260,626,7
51177,2020-04-01,67993,60375,7618,11.2
51179,2020-04-01,72596,65336,7260,10
51181,2020-04-01,3598,3249,349,9.7
51183,2020-04-01,3688,3294,394,10.7
51185,2020-04-01,15957,13921,2036,12.8
51187,2020-04-01,20533,18196,2337,11.4
51191,2020-04-01,26376,23485,2891,11
51193,2020-04-01,9373,8520,853,9.1
51195,2020-04-01,13653,11985,1668,12.2
51197,2020-04-01,14756,12067,2689,18.2
51199,2020-04-01,32387,28898,3489,10.8
51510,2020-04-01,99977,89997,9980,10
51520,2020-04-01,7614,6462,1152,15.1
51530,2020-04-01,3187,2863,324,10.2
51540,2020-04-01,25630,22662,2968,11.6
51550,2020-04-01,120796,108285,12511,10.4
51570,2020-04-01,8558,7535,1023,12
51580,2020-04-01,2585,2125,460,17.8
51590,2020-04-01,19941,16491,3450,17.3
51595,2020-04-01,2342,2036,306,13.1
51600,2020-04-01,13106,11745,1361,10.4
51610,2020-04-01,8102,7608,494,6.1
51620,2020-04-01,3485,3156,329,9.4
51630,2020-04-01,14231,12458,1773,12.5
51640,2020-04-01,2989,2414,575,19.2
51650,2020-04-01,64591,55858,8733,13.5
51660,2020-04-01,24782,21871,2911,11.7
51670,2020-04-01,9893,8393,1500,15.2
51678,2020-04-01,2040,1814,226,11.1
51680,2020-04-01,36343,31951,4392,12.1
51683,2020-04-01,21848,19376,2472,11.3
51685,2020-04-01,9567,8428,1139,11.9
51690,2020-04-01,5880,4860,1020,17.3
51700,2020-04-01,90351,77467,12884,14.3
51710,2020-04-01,111948,96513,15435,13.8
51720,2020-04-01,1715,1501,214,12.5
51730,2020-04-01,13384,11086,2298,17.2
51735,2020-04-01,6151,5651,500,8.1
51740,2020-04-01,44015,38211,5804,13.2
51750,2020-04-01,8605,7611,994,11.6
51760,2020-04-01,122440,104590,17850,14.6
51770,2020-04-01,50064,43536,6528,13
51775,2020-04-01,12924,11466,1458,11.3
51790,2020-04-01,12523,11042,1481,11.8
51800,2020-04-01,43682,39379,4303,9.9
51810,2020-04-01,233066,203982,29084,12.5
51820,2020-04-01,10891,9626,1265,11.6
51830,2020-04-01,6879,5810,1069,15.5
51840,2020-04-01,15112,13366,1746,11.6
53001,2020-04-01,9553,8666,887,9.3
53003,2020-04-01,10242,9363,879,8.6
53005,2020-04-01,104775,89825,14950,14.3
53007,2020-04-01,44379,37050,7329,16.5
53009,2020-04-01,30305,24127,6178,20.4
53011,2020-04-01,245417,209001,36416,14.8
53013,2020-04-01,1732,1522,210,12.1
53015,2020-04-01,50157,41929,8228,16.4
53017,2020-04-01,21414,18133,3281,15.3
53019,2020-04-01,2413,2033,380,15.7
53021,2020-04-01,43850,37928,5922,13.5
53023,2020-04-01,838,720,118,14.1
53025,2020-04-01,47992,41696,6296,13.1
53027,2020-04-01,30519,24106,6413,21
53029,2020-04-01,37581,31463,6118,16.3
53031,2020-04-01,13236,10703,2533,19.1
53033,2020-04-01,NA,NA,188620,15.1
53035,2020-04-01,133507,113559,19948,14.9
53037,2020-04-01,22972,18929,4043,17.6
53039,2020-04-01,9868,8613,1255,12.7
53041,2020-04-01,36529,30089,6440,17.6
53043,2020-04-01,4694,4146,548,11.7
53045,2020-04-01,26507,21860,4647,17.5
53047,2020-04-01,19587,16657,2930,15
53049,2020-04-01,8469,6815,1654,19.5
53051,2020-04-01,5022,4236,786,15.7
53053,2020-04-01,475972,387505,88467,18.6
53055,2020-04-01,8130,6615,1515,18.6
53057,2020-04-01,65769,52898,12871,19.6
53059,2020-04-01,5549,4699,850,15.3
53061,2020-04-01,447496,361326,86170,19.3
53063,2020-04-01,269740,225381,44359,16.4
53065,2020-04-01,19215,16100,3115,16.2
53067,2020-04-01,150456,125748,24708,16.4
53069,2020-04-01,1378,1181,197,14.3
53071,2020-04-01,30601,26772,3829,12.5
53073,2020-04-01,119375,97472,21903,18.3
53075,2020-04-01,22791,20771,2020,8.9
53077,2020-04-01,133635,113897,19738,14.8
54001,2020-04-01,7090,6187,903,12.7
54003,2020-04-01,54878,48380,6498,11.8
54005,2020-04-01,7382,6010,1372,18.6
54007,2020-04-01,5108,4319,789,15.4
54009,2020-04-01,9462,7934,1528,16.1
54011,2020-04-01,40931,34309,6622,16.2
54013,2020-04-01,2444,1942,502,20.5
54015,2020-04-01,3045,2478,567,18.6
54017,2020-04-01,3674,3316,358,9.7
54019,2020-04-01,15825,12851,2974,18.8
54021,2020-04-01,2226,1899,327,14.7
54023,2020-04-01,5736,5158,578,10.1
54025,2020-04-01,14808,12029,2779,18.8
54027,2020-04-01,10210,9267,943,9.2
54029,2020-04-01,12997,10401,2596,20
54031,2020-04-01,5805,5146,659,11.4
54033,2020-04-01,32745,27789,4956,15.1
54035,2020-04-01,12075,10242,1833,15.2
54037,2020-04-01,27983,24765,3218,11.5
54039,2020-04-01,81854,67822,14032,17.1
54041,2020-04-01,6095,4991,1104,18.1
54043,2020-04-01,7065,5833,1232,17.4
54045,2020-04-01,11212,8775,2437,21.7
54047,2020-04-01,4371,3781,590,13.5
54049,2020-04-01,24151,20011,4140,17.1
54051,2020-04-01,12947,10750,2197,17
54053,2020-04-01,10243,8616,1627,15.9
54055,2020-04-01,20657,17301,3356,16.2
54057,2020-04-01,11565,10019,1546,13.4
54059,2020-04-01,6848,5225,1623,23.7
54061,2020-04-01,51107,44820,6287,12.3
54063,2020-04-01,5814,5015,799,13.7
54065,2020-04-01,7931,6909,1022,12.9
54067,2020-04-01,9205,7437,1768,19.2
54069,2020-04-01,19643,16411,3232,16.5
54071,2020-04-01,3512,3229,283,8.1
54073,2020-04-01,2593,2159,434,16.7
54075,2020-04-01,3472,2803,669,19.3
54077,2020-04-01,14721,12616,2105,14.3
54079,2020-04-01,26591,22283,4308,16.2
54081,2020-04-01,29811,24399,5412,18.2
54083,2020-04-01,12293,10191,2102,17.1
54085,2020-04-01,4280,3737,543,12.7
54087,2020-04-01,4985,4079,906,18.2
54089,2020-04-01,4223,3651,572,13.5
54091,2020-04-01,7446,6430,1016,13.6
54093,2020-04-01,3076,2534,542,17.6
54095,2020-04-01,2987,2568,419,14
54097,2020-04-01,9623,8181,1442,15
54099,2020-04-01,15223,12896,2327,15.3
54101,2020-04-01,3136,2698,438,14
54103,2020-04-01,6140,5233,907,14.8
54105,2020-04-01,2135,1787,348,16.3
54107,2020-04-01,35190,29143,6047,17.2
54109,2020-04-01,6647,5573,1074,16.2
55001,2020-04-01,8080,6231,1849,22.9
55003,2020-04-01,7726,6097,1629,21.1
55005,2020-04-01,23843,20064,3779,15.8
55007,2020-04-01,7738,5829,1909,24.7
55009,2020-04-01,137866,118133,19733,14.3
55011,2020-04-01,6722,5417,1305,19.4
55013,2020-04-01,7357,5627,1730,23.5
55015,2020-04-01,26322,23125,3197,12.1
55017,2020-04-01,32254,27729,4525,14
55019,2020-04-01,17572,15847,1725,9.8
55021,2020-04-01,31400,26723,4677,14.9
55023,2020-04-01,7635,6138,1497,19.6
55025,2020-04-01,308729,274047,34682,11.2
55027,2020-04-01,46600,41072,5528,11.9
55029,2020-04-01,14205,11320,2885,20.3
55031,2020-04-01,24425,18742,5683,23.3
55033,2020-04-01,23246,20529,2717,11.7
55035,2020-04-01,56411,49011,7400,13.1
55037,2020-04-01,2178,1754,424,19.5
55039,2020-04-01,54596,45119,9477,17.4
55041,2020-04-01,3622,2952,670,18.5
55043,2020-04-01,28059,24890,3169,11.3
55045,2020-04-01,20272,17890,2382,11.8
55047,2020-04-01,9659,7718,1941,20.1
55049,2020-04-01,14147,11665,2482,17.5
55051,2020-04-01,2686,1952,734,27.3
55053,2020-04-01,10726,8634,2092,19.5
55055,2020-04-01,44181,38400,5781,13.1
55057,2020-04-01,13428,11170,2258,16.8
55059,2020-04-01,88686,74052,14634,16.5
55061,2020-04-01,10378,9307,1071,10.3
55063,2020-04-01,63290,54681,8609,13.6
55065,2020-04-01,9881,8926,955,9.7
55067,2020-04-01,9401,8113,1288,13.7
55069,2020-04-01,14534,12453,2081,14.3
55071,2020-04-01,40690,34051,6639,16.3
55073,2020-04-01,71975,63063,8912,12.4
55075,2020-04-01,19348,15535,3813,19.7
55077,2020-04-01,7628,6389,1239,16.2
55078,2020-04-01,1716,1253,463,27
55079,2020-04-01,457433,381930,75503,16.5
55081,2020-04-01,23451,20455,2996,12.8
55083,2020-04-01,20327,17111,3216,15.8
55085,2020-04-01,17841,14320,3521,19.7
55087,2020-04-01,100942,86266,14676,14.5
55089,2020-04-01,46926,40771,6155,13.1
55091,2020-04-01,4154,3538,616,14.8
55093,2020-04-01,25343,20899,4444,17.5
55095,2020-04-01,24746,20393,4353,17.6
55097,2020-04-01,36826,32542,4284,11.6
55099,2020-04-01,6289,5184,1105,17.6
55101,2020-04-01,96819,81117,15702,16.2
55103,2020-04-01,9085,7931,1154,12.7
55105,2020-04-01,85363,70523,14840,17.4
55107,2020-04-01,6777,5770,1007,14.9
55109,2020-04-01,50787,41668,9119,18
55111,2020-04-01,34950,27215,7735,22.1
55113,2020-04-01,7928,6260,1668,21
55115,2020-04-01,20544,17373,3171,15.4
55117,2020-04-01,62100,52719,9381,15.1
55119,2020-04-01,10953,9833,1120,10.2
55121,2020-04-01,15838,12667,3171,20
55123,2020-04-01,14848,13097,1751,11.8
55125,2020-04-01,9971,7815,2156,21.6
55127,2020-04-01,55270,46823,8447,15.3
55129,2020-04-01,7807,6295,1512,19.4
55131,2020-04-01,74787,64327,10460,14
55133,2020-04-01,214986,186840,28146,13.1
55135,2020-04-01,24904,21498,3406,13.7
55137,2020-04-01,11149,9405,1744,15.6
55139,2020-04-01,90284,77207,13077,14.5
55141,2020-04-01,34887,29419,5468,15.7
56001,2020-04-01,19970,19285,685,3.4
56003,2020-04-01,5191,4986,205,3.9
56005,2020-04-01,23494,22067,1427,6.1
56007,2020-04-01,7657,7358,299,3.9
56009,2020-04-01,8214,7880,334,4.1
56011,2020-04-01,3722,3599,123,3.3
56013,2020-04-01,18917,17883,1034,5.5
56015,2020-04-01,6486,6257,229,3.5
56017,2020-04-01,2170,2075,95,4.4
56019,2020-04-01,3980,3745,235,5.9
56021,2020-04-01,49732,47035,2697,5.4
56023,2020-04-01,9005,8540,465,5.2
56025,2020-04-01,39604,36594,3010,7.6
56027,2020-04-01,1205,1174,31,2.6
56029,2020-04-01,14142,13312,830,5.9
56031,2020-04-01,4511,4317,194,4.3
56033,2020-04-01,15681,14877,804,5.1
56035,2020-04-01,3769,3496,273,7.2
56037,2020-04-01,20681,19368,1313,6.3
56039,2020-04-01,13423,11742,1681,12.5
56041,2020-04-01,8986,8489,497,5.5
56043,2020-04-01,3841,3675,166,4.3
56045,2020-04-01,3764,3639,125,3.3
72001,2020-04-01,NA,NA,NA,NA
72003,2020-04-01,NA,NA,NA,NA
72005,2020-04-01,NA,NA,NA,NA
72007,2020-04-01,NA,NA,NA,NA
72009,2020-04-01,NA,NA,NA,NA
72011,2020-04-01,NA,NA,NA,NA
72013,2020-04-01,NA,NA,NA,NA
72015,2020-04-01,NA,NA,NA,NA
72017,2020-04-01,NA,NA,NA,NA
72019,2020-04-01,NA,NA,NA,NA
72021,2020-04-01,NA,NA,NA,NA
72023,2020-04-01,NA,NA,NA,NA
72025,2020-04-01,NA,NA,NA,NA
72027,2020-04-01,NA,NA,NA,NA
72029,2020-04-01,NA,NA,NA,NA
72031,2020-04-01,NA,NA,NA,NA
72033,2020-04-01,NA,NA,NA,NA
72035,2020-04-01,NA,NA,NA,NA
72037,2020-04-01,NA,NA,NA,NA
72039,2020-04-01,NA,NA,NA,NA
72041,2020-04-01,NA,NA,NA,NA
72043,2020-04-01,NA,NA,NA,NA
72045,2020-04-01,NA,NA,NA,NA
72047,2020-04-01,NA,NA,NA,NA
72049,2020-04-01,NA,NA,NA,NA
72051,2020-04-01,NA,NA,NA,NA
72053,2020-04-01,NA,NA,NA,NA
72054,2020-04-01,NA,NA,NA,NA
72055,2020-04-01,NA,NA,NA,NA
72057,2020-04-01,NA,NA,NA,NA
72059,2020-04-01,NA,NA,NA,NA
72061,2020-04-01,NA,NA,NA,NA
72063,2020-04-01,NA,NA,NA,NA
72065,2020-04-01,NA,NA,NA,NA
72067,2020-04-01,NA,NA,NA,NA
72069,2020-04-01,NA,NA,NA,NA
72071,2020-04-01,NA,NA,NA,NA
72073,2020-04-01,NA,NA,NA,NA
72075,2020-04-01,NA,NA,NA,NA
72077,2020-04-01,NA,NA,NA,NA
72079,2020-04-01,NA,NA,NA,NA
72081,2020-04-01,NA,NA,NA,NA
72083,2020-04-01,NA,NA,NA,NA
72085,2020-04-01,NA,NA,NA,NA
72087,2020-04-01,NA,NA,NA,NA
72089,2020-04-01,NA,NA,NA,NA
72091,2020-04-01,NA,NA,NA,NA
72093,2020-04-01,NA,NA,NA,NA
72095,2020-04-01,NA,NA,NA,NA
72097,2020-04-01,NA,NA,NA,NA
72099,2020-04-01,NA,NA,NA,NA
72101,2020-04-01,NA,NA,NA,NA
72103,2020-04-01,NA,NA,NA,NA
72105,2020-04-01,NA,NA,NA,NA
72107,2020-04-01,NA,NA,NA,NA
72109,2020-04-01,NA,NA,NA,NA
72111,2020-04-01,NA,NA,NA,NA
72113,2020-04-01,NA,NA,NA,NA
72115,2020-04-01,NA,NA,NA,NA
72117,2020-04-01,NA,NA,NA,NA
72119,2020-04-01,NA,NA,NA,NA
72121,2020-04-01,NA,NA,NA,NA
72123,2020-04-01,NA,NA,NA,NA
72125,2020-04-01,NA,NA,NA,NA
72127,2020-04-01,NA,NA,NA,NA
72129,2020-04-01,NA,NA,NA,NA
72131,2020-04-01,NA,NA,NA,NA
72133,2020-04-01,NA,NA,NA,NA
72135,2020-04-01,NA,NA,NA,NA
72137,2020-04-01,NA,NA,NA,NA
72139,2020-04-01,NA,NA,NA,NA
72141,2020-04-01,NA,NA,NA,NA
72143,2020-04-01,NA,NA,NA,NA
72145,2020-04-01,NA,NA,NA,NA
72147,2020-04-01,NA,NA,NA,NA
72149,2020-04-01,NA,NA,NA,NA
72151,2020-04-01,NA,NA,NA,NA
72153,2020-04-01,NA,NA,NA,NA
01001,2020-05-01,25699,24064,1635,6.4
01003,2020-05-01,96634,89246,7388,7.6
01005,2020-05-01,8618,7996,622,7.2
01007,2020-05-01,8643,7872,771,8.9
01009,2020-05-01,24314,23031,1283,5.3
01011,2020-05-01,4615,4358,257,5.6
01013,2020-05-01,8813,7860,953,10.8
01015,2020-05-01,45800,41527,4273,9.3
01017,2020-05-01,15670,14054,1616,10.3
01019,2020-05-01,11370,10631,739,6.5
01021,2020-05-01,19511,18095,1416,7.3
01023,2020-05-01,4659,4307,352,7.6
01025,2020-05-01,7849,7098,751,9.6
01027,2020-05-01,5989,5720,269,4.5
01029,2020-05-01,5720,5379,341,6
01031,2020-05-01,21397,20226,1171,5.5
01033,2020-05-01,23282,21166,2116,9.1
01035,2020-05-01,4579,4217,362,7.9
01037,2020-05-01,4339,4021,318,7.3
01039,2020-05-01,14986,14085,901,6
01041,2020-05-01,5954,5518,436,7.3
01043,2020-05-01,37446,35061,2385,6.4
01045,2020-05-01,20651,19444,1207,5.8
01047,2020-05-01,14608,12743,1865,12.8
01049,2020-05-01,30454,28620,1834,6
01051,2020-05-01,36429,34170,2259,6.2
01053,2020-05-01,14448,13472,976,6.8
01055,2020-05-01,39509,35363,4146,10.5
01057,2020-05-01,6626,6161,465,7
01059,2020-05-01,14215,13439,776,5.5
01061,2020-05-01,10631,10105,526,4.9
01063,2020-05-01,3049,2635,414,13.6
01065,2020-05-01,5842,5117,725,12.4
01067,2020-05-01,6765,6362,403,6
01069,2020-05-01,46245,43214,3031,6.6
01071,2020-05-01,22374,20772,1602,7.2
01073,2020-05-01,314574,289854,24720,7.9
01075,2020-05-01,5730,5385,345,6
01077,2020-05-01,41391,38134,3257,7.9
01079,2020-05-01,14284,13373,911,6.4
01081,2020-05-01,73350,67946,5404,7.4
01083,2020-05-01,44104,41573,2531,5.7
01085,2020-05-01,3641,3087,554,15.2
01087,2020-05-01,7968,6979,989,12.4
01089,2020-05-01,185271,174146,11125,6
01091,2020-05-01,7742,7209,533,6.9
01093,2020-05-01,13083,12303,780,6
01095,2020-05-01,43745,41373,2372,5.4
01097,2020-05-01,190613,171622,18991,10
01099,2020-05-01,7457,6792,665,8.9
01101,2020-05-01,107038,96811,10227,9.6
01103,2020-05-01,58692,55269,3423,5.8
01105,2020-05-01,3456,3026,430,12.4
01107,2020-05-01,7371,6725,646,8.8
01109,2020-05-01,15657,14805,852,5.4
01111,2020-05-01,9402,8755,647,6.9
01113,2020-05-01,23555,21929,1626,6.9
01115,2020-05-01,39927,37286,2641,6.6
01117,2020-05-01,113117,107265,5852,5.2
01119,2020-05-01,4640,4229,411,8.9
01121,2020-05-01,35981,32573,3408,9.5
01123,2020-05-01,17452,15900,1552,8.9
01125,2020-05-01,99683,90357,9326,9.4
01127,2020-05-01,24727,22904,1823,7.4
01129,2020-05-01,6747,6073,674,10
01131,2020-05-01,2877,2416,461,16
01133,2020-05-01,10136,9589,547,5.4
02013,2020-05-01,2228,1993,235,10.5
02016,2020-05-01,3270,2693,577,17.6
02020,2020-05-01,148097,130790,17307,11.7
02050,2020-05-01,6776,5826,950,14
02060,2020-05-01,423,378,45,10.6
02068,2020-05-01,669,506,163,24.4
02070,2020-05-01,1700,1510,190,11.2
02090,2020-05-01,44654,40322,4332,9.7
02100,2020-05-01,1091,834,257,23.6
02105,2020-05-01,1090,894,196,18
02110,2020-05-01,16209,14481,1728,10.7
02122,2020-05-01,26624,23093,3531,13.3
02130,2020-05-01,6634,5642,992,15
02150,2020-05-01,6109,5586,523,8.6
02158,2020-05-01,2189,1642,547,25
02164,2020-05-01,713,624,89,12.5
02170,2020-05-01,47534,41708,5826,12.3
02180,2020-05-01,3839,3271,568,14.8
02185,2020-05-01,3081,2845,236,7.7
02188,2020-05-01,2942,2505,437,14.9
02195,2020-05-01,1453,1259,194,13.4
02198,2020-05-01,2877,2516,361,12.5
02220,2020-05-01,4026,3524,502,12.5
02230,2020-05-01,629,447,182,28.9
02240,2020-05-01,2975,2696,279,9.4
02261,2020-05-01,4470,3916,554,12.4
02275,2020-05-01,1029,900,129,12.5
02282,2020-05-01,279,250,29,10.4
02290,2020-05-01,2365,1962,403,17
04001,2020-05-01,20229,17515,2714,13.4
04003,2020-05-01,51923,47386,4537,8.7
04005,2020-05-01,74219,63941,10278,13.8
04007,2020-05-01,21385,19415,1970,9.2
04009,2020-05-01,15970,14815,1155,7.2
04011,2020-05-01,4580,4344,236,5.2
04012,2020-05-01,8492,7835,657,7.7
04013,2020-05-01,NA,NA,239777,10.1
04015,2020-05-01,92762,77645,15117,16.3
04017,2020-05-01,40732,35963,4769,11.7
04019,2020-05-01,505090,452686,52404,10.4
04021,2020-05-01,190359,171674,18685,9.8
04023,2020-05-01,19855,17333,2522,12.7
04025,2020-05-01,107942,96397,11545,10.7
04027,2020-05-01,97109,76216,20893,21.5
05001,2020-05-01,9360,8926,434,4.6
05003,2020-05-01,7332,6483,849,11.6
05005,2020-05-01,16783,15306,1477,8.8
05007,2020-05-01,138384,129515,8869,6.4
05009,2020-05-01,15952,14705,1247,7.8
05011,2020-05-01,4398,4065,333,7.6
05013,2020-05-01,2411,2268,143,5.9
05015,2020-05-01,12602,11495,1107,8.8
05017,2020-05-01,3283,2903,380,11.6
05019,2020-05-01,9203,8415,788,8.6
05021,2020-05-01,5520,5082,438,7.9
05023,2020-05-01,9443,8428,1015,10.7
05025,2020-05-01,3173,2924,249,7.8
05027,2020-05-01,9270,8501,769,8.3
05029,2020-05-01,8468,7765,703,8.3
05031,2020-05-01,55901,51428,4473,8
05033,2020-05-01,26534,24318,2216,8.4
05035,2020-05-01,21343,18823,2520,11.8
05037,2020-05-01,7327,6743,584,8
05039,2020-05-01,2870,2679,191,6.7
05041,2020-05-01,5330,4853,477,8.9
05043,2020-05-01,7778,7087,691,8.9
05045,2020-05-01,61975,56656,5319,8.6
05047,2020-05-01,7647,6905,742,9.7
05049,2020-05-01,4957,4635,322,6.5
05051,2020-05-01,41547,36250,5297,12.7
05053,2020-05-01,8126,7553,573,7.1
05055,2020-05-01,19737,17952,1785,9
05057,2020-05-01,9756,9122,634,6.5
05059,2020-05-01,14082,12923,1159,8.2
05061,2020-05-01,5450,5112,338,6.2
05063,2020-05-01,17113,15774,1339,7.8
05065,2020-05-01,4769,4227,542,11.4
05067,2020-05-01,5896,5421,475,8.1
05069,2020-05-01,27491,24755,2736,10
05071,2020-05-01,10214,9216,998,9.8
05073,2020-05-01,2464,2237,227,9.2
05075,2020-05-01,6821,6263,558,8.2
05077,2020-05-01,2791,2516,275,9.9
05079,2020-05-01,3769,3497,272,7.2
05081,2020-05-01,5339,4899,440,8.2
05083,2020-05-01,8740,7796,944,10.8
05085,2020-05-01,33287,30687,2600,7.8
05087,2020-05-01,7193,6811,382,5.3
05089,2020-05-01,6292,5718,574,9.1
05091,2020-05-01,19401,17538,1863,9.6
05093,2020-05-01,17623,15166,2457,13.9
05095,2020-05-01,2713,2504,209,7.7
05097,2020-05-01,2921,2659,262,9
05099,2020-05-01,3641,3369,272,7.5
05101,2020-05-01,3255,3013,242,7.4
05103,2020-05-01,9936,9199,737,7.4
05105,2020-05-01,4147,3825,322,7.8
05107,2020-05-01,6529,5735,794,12.2
05109,2020-05-01,4267,3924,343,8
05111,2020-05-01,9787,9055,732,7.5
05113,2020-05-01,8011,7330,681,8.5
05115,2020-05-01,27982,25710,2272,8.1
05117,2020-05-01,3562,3328,234,6.6
05119,2020-05-01,190963,170101,20862,10.9
05121,2020-05-01,7465,6892,573,7.7
05123,2020-05-01,8173,7251,922,11.3
05125,2020-05-01,58122,53723,4399,7.6
05127,2020-05-01,4362,4117,245,5.6
05129,2020-05-01,3044,2792,252,8.3
05131,2020-05-01,57025,51465,5560,9.8
05133,2020-05-01,5539,5186,353,6.4
05135,2020-05-01,5842,5303,539,9.2
05137,2020-05-01,4627,4211,416,9
05139,2020-05-01,16022,14216,1806,11.3
05141,2020-05-01,5841,5274,567,9.7
05143,2020-05-01,125140,116496,8644,6.9
05145,2020-05-01,34305,31476,2829,8.2
05147,2020-05-01,2753,2563,190,6.9
05149,2020-05-01,7902,7387,515,6.5
06001,2020-05-01,800627,689753,110874,13.8
06003,2020-05-01,448,346,102,22.8
06005,2020-05-01,14026,11874,2152,15.3
06007,2020-05-01,91357,79250,12107,13.3
06009,2020-05-01,20566,18172,2394,11.6
06011,2020-05-01,10136,8168,1968,19.4
06013,2020-05-01,532347,457892,74455,14
06015,2020-05-01,9098,7880,1218,13.4
06017,2020-05-01,90575,77091,13484,14.9
06019,2020-05-01,444229,376686,67543,15.2
06021,2020-05-01,12571,11099,1472,11.7
06023,2020-05-01,58174,50685,7489,12.9
06025,2020-05-01,72007,52191,19816,27.5
06027,2020-05-01,8033,7029,1004,12.5
06029,2020-05-01,382878,318242,64636,16.9
06031,2020-05-01,57640,49057,8583,14.9
06033,2020-05-01,27811,23863,3948,14.2
06035,2020-05-01,9300,8413,887,9.5
06037,2020-05-01,NA,NA,878281,18.8
06039,2020-05-01,61836,52663,9173,14.8
06041,2020-05-01,124672,110987,13685,11
06043,2020-05-01,7104,5750,1354,19.1
06045,2020-05-01,35942,31047,4895,13.6
06047,2020-05-01,114828,96812,18016,15.7
06049,2020-05-01,3076,2765,311,10.1
06051,2020-05-01,6894,5065,1829,26.5
06053,2020-05-01,216395,184317,32078,14.8
06055,2020-05-01,68298,57915,10383,15.2
06057,2020-05-01,44447,38639,5808,13.1
06059,2020-05-01,NA,NA,225811,14.9
06061,2020-05-01,181288,158795,22493,12.4
06063,2020-05-01,7484,6465,1019,13.6
06065,2020-05-01,NA,918991,171127,15.7
06067,2020-05-01,694905,595223,99682,14.3
06069,2020-05-01,31490,26784,4706,14.9
06071,2020-05-01,937211,805299,131912,14.1
06073,2020-05-01,NA,NA,234493,15.6
06075,2020-05-01,548897,478825,70072,12.8
06077,2020-05-01,334828,281934,52894,15.8
06079,2020-05-01,128114,111326,16788,13.1
06081,2020-05-01,425140,377291,47849,11.3
06083,2020-05-01,215578,188863,26715,12.4
06085,2020-05-01,NA,892628,113584,11.3
06087,2020-05-01,131335,112495,18840,14.3
06089,2020-05-01,71481,62336,9145,12.8
06091,2020-05-01,1229,1089,140,11.4
06093,2020-05-01,16549,14460,2089,12.6
06095,2020-05-01,198940,170048,28892,14.5
06097,2020-05-01,240073,207790,32283,13.4
06099,2020-05-01,237954,200905,37049,15.6
06101,2020-05-01,45648,38921,6727,14.7
06103,2020-05-01,24859,21786,3073,12.4
06105,2020-05-01,4379,3919,460,10.5
06107,2020-05-01,203859,170214,33645,16.5
06109,2020-05-01,19572,16106,3466,17.7
06111,2020-05-01,403864,348918,54946,13.6
06113,2020-05-01,101427,90764,10663,10.5
06115,2020-05-01,29925,25569,4356,14.6
08001,2020-05-01,272129,237873,34256,12.6
08003,2020-05-01,8456,7776,680,8
08005,2020-05-01,364169,318308,45861,12.6
08007,2020-05-01,6985,6098,887,12.7
08009,2020-05-01,1998,1949,49,2.5
08011,2020-05-01,1731,1651,80,4.6
08013,2020-05-01,192829,173897,18932,9.8
08014,2020-05-01,39842,35404,4438,11.1
08015,2020-05-01,9380,8263,1117,11.9
08017,2020-05-01,1045,1021,24,2.3
08019,2020-05-01,6285,5297,988,15.7
08021,2020-05-01,4041,3770,271,6.7
08023,2020-05-01,1767,1604,163,9.2
08025,2020-05-01,1487,1416,71,4.8
08027,2020-05-01,2035,1888,147,7.2
08029,2020-05-01,14278,13027,1251,8.8
08031,2020-05-01,422548,366352,56196,13.3
08033,2020-05-01,1125,995,130,11.6
08035,2020-05-01,191009,172797,18212,9.5
08037,2020-05-01,35104,27506,7598,21.6
08039,2020-05-01,14408,13398,1010,7
08041,2020-05-01,337811,299910,37901,11.2
08043,2020-05-01,15306,13720,1586,10.4
08045,2020-05-01,30245,26746,3499,11.6
08047,2020-05-01,4415,3350,1065,24.1
08049,2020-05-01,8485,6777,1708,20.1
08051,2020-05-01,11082,9429,1653,14.9
08053,2020-05-01,410,387,23,5.6
08055,2020-05-01,2583,2296,287,11.1
08057,2020-05-01,876,820,56,6.4
08059,2020-05-01,330727,291951,38776,11.7
08061,2020-05-01,895,874,21,2.3
08063,2020-05-01,4132,3996,136,3.3
08065,2020-05-01,4687,3821,866,18.5
08067,2020-05-01,30787,27322,3465,11.3
08069,2020-05-01,200501,180121,20380,10.2
08071,2020-05-01,6409,5785,624,9.7
08073,2020-05-01,2300,2182,118,5.1
08075,2020-05-01,10882,10203,679,6.2
08077,2020-05-01,73957,65878,8079,10.9
08079,2020-05-01,414,363,51,12.3
08081,2020-05-01,7032,6445,587,8.3
08083,2020-05-01,12497,11300,1197,9.6
08085,2020-05-01,21293,19187,2106,9.9
08087,2020-05-01,15614,14491,1123,7.2
08089,2020-05-01,8070,7515,555,6.9
08091,2020-05-01,2475,2099,376,15.2
08093,2020-05-01,10884,9834,1050,9.6
08095,2020-05-01,2373,2289,84,3.5
08097,2020-05-01,11821,9097,2724,23
08099,2020-05-01,6058,5733,325,5.4
08101,2020-05-01,76327,68404,7923,10.4
08103,2020-05-01,2902,2718,184,6.3
08105,2020-05-01,5349,4872,477,8.9
08107,2020-05-01,15479,12845,2634,17
08109,2020-05-01,3291,3054,237,7.2
08111,2020-05-01,443,368,75,16.9
08113,2020-05-01,5000,3559,1441,28.8
08115,2020-05-01,1115,1072,43,3.9
08117,2020-05-01,20227,14865,5362,26.5
08119,2020-05-01,13086,11271,1815,13.9
08121,2020-05-01,2743,2645,98,3.6
08123,2020-05-01,165119,148432,16687,10.1
08125,2020-05-01,5451,5288,163,3
09001,2020-05-01,467766,413234,54532,11.7
09003,2020-05-01,481748,425416,56332,11.7
09005,2020-05-01,102681,92523,10158,9.9
09007,2020-05-01,92763,83723,9040,9.7
09009,2020-05-01,457851,406238,51613,11.3
09011,2020-05-01,132358,109895,22463,17
09013,2020-05-01,84920,77189,7731,9.1
09015,2020-05-01,62828,55564,7264,11.6
10001,2020-05-01,79298,67479,11819,14.9
10003,2020-05-01,295310,257075,38235,12.9
10005,2020-05-01,101424,86908,14516,14.3
11001,2020-05-01,396512,360847,35665,9
12001,2020-05-01,130016,118483,11533,8.9
12003,2020-05-01,11185,10361,824,7.4
12005,2020-05-01,81798,72933,8865,10.8
12007,2020-05-01,10502,9539,963,9.2
12009,2020-05-01,279334,245111,34223,12.3
12011,2020-05-01,NA,845650,177811,17.4
12013,2020-05-01,4632,4300,332,7.2
12015,2020-05-01,70292,60943,9349,13.3
12017,2020-05-01,46503,39905,6598,14.2
12019,2020-05-01,102348,92719,9629,9.4
12021,2020-05-01,174253,151489,22764,13.1
12023,2020-05-01,28592,26067,2525,8.8
12027,2020-05-01,14314,13275,1039,7.3
12029,2020-05-01,5781,5329,452,7.8
12031,2020-05-01,475374,419350,56024,11.8
12033,2020-05-01,142844,126663,16181,11.3
12035,2020-05-01,46188,39505,6683,14.5
12037,2020-05-01,4606,4160,446,9.7
12039,2020-05-01,17513,15922,1591,9.1
12041,2020-05-01,6652,6198,454,6.8
12043,2020-05-01,5136,4727,409,8
12045,2020-05-01,4897,4432,465,9.5
12047,2020-05-01,4101,3678,423,10.3
12049,2020-05-01,8384,7652,732,8.7
12051,2020-05-01,15454,13765,1689,10.9
12053,2020-05-01,71113,60829,10284,14.5
12055,2020-05-01,34093,30109,3984,11.7
12057,2020-05-01,746905,648544,98361,13.2
12059,2020-05-01,6724,6151,573,8.5
12061,2020-05-01,63875,55468,8407,13.2
12063,2020-05-01,17194,15852,1342,7.8
12065,2020-05-01,5101,4698,403,7.9
12067,2020-05-01,2699,2552,147,5.4
12069,2020-05-01,154962,124274,30688,19.8
12071,2020-05-01,342953,295307,47646,13.9
12073,2020-05-01,145225,132023,13202,9.1
12075,2020-05-01,16188,14647,1541,9.5
12077,2020-05-01,2522,2377,145,5.7
12079,2020-05-01,7224,6649,575,8
12081,2020-05-01,173950,151871,22079,12.7
12083,2020-05-01,136428,120482,15946,11.7
12085,2020-05-01,71159,63192,7967,11.2
12086,2020-05-01,NA,NA,122125,10.3
12087,2020-05-01,43845,34793,9052,20.6
12089,2020-05-01,40444,36139,4305,10.6
12091,2020-05-01,94112,84630,9482,10.1
12093,2020-05-01,16833,15486,1347,8
12095,2020-05-01,760215,582121,178094,23.4
12097,2020-05-01,204394,141772,62622,30.6
12099,2020-05-01,707709,606451,101258,14.3
12101,2020-05-01,236116,204725,31391,13.3
12103,2020-05-01,481887,416680,65207,13.5
12105,2020-05-01,327886,267461,60425,18.4
12107,2020-05-01,26315,23248,3067,11.7
12109,2020-05-01,130892,117840,13052,10
12111,2020-05-01,144905,125006,19899,13.7
12113,2020-05-01,80587,73452,7135,8.9
12115,2020-05-01,182099,158078,24021,13.2
12117,2020-05-01,227808,194793,33015,14.5
12119,2020-05-01,31564,27433,4131,13.1
12121,2020-05-01,17495,16066,1429,8.2
12123,2020-05-01,8082,7377,705,8.7
12125,2020-05-01,4444,4137,307,6.9
12127,2020-05-01,246874,211628,35246,14.3
12129,2020-05-01,14253,13222,1031,7.2
12131,2020-05-01,31574,27985,3589,11.4
12133,2020-05-01,9333,8482,851,9.1
13001,2020-05-01,9330,8809,521,5.6
13003,2020-05-01,4451,4253,198,4.4
13005,2020-05-01,4739,4488,251,5.3
13007,2020-05-01,1150,1075,75,6.5
13009,2020-05-01,17641,16092,1549,8.8
13011,2020-05-01,9594,8938,656,6.8
13013,2020-05-01,39544,36361,3183,8
13015,2020-05-01,49281,44559,4722,9.6
13017,2020-05-01,5497,5121,376,6.8
13019,2020-05-01,7363,6873,490,6.7
13021,2020-05-01,66771,60142,6629,9.9
13023,2020-05-01,4423,4098,325,7.3
13025,2020-05-01,6776,6287,489,7.2
13027,2020-05-01,6712,6322,390,5.8
13029,2020-05-01,18317,16833,1484,8.1
13031,2020-05-01,36472,33097,3375,9.3
13033,2020-05-01,8884,8086,798,9
13035,2020-05-01,10520,9635,885,8.4
13037,2020-05-01,2261,2134,127,5.6
13039,2020-05-01,20897,19511,1386,6.6
13043,2020-05-01,5709,5403,306,5.4
13045,2020-05-01,53912,48727,5185,9.6
13047,2020-05-01,31808,29799,2009,6.3
13049,2020-05-01,4783,4580,203,4.2
13051,2020-05-01,139791,123276,16515,11.8
13053,2020-05-01,1977,1820,157,7.9
13055,2020-05-01,9865,8581,1284,13
13057,2020-05-01,130638,120763,9875,7.6
13059,2020-05-01,57611,52069,5542,9.6
13061,2020-05-01,939,805,134,14.3
13063,2020-05-01,139634,119753,19881,14.2
13065,2020-05-01,3039,2899,140,4.6
13067,2020-05-01,408248,372031,36217,8.9
13069,2020-05-01,18850,17610,1240,6.6
13071,2020-05-01,22343,21220,1123,5
13073,2020-05-01,72642,68298,4344,6
13075,2020-05-01,8064,7644,420,5.2
13077,2020-05-01,73385,66289,7096,9.7
13079,2020-05-01,5411,5048,363,6.7
13081,2020-05-01,9391,8623,768,8.2
13083,2020-05-01,7607,7181,426,5.6
13085,2020-05-01,12100,11204,896,7.4
13087,2020-05-01,11479,10891,588,5.1
13089,2020-05-01,393258,347562,45696,11.6
13091,2020-05-01,6865,6391,474,6.9
13093,2020-05-01,4999,4519,480,9.6
13095,2020-05-01,37313,33468,3845,10.3
13097,2020-05-01,71774,63869,7905,11
13099,2020-05-01,4412,4185,227,5.1
13101,2020-05-01,1892,1800,92,4.9
13103,2020-05-01,30708,28328,2380,7.8
13105,2020-05-01,8066,7406,660,8.2
13107,2020-05-01,8593,7969,624,7.3
13109,2020-05-01,4948,4635,313,6.3
13111,2020-05-01,10801,10051,750,6.9
13113,2020-05-01,55800,50976,4824,8.6
13115,2020-05-01,43095,38977,4118,9.6
13117,2020-05-01,119130,110165,8965,7.5
13119,2020-05-01,9950,9077,873,8.8
13121,2020-05-01,553654,489340,64314,11.6
13123,2020-05-01,11745,10921,824,7
13125,2020-05-01,1230,1170,60,4.9
13127,2020-05-01,37874,33642,4232,11.2
13129,2020-05-01,27422,25279,2143,7.8
13131,2020-05-01,10487,9958,529,5
13133,2020-05-01,7255,6718,537,7.4
13135,2020-05-01,476614,430150,46464,9.7
13137,2020-05-01,18658,17205,1453,7.8
13139,2020-05-01,101549,93809,7740,7.6
13141,2020-05-01,2559,2296,263,10.3
13143,2020-05-01,12098,10994,1104,9.1
13145,2020-05-01,16494,15310,1184,7.2
13147,2020-05-01,11420,10621,799,7
13149,2020-05-01,5085,4592,493,9.7
13151,2020-05-01,115155,102084,13071,11.4
13153,2020-05-01,69694,64863,4831,6.9
13155,2020-05-01,3485,3272,213,6.1
13157,2020-05-01,38408,35627,2781,7.2
13159,2020-05-01,6600,6148,452,6.8
13161,2020-05-01,6166,5815,351,5.7
13163,2020-05-01,6657,6168,489,7.3
13165,2020-05-01,3130,2871,259,8.3
13167,2020-05-01,3904,3682,222,5.7
13169,2020-05-01,13141,12305,836,6.4
13171,2020-05-01,7784,7128,656,8.4
13173,2020-05-01,3613,3395,218,6
13175,2020-05-01,19076,17398,1678,8.8
13177,2020-05-01,14599,13675,924,6.3
13179,2020-05-01,25612,23519,2093,8.2
13181,2020-05-01,3435,3199,236,6.9
13183,2020-05-01,8045,7613,432,5.4
13185,2020-05-01,50813,46596,4217,8.3
13187,2020-05-01,16207,14983,1224,7.6
13189,2020-05-01,8559,7695,864,10.1
13191,2020-05-01,5785,5352,433,7.5
13193,2020-05-01,4615,4292,323,7
13195,2020-05-01,12790,11757,1033,8.1
13197,2020-05-01,3148,2943,205,6.5
13199,2020-05-01,8795,7714,1081,12.3
13201,2020-05-01,2779,2675,104,3.7
13205,2020-05-01,8338,7771,567,6.8
13207,2020-05-01,12501,11634,867,6.9
13209,2020-05-01,3881,3627,254,6.5
13211,2020-05-01,9034,8291,743,8.2
13213,2020-05-01,15466,13741,1725,11.2
13215,2020-05-01,77425,69047,8378,10.8
13217,2020-05-01,51290,46062,5228,10.2
13219,2020-05-01,18801,17668,1133,6
13221,2020-05-01,6694,6219,475,7.1
13223,2020-05-01,83842,77120,6722,8
13225,2020-05-01,11639,10804,835,7.2
13227,2020-05-01,14578,13567,1011,6.9
13229,2020-05-01,8393,7925,468,5.6
13231,2020-05-01,8512,7905,607,7.1
13233,2020-05-01,18316,16619,1697,9.3
13235,2020-05-01,3904,3705,199,5.1
13237,2020-05-01,8200,7473,727,8.9
13239,2020-05-01,801,740,61,7.6
13241,2020-05-01,7130,6555,575,8.1
13243,2020-05-01,2507,2358,149,5.9
13245,2020-05-01,83821,75438,8383,10
13247,2020-05-01,43544,38805,4739,10.9
13249,2020-05-01,2161,2023,138,6.4
13251,2020-05-01,5014,4401,613,12.2
13253,2020-05-01,3139,2970,169,5.4
13255,2020-05-01,27797,24988,2809,10.1
13257,2020-05-01,10401,9415,986,9.5
13259,2020-05-01,2518,2343,175,6.9
13261,2020-05-01,12467,11464,1003,8
13263,2020-05-01,2761,2497,264,9.6
13265,2020-05-01,541,496,45,8.3
13267,2020-05-01,9715,9269,446,4.6
13269,2020-05-01,2721,2523,198,7.3
13271,2020-05-01,3783,3408,375,9.9
13273,2020-05-01,3428,3148,280,8.2
13275,2020-05-01,16713,15437,1276,7.6
13277,2020-05-01,20255,18987,1268,6.3
13279,2020-05-01,12139,11104,1035,8.5
13281,2020-05-01,3737,3378,359,9.6
13283,2020-05-01,2693,2507,186,6.9
13285,2020-05-01,36775,32589,4186,11.4
13287,2020-05-01,3217,2977,240,7.5
13289,2020-05-01,2768,2502,266,9.6
13291,2020-05-01,10490,9842,648,6.2
13293,2020-05-01,11241,10217,1024,9.1
13295,2020-05-01,30006,27841,2165,7.2
13297,2020-05-01,44113,40581,3532,8
13299,2020-05-01,15126,14093,1033,6.8
13301,2020-05-01,2614,2362,252,9.6
13303,2020-05-01,7018,6515,503,7.2
13305,2020-05-01,11578,10774,804,6.9
13307,2020-05-01,1008,948,60,6
13309,2020-05-01,1625,1503,122,7.5
13311,2020-05-01,15669,14531,1138,7.3
13313,2020-05-01,43660,38799,4861,11.1
13315,2020-05-01,2716,2557,159,5.9
13317,2020-05-01,3799,3505,294,7.7
13319,2020-05-01,3744,3486,258,6.9
13321,2020-05-01,8714,8170,544,6.2
15001,2020-05-01,87627,69063,18564,21.2
15003,2020-05-01,427919,344927,82992,19.4
15007,2020-05-01,36194,25505,10689,29.5
15009,2020-05-01,84158,56831,27327,32.5
16001,2020-05-01,256125,232458,23667,9.2
16003,2020-05-01,1747,1510,237,13.6
16005,2020-05-01,42050,39008,3042,7.2
16007,2020-05-01,3020,2849,171,5.7
16009,2020-05-01,4172,3741,431,10.3
16011,2020-05-01,23726,22415,1311,5.5
16013,2020-05-01,12482,10586,1896,15.2
16015,2020-05-01,3586,3167,419,11.7
16017,2020-05-01,20971,18412,2559,12.2
16019,2020-05-01,57027,53638,3389,5.9
16021,2020-05-01,5617,5125,492,8.8
16023,2020-05-01,1394,1325,69,4.9
16025,2020-05-01,670,616,54,8.1
16027,2020-05-01,104635,95094,9541,9.1
16029,2020-05-01,4112,3932,180,4.4
16031,2020-05-01,12342,11675,667,5.4
16033,2020-05-01,385,370,15,3.9
16035,2020-05-01,3090,2730,360,11.7
16037,2020-05-01,2223,2078,145,6.5
16039,2020-05-01,11781,10977,804,6.8
16041,2020-05-01,7084,6769,315,4.4
16043,2020-05-01,7768,7360,408,5.3
16045,2020-05-01,8300,7591,709,8.5
16047,2020-05-01,8147,7725,422,5.2
16049,2020-05-01,6691,6049,642,9.6
16051,2020-05-01,13892,13260,632,4.5
16053,2020-05-01,12076,11437,639,5.3
16055,2020-05-01,81041,72273,8768,10.8
16057,2020-05-01,19317,17864,1453,7.5
16059,2020-05-01,3588,3249,339,9.4
16061,2020-05-01,1694,1515,179,10.6
16063,2020-05-01,2549,2341,208,8.2
16065,2020-05-01,21543,20705,838,3.9
16067,2020-05-01,11630,11013,617,5.3
16069,2020-05-01,20584,18989,1595,7.7
16071,2020-05-01,2382,2231,151,6.3
16073,2020-05-01,5572,5080,492,8.8
16075,2020-05-01,11802,10889,913,7.7
16077,2020-05-01,4143,3942,201,4.9
16079,2020-05-01,5324,4551,773,14.5
16081,2020-05-01,6507,5773,734,11.3
16083,2020-05-01,40982,37567,3415,8.3
16085,2020-05-01,5445,4680,765,14
16087,2020-05-01,4692,4336,356,7.6
17001,2020-05-01,30386,26927,3459,11.4
17003,2020-05-01,1866,1597,269,14.4
17005,2020-05-01,7297,6368,929,12.7
17007,2020-05-01,25663,20311,5352,20.9
17009,2020-05-01,2954,2764,190,6.4
17011,2020-05-01,16254,14203,2051,12.6
17013,2020-05-01,2190,1880,310,14.2
17015,2020-05-01,7467,6468,999,13.4
17017,2020-05-01,5687,5071,616,10.8
17019,2020-05-01,103660,92792,10868,10.5
17021,2020-05-01,13155,11477,1678,12.8
17023,2020-05-01,7219,6245,974,13.5
17025,2020-05-01,6559,5223,1336,20.4
17027,2020-05-01,19171,16976,2195,11.4
17029,2020-05-01,21854,19245,2609,11.9
17031,2020-05-01,NA,NA,421314,16.8
17033,2020-05-01,8204,7336,868,10.6
17035,2020-05-01,5693,5162,531,9.3
17037,2020-05-01,50945,43824,7121,14
17039,2020-05-01,6754,6077,677,10
17041,2020-05-01,9544,8629,915,9.6
17043,2020-05-01,473930,413194,60736,12.8
17045,2020-05-01,9111,7952,1159,12.7
17047,2020-05-01,2504,2139,365,14.6
17049,2020-05-01,18469,15983,2486,13.5
17051,2020-05-01,9363,8166,1197,12.8
17053,2020-05-01,6094,5399,695,11.4
17055,2020-05-01,16225,12901,3324,20.5
17057,2020-05-01,14353,12439,1914,13.3
17059,2020-05-01,1983,1689,294,14.8
17061,2020-05-01,5709,5147,562,9.8
17063,2020-05-01,23846,20556,3290,13.8
17065,2020-05-01,4028,3479,549,13.6
17067,2020-05-01,7998,7033,965,12.1
17069,2020-05-01,1236,1081,155,12.5
17071,2020-05-01,3512,3063,449,12.8
17073,2020-05-01,23271,20039,3232,13.9
17075,2020-05-01,13268,12056,1212,9.1
17077,2020-05-01,26096,22421,3675,14.1
17079,2020-05-01,4493,4036,457,10.2
17081,2020-05-01,16803,13305,3498,20.8
17083,2020-05-01,10360,8979,1381,13.3
17085,2020-05-01,10230,8518,1712,16.7
17087,2020-05-01,4147,3498,649,15.6
17089,2020-05-01,254094,213556,40538,16
17091,2020-05-01,52766,45217,7549,14.3
17093,2020-05-01,65392,56376,9016,13.8
17095,2020-05-01,20872,18003,2869,13.7
17097,2020-05-01,349952,302204,47748,13.6
17099,2020-05-01,51074,42417,8657,16.9
17101,2020-05-01,5641,4848,793,14.1
17103,2020-05-01,16727,14718,2009,12
17105,2020-05-01,15572,13963,1609,10.3
17107,2020-05-01,11707,10450,1257,10.7
17109,2020-05-01,12824,11471,1353,10.6
17111,2020-05-01,155516,134771,20745,13.3
17113,2020-05-01,81368,71894,9474,11.6
17115,2020-05-01,46044,39026,7018,15.2
17117,2020-05-01,21279,18755,2524,11.9
17119,2020-05-01,127452,109837,17615,13.8
17121,2020-05-01,17436,14162,3274,18.8
17123,2020-05-01,4862,4300,562,11.6
17125,2020-05-01,5793,5072,721,12.4
17127,2020-05-01,5149,4187,962,18.7
17129,2020-05-01,5773,5133,640,11.1
17131,2020-05-01,7517,6450,1067,14.2
17133,2020-05-01,17548,15741,1807,10.3
17135,2020-05-01,11246,9594,1652,14.7
17137,2020-05-01,15272,13646,1626,10.6
17139,2020-05-01,6962,6422,540,7.8
17141,2020-05-01,23233,19974,3259,14
17143,2020-05-01,82124,67727,14397,17.5
17145,2020-05-01,8291,6626,1665,20.1
17147,2020-05-01,8061,7358,703,8.7
17149,2020-05-01,6613,6010,603,9.1
17151,2020-05-01,1586,1375,211,13.3
17153,2020-05-01,1770,1468,302,17.1
17155,2020-05-01,2865,2474,391,13.6
17157,2020-05-01,13743,11787,1956,14.2
17159,2020-05-01,7351,6480,871,11.8
17161,2020-05-01,68586,56379,12207,17.8
17163,2020-05-01,122077,103068,19009,15.6
17165,2020-05-01,9599,7996,1603,16.7
17167,2020-05-01,92797,79546,13251,14.3
17169,2020-05-01,3172,2865,307,9.7
17171,2020-05-01,2252,2022,230,10.2
17173,2020-05-01,10038,8875,1163,11.6
17175,2020-05-01,2275,2020,255,11.2
17177,2020-05-01,20148,17878,2270,11.3
17179,2020-05-01,60218,51508,8710,14.5
17181,2020-05-01,7064,6142,922,13.1
17183,2020-05-01,31730,27048,4682,14.8
17185,2020-05-01,5754,4901,853,14.8
17187,2020-05-01,7905,7143,762,9.6
17189,2020-05-01,9091,7925,1166,12.8
17191,2020-05-01,6871,5692,1179,17.2
17193,2020-05-01,6017,5209,808,13.4
17195,2020-05-01,26964,22783,4181,15.5
17197,2020-05-01,339680,288816,50864,15
17199,2020-05-01,31146,25633,5513,17.7
17201,2020-05-01,134460,107274,27186,20.2
17203,2020-05-01,17097,15336,1761,10.3
18001,2020-05-01,16308,14739,1569,9.6
18003,2020-05-01,181808,156090,25718,14.1
18005,2020-05-01,42681,37100,5581,13.1
18007,2020-05-01,4056,3687,369,9.1
18009,2020-05-01,4854,4074,780,16.1
18011,2020-05-01,34194,31951,2243,6.6
18013,2020-05-01,7525,6592,933,12.4
18015,2020-05-01,9402,8187,1215,12.9
18017,2020-05-01,17638,15413,2225,12.6
18019,2020-05-01,59592,52142,7450,12.5
18021,2020-05-01,11397,10213,1184,10.4
18023,2020-05-01,16658,14773,1885,11.3
18025,2020-05-01,4757,4273,484,10.2
18027,2020-05-01,16424,15541,883,5.4
18029,2020-05-01,24612,21820,2792,11.3
18031,2020-05-01,15065,12494,2571,17.1
18033,2020-05-01,22004,18827,3177,14.4
18035,2020-05-01,50840,44780,6060,11.9
18037,2020-05-01,22445,21212,1233,5.5
18039,2020-05-01,108787,96390,12397,11.4
18041,2020-05-01,8883,7285,1598,18
18043,2020-05-01,39766,35335,4431,11.1
18045,2020-05-01,7800,6732,1068,13.7
18047,2020-05-01,10995,9928,1067,9.7
18049,2020-05-01,9763,8762,1001,10.3
18051,2020-05-01,19843,17256,2587,13
18053,2020-05-01,32119,28918,3201,10
18055,2020-05-01,13068,11913,1155,8.8
18057,2020-05-01,176634,163593,13041,7.4
18059,2020-05-01,39528,35733,3795,9.6
18061,2020-05-01,19288,17129,2159,11.2
18063,2020-05-01,86507,79637,6870,7.9
18065,2020-05-01,21911,19215,2696,12.3
18067,2020-05-01,40411,31430,8981,22.2
18069,2020-05-01,17829,15409,2420,13.6
18071,2020-05-01,22015,18152,3863,17.5
18073,2020-05-01,15403,13577,1826,11.9
18075,2020-05-01,8741,7432,1309,15
18077,2020-05-01,14688,12487,2201,15
18079,2020-05-01,13530,11397,2133,15.8
18081,2020-05-01,80699,72932,7767,9.6
18083,2020-05-01,17973,15996,1977,11
18085,2020-05-01,41354,37802,3552,8.6
18087,2020-05-01,18440,16518,1922,10.4
18089,2020-05-01,225295,187835,37460,16.6
18091,2020-05-01,47516,40305,7211,15.2
18093,2020-05-01,20511,18182,2329,11.4
18095,2020-05-01,58752,50815,7937,13.5
18097,2020-05-01,483478,427485,55993,11.6
18099,2020-05-01,22319,20134,2185,9.8
18101,2020-05-01,5407,5104,303,5.6
18103,2020-05-01,15539,13307,2232,14.4
18105,2020-05-01,67272,61884,5388,8
18107,2020-05-01,18636,16999,1637,8.8
18109,2020-05-01,34451,31575,2876,8.3
18111,2020-05-01,6489,5744,745,11.5
18113,2020-05-01,22145,18303,3842,17.3
18115,2020-05-01,3155,2712,443,14
18117,2020-05-01,8238,6548,1690,20.5
18119,2020-05-01,8935,8123,812,9.1
18121,2020-05-01,6816,6235,581,8.5
18123,2020-05-01,8931,7901,1030,11.5
18125,2020-05-01,6147,5582,565,9.2
18127,2020-05-01,83302,71805,11497,13.8
18129,2020-05-01,12420,11449,971,7.8
18131,2020-05-01,6213,5646,567,9.1
18133,2020-05-01,16191,14387,1804,11.1
18135,2020-05-01,11346,10146,1200,10.6
18137,2020-05-01,13340,11750,1590,11.9
18139,2020-05-01,8888,7753,1135,12.8
18141,2020-05-01,131729,114923,16806,12.8
18143,2020-05-01,10686,8839,1847,17.3
18145,2020-05-01,23453,20127,3326,14.2
18147,2020-05-01,10004,9144,860,8.6
18149,2020-05-01,9487,8313,1174,12.4
18151,2020-05-01,18981,16646,2335,12.3
18153,2020-05-01,7904,7058,846,10.7
18155,2020-05-01,4467,3714,753,16.9
18157,2020-05-01,89314,78637,10677,12
18159,2020-05-01,8941,7825,1116,12.5
18161,2020-05-01,3342,3039,303,9.1
18163,2020-05-01,90690,79540,11150,12.3
18165,2020-05-01,6633,5834,799,12
18167,2020-05-01,45783,40260,5523,12.1
18169,2020-05-01,14637,13191,1446,9.9
18171,2020-05-01,3893,3510,383,9.8
18173,2020-05-01,30898,27970,2928,9.5
18175,2020-05-01,13321,11602,1719,12.9
18177,2020-05-01,29714,26666,3048,10.3
18179,2020-05-01,13551,12144,1407,10.4
18181,2020-05-01,13012,11818,1194,9.2
18183,2020-05-01,16668,14797,1871,11.2
19001,2020-05-01,4085,3813,272,6.7
19003,2020-05-01,2018,1893,125,6.2
19005,2020-05-01,6945,6471,474,6.8
19007,2020-05-01,5991,5526,465,7.8
19009,2020-05-01,2971,2836,135,4.5
19011,2020-05-01,12815,11822,993,7.7
19013,2020-05-01,67159,60311,6848,10.2
19015,2020-05-01,14349,13452,897,6.3
19017,2020-05-01,13281,12371,910,6.9
19019,2020-05-01,11057,10311,746,6.7
19021,2020-05-01,11545,11012,533,4.6
19023,2020-05-01,7572,7062,510,6.7
19025,2020-05-01,4087,3833,254,6.2
19027,2020-05-01,10533,9830,703,6.7
19029,2020-05-01,6763,6413,350,5.2
19031,2020-05-01,10267,9603,664,6.5
19033,2020-05-01,23233,21438,1795,7.7
19035,2020-05-01,6179,5863,316,5.1
19037,2020-05-01,6292,5926,366,5.8
19039,2020-05-01,4621,4210,411,8.9
19041,2020-05-01,8352,7780,572,6.8
19043,2020-05-01,9624,8890,734,7.6
19045,2020-05-01,22057,19738,2319,10.5
19047,2020-05-01,7857,7339,518,6.6
19049,2020-05-01,48141,45352,2789,5.8
19051,2020-05-01,4085,3858,227,5.6
19053,2020-05-01,4096,3827,269,6.6
19055,2020-05-01,10329,9732,597,5.8
19057,2020-05-01,18529,16321,2208,11.9
19059,2020-05-01,10159,9389,770,7.6
19061,2020-05-01,55174,49468,5706,10.3
19063,2020-05-01,5156,4790,366,7.1
19065,2020-05-01,10282,9518,764,7.4
19067,2020-05-01,8189,7535,654,8
19069,2020-05-01,5625,5361,264,4.7
19071,2020-05-01,3598,3431,167,4.6
19073,2020-05-01,5288,4902,386,7.3
19075,2020-05-01,6147,5721,426,6.9
19077,2020-05-01,5279,4895,384,7.3
19079,2020-05-01,6700,6283,417,6.2
19081,2020-05-01,5812,5359,453,7.8
19083,2020-05-01,7777,7269,508,6.5
19085,2020-05-01,6955,6544,411,5.9
19087,2020-05-01,9507,8660,847,8.9
19089,2020-05-01,5018,4753,265,5.3
19091,2020-05-01,4937,4636,301,6.1
19093,2020-05-01,3943,3769,174,4.4
19095,2020-05-01,9829,9069,760,7.7
19097,2020-05-01,10622,9627,995,9.4
19099,2020-05-01,19337,17719,1618,8.4
19101,2020-05-01,9139,8264,875,9.6
19103,2020-05-01,82903,76474,6429,7.8
19105,2020-05-01,10180,9310,870,8.5
19107,2020-05-01,5191,4811,380,7.3
19109,2020-05-01,8030,7554,476,5.9
19111,2020-05-01,15662,14017,1645,10.5
19113,2020-05-01,118845,107395,11450,9.6
19115,2020-05-01,6086,5605,481,7.9
19117,2020-05-01,4615,4371,244,5.3
19119,2020-05-01,6520,6298,222,3.4
19121,2020-05-01,8210,7493,717,8.7
19123,2020-05-01,11928,10976,952,8
19125,2020-05-01,17752,16496,1256,7.1
19127,2020-05-01,17240,15563,1677,9.7
19129,2020-05-01,7064,6638,426,6
19131,2020-05-01,6098,5798,300,4.9
19133,2020-05-01,4257,3952,305,7.2
19135,2020-05-01,3939,3641,298,7.6
19137,2020-05-01,4812,4476,336,7
19139,2020-05-01,22139,19588,2551,11.5
19141,2020-05-01,8047,7684,363,4.5
19143,2020-05-01,3486,3340,146,4.2
19145,2020-05-01,6267,5748,519,8.3
19147,2020-05-01,4554,4205,349,7.7
19149,2020-05-01,13809,13087,722,5.2
19151,2020-05-01,4143,3936,207,5
19153,2020-05-01,262909,237100,25809,9.8
19155,2020-05-01,47362,43320,4042,8.5
19157,2020-05-01,9818,8957,861,8.8
19159,2020-05-01,2333,2189,144,6.2
19161,2020-05-01,5167,4926,241,4.7
19163,2020-05-01,86191,76650,9541,11.1
19165,2020-05-01,6259,5923,336,5.4
19167,2020-05-01,20818,20117,701,3.4
19169,2020-05-01,54594,51436,3158,5.8
19171,2020-05-01,9155,8546,609,6.7
19173,2020-05-01,3113,2951,162,5.2
19175,2020-05-01,6041,5505,536,8.9
19177,2020-05-01,3648,3398,250,6.9
19179,2020-05-01,17286,15762,1524,8.8
19181,2020-05-01,26987,25080,1907,7.1
19183,2020-05-01,11239,10525,714,6.4
19185,2020-05-01,2753,2557,196,7.1
19187,2020-05-01,18602,17215,1387,7.5
19189,2020-05-01,5158,4566,592,11.5
19191,2020-05-01,10654,9944,710,6.7
19193,2020-05-01,53578,49038,4540,8.5
19195,2020-05-01,3957,3584,373,9.4
19197,2020-05-01,7031,6646,385,5.5
20001,2020-05-01,6380,5929,451,7.1
20003,2020-05-01,4158,3948,210,5.1
20005,2020-05-01,6861,6219,642,9.4
20007,2020-05-01,2302,2204,98,4.3
20009,2020-05-01,13596,12751,845,6.2
20011,2020-05-01,6637,6151,486,7.3
20013,2020-05-01,5119,4748,371,7.2
20015,2020-05-01,32184,28783,3401,10.6
20017,2020-05-01,1456,1342,114,7.8
20019,2020-05-01,1457,1338,119,8.2
20021,2020-05-01,10034,9204,830,8.3
20023,2020-05-01,1262,1228,34,2.7
20025,2020-05-01,1120,1096,24,2.1
20027,2020-05-01,3758,3525,233,6.2
20029,2020-05-01,3787,3593,194,5.1
20031,2020-05-01,3858,3607,251,6.5
20033,2020-05-01,852,811,41,4.8
20035,2020-05-01,16933,15258,1675,9.9
20037,2020-05-01,18760,17280,1480,7.9
20039,2020-05-01,1177,1117,60,5.1
20041,2020-05-01,8816,8231,585,6.6
20043,2020-05-01,4094,3817,277,6.8
20045,2020-05-01,64660,58229,6431,9.9
20047,2020-05-01,1434,1385,49,3.4
20049,2020-05-01,1169,1093,76,6.5
20051,2020-05-01,16649,15750,899,5.4
20053,2020-05-01,2632,2534,98,3.7
20055,2020-05-01,19989,19026,963,4.8
20057,2020-05-01,16888,16158,730,4.3
20059,2020-05-01,14168,13076,1092,7.7
20061,2020-05-01,11758,10595,1163,9.9
20063,2020-05-01,1424,1376,48,3.4
20065,2020-05-01,1126,1056,70,6.2
20067,2020-05-01,3055,2912,143,4.7
20069,2020-05-01,3176,3100,76,2.4
20071,2020-05-01,814,799,15,1.8
20073,2020-05-01,3139,2911,228,7.3
20075,2020-05-01,1582,1558,24,1.5
20077,2020-05-01,2771,2611,160,5.8
20079,2020-05-01,16506,15182,1324,8
20081,2020-05-01,2183,2118,65,3
20083,2020-05-01,960,932,28,2.9
20085,2020-05-01,7262,6501,761,10.5
20087,2020-05-01,9995,9263,732,7.3
20089,2020-05-01,1256,1205,51,4.1
20091,2020-05-01,335581,306440,29141,8.7
20093,2020-05-01,1978,1905,73,3.7
20095,2020-05-01,3239,3005,234,7.2
20097,2020-05-01,1219,1162,57,4.7
20099,2020-05-01,9618,8877,741,7.7
20101,2020-05-01,745,721,24,3.2
20103,2020-05-01,36174,32650,3524,9.7
20105,2020-05-01,1595,1542,53,3.3
20107,2020-05-01,4249,3856,393,9.2
20109,2020-05-01,1586,1537,49,3.1
20111,2020-05-01,16079,14935,1144,7.1
20113,2020-05-01,16953,16122,831,4.9
20115,2020-05-01,5798,5470,328,5.7
20117,2020-05-01,5436,5217,219,4
20119,2020-05-01,2085,2009,76,3.6
20121,2020-05-01,17122,15851,1271,7.4
20123,2020-05-01,3349,3239,110,3.3
20125,2020-05-01,14965,13415,1550,10.4
20127,2020-05-01,2978,2830,148,5
20129,2020-05-01,1114,1082,32,2.9
20131,2020-05-01,5489,5277,212,3.9
20133,2020-05-01,6231,5724,507,8.1
20135,2020-05-01,1315,1258,57,4.3
20137,2020-05-01,2617,2532,85,3.2
20139,2020-05-01,7823,7264,559,7.1
20141,2020-05-01,1934,1863,71,3.7
20143,2020-05-01,2911,2720,191,6.6
20145,2020-05-01,2815,2688,127,4.5
20147,2020-05-01,2618,2494,124,4.7
20149,2020-05-01,11975,11278,697,5.8
20151,2020-05-01,4816,4580,236,4.9
20153,2020-05-01,1486,1440,46,3.1
20155,2020-05-01,29739,27439,2300,7.7
20157,2020-05-01,2289,2199,90,3.9
20159,2020-05-01,5007,4725,282,5.6
20161,2020-05-01,34332,31847,2485,7.2
20163,2020-05-01,2470,2345,125,5.1
20165,2020-05-01,1527,1432,95,6.2
20167,2020-05-01,3302,3098,204,6.2
20169,2020-05-01,29456,26926,2530,8.6
20171,2020-05-01,2737,2645,92,3.4
20173,2020-05-01,259113,222259,36854,14.2
20175,2020-05-01,9703,9119,584,6
20177,2020-05-01,90261,81916,8345,9.2
20179,2020-05-01,1436,1398,38,2.6
20181,2020-05-01,2817,2702,115,4.1
20183,2020-05-01,1935,1873,62,3.2
20185,2020-05-01,2019,1933,86,4.3
20187,2020-05-01,1032,1008,24,2.3
20189,2020-05-01,2759,2677,82,3
20191,2020-05-01,10968,9580,1388,12.7
20193,2020-05-01,4063,3921,142,3.5
20195,2020-05-01,1406,1343,63,4.5
20197,2020-05-01,3561,3351,210,5.9
20199,2020-05-01,809,793,16,2
20201,2020-05-01,2977,2888,89,3
20203,2020-05-01,1199,1175,24,2
20205,2020-05-01,3910,3548,362,9.3
20207,2020-05-01,1592,1460,132,8.3
20209,2020-05-01,78615,68185,10430,13.3
21001,2020-05-01,7345,6521,824,11.2
21003,2020-05-01,8767,7975,792,9
21005,2020-05-01,12061,10838,1223,10.1
21007,2020-05-01,3420,3093,327,9.6
21009,2020-05-01,18670,16336,2334,12.5
21011,2020-05-01,4691,4097,594,12.7
21013,2020-05-01,8370,7520,850,10.2
21015,2020-05-01,71493,65036,6457,9
21017,2020-05-01,10204,9202,1002,9.8
21019,2020-05-01,18307,15838,2469,13.5
21021,2020-05-01,13115,11561,1554,11.8
21023,2020-05-01,3821,3483,338,8.8
21025,2020-05-01,3411,2976,435,12.8
21027,2020-05-01,8233,7313,920,11.2
21029,2020-05-01,43660,38251,5409,12.4
21031,2020-05-01,5033,4389,644,12.8
21033,2020-05-01,5794,5296,498,8.6
21035,2020-05-01,18376,16797,1579,8.6
21037,2020-05-01,50504,45977,4527,9
21039,2020-05-01,2213,2081,132,6
21041,2020-05-01,5547,5040,507,9.1
21043,2020-05-01,10063,8694,1369,13.6
21045,2020-05-01,7146,6504,642,9
21047,2020-05-01,25991,22477,3514,13.5
21049,2020-05-01,17328,15594,1734,10
21051,2020-05-01,5488,4812,676,12.3
21053,2020-05-01,4218,3950,268,6.4
21055,2020-05-01,3806,3504,302,7.9
21057,2020-05-01,3362,3103,259,7.7
21059,2020-05-01,46834,42048,4786,10.2
21061,2020-05-01,4690,4008,682,14.5
21063,2020-05-01,2089,1805,284,13.6
21065,2020-05-01,5300,4648,652,12.3
21067,2020-05-01,175901,159070,16831,9.6
21069,2020-05-01,6429,5638,791,12.3
21071,2020-05-01,11062,9667,1395,12.6
21073,2020-05-01,25445,22704,2741,10.8
21075,2020-05-01,2101,1918,183,8.7
21077,2020-05-01,4115,3742,373,9.1
21079,2020-05-01,7770,7009,761,9.8
21081,2020-05-01,12036,10551,1485,12.3
21083,2020-05-01,16406,15048,1358,8.3
21085,2020-05-01,11191,9803,1388,12.4
21087,2020-05-01,5464,4982,482,8.8
21089,2020-05-01,13761,11910,1851,13.5
21091,2020-05-01,3972,3505,467,11.8
21093,2020-05-01,49266,42665,6601,13.4
21095,2020-05-01,6780,5757,1023,15.1
21097,2020-05-01,9036,8118,918,10.2
21099,2020-05-01,8162,7382,780,9.6
21101,2020-05-01,21638,19528,2110,9.8
21103,2020-05-01,8407,7518,889,10.6
21105,2020-05-01,1831,1704,127,6.9
21107,2020-05-01,18495,16092,2403,13
21109,2020-05-01,4272,3664,608,14.2
21111,2020-05-01,401662,353303,48359,12
21113,2020-05-01,26557,24166,2391,9
21115,2020-05-01,6931,6125,806,11.6
21117,2020-05-01,87800,79508,8292,9.4
21119,2020-05-01,4458,4000,458,10.3
21121,2020-05-01,10212,8832,1380,13.5
21123,2020-05-01,6091,5292,799,13.1
21125,2020-05-01,25407,22329,3078,12.1
21127,2020-05-01,5543,4919,624,11.3
21129,2020-05-01,2181,1956,225,10.3
21131,2020-05-01,2735,2357,378,13.8
21133,2020-05-01,6353,5507,846,13.3
21135,2020-05-01,5000,4308,692,13.8
21137,2020-05-01,9742,8552,1190,12.2
21139,2020-05-01,3616,3202,414,11.4
21141,2020-05-01,12679,11552,1127,8.9
21143,2020-05-01,3102,2887,215,6.9
21145,2020-05-01,29162,25821,3341,11.5
21147,2020-05-01,5012,4477,535,10.7
21149,2020-05-01,4136,3780,356,8.6
21151,2020-05-01,46393,41470,4923,10.6
21153,2020-05-01,3367,2659,708,21
21155,2020-05-01,9345,7630,1715,18.4
21157,2020-05-01,15259,13863,1396,9.1
21159,2020-05-01,2684,2265,419,15.6
21161,2020-05-01,7185,6189,996,13.9
21163,2020-05-01,12078,10580,1498,12.4
21165,2020-05-01,2236,1969,267,11.9
21167,2020-05-01,10456,9270,1186,11.3
21169,2020-05-01,4221,3662,559,13.2
21171,2020-05-01,4733,4402,331,7
21173,2020-05-01,11582,10022,1560,13.5
21175,2020-05-01,4562,4162,400,8.8
21177,2020-05-01,10494,9165,1329,12.7
21179,2020-05-01,23436,20198,3238,13.8
21181,2020-05-01,3474,3068,406,11.7
21183,2020-05-01,9698,8626,1072,11.1
21185,2020-05-01,33035,30092,2943,8.9
21187,2020-05-01,5367,4804,563,10.5
21189,2020-05-01,1128,1026,102,9
21191,2020-05-01,6898,6363,535,7.8
21193,2020-05-01,8477,7463,1014,12
21195,2020-05-01,19501,17146,2355,12.1
21197,2020-05-01,5199,4653,546,10.5
21199,2020-05-01,26475,23113,3362,12.7
21201,2020-05-01,828,757,71,8.6
21203,2020-05-01,6641,5753,888,13.4
21205,2020-05-01,10165,8926,1239,12.2
21207,2020-05-01,6131,5205,926,15.1
21209,2020-05-01,30170,26990,3180,10.5
21211,2020-05-01,26052,23398,2654,10.2
21213,2020-05-01,8474,7271,1203,14.2
21215,2020-05-01,10674,9412,1262,11.8
21217,2020-05-01,13652,12154,1498,11
21219,2020-05-01,5641,5230,411,7.3
21221,2020-05-01,6299,5625,674,10.7
21223,2020-05-01,3929,3474,455,11.6
21225,2020-05-01,6163,5448,715,11.6
21227,2020-05-01,63432,55416,8016,12.6
21229,2020-05-01,6412,5628,784,12.2
21231,2020-05-01,7704,7040,664,8.6
21233,2020-05-01,5728,5136,592,10.3
21235,2020-05-01,13969,12334,1635,11.7
21237,2020-05-01,2119,1899,220,10.4
21239,2020-05-01,15607,14386,1221,7.8
22001,2020-05-01,23047,20501,2546,11
22003,2020-05-01,8314,6997,1317,15.8
22005,2020-05-01,62384,55116,7268,11.7
22007,2020-05-01,8732,7404,1328,15.2
22009,2020-05-01,15071,13123,1948,12.9
22011,2020-05-01,14492,13132,1360,9.4
22013,2020-05-01,5282,4730,552,10.5
22015,2020-05-01,54910,48916,5994,10.9
22017,2020-05-01,100657,85953,14704,14.6
22019,2020-05-01,98909,84829,14080,14.2
22021,2020-05-01,3563,3224,339,9.5
22023,2020-05-01,3449,3155,294,8.5
22025,2020-05-01,3357,3053,304,9.1
22027,2020-05-01,5303,4881,422,8
22029,2020-05-01,6775,6013,762,11.2
22031,2020-05-01,10105,9073,1032,10.2
22033,2020-05-01,223532,194627,28905,12.9
22035,2020-05-01,1774,1538,236,13.3
22037,2020-05-01,7447,6678,769,10.3
22039,2020-05-01,12024,10676,1348,11.2
22041,2020-05-01,7198,6428,770,10.7
22043,2020-05-01,7881,7149,732,9.3
22045,2020-05-01,27642,23800,3842,13.9
22047,2020-05-01,13632,11621,2011,14.8
22049,2020-05-01,6611,6115,496,7.5
22051,2020-05-01,209263,174744,34519,16.5
22053,2020-05-01,12879,11328,1551,12
22055,2020-05-01,112817,99517,13300,11.8
22057,2020-05-01,40559,36441,4118,10.2
22059,2020-05-01,6780,6351,429,6.3
22061,2020-05-01,20377,18463,1914,9.4
22063,2020-05-01,66467,58872,7595,11.4
22065,2020-05-01,3516,3098,418,11.9
22067,2020-05-01,9905,8634,1271,12.8
22069,2020-05-01,15746,14299,1447,9.2
22071,2020-05-01,181747,145434,36313,20
22073,2020-05-01,68073,60276,7797,11.5
22075,2020-05-01,9373,8183,1190,12.7
22077,2020-05-01,9343,8203,1140,12.2
22079,2020-05-01,53544,48439,5105,9.5
22081,2020-05-01,3491,3217,274,7.8
22083,2020-05-01,7950,7141,809,10.2
22085,2020-05-01,8964,8313,651,7.3
22087,2020-05-01,19762,16385,3377,17.1
22089,2020-05-01,23987,20679,3308,13.8
22091,2020-05-01,4251,3509,742,17.5
22093,2020-05-01,8737,7446,1291,14.8
22095,2020-05-01,19235,15742,3493,18.2
22097,2020-05-01,32145,28045,4100,12.8
22099,2020-05-01,21847,19099,2748,12.6
22101,2020-05-01,19743,16964,2779,14.1
22103,2020-05-01,112963,98880,14083,12.5
22105,2020-05-01,55815,46755,9060,16.2
22107,2020-05-01,1315,1179,136,10.3
22109,2020-05-01,45652,40103,5549,12.2
22111,2020-05-01,8609,7773,836,9.7
22113,2020-05-01,23243,20691,2552,11
22115,2020-05-01,15602,14012,1590,10.2
22117,2020-05-01,16394,14332,2062,12.6
22119,2020-05-01,13528,11947,1581,11.7
22121,2020-05-01,13051,11546,1505,11.5
22123,2020-05-01,3570,3141,429,12
22125,2020-05-01,5024,4600,424,8.4
22127,2020-05-01,4550,4154,396,8.7
23001,2020-05-01,55018,50309,4709,8.6
23003,2020-05-01,29573,27399,2174,7.4
23005,2020-05-01,161339,146119,15220,9.4
23007,2020-05-01,13448,12052,1396,10.4
23009,2020-05-01,27730,25444,2286,8.2
23011,2020-05-01,61955,57167,4788,7.7
23013,2020-05-01,19795,18173,1622,8.2
23015,2020-05-01,16559,15272,1287,7.8
23017,2020-05-01,25451,22809,2642,10.4
23019,2020-05-01,74392,67863,6529,8.8
23021,2020-05-01,7087,6564,523,7.4
23023,2020-05-01,19576,18061,1515,7.7
23025,2020-05-01,22126,19992,2134,9.6
23027,2020-05-01,20000,18587,1413,7.1
23029,2020-05-01,13529,12560,969,7.2
23031,2020-05-01,109967,100545,9422,8.6
24001,2020-05-01,30508,27168,3340,10.9
24003,2020-05-01,306455,280080,26375,8.6
24005,2020-05-01,440009,397720,42289,9.6
24009,2020-05-01,47738,44226,3512,7.4
24011,2020-05-01,17544,16257,1287,7.3
24013,2020-05-01,92237,85179,7058,7.7
24015,2020-05-01,50972,46963,4009,7.9
24017,2020-05-01,84791,77077,7714,9.1
24019,2020-05-01,16282,14939,1343,8.2
24021,2020-05-01,132116,120644,11472,8.7
24023,2020-05-01,15130,13651,1479,9.8
24025,2020-05-01,136631,124892,11739,8.6
24027,2020-05-01,181027,167528,13499,7.5
24029,2020-05-01,9862,9076,786,8
24031,2020-05-01,541732,495048,46684,8.6
24033,2020-05-01,497249,444692,52557,10.6
24035,2020-05-01,27320,25040,2280,8.3
24037,2020-05-01,56803,53262,3541,6.2
24039,2020-05-01,8399,7542,857,10.2
24041,2020-05-01,17588,16085,1503,8.5
24043,2020-05-01,72035,64980,7055,9.8
24045,2020-05-01,47206,41896,5310,11.2
24047,2020-05-01,24867,20550,4317,17.4
24510,2020-05-01,275686,245289,30397,11
25001,2020-05-01,105334,85908,19426,18.4
25003,2020-05-01,59882,50932,8950,14.9
25005,2020-05-01,290335,236198,54137,18.6
25007,2020-05-01,9383,7952,1431,15.3
25009,2020-05-01,408279,338096,70183,17.2
25011,2020-05-01,38505,33742,4763,12.4
25013,2020-05-01,217772,180799,36973,17
25015,2020-05-01,82415,72808,9607,11.7
25017,2020-05-01,853989,746630,107359,12.6
25019,2020-05-01,7646,6405,1241,16.2
25021,2020-05-01,373473,317590,55883,15
25023,2020-05-01,274487,227197,47290,17.2
25025,2020-05-01,440622,368075,72547,16.5
25027,2020-05-01,423502,360768,62734,14.8
26001,2020-05-01,3848,3141,707,18.4
26003,2020-05-01,3112,2471,641,20.6
26005,2020-05-01,63471,53221,10250,16.1
26007,2020-05-01,13393,11369,2024,15.1
26009,2020-05-01,10241,8158,2083,20.3
26011,2020-05-01,6078,4683,1395,23
26013,2020-05-01,3082,2331,751,24.4
26015,2020-05-01,31193,26194,4999,16
26017,2020-05-01,50403,40673,9730,19.3
26019,2020-05-01,8640,6941,1699,19.7
26021,2020-05-01,72504,58983,13521,18.6
26023,2020-05-01,20456,16793,3663,17.9
26025,2020-05-01,64267,50274,13993,21.8
26027,2020-05-01,25377,21220,4157,16.4
26029,2020-05-01,12631,9716,2915,23.1
26031,2020-05-01,10820,7761,3059,28.3
26033,2020-05-01,16044,13406,2638,16.4
26035,2020-05-01,12152,9427,2725,22.4
26037,2020-05-01,40667,34481,6186,15.2
26039,2020-05-01,5795,4533,1262,21.8
26041,2020-05-01,17148,14210,2938,17.1
26043,2020-05-01,12360,10764,1596,12.9
26045,2020-05-01,57820,47532,10288,17.8
26047,2020-05-01,17446,13345,4101,23.5
26049,2020-05-01,182612,136562,46050,25.2
26051,2020-05-01,9976,8076,1900,19
26053,2020-05-01,5762,4939,823,14.3
26055,2020-05-01,48941,39645,9296,19
26057,2020-05-01,18552,15479,3073,16.6
26059,2020-05-01,19753,15202,4551,23
26061,2020-05-01,15215,13022,2193,14.4
26063,2020-05-01,16390,13481,2909,17.7
26065,2020-05-01,147983,124782,23201,15.7
26067,2020-05-01,30653,24691,5962,19.4
26069,2020-05-01,10284,8149,2135,20.8
26071,2020-05-01,4972,4259,713,14.3
26073,2020-05-01,32348,26255,6093,18.8
26075,2020-05-01,75825,60846,14979,19.8
26077,2020-05-01,131343,111733,19610,14.9
26079,2020-05-01,8069,6209,1860,23.1
26081,2020-05-01,357350,296788,60562,16.9
26083,2020-05-01,866,714,152,17.6
26085,2020-05-01,4067,3258,809,19.9
26087,2020-05-01,38641,27810,10831,28
26089,2020-05-01,10217,8404,1813,17.7
26091,2020-05-01,46864,36679,10185,21.7
26093,2020-05-01,90405,71750,18655,20.6
26095,2020-05-01,2288,1935,353,15.4
26097,2020-05-01,4845,3495,1350,27.9
26099,2020-05-01,415707,304939,110768,26.6
26101,2020-05-01,10230,7858,2372,23.2
26103,2020-05-01,31450,25690,5760,18.3
26105,2020-05-01,13426,10917,2509,18.7
26107,2020-05-01,18062,14584,3478,19.3
26109,2020-05-01,10723,9363,1360,12.7
26111,2020-05-01,40176,33994,6182,15.4
26113,2020-05-01,7021,5659,1362,19.4
26115,2020-05-01,76745,60639,16106,21
26117,2020-05-01,28753,23073,5680,19.8
26119,2020-05-01,3068,2338,730,23.8
26121,2020-05-01,80590,60669,19921,24.7
26123,2020-05-01,23824,19439,4385,18.4
26125,2020-05-01,582523,464273,118250,20.3
26127,2020-05-01,12357,9895,2462,19.9
26129,2020-05-01,8243,6557,1686,20.5
26131,2020-05-01,2042,1617,425,20.8
26133,2020-05-01,11630,9487,2143,18.4
26135,2020-05-01,3033,2288,745,24.6
26137,2020-05-01,11964,9302,2662,22.3
26139,2020-05-01,158554,133452,25102,15.8
26141,2020-05-01,4978,3951,1027,20.6
26143,2020-05-01,8048,6123,1925,23.9
26145,2020-05-01,84396,66515,17881,21.2
26147,2020-05-01,70191,51395,18796,26.8
26149,2020-05-01,30192,24524,5668,18.8
26151,2020-05-01,20052,15540,4512,22.5
26153,2020-05-01,3309,2768,541,16.3
26155,2020-05-01,33791,26641,7150,21.2
26157,2020-05-01,24402,18967,5435,22.3
26159,2020-05-01,35231,29448,5783,16.4
26161,2020-05-01,192357,165985,26372,13.7
26163,2020-05-01,746427,541758,204669,27.4
26165,2020-05-01,15260,11849,3411,22.4
27001,2020-05-01,7373,6445,928,12.6
27003,2020-05-01,197393,174404,22989,11.6
27005,2020-05-01,18808,16881,1927,10.2
27007,2020-05-01,24900,22307,2593,10.4
27009,2020-05-01,22091,19595,2496,11.3
27011,2020-05-01,2510,2364,146,5.8
27013,2020-05-01,40313,36214,4099,10.2
27015,2020-05-01,14270,13101,1169,8.2
27017,2020-05-01,17500,15221,2279,13
27019,2020-05-01,57846,52300,5546,9.6
27021,2020-05-01,14156,12045,2111,14.9
27023,2020-05-01,6818,6298,520,7.6
27025,2020-05-01,29655,26388,3267,11
27027,2020-05-01,35929,33555,2374,6.6
27029,2020-05-01,4502,3944,558,12.4
27031,2020-05-01,2918,2409,509,17.4
27033,2020-05-01,6155,5770,385,6.3
27035,2020-05-01,32087,28090,3997,12.5
27037,2020-05-01,242465,213545,28920,11.9
27039,2020-05-01,12118,10942,1176,9.7
27041,2020-05-01,20750,19053,1697,8.2
27043,2020-05-01,7061,6365,696,9.9
27045,2020-05-01,11648,10667,981,8.4
27047,2020-05-01,16384,14796,1588,9.7
27049,2020-05-01,26320,23177,3143,11.9
27051,2020-05-01,3302,3084,218,6.6
27053,2020-05-01,709674,622539,87135,12.3
27055,2020-05-01,10014,9327,687,6.9
27057,2020-05-01,9809,8782,1027,10.5
27059,2020-05-01,21122,18774,2348,11.1
27061,2020-05-01,22077,18986,3091,14
27063,2020-05-01,5742,5362,380,6.6
27065,2020-05-01,8920,7935,985,11
27067,2020-05-01,24502,22789,1713,7
27069,2020-05-01,2470,2278,192,7.8
27071,2020-05-01,5790,5112,678,11.7
27073,2020-05-01,3514,3312,202,5.7
27075,2020-05-01,5192,4390,802,15.4
27077,2020-05-01,2362,2129,233,9.9
27079,2020-05-01,15857,14224,1633,10.3
27081,2020-05-01,3124,2967,157,5
27083,2020-05-01,14639,13718,921,6.3
27085,2020-05-01,19035,17377,1658,8.7
27087,2020-05-01,2144,1589,555,25.9
27089,2020-05-01,5479,5015,464,8.5
27091,2020-05-01,9942,9144,798,8
27093,2020-05-01,13143,12197,946,7.2
27095,2020-05-01,12792,11140,1652,12.9
27097,2020-05-01,17862,16149,1713,9.6
27099,2020-05-01,20964,19247,1717,8.2
27101,2020-05-01,4851,4572,279,5.8
27103,2020-05-01,20538,18738,1800,8.8
27105,2020-05-01,11445,10672,773,6.8
27107,2020-05-01,3336,3025,311,9.3
27109,2020-05-01,92945,82232,10713,11.5
27111,2020-05-01,31329,28973,2356,7.5
27113,2020-05-01,8509,7571,938,11
27115,2020-05-01,14051,11905,2146,15.3
27117,2020-05-01,4703,4454,249,5.3
27119,2020-05-01,16427,14935,1492,9.1
27121,2020-05-01,6539,6123,416,6.4
27123,2020-05-01,290351,253488,36863,12.7
27125,2020-05-01,2239,2007,232,10.4
27127,2020-05-01,7940,7139,801,10.1
27129,2020-05-01,8171,7456,715,8.8
27131,2020-05-01,36939,33712,3227,8.7
27133,2020-05-01,5645,5363,282,5
27135,2020-05-01,8091,7302,789,9.8
27137,2020-05-01,100545,86853,13692,13.6
27139,2020-05-01,84013,74131,9882,11.8
27141,2020-05-01,51817,46289,5528,10.7
27143,2020-05-01,8239,7546,693,8.4
27145,2020-05-01,91048,81623,9425,10.4
27147,2020-05-01,20191,18238,1953,9.7
27149,2020-05-01,5435,5226,209,3.8
27151,2020-05-01,4775,4462,313,6.6
27153,2020-05-01,13718,12660,1058,7.7
27155,2020-05-01,1762,1668,94,5.3
27157,2020-05-01,12590,11330,1260,10
27159,2020-05-01,5929,5296,633,10.7
27161,2020-05-01,9134,8229,905,9.9
27163,2020-05-01,142571,127336,15235,10.7
27165,2020-05-01,6686,6239,447,6.7
27167,2020-05-01,3486,3272,214,6.1
27169,2020-05-01,28126,25640,2486,8.8
27171,2020-05-01,74409,67196,7213,9.7
27173,2020-05-01,5338,4976,362,6.8
28001,2020-05-01,10260,8811,1449,14.1
28003,2020-05-01,14901,13725,1176,7.9
28005,2020-05-01,4459,4069,390,8.7
28007,2020-05-01,7098,6403,695,9.8
28009,2020-05-01,2900,2603,297,10.2
28011,2020-05-01,11496,10484,1012,8.8
28013,2020-05-01,5850,5317,533,9.1
28015,2020-05-01,3468,3158,310,8.9
28017,2020-05-01,6991,5949,1042,14.9
28019,2020-05-01,3565,3314,251,7
28021,2020-05-01,3112,2544,568,18.3
28023,2020-05-01,5766,5155,611,10.6
28025,2020-05-01,8105,6854,1251,15.4
28027,2020-05-01,8588,7163,1425,16.6
28029,2020-05-01,10358,9308,1050,10.1
28031,2020-05-01,8203,7554,649,7.9
28033,2020-05-01,87559,80313,7246,8.3
28035,2020-05-01,31839,28325,3514,11
28037,2020-05-01,2774,2507,267,9.6
28039,2020-05-01,9057,8014,1043,11.5
28041,2020-05-01,4407,3913,494,11.2
28043,2020-05-01,9150,8335,815,8.9
28045,2020-05-01,17766,15370,2396,13.5
28047,2020-05-01,85674,70937,14737,17.2
28049,2020-05-01,101941,87739,14202,13.9
28051,2020-05-01,5911,4552,1359,23
28053,2020-05-01,2362,2016,346,14.6
28055,2020-05-01,364,336,28,7.7
28057,2020-05-01,9912,8970,942,9.5
28059,2020-05-01,56549,47330,9219,16.3
28061,2020-05-01,6096,5505,591,9.7
28063,2020-05-01,2016,1609,407,20.2
28065,2020-05-01,3983,3535,448,11.2
28067,2020-05-01,25407,23370,2037,8
28069,2020-05-01,3458,3051,407,11.8
28071,2020-05-01,25087,22899,2188,8.7
28073,2020-05-01,29221,26727,2494,8.5
28075,2020-05-01,29025,26116,2909,10
28077,2020-05-01,4672,4173,499,10.7
28079,2020-05-01,8288,7356,932,11.2
28081,2020-05-01,40051,34967,5084,12.7
28083,2020-05-01,9819,8659,1160,11.8
28085,2020-05-01,14339,12911,1428,10
28087,2020-05-01,24381,21588,2793,11.5
28089,2020-05-01,51021,45381,5640,11.1
28091,2020-05-01,9874,9029,845,8.6
28093,2020-05-01,13627,12377,1250,9.2
28095,2020-05-01,15407,13499,1908,12.4
28097,2020-05-01,3962,3575,387,9.8
28099,2020-05-01,11028,9418,1610,14.6
28101,2020-05-01,7898,7003,895,11.3
28103,2020-05-01,4028,3489,539,13.4
28105,2020-05-01,20982,18790,2192,10.4
28107,2020-05-01,12712,11152,1560,12.3
28109,2020-05-01,22221,20069,2152,9.7
28111,2020-05-01,4096,3655,441,10.8
28113,2020-05-01,14582,13018,1564,10.7
28115,2020-05-01,14353,12743,1610,11.2
28117,2020-05-01,11005,10005,1000,9.1
28119,2020-05-01,2495,2176,319,12.8
28121,2020-05-01,70911,65322,5589,7.9
28123,2020-05-01,12524,11524,1000,8
28125,2020-05-01,1561,1378,183,11.7
28127,2020-05-01,9971,9150,821,8.2
28129,2020-05-01,6594,6186,408,6.2
28131,2020-05-01,6769,6044,725,10.7
28133,2020-05-01,7670,6865,805,10.5
28135,2020-05-01,5327,4932,395,7.4
28137,2020-05-01,11755,10606,1149,9.8
28139,2020-05-01,9146,8347,799,8.7
28141,2020-05-01,8273,7579,694,8.4
28143,2020-05-01,5062,3814,1248,24.7
28145,2020-05-01,13822,12373,1449,10.5
28147,2020-05-01,4990,4513,477,9.6
28149,2020-05-01,20164,17513,2651,13.1
28151,2020-05-01,16122,14038,2084,12.9
28153,2020-05-01,7688,6957,731,9.5
28155,2020-05-01,3743,3412,331,8.8
28157,2020-05-01,2713,2344,369,13.6
28159,2020-05-01,7244,6388,856,11.8
28161,2020-05-01,4738,4193,545,11.5
28163,2020-05-01,9938,8546,1392,14
29001,2020-05-01,9540,8953,587,6.2
29003,2020-05-01,9193,8720,473,5.1
29005,2020-05-01,2719,2576,143,5.3
29007,2020-05-01,10043,8981,1062,10.6
29009,2020-05-01,15533,14008,1525,9.8
29011,2020-05-01,4985,4645,340,6.8
29013,2020-05-01,7146,6675,471,6.6
29015,2020-05-01,7047,6351,696,9.9
29017,2020-05-01,5150,4741,409,7.9
29019,2020-05-01,89744,83825,5919,6.6
29021,2020-05-01,41578,38737,2841,6.8
29023,2020-05-01,17590,15890,1700,9.7
29025,2020-05-01,4111,3738,373,9.1
29027,2020-05-01,20258,19041,1217,6
29029,2020-05-01,17835,16041,1794,10.1
29031,2020-05-01,38383,35185,3198,8.3
29033,2020-05-01,4516,4232,284,6.3
29035,2020-05-01,2451,2245,206,8.4
29037,2020-05-01,50488,46421,4067,8.1
29039,2020-05-01,5498,5215,283,5.1
29041,2020-05-01,3605,3449,156,4.3
29043,2020-05-01,42501,39220,3281,7.7
29045,2020-05-01,3127,2834,293,9.4
29047,2020-05-01,132160,116038,16122,12.2
29049,2020-05-01,10230,9085,1145,11.2
29051,2020-05-01,37067,34794,2273,6.1
29053,2020-05-01,6831,6208,623,9.1
29055,2020-05-01,10332,9373,959,9.3
29057,2020-05-01,3452,3274,178,5.2
29059,2020-05-01,6629,6126,503,7.6
29061,2020-05-01,4040,3824,216,5.3
29063,2020-05-01,4580,4328,252,5.5
29065,2020-05-01,6025,5679,346,5.7
29067,2020-05-01,5059,4405,654,12.9
29069,2020-05-01,11419,10407,1012,8.9
29071,2020-05-01,50090,44671,5419,10.8
29073,2020-05-01,7397,6678,719,9.7
29075,2020-05-01,3344,3233,111,3.3
29077,2020-05-01,142436,130395,12041,8.5
29079,2020-05-01,4172,3923,249,6
29081,2020-05-01,3680,3492,188,5.1
29083,2020-05-01,9197,8406,791,8.6
29085,2020-05-01,3604,3391,213,5.9
29087,2020-05-01,2514,2427,87,3.5
29089,2020-05-01,4535,4271,264,5.8
29091,2020-05-01,15415,14069,1346,8.7
29093,2020-05-01,3398,3072,326,9.6
29095,2020-05-01,341571,302198,39373,11.5
29097,2020-05-01,53366,48540,4826,9
29099,2020-05-01,109858,98754,11104,10.1
29101,2020-05-01,22162,20369,1793,8.1
29103,2020-05-01,1693,1628,65,3.8
29105,2020-05-01,16208,14218,1990,12.3
29107,2020-05-01,15653,14397,1256,8
29109,2020-05-01,17037,15610,1427,8.4
29111,2020-05-01,4763,4396,367,7.7
29113,2020-05-01,27465,24416,3049,11.1
29115,2020-05-01,4865,4550,315,6.5
29117,2020-05-01,7169,6875,294,4.1
29119,2020-05-01,9872,9243,629,6.4
29121,2020-05-01,7168,6781,387,5.4
29123,2020-05-01,5221,4730,491,9.4
29125,2020-05-01,3775,3552,223,5.9
29127,2020-05-01,13555,12721,834,6.2
29129,2020-05-01,1908,1834,74,3.9
29131,2020-05-01,11685,10548,1137,9.7
29133,2020-05-01,5498,5186,312,5.7
29135,2020-05-01,7083,6678,405,5.7
29137,2020-05-01,3730,3454,276,7.4
29139,2020-05-01,5552,5123,429,7.7
29141,2020-05-01,8147,7467,680,8.3
29143,2020-05-01,8249,7621,628,7.6
29145,2020-05-01,25503,23189,2314,9.1
29147,2020-05-01,10108,9571,537,5.3
29149,2020-05-01,3850,3542,308,8
29151,2020-05-01,6703,6409,294,4.4
29153,2020-05-01,3485,3152,333,9.6
29155,2020-05-01,6043,5400,643,10.6
29157,2020-05-01,9485,8267,1218,12.8
29159,2020-05-01,19894,17696,2198,11
29161,2020-05-01,18575,17476,1099,5.9
29163,2020-05-01,7351,6696,655,8.9
29165,2020-05-01,55637,50070,5567,10
29167,2020-05-01,13402,12540,862,6.4
29169,2020-05-01,14097,13050,1047,7.4
29171,2020-05-01,2236,2105,131,5.9
29173,2020-05-01,5361,5050,311,5.8
29175,2020-05-01,9930,9080,850,8.6
29177,2020-05-01,10870,9282,1588,14.6
29179,2020-05-01,2885,2676,209,7.2
29181,2020-05-01,4947,4352,595,12
29183,2020-05-01,212118,192375,19743,9.3
29185,2020-05-01,3685,3388,297,8.1
29186,2020-05-01,8823,8137,686,7.8
29187,2020-05-01,25304,22602,2702,10.7
29189,2020-05-01,494496,443574,50922,10.3
29195,2020-05-01,9997,9521,476,4.8
29197,2020-05-01,1857,1763,94,5.1
29199,2020-05-01,2259,2182,77,3.4
29201,2020-05-01,19047,17710,1337,7
29203,2020-05-01,3196,2894,302,9.4
29205,2020-05-01,2938,2810,128,4.4
29207,2020-05-01,12951,11956,995,7.7
29209,2020-05-01,11623,9498,2125,18.3
29211,2020-05-01,2717,2618,99,3.6
29213,2020-05-01,24664,18265,6399,25.9
29215,2020-05-01,8626,8063,563,6.5
29217,2020-05-01,9260,8807,453,4.9
29219,2020-05-01,17201,15537,1664,9.7
29221,2020-05-01,9612,8601,1011,10.5
29223,2020-05-01,4986,4570,416,8.3
29225,2020-05-01,16369,15108,1261,7.7
29227,2020-05-01,1173,1119,54,4.6
29229,2020-05-01,7250,6605,645,8.9
29510,2020-05-01,145447,125681,19766,13.6
30001,2020-05-01,4921,4657,264,5.4
30003,2020-05-01,4762,4319,443,9.3
30005,2020-05-01,2271,2155,116,5.1
30007,2020-05-01,2529,2328,201,7.9
30009,2020-05-01,5473,4978,495,9
30011,2020-05-01,598,580,18,3
30013,2020-05-01,37125,33933,3192,8.6
30015,2020-05-01,2385,2269,116,4.9
30017,2020-05-01,6169,5771,398,6.5
30019,2020-05-01,893,861,32,3.6
30021,2020-05-01,4587,4208,379,8.3
30023,2020-05-01,4961,4623,338,6.8
30025,2020-05-01,1555,1469,86,5.5
30027,2020-05-01,5728,5395,333,5.8
30029,2020-05-01,48859,42802,6057,12.4
30031,2020-05-01,68314,61912,6402,9.4
30033,2020-05-01,709,688,21,3
30035,2020-05-01,5385,4832,553,10.3
30037,2020-05-01,353,328,25,7.1
30039,2020-05-01,1501,1310,191,12.7
30041,2020-05-01,7401,6929,472,6.4
30043,2020-05-01,5629,5222,407,7.2
30045,2020-05-01,944,886,58,6.1
30047,2020-05-01,13403,12302,1101,8.2
30049,2020-05-01,35505,32981,2524,7.1
30051,2020-05-01,916,893,23,2.5
30053,2020-05-01,8117,7054,1063,13.1
30055,2020-05-01,940,907,33,3.5
30057,2020-05-01,3891,3537,354,9.1
30059,2020-05-01,885,824,61,6.9
30061,2020-05-01,1752,1510,242,13.8
30063,2020-05-01,63295,56964,6331,10
30065,2020-05-01,2278,2102,176,7.7
30067,2020-05-01,8772,7519,1253,14.3
30069,2020-05-01,252,243,9,3.6
30071,2020-05-01,1849,1739,110,5.9
30073,2020-05-01,2640,2473,167,6.3
30075,2020-05-01,896,861,35,3.9
30077,2020-05-01,2900,2709,191,6.6
30079,2020-05-01,460,423,37,8
30081,2020-05-01,20265,18727,1538,7.6
30083,2020-05-01,5940,5391,549,9.2
30085,2020-05-01,4397,4050,347,7.9
30087,2020-05-01,3815,3504,311,8.2
30089,2020-05-01,5055,4549,506,10
30091,2020-05-01,1697,1588,109,6.4
30093,2020-05-01,16817,15244,1573,9.4
30095,2020-05-01,5202,4828,374,7.2
30097,2020-05-01,1808,1721,87,4.8
30099,2020-05-01,2722,2578,144,5.3
30101,2020-05-01,2095,1946,149,7.1
30103,2020-05-01,330,315,15,4.5
30105,2020-05-01,3928,3712,216,5.5
30107,2020-05-01,754,678,76,10.1
30109,2020-05-01,437,409,28,6.4
30111,2020-05-01,81603,75008,6595,8.1
31001,2020-05-01,16776,15839,937,5.6
31003,2020-05-01,4012,3931,81,2
31005,2020-05-01,225,215,10,4.4
31007,2020-05-01,372,362,10,2.7
31009,2020-05-01,251,246,5,2
31011,2020-05-01,2931,2854,77,2.6
31013,2020-05-01,5431,5130,301,5.5
31015,2020-05-01,1060,1028,32,3
31017,2020-05-01,1394,1357,37,2.7
31019,2020-05-01,27136,25284,1852,6.8
31021,2020-05-01,3515,3372,143,4.1
31023,2020-05-01,4584,4382,202,4.4
31025,2020-05-01,13348,12636,712,5.3
31027,2020-05-01,4571,4438,133,2.9
31029,2020-05-01,2283,2241,42,1.8
31031,2020-05-01,3336,3248,88,2.6
31033,2020-05-01,4269,4063,206,4.8
31035,2020-05-01,3295,3162,133,4
31037,2020-05-01,5603,5385,218,3.9
31039,2020-05-01,4886,4755,131,2.7
31041,2020-05-01,6350,6178,172,2.7
31043,2020-05-01,10382,9743,639,6.2
31045,2020-05-01,4939,4794,145,2.9
31047,2020-05-01,13373,12803,570,4.3
31049,2020-05-01,935,907,28,3
31051,2020-05-01,2870,2758,112,3.9
31053,2020-05-01,20162,19363,799,4
31055,2020-05-01,299860,280081,19779,6.6
31057,2020-05-01,1160,1138,22,1.9
31059,2020-05-01,3187,3075,112,3.5
31061,2020-05-01,1448,1393,55,3.8
31063,2020-05-01,1533,1489,44,2.9
31065,2020-05-01,2629,2553,76,2.9
31067,2020-05-01,10876,10391,485,4.5
31069,2020-05-01,1057,1016,41,3.9
31071,2020-05-01,1130,1107,23,2
31073,2020-05-01,1088,1052,36,3.3
31075,2020-05-01,404,398,6,1.5
31077,2020-05-01,1261,1220,41,3.3
31079,2020-05-01,32136,29355,2781,8.7
31081,2020-05-01,4679,4464,215,4.6
31083,2020-05-01,1790,1721,69,3.9
31085,2020-05-01,632,622,10,1.6
31087,2020-05-01,1311,1268,43,3.3
31089,2020-05-01,5815,5668,147,2.5
31091,2020-05-01,396,386,10,2.5
31093,2020-05-01,3313,3108,205,6.2
31095,2020-05-01,4201,4068,133,3.2
31097,2020-05-01,2071,1983,88,4.2
31099,2020-05-01,3785,3617,168,4.4
31101,2020-05-01,4566,4395,171,3.7
31103,2020-05-01,593,582,11,1.9
31105,2020-05-01,2013,1929,84,4.2
31107,2020-05-01,4641,4503,138,3
31109,2020-05-01,176587,166990,9597,5.4
31111,2020-05-01,18540,17581,959,5.2
31113,2020-05-01,476,461,15,3.2
31115,2020-05-01,393,382,11,2.8
31117,2020-05-01,441,430,11,2.5
31119,2020-05-01,19555,18765,790,4
31121,2020-05-01,3957,3744,213,5.4
31123,2020-05-01,2647,2538,109,4.1
31125,2020-05-01,1950,1873,77,3.9
31127,2020-05-01,3557,3408,149,4.2
31129,2020-05-01,2469,2410,59,2.4
31131,2020-05-01,8414,8069,345,4.1
31133,2020-05-01,1478,1432,46,3.1
31135,2020-05-01,1835,1801,34,1.9
31137,2020-05-01,5021,4828,193,3.8
31139,2020-05-01,4059,3942,117,2.9
31141,2020-05-01,17629,16611,1018,5.8
31143,2020-05-01,2913,2798,115,3.9
31145,2020-05-01,5816,5596,220,3.8
31147,2020-05-01,4217,4084,133,3.2
31149,2020-05-01,883,863,20,2.3
31151,2020-05-01,7369,7062,307,4.2
31153,2020-05-01,96524,91277,5247,5.4
31155,2020-05-01,11029,10566,463,4.2
31157,2020-05-01,18148,17298,850,4.7
31159,2020-05-01,8861,8361,500,5.6
31161,2020-05-01,2713,2653,60,2.2
31163,2020-05-01,1642,1583,59,3.6
31165,2020-05-01,727,714,13,1.8
31167,2020-05-01,3509,3390,119,3.4
31169,2020-05-01,2786,2710,76,2.7
31171,2020-05-01,423,409,14,3.3
31173,2020-05-01,2984,2754,230,7.7
31175,2020-05-01,2124,2061,63,3
31177,2020-05-01,11049,10548,501,4.5
31179,2020-05-01,5499,5321,178,3.2
31181,2020-05-01,1648,1572,76,4.6
31183,2020-05-01,547,537,10,1.8
31185,2020-05-01,7162,6802,360,5
32001,2020-05-01,10173,9247,926,9.1
32003,2020-05-01,NA,762419,298230,28.1
32005,2020-05-01,19950,16488,3462,17.4
32007,2020-05-01,24391,21203,3188,13.1
32009,2020-05-01,361,339,22,6.1
32011,2020-05-01,878,840,38,4.3
32013,2020-05-01,7341,6729,612,8.3
32015,2020-05-01,2854,2672,182,6.4
32017,2020-05-01,1787,1671,116,6.5
32019,2020-05-01,21383,18356,3027,14.2
32021,2020-05-01,1910,1747,163,8.5
32023,2020-05-01,16308,13665,2643,16.2
32027,2020-05-01,2301,2155,146,6.3
32029,2020-05-01,1865,1581,284,15.2
32031,2020-05-01,234243,197898,36345,15.5
32033,2020-05-01,4219,3975,244,5.8
32510,2020-05-01,24383,20801,3582,14.7
33001,2020-05-01,30968,26514,4454,14.4
33003,2020-05-01,21955,18189,3766,17.2
33005,2020-05-01,39463,34953,4510,11.4
33007,2020-05-01,14261,12033,2228,15.6
33009,2020-05-01,47278,41553,5725,12.1
33011,2020-05-01,241594,207807,33787,14
33013,2020-05-01,82064,72518,9546,11.6
33015,2020-05-01,185387,158708,26679,14.4
33017,2020-05-01,73280,63663,9617,13.1
33019,2020-05-01,22924,20760,2164,9.4
34001,2020-05-01,120815,77360,43455,36
34003,2020-05-01,474845,396097,78748,16.6
34005,2020-05-01,227735,195639,32096,14.1
34007,2020-05-01,255575,212421,43154,16.9
34009,2020-05-01,43088,32485,10603,24.6
34011,2020-05-01,67495,56365,11130,16.5
34013,2020-05-01,375389,306889,68500,18.2
34015,2020-05-01,150679,126511,24168,16
34017,2020-05-01,358865,295382,63483,17.7
34019,2020-05-01,62518,54812,7706,12.3
34021,2020-05-01,203120,179596,23524,11.6
34023,2020-05-01,427595,364215,63380,14.8
34025,2020-05-01,323537,273155,50382,15.6
34027,2020-05-01,249858,216545,33313,13.3
34029,2020-05-01,277088,230245,46843,16.9
34031,2020-05-01,248333,196567,51766,20.8
34033,2020-05-01,29601,25294,4307,14.6
34035,2020-05-01,165465,144058,21407,12.9
34037,2020-05-01,74488,62317,12171,16.3
34039,2020-05-01,276125,231352,44773,16.2
34041,2020-05-01,55051,47169,7882,14.3
35001,2020-05-01,317163,284465,32698,10.3
35003,2020-05-01,1113,1041,72,6.5
35005,2020-05-01,26824,24440,2384,8.9
35006,2020-05-01,8528,7704,824,9.7
35007,2020-05-01,4695,4299,396,8.4
35009,2020-05-01,21268,20067,1201,5.6
35011,2020-05-01,683,655,28,4.1
35013,2020-05-01,94362,85492,8870,9.4
35015,2020-05-01,32589,30338,2251,6.9
35017,2020-05-01,11985,10807,1178,9.8
35019,2020-05-01,1429,1340,89,6.2
35021,2020-05-01,270,262,8,3
35023,2020-05-01,1866,1768,98,5.3
35025,2020-05-01,28594,25415,3179,11.1
35027,2020-05-01,8565,7609,956,11.2
35028,2020-05-01,9582,9219,363,3.8
35029,2020-05-01,9973,8457,1516,15.2
35031,2020-05-01,22643,20374,2269,10
35033,2020-05-01,2017,1849,168,8.3
35035,2020-05-01,24281,21796,2485,10.2
35037,2020-05-01,2968,2772,196,6.6
35039,2020-05-01,16178,14755,1423,8.8
35041,2020-05-01,7855,7400,455,5.8
35043,2020-05-01,63659,56753,6906,10.8
35045,2020-05-01,48593,43009,5584,11.5
35047,2020-05-01,9992,9093,899,9
35049,2020-05-01,68981,61541,7440,10.8
35051,2020-05-01,3893,3512,381,9.8
35053,2020-05-01,5928,5495,433,7.3
35055,2020-05-01,13858,11696,2162,15.6
35057,2020-05-01,5039,4538,501,9.9
35059,2020-05-01,1599,1516,83,5.2
35061,2020-05-01,28603,25980,2623,9.2
36001,2020-05-01,154810,138793,16017,10.3
36003,2020-05-01,18487,16454,2033,11
36005,2020-05-01,555144,418630,136514,24.6
36007,2020-05-01,81276,71374,9902,12.2
36009,2020-05-01,31886,27092,4794,15
36011,2020-05-01,34517,30532,3985,11.5
36013,2020-05-01,51800,45403,6397,12.3
36015,2020-05-01,35028,30198,4830,13.8
36017,2020-05-01,21678,19775,1903,8.8
36019,2020-05-01,34616,30279,4337,12.5
36021,2020-05-01,29822,27212,2610,8.8
36023,2020-05-01,22074,19604,2470,11.2
36025,2020-05-01,18249,16472,1777,9.7
36027,2020-05-01,140162,124129,16033,11.4
36029,2020-05-01,429894,364855,65039,15.1
36031,2020-05-01,15733,13707,2026,12.9
36033,2020-05-01,18899,16567,2332,12.3
36035,2020-05-01,22352,19653,2699,12.1
36037,2020-05-01,28225,25085,3140,11.1
36039,2020-05-01,19973,17586,2387,12
36041,2020-05-01,2035,1814,221,10.9
36043,2020-05-01,26757,23794,2963,11.1
36045,2020-05-01,42330,37029,5301,12.5
36047,2020-05-01,NA,853339,218995,20.4
36049,2020-05-01,10935,9834,1101,10.1
36051,2020-05-01,29069,26108,2961,10.2
36053,2020-05-01,31834,28030,3804,11.9
36055,2020-05-01,356314,312230,44084,12.4
36057,2020-05-01,21766,19193,2573,11.8
36059,2020-05-01,682195,592086,90109,13.2
36061,2020-05-01,777441,659241,118200,15.2
36063,2020-05-01,97405,80555,16850,17.3
36065,2020-05-01,99772,87459,12313,12.3
36067,2020-05-01,218566,190724,27842,12.7
36069,2020-05-01,53479,47765,5714,10.7
36071,2020-05-01,179336,156338,22998,12.8
36073,2020-05-01,16759,14705,2054,12.3
36075,2020-05-01,51535,44816,6719,13
36077,2020-05-01,26050,23614,2436,9.4
36079,2020-05-01,49527,43897,5630,11.4
36081,2020-05-01,NA,814254,226634,21.8
36083,2020-05-01,79420,71415,8005,10.1
36085,2020-05-01,194941,159518,35423,18.2
36087,2020-05-01,149906,131470,18436,12.3
36089,2020-05-01,42375,37533,4842,11.4
36091,2020-05-01,117800,105507,12293,10.4
36093,2020-05-01,76109,67226,8883,11.7
36095,2020-05-01,13932,12638,1294,9.3
36097,2020-05-01,7833,6784,1049,13.4
36099,2020-05-01,14672,12788,1884,12.8
36101,2020-05-01,41302,36214,5088,12.3
36103,2020-05-01,747463,646233,101230,13.5
36105,2020-05-01,34782,30352,4430,12.7
36107,2020-05-01,21947,19412,2535,11.6
36109,2020-05-01,47451,43326,4125,8.7
36111,2020-05-01,84756,74390,10366,12.2
36113,2020-05-01,30378,26345,4033,13.3
36115,2020-05-01,26190,23377,2813,10.7
36117,2020-05-01,41850,37384,4466,10.7
36119,2020-05-01,467072,410003,57069,12.2
36121,2020-05-01,17285,15421,1864,10.8
36123,2020-05-01,11061,10033,1028,9.3
37001,2020-05-01,77798,67183,10615,13.6
37003,2020-05-01,17237,14756,2481,14.4
37005,2020-05-01,3980,3456,524,13.2
37007,2020-05-01,10014,8860,1154,11.5
37009,2020-05-01,11918,10495,1423,11.9
37011,2020-05-01,6824,6039,785,11.5
37013,2020-05-01,18540,16689,1851,10
37015,2020-05-01,7390,6728,662,9
37017,2020-05-01,13622,12009,1613,11.8
37019,2020-05-01,50368,42117,8251,16.4
37021,2020-05-01,134742,109829,24913,18.5
37023,2020-05-01,38855,33310,5545,14.3
37025,2020-05-01,105380,91384,13996,13.3
37027,2020-05-01,34859,29631,5228,15
37029,2020-05-01,4382,3984,398,9.1
37031,2020-05-01,29725,26274,3451,11.6
37033,2020-05-01,9482,8150,1332,14
37035,2020-05-01,77236,64580,12656,16.4
37037,2020-05-01,33650,30406,3244,9.6
37039,2020-05-01,10989,9190,1799,16.4
37041,2020-05-01,5198,4718,480,9.2
37043,2020-05-01,3936,3412,524,13.3
37045,2020-05-01,47594,40864,6730,14.1
37047,2020-05-01,22102,19262,2840,12.8
37049,2020-05-01,39641,35067,4574,11.5
37051,2020-05-01,124565,103572,20993,16.9
37053,2020-05-01,13368,11660,1708,12.8
37055,2020-05-01,19215,14993,4222,22
37057,2020-05-01,75971,66167,9804,12.9
37059,2020-05-01,19632,16893,2739,14
37061,2020-05-01,23798,21612,2186,9.2
37063,2020-05-01,165827,146398,19429,11.7
37065,2020-05-01,20367,16882,3485,17.1
37067,2020-05-01,178990,153991,24999,14
37069,2020-05-01,29674,26096,3578,12.1
37071,2020-05-01,107685,91282,16403,15.2
37073,2020-05-01,4736,4301,435,9.2
37075,2020-05-01,3176,2573,603,19
37077,2020-05-01,28727,25714,3013,10.5
37079,2020-05-01,9181,8324,857,9.3
37081,2020-05-01,253505,213395,40110,15.8
37083,2020-05-01,19596,16835,2761,14.1
37085,2020-05-01,51187,44376,6811,13.3
37087,2020-05-01,27796,23282,4514,16.2
37089,2020-05-01,50067,42886,7181,14.3
37091,2020-05-01,8849,7961,888,10
37093,2020-05-01,19214,16317,2897,15.1
37095,2020-05-01,1730,1451,279,16.1
37097,2020-05-01,87169,74552,12617,14.5
37099,2020-05-01,19923,16437,3486,17.5
37101,2020-05-01,93942,83047,10895,11.6
37103,2020-05-01,4006,3626,380,9.5
37105,2020-05-01,25377,21695,3682,14.5
37107,2020-05-01,26686,24031,2655,9.9
37109,2020-05-01,42053,36519,5534,13.2
37111,2020-05-01,20281,17528,2753,13.6
37113,2020-05-01,14927,13072,1855,12.4
37115,2020-05-01,9120,7841,1279,14
37117,2020-05-01,8481,7558,923,10.9
37119,2020-05-01,604317,515770,88547,14.7
37121,2020-05-01,5713,4932,781,13.7
37123,2020-05-01,10907,9707,1200,11
37125,2020-05-01,38844,33265,5579,14.4
37127,2020-05-01,41078,35176,5902,14.4
37129,2020-05-01,117120,99897,17223,14.7
37131,2020-05-01,7172,6426,746,10.4
37133,2020-05-01,61552,53631,7921,12.9
37135,2020-05-01,74612,67461,7151,9.6
37137,2020-05-01,5019,4550,469,9.3
37139,2020-05-01,16152,14120,2032,12.6
37141,2020-05-01,26552,23304,3248,12.2
37143,2020-05-01,4640,4141,499,10.8
37145,2020-05-01,17931,15402,2529,14.1
37147,2020-05-01,84218,74667,9551,11.3
37149,2020-05-01,8589,7589,1000,11.6
37151,2020-05-01,62445,53799,8646,13.8
37153,2020-05-01,16615,14200,2415,14.5
37155,2020-05-01,48501,42105,6396,13.2
37157,2020-05-01,38203,32409,5794,15.2
37159,2020-05-01,64374,54184,10190,15.8
37161,2020-05-01,24161,20046,4115,17
37163,2020-05-01,27348,24791,2557,9.3
37165,2020-05-01,11263,9114,2149,19.1
37167,2020-05-01,28602,25294,3308,11.6
37169,2020-05-01,20118,17693,2425,12.1
37171,2020-05-01,31901,27887,4014,12.6
37173,2020-05-01,7346,5798,1548,21.1
37175,2020-05-01,13522,11956,1566,11.6
37177,2020-05-01,1270,1062,208,16.4
37179,2020-05-01,115731,103000,12731,11
37181,2020-05-01,17101,14273,2828,16.5
37183,2020-05-01,562515,493390,69125,12.3
37185,2020-05-01,6526,5480,1046,16
37187,2020-05-01,4187,3697,490,11.7
37189,2020-05-01,25660,22086,3574,13.9
37191,2020-05-01,48813,43684,5129,10.5
37193,2020-05-01,28098,24587,3511,12.5
37195,2020-05-01,33993,29071,4922,14.5
37197,2020-05-01,17033,14511,2522,14.8
37199,2020-05-01,7984,6987,997,12.5
38001,2020-05-01,998,950,48,4.8
38003,2020-05-01,5166,4856,310,6
38005,2020-05-01,2325,2044,281,12.1
38007,2020-05-01,461,436,25,5.4
38009,2020-05-01,3058,2836,222,7.3
38011,2020-05-01,1688,1598,90,5.3
38013,2020-05-01,1062,974,88,8.3
38015,2020-05-01,50846,47132,3714,7.3
38017,2020-05-01,105934,97838,8096,7.6
38019,2020-05-01,1958,1857,101,5.2
38021,2020-05-01,2342,2231,111,4.7
38023,2020-05-01,1442,1378,64,4.4
38025,2020-05-01,3178,2955,223,7
38027,2020-05-01,1224,1143,81,6.6
38029,2020-05-01,1516,1422,94,6.2
38031,2020-05-01,1609,1533,76,4.7
38033,2020-05-01,860,822,38,4.4
38035,2020-05-01,37136,33998,3138,8.5
38037,2020-05-01,1225,1182,43,3.5
38039,2020-05-01,1029,988,41,4
38041,2020-05-01,1427,1353,74,5.2
38043,2020-05-01,1287,1203,84,6.5
38045,2020-05-01,2071,2002,69,3.3
38047,2020-05-01,854,815,39,4.6
38049,2020-05-01,3136,2882,254,8.1
38051,2020-05-01,1103,1064,39,3.5
38053,2020-05-01,9795,8608,1187,12.1
38055,2020-05-01,4883,4573,310,6.3
38057,2020-05-01,3709,3428,281,7.6
38059,2020-05-01,16801,15485,1316,7.8
38061,2020-05-01,7120,6538,582,8.2
38063,2020-05-01,1433,1332,101,7
38065,2020-05-01,870,815,55,6.3
38067,2020-05-01,3636,3168,468,12.9
38069,2020-05-01,1717,1607,110,6.4
38071,2020-05-01,5889,5431,458,7.8
38073,2020-05-01,2931,2767,164,5.6
38075,2020-05-01,1255,1158,97,7.7
38077,2020-05-01,8792,8243,549,6.2
38079,2020-05-01,5092,4296,796,15.6
38081,2020-05-01,2864,2697,167,5.8
38083,2020-05-01,696,649,47,6.8
38085,2020-05-01,1193,1128,65,5.4
38087,2020-05-01,380,364,16,4.2
38089,2020-05-01,18956,16799,2157,11.4
38091,2020-05-01,959,912,47,4.9
38093,2020-05-01,10616,10043,573,5.4
38095,2020-05-01,1183,1142,41,3.5
38097,2020-05-01,4495,4226,269,6
38099,2020-05-01,5271,4921,350,6.6
38101,2020-05-01,32430,29163,3267,10.1
38103,2020-05-01,1921,1815,106,5.5
38105,2020-05-01,23834,20014,3820,16
39001,2020-05-01,10985,9500,1485,13.5
39003,2020-05-01,49315,41006,8309,16.8
39005,2020-05-01,26297,23476,2821,10.7
39007,2020-05-01,43601,37607,5994,13.7
39009,2020-05-01,25603,22842,2761,10.8
39011,2020-05-01,24933,21625,3308,13.3
39013,2020-05-01,29270,24260,5010,17.1
39015,2020-05-01,19363,16734,2629,13.6
39017,2020-05-01,194915,169185,25730,13.2
39019,2020-05-01,13030,11138,1892,14.5
39021,2020-05-01,20306,17880,2426,11.9
39023,2020-05-01,63874,54907,8967,14
39025,2020-05-01,106084,92953,13131,12.4
39027,2020-05-01,18081,15500,2581,14.3
39029,2020-05-01,48477,40242,8235,17
39031,2020-05-01,14551,12515,2036,14
39033,2020-05-01,19656,15860,3796,19.3
39035,2020-05-01,603000,492936,110064,18.3
39037,2020-05-01,26174,22796,3378,12.9
39039,2020-05-01,18418,15144,3274,17.8
39041,2020-05-01,110062,100001,10061,9.1
39043,2020-05-01,37637,29151,8486,22.5
39045,2020-05-01,78540,69730,8810,11.2
39047,2020-05-01,14199,12344,1855,13.1
39049,2020-05-01,710672,619364,91308,12.8
39051,2020-05-01,21777,18232,3545,16.3
39053,2020-05-01,12510,11060,1450,11.6
39055,2020-05-01,45268,40056,5212,11.5
39057,2020-05-01,81714,72648,9066,11.1
39059,2020-05-01,18509,15972,2537,13.7
39061,2020-05-01,416978,360230,56748,13.6
39063,2020-05-01,42577,36357,6220,14.6
39065,2020-05-01,14632,12388,2244,15.3
39067,2020-05-01,6948,5959,989,14.2
39069,2020-05-01,13411,11337,2074,15.5
39071,2020-05-01,17792,15132,2660,15
39073,2020-05-01,12953,11382,1571,12.1
39075,2020-05-01,20770,19560,1210,5.8
39077,2020-05-01,28385,23674,4711,16.6
39079,2020-05-01,13278,11516,1762,13.3
39081,2020-05-01,27939,23337,4602,16.5
39083,2020-05-01,31376,28129,3247,10.3
39085,2020-05-01,120899,102812,18087,15
39087,2020-05-01,24145,20580,3565,14.8
39089,2020-05-01,90753,80459,10294,11.3
39091,2020-05-01,23159,19686,3473,15
39093,2020-05-01,153287,124769,28518,18.6
39095,2020-05-01,215117,168043,47074,21.9
39097,2020-05-01,20834,18662,2172,10.4
39099,2020-05-01,102453,84706,17747,17.3
39101,2020-05-01,29105,25057,4048,13.9
39103,2020-05-01,93536,80092,13444,14.4
39105,2020-05-01,8977,7775,1202,13.4
39107,2020-05-01,23704,21302,2402,10.1
39109,2020-05-01,54287,47352,6935,12.8
39111,2020-05-01,6052,5173,879,14.5
39113,2020-05-01,257747,217477,40270,15.6
39115,2020-05-01,6638,5741,897,13.5
39117,2020-05-01,17049,14891,2158,12.7
39119,2020-05-01,40435,35468,4967,12.3
39121,2020-05-01,4709,4086,623,13.2
39123,2020-05-01,21181,18016,3165,14.9
39125,2020-05-01,9060,7638,1422,15.7
39127,2020-05-01,15959,13897,2062,12.9
39129,2020-05-01,26604,23500,3104,11.7
39131,2020-05-01,11110,9423,1687,15.2
39133,2020-05-01,85610,75305,10305,12
39135,2020-05-01,21166,18493,2673,12.6
39137,2020-05-01,18846,16642,2204,11.7
39139,2020-05-01,52694,43280,9414,17.9
39141,2020-05-01,35729,30413,5316,14.9
39143,2020-05-01,30761,25522,5239,17
39145,2020-05-01,29579,25749,3830,12.9
39147,2020-05-01,28492,23894,4598,16.1
39149,2020-05-01,24674,21061,3613,14.6
39151,2020-05-01,186396,160358,26038,14
39153,2020-05-01,273347,234884,38463,14.1
39155,2020-05-01,86659,71042,15617,18
39157,2020-05-01,44930,39032,5898,13.1
39159,2020-05-01,29118,26334,2784,9.6
39161,2020-05-01,14964,13056,1908,12.8
39163,2020-05-01,5681,4904,777,13.7
39165,2020-05-01,118343,104531,13812,11.7
39167,2020-05-01,27368,23589,3779,13.8
39169,2020-05-01,60604,54150,6454,10.6
39171,2020-05-01,18980,15728,3252,17.1
39173,2020-05-01,67875,57844,10031,14.8
39175,2020-05-01,12934,10682,2252,17.4
40001,2020-05-01,8661,7594,1067,12.3
40003,2020-05-01,2747,2594,153,5.6
40005,2020-05-01,5221,4729,492,9.4
40007,2020-05-01,2505,2388,117,4.7
40009,2020-05-01,10091,9019,1072,10.6
40011,2020-05-01,4477,4067,410,9.2
40013,2020-05-01,22491,20615,1876,8.3
40015,2020-05-01,12060,11018,1042,8.6
40017,2020-05-01,75161,67454,7707,10.3
40019,2020-05-01,21376,18664,2712,12.7
40021,2020-05-01,19579,17911,1668,8.5
40023,2020-05-01,5650,5071,579,10.2
40025,2020-05-01,1346,1314,32,2.4
40027,2020-05-01,140939,127201,13738,9.7
40029,2020-05-01,2263,2073,190,8.4
40031,2020-05-01,48294,42424,5870,12.2
40033,2020-05-01,2781,2398,383,13.8
40035,2020-05-01,5835,5382,453,7.8
40037,2020-05-01,30865,27925,2940,9.5
40039,2020-05-01,15286,14031,1255,8.2
40041,2020-05-01,18023,16372,1651,9.2
40043,2020-05-01,2695,2525,170,6.3
40045,2020-05-01,2206,2084,122,5.5
40047,2020-05-01,26782,24621,2161,8.1
40049,2020-05-01,12774,11619,1155,9
40051,2020-05-01,26048,23636,2412,9.3
40053,2020-05-01,2745,2623,122,4.4
40055,2020-05-01,1883,1690,193,10.2
40057,2020-05-01,1177,1132,45,3.8
40059,2020-05-01,1771,1697,74,4.2
40061,2020-05-01,4341,3899,442,10.2
40063,2020-05-01,5402,4896,506,9.4
40065,2020-05-01,10690,10069,621,5.8
40067,2020-05-01,2584,2302,282,10.9
40069,2020-05-01,3857,3396,461,12
40071,2020-05-01,18451,16637,1814,9.8
40073,2020-05-01,8920,8311,609,6.8
40075,2020-05-01,3560,3294,266,7.5
40077,2020-05-01,3189,2797,392,12.3
40079,2020-05-01,18958,16902,2056,10.8
40081,2020-05-01,15264,13956,1308,8.6
40083,2020-05-01,21640,19899,1741,8
40085,2020-05-01,6709,6204,505,7.5
40087,2020-05-01,19522,17767,1755,9
40089,2020-05-01,15086,13888,1198,7.9
40091,2020-05-01,7129,6379,750,10.5
40093,2020-05-01,3683,3427,256,7
40095,2020-05-01,6834,6078,756,11.1
40097,2020-05-01,19415,17981,1434,7.4
40099,2020-05-01,6294,5706,588,9.3
40101,2020-05-01,28851,26339,2512,8.7
40103,2020-05-01,5408,5066,342,6.3
40105,2020-05-01,4522,4155,367,8.1
40107,2020-05-01,4392,4028,364,8.3
40109,2020-05-01,382035,341190,40845,10.7
40111,2020-05-01,15284,13789,1495,9.8
40113,2020-05-01,20290,18271,2019,10
40115,2020-05-01,14467,13032,1435,9.9
40117,2020-05-01,7212,6525,687,9.5
40119,2020-05-01,37270,33924,3346,9
40121,2020-05-01,16904,15092,1812,10.7
40123,2020-05-01,19166,17655,1511,7.9
40125,2020-05-01,32256,29260,2996,9.3
40127,2020-05-01,4458,4076,382,8.6
40129,2020-05-01,1823,1706,117,6.4
40131,2020-05-01,44299,40214,4085,9.2
40133,2020-05-01,9254,8339,915,9.9
40135,2020-05-01,16712,14633,2079,12.4
40137,2020-05-01,18730,16549,2181,11.6
40139,2020-05-01,10928,10626,302,2.8
40141,2020-05-01,2997,2539,458,15.3
40143,2020-05-01,322473,288508,33965,10.5
40145,2020-05-01,37596,34216,3380,9
40147,2020-05-01,22000,19984,2016,9.2
40149,2020-05-01,5207,4743,464,8.9
40151,2020-05-01,4560,4323,237,5.2
40153,2020-05-01,9264,8399,865,9.3
41001,2020-05-01,7428,6710,718,9.7
41003,2020-05-01,46171,42324,3847,8.3
41005,2020-05-01,217751,193674,24077,11.1
41007,2020-05-01,18816,15235,3581,19
41009,2020-05-01,23986,21230,2756,11.5
41011,2020-05-01,26749,22934,3815,14.3
41013,2020-05-01,10450,9092,1358,13
41015,2020-05-01,9027,7800,1227,13.6
41017,2020-05-01,97422,84512,12910,13.3
41019,2020-05-01,48446,42697,5749,11.9
41021,2020-05-01,1068,989,79,7.4
41023,2020-05-01,3243,2903,340,10.5
41025,2020-05-01,3649,3390,259,7.1
41027,2020-05-01,13638,12178,1460,10.7
41029,2020-05-01,105982,93479,12503,11.8
41031,2020-05-01,10568,9252,1316,12.5
41033,2020-05-01,36501,32457,4044,11.1
41035,2020-05-01,30007,26613,3394,11.3
41037,2020-05-01,3694,3452,242,6.6
41039,2020-05-01,179811,157904,21907,12.2
41041,2020-05-01,20830,16680,4150,19.9
41043,2020-05-01,59027,52391,6636,11.2
41045,2020-05-01,12767,11915,852,6.7
41047,2020-05-01,162794,145954,16840,10.3
41049,2020-05-01,5807,5465,342,5.9
41051,2020-05-01,460415,399591,60824,13.2
41053,2020-05-01,39814,36063,3751,9.4
41055,2020-05-01,1010,928,82,8.1
41057,2020-05-01,11780,10186,1594,13.5
41059,2020-05-01,38443,34706,3737,9.7
41061,2020-05-01,12302,10784,1518,12.3
41063,2020-05-01,3490,3143,347,9.9
41065,2020-05-01,12956,11451,1505,11.6
41067,2020-05-01,319599,287789,31810,10
41069,2020-05-01,712,679,33,4.6
41071,2020-05-01,54851,48900,5951,10.8
42001,2020-05-01,53382,46753,6629,12.4
42003,2020-05-01,637311,549468,87843,13.8
42005,2020-05-01,31250,27044,4206,13.5
42007,2020-05-01,83758,70750,13008,15.5
42009,2020-05-01,23937,20810,3127,13.1
42011,2020-05-01,213446,181667,31779,14.9
42013,2020-05-01,59733,51564,8169,13.7
42015,2020-05-01,28440,25472,2968,10.4
42017,2020-05-01,338749,294014,44735,13.2
42019,2020-05-01,96974,85170,11804,12.2
42021,2020-05-01,56657,48899,7758,13.7
42023,2020-05-01,2052,1606,446,21.7
42025,2020-05-01,31682,26978,4704,14.8
42027,2020-05-01,78043,71413,6630,8.5
42029,2020-05-01,278203,249810,28393,10.2
42031,2020-05-01,16678,14737,1941,11.6
42033,2020-05-01,35859,31259,4600,12.8
42035,2020-05-01,17769,15687,2082,11.7
42037,2020-05-01,33428,29313,4115,12.3
42039,2020-05-01,38757,33650,5107,13.2
42041,2020-05-01,130683,116904,13779,10.5
42043,2020-05-01,146055,125995,20060,13.7
42045,2020-05-01,293735,252633,41102,14
42047,2020-05-01,15575,12360,3215,20.6
42049,2020-05-01,126569,108304,18265,14.4
42051,2020-05-01,56895,47332,9563,16.8
42053,2020-05-01,1835,1589,246,13.4
42055,2020-05-01,78220,69120,9100,11.6
42057,2020-05-01,7781,6462,1319,17
42059,2020-05-01,15706,13502,2204,14
42061,2020-05-01,19910,17216,2694,13.5
42063,2020-05-01,37934,32913,5021,13.2
42065,2020-05-01,20427,17940,2487,12.2
42067,2020-05-01,12661,11537,1124,8.9
42069,2020-05-01,104333,89004,15329,14.7
42071,2020-05-01,283430,249090,34340,12.1
42073,2020-05-01,40589,34795,5794,14.3
42075,2020-05-01,72817,63936,8881,12.2
42077,2020-05-01,191869,163644,28225,14.7
42079,2020-05-01,158756,132933,25823,16.3
42081,2020-05-01,55895,48995,6900,12.3
42083,2020-05-01,17431,14760,2671,15.3
42085,2020-05-01,48224,41348,6876,14.3
42087,2020-05-01,21296,18951,2345,11
42089,2020-05-01,80632,65146,15486,19.2
42091,2020-05-01,444119,390523,53596,12.1
42093,2020-05-01,8959,8127,832,9.3
42095,2020-05-01,158921,136804,22117,13.9
42097,2020-05-01,42460,36884,5576,13.1
42099,2020-05-01,24162,21694,2468,10.2
42101,2020-05-01,734375,607497,126878,17.3
42103,2020-05-01,25379,21318,4061,16
42105,2020-05-01,7307,6467,840,11.5
42107,2020-05-01,67334,58442,8892,13.2
42109,2020-05-01,19267,17179,2088,10.8
42111,2020-05-01,32703,28387,4316,13.2
42113,2020-05-01,2540,2266,274,10.8
42115,2020-05-01,19710,17727,1983,10.1
42117,2020-05-01,19035,16794,2241,11.8
42119,2020-05-01,18926,16985,1941,10.3
42121,2020-05-01,22349,19665,2684,12
42123,2020-05-01,18743,16711,2032,10.8
42125,2020-05-01,105559,90541,15018,14.2
42127,2020-05-01,22246,19332,2914,13.1
42129,2020-05-01,177904,152744,25160,14.1
42131,2020-05-01,13158,11583,1575,12
42133,2020-05-01,233820,203106,30714,13.1
44001,2020-05-01,23507,21043,2464,10.5
44003,2020-05-01,84999,73711,11288,13.3
44005,2020-05-01,40538,35718,4820,11.9
44007,2020-05-01,308078,263183,44895,14.6
44009,2020-05-01,61849,54775,7074,11.4
45001,2020-05-01,10388,9055,1333,12.8
45003,2020-05-01,74947,67835,7112,9.5
45005,2020-05-01,2721,2401,320,11.8
45007,2020-05-01,89796,79158,10638,11.8
45009,2020-05-01,5045,4427,618,12.2
45011,2020-05-01,8037,7222,815,10.1
45013,2020-05-01,75867,67643,8224,10.8
45015,2020-05-01,102622,92117,10505,10.2
45017,2020-05-01,6550,5911,639,9.8
45019,2020-05-01,210619,184770,25849,12.3
45021,2020-05-01,25334,21567,3767,14.9
45023,2020-05-01,13723,11659,2064,15
45025,2020-05-01,22072,19941,2131,9.7
45027,2020-05-01,13085,11719,1366,10.4
45029,2020-05-01,16478,14985,1493,9.1
45031,2020-05-01,30490,27354,3136,10.3
45033,2020-05-01,13595,12436,1159,8.5
45035,2020-05-01,76405,68102,8303,10.9
45037,2020-05-01,10838,9789,1049,9.7
45039,2020-05-01,9727,8472,1255,12.9
45041,2020-05-01,66176,60308,5868,8.9
45043,2020-05-01,26501,23169,3332,12.6
45045,2020-05-01,252829,223312,29517,11.7
45047,2020-05-01,31823,28494,3329,10.5
45049,2020-05-01,8274,7684,590,7.1
45051,2020-05-01,149336,123715,25621,17.2
45053,2020-05-01,12422,11289,1133,9.1
45055,2020-05-01,29289,26630,2659,9.1
45057,2020-05-01,42312,37091,5221,12.3
45059,2020-05-01,30301,26120,4181,13.8
45061,2020-05-01,6957,6166,791,11.4
45063,2020-05-01,148092,136753,11339,7.7
45065,2020-05-01,3380,3022,358,10.6
45067,2020-05-01,13210,11769,1441,10.9
45069,2020-05-01,9660,8107,1553,16.1
45071,2020-05-01,19270,17753,1517,7.9
45073,2020-05-01,35688,31999,3689,10.3
45075,2020-05-01,35715,30813,4902,13.7
45077,2020-05-01,55904,50011,5893,10.5
45079,2020-05-01,197214,178055,19159,9.7
45081,2020-05-01,8808,8197,611,6.9
45083,2020-05-01,159602,138345,21257,13.3
45085,2020-05-01,42810,38076,4734,11.1
45087,2020-05-01,12084,10201,1883,15.6
45089,2020-05-01,12303,10837,1466,11.9
45091,2020-05-01,142540,126147,16393,11.5
46003,2020-05-01,1471,1404,67,4.6
46005,2020-05-01,9307,8860,447,4.8
46007,2020-05-01,1041,985,56,5.4
46009,2020-05-01,2852,2699,153,5.4
46011,2020-05-01,18414,17240,1174,6.4
46013,2020-05-01,20608,19181,1427,6.9
46015,2020-05-01,2457,2271,186,7.6
46017,2020-05-01,595,504,91,15.3
46019,2020-05-01,4925,4534,391,7.9
46021,2020-05-01,788,756,32,4.1
46023,2020-05-01,3788,3435,353,9.3
46025,2020-05-01,2082,1968,114,5.5
46027,2020-05-01,6749,6199,550,8.1
46029,2020-05-01,15166,14105,1061,7
46031,2020-05-01,1286,1219,67,5.2
46033,2020-05-01,4018,3679,339,8.4
46035,2020-05-01,10745,10105,640,6
46037,2020-05-01,2726,2537,189,6.9
46039,2020-05-01,2199,2066,133,6
46041,2020-05-01,2181,2046,135,6.2
46043,2020-05-01,1543,1497,46,3
46045,2020-05-01,1937,1869,68,3.5
46047,2020-05-01,3058,2800,258,8.4
46049,2020-05-01,1005,965,40,4
46051,2020-05-01,4332,4124,208,4.8
46053,2020-05-01,2028,1923,105,5.2
46055,2020-05-01,1058,1028,30,2.8
46057,2020-05-01,3304,3153,151,4.6
46059,2020-05-01,1743,1685,58,3.3
46061,2020-05-01,1695,1587,108,6.4
46063,2020-05-01,695,663,32,4.6
46065,2020-05-01,9766,9250,516,5.3
46067,2020-05-01,3589,3412,177,4.9
46069,2020-05-01,660,636,24,3.6
46071,2020-05-01,1151,1104,47,4.1
46073,2020-05-01,1139,1103,36,3.2
46075,2020-05-01,509,479,30,5.9
46077,2020-05-01,2625,2499,126,4.8
46079,2020-05-01,6461,6162,299,4.6
46081,2020-05-01,13355,11843,1512,11.3
46083,2020-05-01,35422,33275,2147,6.1
46085,2020-05-01,1576,1448,128,8.1
46087,2020-05-01,3026,2848,178,5.9
46089,2020-05-01,997,932,65,6.5
46091,2020-05-01,2349,2217,132,5.6
46093,2020-05-01,13849,12760,1089,7.9
46095,2020-05-01,646,587,59,9.1
46097,2020-05-01,1127,1080,47,4.2
46099,2020-05-01,113307,104484,8823,7.8
46101,2020-05-01,3955,3591,364,9.2
46102,2020-05-01,3490,3214,276,7.9
46103,2020-05-01,56967,52136,4831,8.5
46105,2020-05-01,1346,1287,59,4.4
46107,2020-05-01,1013,973,40,3.9
46109,2020-05-01,4703,4346,357,7.6
46111,2020-05-01,1116,1057,59,5.3
46115,2020-05-01,3068,2924,144,4.7
46117,2020-05-01,1856,1744,112,6
46119,2020-05-01,756,729,27,3.6
46121,2020-05-01,3004,2790,214,7.1
46123,2020-05-01,2948,2815,133,4.5
46125,2020-05-01,4590,4303,287,6.3
46127,2020-05-01,8369,7656,713,8.5
46129,2020-05-01,2134,1986,148,6.9
46135,2020-05-01,11837,11063,774,6.5
46137,2020-05-01,922,878,44,4.8
47001,2020-05-01,33229,30249,2980,9
47003,2020-05-01,20733,18152,2581,12.4
47005,2020-05-01,6595,5979,616,9.3
47007,2020-05-01,4100,3708,392,9.6
47009,2020-05-01,61189,56093,5096,8.3
47011,2020-05-01,52880,48744,4136,7.8
47013,2020-05-01,14226,12835,1391,9.8
47015,2020-05-01,6292,5611,681,10.8
47017,2020-05-01,11322,10356,966,8.5
47019,2020-05-01,22438,20645,1793,8
47021,2020-05-01,20045,18588,1457,7.3
47023,2020-05-01,7993,7422,571,7.1
47025,2020-05-01,12172,11103,1069,8.8
47027,2020-05-01,2644,2407,237,9
47029,2020-05-01,14529,12398,2131,14.7
47031,2020-05-01,24819,21588,3231,13
47033,2020-05-01,6438,6032,406,6.3
47035,2020-05-01,21709,19957,1752,8.1
47037,2020-05-01,384838,341221,43617,11.3
47039,2020-05-01,4423,3962,461,10.4
47041,2020-05-01,7238,6140,1098,15.2
47043,2020-05-01,24793,22876,1917,7.7
47045,2020-05-01,15287,13702,1585,10.4
47047,2020-05-01,18109,16822,1287,7.1
47049,2020-05-01,7237,6785,452,6.2
47051,2020-05-01,18957,16350,2607,13.8
47053,2020-05-01,21117,19448,1669,7.9
47055,2020-05-01,13809,11997,1812,13.1
47057,2020-05-01,9110,8296,814,8.9
47059,2020-05-01,27702,24793,2909,10.5
47061,2020-05-01,5267,4460,807,15.3
47063,2020-05-01,27222,24626,2596,9.5
47065,2020-05-01,175052,158550,16502,9.4
47067,2020-05-01,2062,1853,209,10.1
47069,2020-05-01,9073,8377,696,7.7
47071,2020-05-01,9835,9134,701,7.1
47073,2020-05-01,22633,20320,2313,10.2
47075,2020-05-01,7489,6774,715,9.5
47077,2020-05-01,11506,10222,1284,11.2
47079,2020-05-01,13149,11995,1154,8.8
47081,2020-05-01,10465,9660,805,7.7
47083,2020-05-01,3118,2852,266,8.5
47085,2020-05-01,8400,7814,586,7
47087,2020-05-01,4435,3989,446,10.1
47089,2020-05-01,24243,21623,2620,10.8
47091,2020-05-01,7022,6373,649,9.2
47093,2020-05-01,232887,215437,17450,7.5
47095,2020-05-01,1612,1488,124,7.7
47097,2020-05-01,9422,8395,1027,10.9
47099,2020-05-01,18617,16470,2147,11.5
47101,2020-05-01,5296,4710,586,11.1
47103,2020-05-01,15303,13690,1613,10.5
47105,2020-05-01,22566,20811,1755,7.8
47107,2020-05-01,22179,19741,2438,11
47109,2020-05-01,8051,7370,681,8.5
47111,2020-05-01,10553,9616,937,8.9
47113,2020-05-01,46949,42574,4375,9.3
47115,2020-05-01,11752,10685,1067,9.1
47117,2020-05-01,14825,12337,2488,16.8
47119,2020-05-01,49158,42301,6857,13.9
47121,2020-05-01,5020,4479,541,10.8
47123,2020-05-01,19424,17156,2268,11.7
47125,2020-05-01,81259,73608,7651,9.4
47127,2020-05-01,3448,3154,294,8.5
47129,2020-05-01,7228,6743,485,6.7
47131,2020-05-01,11820,10997,823,7
47133,2020-05-01,9212,8465,747,8.1
47135,2020-05-01,2694,2279,415,15.4
47137,2020-05-01,2242,2087,155,6.9
47139,2020-05-01,7492,6879,613,8.2
47141,2020-05-01,33286,30521,2765,8.3
47143,2020-05-01,12154,10579,1575,13
47145,2020-05-01,21816,20288,1528,7
47147,2020-05-01,35067,32288,2779,7.9
47149,2020-05-01,178079,158355,19724,11.1
47151,2020-05-01,7902,7105,797,10.1
47153,2020-05-01,5933,5307,626,10.6
47155,2020-05-01,50002,41327,8675,17.3
47157,2020-05-01,427299,383322,43977,10.3
47159,2020-05-01,8833,8029,804,9.1
47161,2020-05-01,5124,4779,345,6.7
47163,2020-05-01,66173,60403,5770,8.7
47165,2020-05-01,97021,88081,8940,9.2
47167,2020-05-01,26242,24257,1985,7.6
47169,2020-05-01,5052,4662,390,7.7
47171,2020-05-01,6682,6084,598,8.9
47173,2020-05-01,7268,6695,573,7.9
47175,2020-05-01,1964,1745,219,11.2
47177,2020-05-01,16645,14163,2482,14.9
47179,2020-05-01,56957,52432,4525,7.9
47181,2020-05-01,6251,5744,507,8.1
47183,2020-05-01,14631,13709,922,6.3
47185,2020-05-01,11577,10466,1111,9.6
47187,2020-05-01,119255,111621,7634,6.4
47189,2020-05-01,72667,66298,6369,8.8
48001,2020-05-01,22698,21008,1690,7.4
48003,2020-05-01,9009,7866,1143,12.7
48005,2020-05-01,34441,30792,3649,10.6
48007,2020-05-01,8766,7720,1046,11.9
48009,2020-05-01,3734,3466,268,7.2
48011,2020-05-01,872,823,49,5.6
48013,2020-05-01,21002,18310,2692,12.8
48015,2020-05-01,13061,11889,1172,9
48017,2020-05-01,2347,2210,137,5.8
48019,2020-05-01,9291,8482,809,8.7
48021,2020-05-01,40411,36621,3790,9.4
48023,2020-05-01,1669,1596,73,4.4
48025,2020-05-01,9745,8485,1260,12.9
48027,2020-05-01,139552,125401,14151,10.1
48029,2020-05-01,910375,797578,112797,12.4
48031,2020-05-01,6209,5870,339,5.5
48033,2020-05-01,375,357,18,4.8
48035,2020-05-01,8035,7448,587,7.3
48037,2020-05-01,37355,33384,3971,10.6
48039,2020-05-01,172981,151636,21345,12.3
48041,2020-05-01,112316,103193,9123,8.1
48043,2020-05-01,3954,3520,434,11
48045,2020-05-01,548,515,33,6
48047,2020-05-01,2552,2171,381,14.9
48049,2020-05-01,14758,13439,1319,8.9
48051,2020-05-01,7859,7159,700,8.9
48053,2020-05-01,22581,21061,1520,6.7
48055,2020-05-01,18320,16560,1760,9.6
48057,2020-05-01,11083,10192,891,8
48059,2020-05-01,5695,5252,443,7.8
48061,2020-05-01,165134,141573,23561,14.3
48063,2020-05-01,4829,4401,428,8.9
48065,2020-05-01,2793,2641,152,5.4
48067,2020-05-01,11830,10689,1141,9.6
48069,2020-05-01,3205,3065,140,4.4
48071,2020-05-01,19293,16745,2548,13.2
48073,2020-05-01,20978,18691,2287,10.9
48075,2020-05-01,2992,2850,142,4.7
48077,2020-05-01,4590,4240,350,7.6
48079,2020-05-01,1086,978,108,9.9
48081,2020-05-01,1322,1225,97,7.3
48083,2020-05-01,2782,2519,263,9.5
48085,2020-05-01,548824,491919,56905,10.4
48087,2020-05-01,1043,995,48,4.6
48089,2020-05-01,9244,8566,678,7.3
48091,2020-05-01,71614,64352,7262,10.1
48093,2020-05-01,5413,5022,391,7.2
48095,2020-05-01,1250,1180,70,5.6
48097,2020-05-01,19025,16995,2030,10.7
48099,2020-05-01,22995,20891,2104,9.1
48101,2020-05-01,577,547,30,5.2
48103,2020-05-01,1652,1327,325,19.7
48105,2020-05-01,1559,1353,206,13.2
48107,2020-05-01,2271,2111,160,7
48109,2020-05-01,1114,1005,109,9.8
48111,2020-05-01,3620,3498,122,3.4
48113,2020-05-01,NA,NA,159817,12.2
48115,2020-05-01,4456,3918,538,12.1
48117,2020-05-01,8243,7916,327,4
48119,2020-05-01,2271,2103,168,7.4
48121,2020-05-01,486451,433730,52721,10.8
48123,2020-05-01,8976,8264,712,7.9
48125,2020-05-01,673,622,51,7.6
48127,2020-05-01,6350,5803,547,8.6
48129,2020-05-01,1353,1292,61,4.5
48131,2020-05-01,4844,4042,802,16.6
48133,2020-05-01,6888,6241,647,9.4
48135,2020-05-01,81445,68460,12985,15.9
48137,2020-05-01,1170,1125,45,3.8
48139,2020-05-01,89150,80909,8241,9.2
48141,2020-05-01,353658,306780,46878,13.3
48143,2020-05-01,18994,17458,1536,8.1
48145,2020-05-01,6265,5760,505,8.1
48147,2020-05-01,15971,14908,1063,6.7
48149,2020-05-01,11269,10573,696,6.2
48151,2020-05-01,1552,1465,87,5.6
48153,2020-05-01,2432,2249,183,7.5
48155,2020-05-01,553,518,35,6.3
48157,2020-05-01,385001,339978,45023,11.7
48159,2020-05-01,4659,4338,321,6.9
48161,2020-05-01,6175,5513,662,10.7
48163,2020-05-01,9154,8447,707,7.7
48165,2020-05-01,9391,8668,723,7.7
48167,2020-05-01,161754,140163,21591,13.3
48169,2020-05-01,1929,1743,186,9.6
48171,2020-05-01,12533,11539,994,7.9
48173,2020-05-01,749,713,36,4.8
48175,2020-05-01,3019,2716,303,10
48177,2020-05-01,9056,8351,705,7.8
48179,2020-05-01,7614,6865,749,9.8
48181,2020-05-01,61505,56080,5425,8.8
48183,2020-05-01,54956,48460,6496,11.8
48185,2020-05-01,10799,9634,1165,10.8
48187,2020-05-01,77808,69325,8483,10.9
48189,2020-05-01,11502,10479,1023,8.9
48191,2020-05-01,1044,973,71,6.8
48193,2020-05-01,3590,3382,208,5.8
48195,2020-05-01,2329,2248,81,3.5
48197,2020-05-01,1627,1539,88,5.4
48199,2020-05-01,24238,21013,3225,13.3
48201,2020-05-01,NA,NA,303953,13.5
48203,2020-05-01,28507,25435,3072,10.8
48205,2020-05-01,2533,2474,59,2.3
48207,2020-05-01,2553,2424,129,5.1
48209,2020-05-01,116405,103957,12448,10.7
48211,2020-05-01,1719,1626,93,5.4
48213,2020-05-01,35707,32517,3190,8.9
48215,2020-05-01,353373,296668,56705,16
48217,2020-05-01,15788,14341,1447,9.2
48219,2020-05-01,10235,8985,1250,12.2
48221,2020-05-01,26197,23656,2541,9.7
48223,2020-05-01,16715,15569,1146,6.9
48225,2020-05-01,9593,8975,618,6.4
48227,2020-05-01,13100,11598,1502,11.5
48229,2020-05-01,1781,1577,204,11.5
48231,2020-05-01,41467,37412,4055,9.8
48233,2020-05-01,8263,7451,812,9.8
48235,2020-05-01,715,657,58,8.1
48237,2020-05-01,3367,3047,320,9.5
48239,2020-05-01,7124,6606,518,7.3
48241,2020-05-01,12709,10808,1901,15
48243,2020-05-01,901,831,70,7.8
48245,2020-05-01,104024,85840,18184,17.5
48247,2020-05-01,1834,1621,213,11.6
48249,2020-05-01,16101,13255,2846,17.7
48251,2020-05-01,79221,71278,7943,10
48253,2020-05-01,5474,4976,498,9.1
48255,2020-05-01,6782,6204,578,8.5
48257,2020-05-01,64218,57881,6337,9.9
48259,2020-05-01,20919,19246,1673,8
48261,2020-05-01,157,147,10,6.4
48263,2020-05-01,441,421,20,4.5
48265,2020-05-01,20869,18924,1945,9.3
48267,2020-05-01,1711,1614,97,5.7
48269,2020-05-01,185,180,5,2.7
48271,2020-05-01,1240,1151,89,7.2
48273,2020-05-01,12971,11425,1546,11.9
48275,2020-05-01,1406,1301,105,7.5
48277,2020-05-01,22334,20357,1977,8.9
48279,2020-05-01,5074,4734,340,6.7
48281,2020-05-01,8593,7975,618,7.2
48283,2020-05-01,3474,3128,346,10
48285,2020-05-01,8144,7584,560,6.9
48287,2020-05-01,8852,8268,584,6.6
48289,2020-05-01,5800,5219,581,10
48291,2020-05-01,32596,28003,4593,14.1
48293,2020-05-01,8120,7397,723,8.9
48295,2020-05-01,1487,1408,79,5.3
48297,2020-05-01,5012,4536,476,9.5
48299,2020-05-01,7954,7320,634,8
48301,2020-05-01,218,210,8,3.7
48303,2020-05-01,149632,136684,12948,8.7
48305,2020-05-01,2621,2412,209,8
48307,2020-05-01,3116,2825,291,9.3
48309,2020-05-01,116122,105705,10417,9
48311,2020-05-01,720,696,24,3.3
48313,2020-05-01,4309,3903,406,9.4
48315,2020-05-01,4160,3694,466,11.2
48317,2020-05-01,2412,2204,208,8.6
48319,2020-05-01,1661,1548,113,6.8
48321,2020-05-01,16166,13854,2312,14.3
48323,2020-05-01,24256,19513,4743,19.6
48325,2020-05-01,20463,18438,2025,9.9
48327,2020-05-01,826,767,59,7.1
48329,2020-05-01,94628,82924,11704,12.4
48331,2020-05-01,9424,8512,912,9.7
48333,2020-05-01,1771,1690,81,4.6
48335,2020-05-01,2310,2072,238,10.3
48337,2020-05-01,8769,7916,853,9.7
48339,2020-05-01,277166,245699,31467,11.4
48341,2020-05-01,10106,9617,489,4.8
48343,2020-05-01,4732,4167,565,11.9
48345,2020-05-01,422,403,19,4.5
48347,2020-05-01,26316,23953,2363,9
48349,2020-05-01,22250,20219,2031,9.1
48351,2020-05-01,4890,4154,736,15.1
48353,2020-05-01,6832,6379,453,6.6
48355,2020-05-01,160307,139099,21208,13.2
48357,2020-05-01,3937,3646,291,7.4
48359,2020-05-01,847,806,41,4.8
48361,2020-05-01,35245,29742,5503,15.6
48363,2020-05-01,12924,11644,1280,9.9
48365,2020-05-01,9335,8316,1019,10.9
48367,2020-05-01,64721,58946,5775,8.9
48369,2020-05-01,4631,4512,119,2.6
48371,2020-05-01,6208,5496,712,11.5
48373,2020-05-01,17716,15657,2059,11.6
48375,2020-05-01,52499,48059,4440,8.5
48377,2020-05-01,3257,2582,675,20.7
48379,2020-05-01,5705,5340,365,6.4
48381,2020-05-01,69889,65005,4884,7
48383,2020-05-01,1812,1565,247,13.6
48385,2020-05-01,1015,928,87,8.6
48387,2020-05-01,4931,4542,389,7.9
48389,2020-05-01,8413,7580,833,9.9
48391,2020-05-01,2976,2635,341,11.5
48393,2020-05-01,392,369,23,5.9
48395,2020-05-01,7014,6431,583,8.3
48397,2020-05-01,50971,46003,4968,9.7
48399,2020-05-01,4414,4101,313,7.1
48401,2020-05-01,21185,19149,2036,9.6
48403,2020-05-01,3910,3355,555,14.2
48405,2020-05-01,2988,2627,361,12.1
48407,2020-05-01,11121,9966,1155,10.4
48409,2020-05-01,28503,24468,4035,14.2
48411,2020-05-01,2038,1906,132,6.5
48413,2020-05-01,1191,1081,110,9.2
48415,2020-05-01,6136,5425,711,11.6
48417,2020-05-01,1684,1557,127,7.5
48419,2020-05-01,10866,9899,967,8.9
48421,2020-05-01,1210,1174,36,3
48423,2020-05-01,105719,94841,10878,10.3
48425,2020-05-01,4112,3720,392,9.5
48427,2020-05-01,26598,21002,5596,21
48429,2020-05-01,3880,3580,300,7.7
48431,2020-05-01,537,494,43,8
48433,2020-05-01,557,521,36,6.5
48435,2020-05-01,1228,1065,163,13.3
48437,2020-05-01,2439,2276,163,6.7
48439,2020-05-01,NA,921985,125753,12
48441,2020-05-01,63350,58191,5159,8.1
48443,2020-05-01,365,344,21,5.8
48445,2020-05-01,4699,4214,485,10.3
48447,2020-05-01,605,570,35,5.8
48449,2020-05-01,12656,11575,1081,8.5
48451,2020-05-01,51746,46845,4901,9.5
48453,2020-05-01,711147,635067,76080,10.7
48455,2020-05-01,5140,4591,549,10.7
48457,2020-05-01,7194,6241,953,13.2
48459,2020-05-01,16865,15037,1828,10.8
48461,2020-05-01,1779,1642,137,7.7
48463,2020-05-01,11096,10156,940,8.5
48465,2020-05-01,21782,18897,2885,13.2
48467,2020-05-01,24979,22764,2215,8.9
48469,2020-05-01,39917,35158,4759,11.9
48471,2020-05-01,23538,21233,2305,9.8
48473,2020-05-01,22987,20499,2488,10.8
48475,2020-05-01,6209,5410,799,12.9
48477,2020-05-01,14735,13667,1068,7.2
48479,2020-05-01,112817,98068,14749,13.1
48481,2020-05-01,20606,18757,1849,9
48483,2020-05-01,2118,1969,149,7
48485,2020-05-01,53184,48251,4933,9.3
48487,2020-05-01,4763,4440,323,6.8
48489,2020-05-01,6531,5508,1023,15.7
48491,2020-05-01,304019,274293,29726,9.8
48493,2020-05-01,23194,21140,2054,8.9
48495,2020-05-01,3886,3363,523,13.5
48497,2020-05-01,30684,27621,3063,10
48499,2020-05-01,17246,15690,1556,9
48501,2020-05-01,3603,2917,686,19
48503,2020-05-01,7489,6970,519,6.9
48505,2020-05-01,4406,3701,705,16
48507,2020-05-01,3334,2731,603,18.1
49001,2020-05-01,2775,2625,150,5.4
49003,2020-05-01,26186,23715,2471,9.4
49005,2020-05-01,63528,60897,2631,4.1
49007,2020-05-01,8363,7822,541,6.5
49009,2020-05-01,396,379,17,4.3
49011,2020-05-01,169350,158223,11127,6.6
49013,2020-05-01,7724,6890,834,10.8
49015,2020-05-01,4255,4018,237,5.6
49017,2020-05-01,2709,2309,400,14.8
49019,2020-05-01,6056,5069,987,16.3
49021,2020-05-01,24224,22582,1642,6.8
49023,2020-05-01,5549,5343,206,3.7
49025,2020-05-01,3744,3395,349,9.3
49027,2020-05-01,5764,5530,234,4.1
49029,2020-05-01,5314,5042,272,5.1
49031,2020-05-01,479,437,42,8.8
49033,2020-05-01,1117,1070,47,4.2
49035,2020-05-01,624846,571722,53124,8.5
49037,2020-05-01,5451,4694,757,13.9
49039,2020-05-01,12290,11731,559,4.5
49041,2020-05-01,9544,9027,517,5.4
49043,2020-05-01,22556,18891,3665,16.2
49045,2020-05-01,34004,31315,2689,7.9
49047,2020-05-01,13345,11670,1675,12.6
49049,2020-05-01,299824,283023,16801,5.6
49051,2020-05-01,15933,13867,2066,13
49053,2020-05-01,76439,69953,6486,8.5
49055,2020-05-01,1404,1256,148,10.5
49057,2020-05-01,125970,115957,10013,7.9
50001,2020-05-01,19767,18220,1547,7.8
50003,2020-05-01,17229,15287,1942,11.3
50005,2020-05-01,14296,12993,1303,9.1
50007,2020-05-01,93061,85108,7953,8.5
50009,2020-05-01,2597,2319,278,10.7
50011,2020-05-01,26505,24235,2270,8.6
50013,2020-05-01,3980,3616,364,9.1
50015,2020-05-01,13587,11685,1902,14
50017,2020-05-01,15401,14277,1124,7.3
50019,2020-05-01,12596,11002,1594,12.7
50021,2020-05-01,29586,26169,3417,11.5
50023,2020-05-01,33010,30438,2572,7.8
50025,2020-05-01,21150,18876,2274,10.8
50027,2020-05-01,27736,25085,2651,9.6
51001,2020-05-01,15412,14006,1406,9.1
51003,2020-05-01,54570,50342,4228,7.7
51005,2020-05-01,6755,6167,588,8.7
51007,2020-05-01,6028,5584,444,7.4
51009,2020-05-01,14323,13313,1010,7.1
51011,2020-05-01,6835,6360,475,6.9
51013,2020-05-01,146689,138240,8449,5.8
51015,2020-05-01,36076,33732,2344,6.5
51017,2020-05-01,2150,1731,419,19.5
51019,2020-05-01,37009,34433,2576,7
51021,2020-05-01,2748,2528,220,8
51023,2020-05-01,16692,15535,1157,6.9
51025,2020-05-01,5914,5372,542,9.2
51027,2020-05-01,6275,5629,646,10.3
51029,2020-05-01,6131,5569,562,9.2
51031,2020-05-01,25007,23064,1943,7.8
51033,2020-05-01,14725,13400,1325,9
51035,2020-05-01,12875,11365,1510,11.7
51036,2020-05-01,3525,3216,309,8.8
51037,2020-05-01,4936,4609,327,6.6
51041,2020-05-01,182830,167768,15062,8.2
51043,2020-05-01,7321,6837,484,6.6
51045,2020-05-01,2243,2066,177,7.9
51047,2020-05-01,24056,22343,1713,7.1
51049,2020-05-01,4448,4111,337,7.6
51051,2020-05-01,4648,4239,409,8.8
51053,2020-05-01,13116,12057,1059,8.1
51057,2020-05-01,5354,4878,476,8.9
51059,2020-05-01,617824,567602,50222,8.1
51061,2020-05-01,35934,33528,2406,6.7
51063,2020-05-01,7833,7259,574,7.3
51065,2020-05-01,13437,12411,1026,7.6
51067,2020-05-01,25229,23339,1890,7.5
51069,2020-05-01,47803,44459,3344,7
51071,2020-05-01,7636,6907,729,9.5
51073,2020-05-01,18759,17340,1419,7.6
51075,2020-05-01,10899,10175,724,6.6
51077,2020-05-01,7906,7322,584,7.4
51079,2020-05-01,9996,9225,771,7.7
51081,2020-05-01,4128,3796,332,8
51083,2020-05-01,15033,13740,1293,8.6
51085,2020-05-01,56685,52786,3899,6.9
51087,2020-05-01,177301,161518,15783,8.9
51089,2020-05-01,23102,20661,2441,10.6
51091,2020-05-01,1201,1144,57,4.7
51093,2020-05-01,18470,17260,1210,6.6
51095,2020-05-01,36284,32468,3816,10.5
51097,2020-05-01,3744,3496,248,6.6
51099,2020-05-01,13577,12801,776,5.7
51101,2020-05-01,8893,8229,664,7.5
51103,2020-05-01,5253,4793,460,8.8
51105,2020-05-01,8253,7589,664,8
51107,2020-05-01,219065,202188,16877,7.7
51109,2020-05-01,19682,18273,1409,7.2
51111,2020-05-01,5131,4819,312,6.1
51113,2020-05-01,7124,6739,385,5.4
51115,2020-05-01,3927,3675,252,6.4
51117,2020-05-01,12394,11325,1069,8.6
51119,2020-05-01,5025,4679,346,6.9
51121,2020-05-01,47407,44108,3299,7
51125,2020-05-01,7164,6595,569,7.9
51127,2020-05-01,12196,11430,766,6.3
51131,2020-05-01,5174,4639,535,10.3
51133,2020-05-01,5557,5167,390,7
51135,2020-05-01,7010,6593,417,5.9
51137,2020-05-01,16648,15302,1346,8.1
51139,2020-05-01,11822,10508,1314,11.1
51141,2020-05-01,7121,6478,643,9
51143,2020-05-01,29211,26689,2522,8.6
51145,2020-05-01,13720,12761,959,7
51147,2020-05-01,9773,8995,778,8
51149,2020-05-01,14532,13328,1204,8.3
51153,2020-05-01,242849,220137,22712,9.4
51155,2020-05-01,15974,14130,1844,11.5
51157,2020-05-01,3606,3386,220,6.1
51159,2020-05-01,3952,3731,221,5.6
51161,2020-05-01,47612,43963,3649,7.7
51163,2020-05-01,10135,9344,791,7.8
51165,2020-05-01,39948,36919,3029,7.6
51167,2020-05-01,11068,10198,870,7.9
51169,2020-05-01,8747,8149,598,6.8
51171,2020-05-01,21614,19915,1699,7.9
51173,2020-05-01,13190,12058,1132,8.6
51175,2020-05-01,8692,8157,535,6.2
51177,2020-05-01,66111,60478,5633,8.5
51179,2020-05-01,70806,65270,5536,7.8
51181,2020-05-01,3575,3314,261,7.3
51183,2020-05-01,3627,3260,367,10.1
51185,2020-05-01,15345,13941,1404,9.1
51187,2020-05-01,19996,18293,1703,8.5
51191,2020-05-01,25481,23502,1979,7.8
51193,2020-05-01,9234,8582,652,7.1
51195,2020-05-01,12966,11883,1083,8.4
51197,2020-05-01,13568,12004,1564,11.5
51199,2020-05-01,31733,29146,2587,8.2
51510,2020-05-01,98160,90210,7950,8.1
51520,2020-05-01,7245,6516,729,10.1
51530,2020-05-01,3020,2784,236,7.8
51540,2020-05-01,25022,22662,2360,9.4
51550,2020-05-01,118974,109087,9887,8.3
51570,2020-05-01,8325,7549,776,9.3
51580,2020-05-01,2445,2108,337,13.8
51590,2020-05-01,18650,16351,2299,12.3
51595,2020-05-01,2303,1987,316,13.7
51600,2020-05-01,12865,11805,1060,8.2
51610,2020-05-01,8032,7647,385,4.8
51620,2020-05-01,3467,3162,305,8.8
51630,2020-05-01,13835,12460,1375,9.9
51640,2020-05-01,2820,2531,289,10.2
51650,2020-05-01,63349,56276,7073,11.2
51660,2020-05-01,23699,21217,2482,10.5
51670,2020-05-01,9637,8377,1260,13.1
51678,2020-05-01,1950,1778,172,8.8
51680,2020-05-01,35437,32078,3359,9.5
51683,2020-05-01,21444,19435,2009,9.4
51685,2020-05-01,9402,8479,923,9.8
51690,2020-05-01,5551,4761,790,14.2
51700,2020-05-01,88425,78018,10407,11.8
51710,2020-05-01,109554,97209,12345,11.3
51720,2020-05-01,1651,1503,148,9
51730,2020-05-01,13197,11091,2106,16
51735,2020-05-01,6050,5699,351,5.8
51740,2020-05-01,43495,38516,4979,11.4
51750,2020-05-01,8275,7531,744,9
51760,2020-05-01,118743,104833,13910,11.7
51770,2020-05-01,48469,43170,5299,10.9
51775,2020-05-01,12430,11342,1088,8.8
51790,2020-05-01,12095,10980,1115,9.2
51800,2020-05-01,43238,39629,3609,8.3
51810,2020-05-01,226633,205919,20714,9.1
51820,2020-05-01,10554,9567,987,9.4
51830,2020-05-01,6677,5868,809,12.1
51840,2020-05-01,14728,13443,1285,8.7
53001,2020-05-01,9639,8626,1013,10.5
53003,2020-05-01,10221,9547,674,6.6
53005,2020-05-01,103569,92486,11083,10.7
53007,2020-05-01,43182,37742,5440,12.6
53009,2020-05-01,28720,24379,4341,15.1
53011,2020-05-01,241194,210799,30395,12.6
53013,2020-05-01,1680,1525,155,9.2
53015,2020-05-01,48859,42267,6592,13.5
53017,2020-05-01,20933,18520,2413,11.5
53019,2020-05-01,2387,2063,324,13.6
53021,2020-05-01,43784,39075,4709,10.8
53023,2020-05-01,818,732,86,10.5
53025,2020-05-01,48015,42909,5106,10.6
53027,2020-05-01,29241,24057,5184,17.7
53029,2020-05-01,36029,31774,4255,11.8
53031,2020-05-01,12692,10839,1853,14.6
53033,2020-05-01,NA,NA,154511,12.2
53035,2020-05-01,129313,114254,15059,11.6
53037,2020-05-01,21971,19136,2835,12.9
53039,2020-05-01,9910,8892,1018,10.3
53041,2020-05-01,35129,30264,4865,13.8
53043,2020-05-01,4491,4112,379,8.4
53045,2020-05-01,25344,21963,3381,13.3
53047,2020-05-01,19247,17068,2179,11.3
53049,2020-05-01,8170,6829,1341,16.4
53051,2020-05-01,4893,4272,621,12.7
53053,2020-05-01,454547,388214,66333,14.6
53055,2020-05-01,7945,6839,1106,13.9
53057,2020-05-01,62508,53455,9053,14.5
53059,2020-05-01,5453,4744,709,13
53061,2020-05-01,438896,378718,60178,13.7
53063,2020-05-01,259919,226966,32953,12.7
53065,2020-05-01,18322,16235,2087,11.4
53067,2020-05-01,144344,126259,18085,12.5
53069,2020-05-01,1336,1173,163,12.2
53071,2020-05-01,29829,27061,2768,9.3
53073,2020-05-01,114575,98671,15904,13.9
53075,2020-05-01,21470,20007,1463,6.8
53077,2020-05-01,131178,115119,16059,12.2
54001,2020-05-01,7151,6372,779,10.9
54003,2020-05-01,57811,51890,5921,10.2
54005,2020-05-01,7442,6393,1049,14.1
54007,2020-05-01,5221,4613,608,11.6
54009,2020-05-01,9854,8580,1274,12.9
54011,2020-05-01,42195,36678,5517,13.1
54013,2020-05-01,2491,2078,413,16.6
54015,2020-05-01,3120,2640,480,15.4
54017,2020-05-01,3802,3483,319,8.4
54019,2020-05-01,16085,13830,2255,14
54021,2020-05-01,2259,1961,298,13.2
54023,2020-05-01,5975,5456,519,8.7
54025,2020-05-01,15214,13150,2064,13.6
54027,2020-05-01,10709,9850,859,8
54029,2020-05-01,13466,11242,2224,16.5
54031,2020-05-01,5887,5255,632,10.7
54033,2020-05-01,34309,30355,3954,11.5
54035,2020-05-01,12933,11489,1444,11.2
54037,2020-05-01,29412,26505,2907,9.9
54039,2020-05-01,83448,72145,11303,13.5
54041,2020-05-01,6340,5424,916,14.4
54043,2020-05-01,7174,6237,937,13.1
54045,2020-05-01,11213,9409,1804,16.1
54047,2020-05-01,4496,3927,569,12.7
54049,2020-05-01,25141,21795,3346,13.3
54051,2020-05-01,13577,11532,2045,15.1
54053,2020-05-01,10129,8930,1199,11.8
54055,2020-05-01,21061,18362,2699,12.8
54057,2020-05-01,12007,10750,1257,10.5
54059,2020-05-01,6787,5533,1254,18.5
54061,2020-05-01,53288,48118,5170,9.7
54063,2020-05-01,6011,5386,625,10.4
54065,2020-05-01,8144,7377,767,9.4
54067,2020-05-01,9283,8058,1225,13.2
54069,2020-05-01,20368,17602,2766,13.6
54071,2020-05-01,3669,3421,248,6.8
54073,2020-05-01,2668,2253,415,15.6
54075,2020-05-01,3546,2988,558,15.7
54077,2020-05-01,15196,13573,1623,10.7
54079,2020-05-01,26967,23829,3138,11.6
54081,2020-05-01,30220,26252,3968,13.1
54083,2020-05-01,12453,10853,1600,12.8
54085,2020-05-01,4324,3866,458,10.6
54087,2020-05-01,5134,4357,777,15.1
54089,2020-05-01,4355,3913,442,10.1
54091,2020-05-01,7779,6983,796,10.2
54093,2020-05-01,3189,2767,422,13.2
54095,2020-05-01,3132,2751,381,12.2
54097,2020-05-01,9808,8593,1215,12.4
54099,2020-05-01,15686,13786,1900,12.1
54101,2020-05-01,3255,2874,381,11.7
54103,2020-05-01,6504,5652,852,13.1
54105,2020-05-01,2201,1919,282,12.8
54107,2020-05-01,36129,31232,4897,13.6
54109,2020-05-01,6740,5919,821,12.2
55001,2020-05-01,8206,6946,1260,15.4
55003,2020-05-01,7769,6635,1134,14.6
55005,2020-05-01,24081,21729,2352,9.8
55007,2020-05-01,7465,6326,1139,15.3
55009,2020-05-01,140129,124356,15773,11.3
55011,2020-05-01,6459,5714,745,11.5
55013,2020-05-01,7316,6337,979,13.4
55015,2020-05-01,26610,24420,2190,8.2
55017,2020-05-01,32160,29177,2983,9.3
55019,2020-05-01,17530,16443,1087,6.2
55021,2020-05-01,31173,27993,3180,10.2
55023,2020-05-01,7325,6439,886,12.1
55025,2020-05-01,314060,288328,25732,8.2
55027,2020-05-01,46915,42900,4015,8.6
55029,2020-05-01,14511,12778,1733,11.9
55031,2020-05-01,23115,19280,3835,16.6
55033,2020-05-01,23476,21373,2103,9
55035,2020-05-01,57408,51798,5610,9.8
55037,2020-05-01,2179,1880,299,13.7
55039,2020-05-01,55554,49667,5887,10.6
55041,2020-05-01,3883,3009,874,22.5
55043,2020-05-01,27476,24733,2743,10
55045,2020-05-01,20160,18656,1504,7.5
55047,2020-05-01,9408,8325,1083,11.5
55049,2020-05-01,13656,12115,1541,11.3
55051,2020-05-01,2564,2104,460,17.9
55053,2020-05-01,9911,8472,1439,14.5
55055,2020-05-01,44509,40529,3980,8.9
55057,2020-05-01,13327,11621,1706,12.8
55059,2020-05-01,88509,77754,10755,12.2
55061,2020-05-01,10537,9669,868,8.2
55063,2020-05-01,64269,57866,6403,10
55065,2020-05-01,9831,9095,736,7.5
55067,2020-05-01,9379,8539,840,9
55069,2020-05-01,14533,13234,1299,8.9
55071,2020-05-01,40291,36000,4291,10.7
55073,2020-05-01,72260,66270,5990,8.3
55075,2020-05-01,19580,16951,2629,13.4
55077,2020-05-01,7596,6755,841,11.1
55078,2020-05-01,1842,1291,551,29.9
55079,2020-05-01,462209,400881,61328,13.3
55081,2020-05-01,23606,21635,1971,8.3
55083,2020-05-01,19899,17916,1983,10
55085,2020-05-01,17912,15851,2061,11.5
55087,2020-05-01,101565,91561,10004,9.8
55089,2020-05-01,47226,42741,4485,9.5
55091,2020-05-01,4127,3726,401,9.7
55093,2020-05-01,24944,21794,3150,12.6
55095,2020-05-01,24407,21706,2701,11.1
55097,2020-05-01,37036,33703,3333,9
55099,2020-05-01,6279,5605,674,10.7
55101,2020-05-01,96539,85290,11249,11.7
55103,2020-05-01,8967,8226,741,8.3
55105,2020-05-01,84684,74312,10372,12.2
55107,2020-05-01,6545,5941,604,9.2
55109,2020-05-01,49935,43592,6343,12.7
55111,2020-05-01,33580,28457,5123,15.3
55113,2020-05-01,8019,7185,834,10.4
55115,2020-05-01,20599,17948,2651,12.9
55117,2020-05-01,61440,54388,7052,11.5
55119,2020-05-01,10876,10235,641,5.9
55121,2020-05-01,15750,14038,1712,10.9
55123,2020-05-01,14758,13595,1163,7.9
55125,2020-05-01,10263,9156,1107,10.8
55127,2020-05-01,55467,49612,5855,10.6
55129,2020-05-01,7766,6964,802,10.3
55131,2020-05-01,74894,67399,7495,10
55133,2020-05-01,217345,196138,21207,9.8
55135,2020-05-01,25149,22783,2366,9.4
55137,2020-05-01,11031,9945,1086,9.8
55139,2020-05-01,90751,81954,8797,9.7
55141,2020-05-01,34750,30965,3785,10.9
56001,2020-05-01,20123,19050,1073,5.3
56003,2020-05-01,5394,5089,305,5.7
56005,2020-05-01,24118,21754,2364,9.8
56007,2020-05-01,7989,7449,540,6.8
56009,2020-05-01,8161,7489,672,8.2
56011,2020-05-01,3877,3682,195,5
56013,2020-05-01,19555,17920,1635,8.4
56015,2020-05-01,6623,6277,346,5.2
56017,2020-05-01,2241,2092,149,6.6
56019,2020-05-01,4221,3882,339,8
56021,2020-05-01,51434,47392,4042,7.9
56023,2020-05-01,9401,8702,699,7.4
56025,2020-05-01,41042,36353,4689,11.4
56027,2020-05-01,1268,1210,58,4.6
56029,2020-05-01,15158,13891,1267,8.4
56031,2020-05-01,4678,4364,314,6.7
56033,2020-05-01,16540,15310,1230,7.4
56035,2020-05-01,4093,3687,406,9.9
56037,2020-05-01,21179,19095,2084,9.8
56039,2020-05-01,14614,12290,2324,15.9
56041,2020-05-01,9377,8559,818,8.7
56043,2020-05-01,4019,3739,280,7
56045,2020-05-01,3871,3679,192,5
72001,2020-05-01,3832,3396,436,11.4
72003,2020-05-01,11404,10213,1191,10.4
72005,2020-05-01,13809,12334,1475,10.7
72007,2020-05-01,6190,5499,691,11.2
72009,2020-05-01,5880,5323,557,9.5
72011,2020-05-01,8465,7720,745,8.8
72013,2020-05-01,22461,20031,2430,10.8
72015,2020-05-01,4394,4017,377,8.6
72017,2020-05-01,5581,4894,687,12.3
72019,2020-05-01,6988,6178,810,11.6
72021,2020-05-01,63059,56621,6438,10.2
72023,2020-05-01,12991,11693,1298,10
72025,2020-05-01,45530,41439,4091,9
72027,2020-05-01,8946,8059,887,9.9
72029,2020-05-01,15513,14028,1485,9.6
72031,2020-05-01,59265,53503,5762,9.7
72033,2020-05-01,7617,6763,854,11.2
72035,2020-05-01,15210,14005,1205,7.9
72037,2020-05-01,3446,3095,351,10.2
72039,2020-05-01,3517,3055,462,13.1
72041,2020-05-01,14437,13429,1008,7
72043,2020-05-01,9285,8393,892,9.6
72045,2020-05-01,4654,4138,516,11.1
72047,2020-05-01,8610,7447,1163,13.5
72049,2020-05-01,846,780,66,7.8
72051,2020-05-01,12756,11698,1058,8.3
72053,2020-05-01,10210,9078,1132,11.1
72054,2020-05-01,3102,2720,382,12.3
72055,2020-05-01,3574,3144,430,12
72057,2020-05-01,10460,9611,849,8.1
72059,2020-05-01,4745,4282,463,9.8
72061,2020-05-01,36198,33845,2353,6.5
72063,2020-05-01,17249,16129,1120,6.5
72065,2020-05-01,12274,11163,1111,9.1
72067,2020-05-01,5154,4638,516,10
72069,2020-05-01,15959,14542,1417,8.9
72071,2020-05-01,11190,10127,1063,9.5
72073,2020-05-01,3946,3660,286,7.2
72075,2020-05-01,14126,12986,1140,8.1
72077,2020-05-01,11593,10480,1113,9.6
72079,2020-05-01,4844,4235,609,12.6
72081,2020-05-01,6388,5571,817,12.8
72083,2020-05-01,2426,2120,306,12.6
72085,2020-05-01,10636,9681,955,9
72087,2020-05-01,7930,7151,779,9.8
72089,2020-05-01,5893,5251,642,10.9
72091,2020-05-01,10768,9734,1034,9.6
72093,2020-05-01,1805,1665,140,7.8
72095,2020-05-01,2581,2311,270,10.5
72097,2020-05-01,20336,18280,2056,10.1
72099,2020-05-01,9978,8874,1104,11.1
72101,2020-05-01,7640,6728,912,11.9
72103,2020-05-01,7670,7029,641,8.4
72105,2020-05-01,6998,5961,1037,14.8
72107,2020-05-01,4704,4071,633,13.5
72109,2020-05-01,3940,3571,369,9.4
72111,2020-05-01,5228,4638,590,11.3
72113,2020-05-01,41914,37863,4051,9.7
72115,2020-05-01,5757,5041,716,12.4
72117,2020-05-01,4450,3913,537,12.1
72119,2020-05-01,16229,14544,1685,10.4
72121,2020-05-01,5460,4903,557,10.2
72123,2020-05-01,6464,5782,682,10.6
72125,2020-05-01,8935,8083,852,9.5
72127,2020-05-01,129938,118404,11534,8.9
72129,2020-05-01,10866,9873,993,9.1
72131,2020-05-01,9523,8375,1148,12.1
72133,2020-05-01,7937,7409,528,6.7
72135,2020-05-01,26227,23992,2235,8.5
72137,2020-05-01,27861,25355,2506,9
72139,2020-05-01,25732,23926,1806,7
72141,2020-05-01,6096,5524,572,9.4
72143,2020-05-01,9369,8287,1082,11.5
72145,2020-05-01,12648,10974,1674,13.2
72147,2020-05-01,2381,2139,242,10.2
72149,2020-05-01,6454,5825,629,9.7
72151,2020-05-01,8004,7154,850,10.6
72153,2020-05-01,8711,7675,1036,11.9
01001,2020-06-01,25769,24082,1687,6.5
01003,2020-06-01,99638,92352,7286,7.3
01005,2020-06-01,8809,8006,803,9.1
01007,2020-06-01,8638,7894,744,8.6
01009,2020-06-01,24634,23234,1400,5.7
01011,2020-06-01,4824,4504,320,6.6
01013,2020-06-01,9205,8172,1033,11.2
01015,2020-06-01,46272,42073,4199,9.1
01017,2020-06-01,15894,14315,1579,9.9
01019,2020-06-01,11530,10832,698,6.1
01021,2020-06-01,19607,18284,1323,6.7
01023,2020-06-01,4719,4275,444,9.4
01025,2020-06-01,7912,7026,886,11.2
01027,2020-06-01,6035,5751,284,4.7
01029,2020-06-01,5828,5481,347,6
01031,2020-06-01,21781,20470,1311,6
01033,2020-06-01,23575,21519,2056,8.7
01035,2020-06-01,4647,4219,428,9.2
01037,2020-06-01,4406,4095,311,7.1
01039,2020-06-01,15362,14364,998,6.5
01041,2020-06-01,6417,5966,451,7
01043,2020-06-01,38240,36106,2134,5.6
01045,2020-06-01,20810,19454,1356,6.5
01047,2020-06-01,14905,12879,2026,13.6
01049,2020-06-01,31167,29379,1788,5.7
01051,2020-06-01,36502,34099,2403,6.6
01053,2020-06-01,14779,13596,1183,8
01055,2020-06-01,40447,36431,4016,9.9
01057,2020-06-01,6465,6002,463,7.2
01059,2020-06-01,14275,13434,841,5.9
01061,2020-06-01,11005,10397,608,5.5
01063,2020-06-01,3076,2646,430,14
01065,2020-06-01,6123,5379,744,12.2
01067,2020-06-01,6887,6455,432,6.3
01069,2020-06-01,46797,43380,3417,7.3
01071,2020-06-01,22838,21205,1633,7.2
01073,2020-06-01,316574,289307,27267,8.6
01075,2020-06-01,5768,5397,371,6.4
01077,2020-06-01,41865,38775,3090,7.4
01079,2020-06-01,14455,13503,952,6.6
01081,2020-06-01,74198,68754,5444,7.3
01083,2020-06-01,44275,41795,2480,5.6
01085,2020-06-01,3762,3118,644,17.1
01087,2020-06-01,8192,7125,1067,13
01089,2020-06-01,186389,174345,12044,6.5
01091,2020-06-01,7865,7223,642,8.2
01093,2020-06-01,13220,12359,861,6.5
01095,2020-06-01,44416,41986,2430,5.5
01097,2020-06-01,193211,171285,21926,11.3
01099,2020-06-01,7564,6743,821,10.9
01101,2020-06-01,108253,96486,11767,10.9
01103,2020-06-01,58931,55410,3521,6
01105,2020-06-01,3557,3050,507,14.3
01107,2020-06-01,7586,6931,655,8.6
01109,2020-06-01,15830,14759,1071,6.8
01111,2020-06-01,9591,8954,637,6.6
01113,2020-06-01,23774,22025,1749,7.4
01115,2020-06-01,39917,37310,2607,6.5
01117,2020-06-01,113204,107105,6099,5.4
01119,2020-06-01,4716,4243,473,10
01121,2020-06-01,36201,33142,3059,8.5
01123,2020-06-01,17934,16314,1620,9
01125,2020-06-01,100731,91536,9195,9.1
01127,2020-06-01,24947,22950,1997,8
01129,2020-06-01,6872,6079,793,11.5
01131,2020-06-01,2995,2422,573,19.1
01133,2020-06-01,10159,9529,630,6.2
02013,2020-06-01,2848,2724,124,4.4
02016,2020-06-01,3640,3364,276,7.6
02020,2020-06-01,148057,131946,16111,10.9
02050,2020-06-01,7121,6051,1070,15
02060,2020-06-01,872,830,42,4.8
02068,2020-06-01,773,620,153,19.8
02070,2020-06-01,1857,1647,210,11.3
02090,2020-06-01,44442,40310,4132,9.3
02100,2020-06-01,1135,902,233,20.5
02105,2020-06-01,1156,963,193,16.7
02110,2020-06-01,16122,14373,1749,10.8
02122,2020-06-01,27254,23976,3278,12
02130,2020-06-01,6821,5909,912,13.4
02150,2020-06-01,6518,5992,526,8.1
02158,2020-06-01,2032,1449,583,28.7
02164,2020-06-01,857,761,96,11.2
02170,2020-06-01,47778,42133,5645,11.8
02180,2020-06-01,4054,3464,590,14.6
02185,2020-06-01,2985,2708,277,9.3
02188,2020-06-01,2941,2457,484,16.5
02195,2020-06-01,1550,1383,167,10.8
02198,2020-06-01,3038,2660,378,12.4
02220,2020-06-01,4238,3761,477,11.3
02230,2020-06-01,629,465,164,26.1
02240,2020-06-01,3059,2782,277,9.1
02261,2020-06-01,4962,4476,486,9.8
02275,2020-06-01,1061,942,119,11.2
02282,2020-06-01,292,266,26,8.9
02290,2020-06-01,2384,2003,381,16
04001,2020-06-01,19741,16349,3392,17.2
04003,2020-06-01,51420,46729,4691,9.1
04005,2020-06-01,75247,65221,10026,13.3
04007,2020-06-01,21034,19006,2028,9.6
04009,2020-06-01,15581,14174,1407,9
04011,2020-06-01,4444,4098,346,7.8
04012,2020-06-01,8375,7636,739,8.8
04013,2020-06-01,NA,NA,239292,10.3
04015,2020-06-01,89666,77940,11726,13.1
04017,2020-06-01,40174,34723,5451,13.6
04019,2020-06-01,495268,442924,52344,10.6
04021,2020-06-01,188515,169039,19476,10.3
04023,2020-06-01,19454,16756,2698,13.9
04025,2020-06-01,107386,96731,10655,9.9
04027,2020-06-01,95892,74191,21701,22.6
05001,2020-06-01,9447,8958,489,5.2
05003,2020-06-01,7287,6481,806,11.1
05005,2020-06-01,16906,15491,1415,8.4
05007,2020-06-01,138516,130260,8256,6
05009,2020-06-01,15861,14809,1052,6.6
05011,2020-06-01,4499,4184,315,7
05013,2020-06-01,2426,2272,154,6.3
05015,2020-06-01,12909,12010,899,7
05017,2020-06-01,3289,2877,412,12.5
05019,2020-06-01,9076,8311,765,8.4
05021,2020-06-01,5564,5128,436,7.8
05023,2020-06-01,9465,8635,830,8.8
05025,2020-06-01,3193,2964,229,7.2
05027,2020-06-01,8997,8251,746,8.3
05029,2020-06-01,8439,7802,637,7.5
05031,2020-06-01,55835,51648,4187,7.5
05033,2020-06-01,26664,24839,1825,6.8
05035,2020-06-01,21402,18987,2415,11.3
05037,2020-06-01,7363,6847,516,7
05039,2020-06-01,2820,2626,194,6.9
05041,2020-06-01,5386,4916,470,8.7
05043,2020-06-01,7652,7012,640,8.4
05045,2020-06-01,61972,57498,4474,7.2
05047,2020-06-01,7560,7029,531,7
05049,2020-06-01,5019,4680,339,6.8
05051,2020-06-01,41923,37604,4319,10.3
05053,2020-06-01,8237,7670,567,6.9
05055,2020-06-01,19698,18067,1631,8.3
05057,2020-06-01,9649,9025,624,6.5
05059,2020-06-01,14092,13043,1049,7.4
05061,2020-06-01,5554,5221,333,6
05063,2020-06-01,16819,15610,1209,7.2
05065,2020-06-01,4604,4090,514,11.2
05067,2020-06-01,5959,5458,501,8.4
05069,2020-06-01,27710,25040,2670,9.6
05071,2020-06-01,10243,9468,775,7.6
05073,2020-06-01,2413,2186,227,9.4
05075,2020-06-01,6631,6083,548,8.3
05077,2020-06-01,2825,2574,251,8.9
05079,2020-06-01,3821,3546,275,7.2
05081,2020-06-01,5378,4952,426,7.9
05083,2020-06-01,8790,8044,746,8.5
05085,2020-06-01,33607,31167,2440,7.3
05087,2020-06-01,7238,6875,363,5
05089,2020-06-01,6441,5903,538,8.4
05091,2020-06-01,19414,17729,1685,8.7
05093,2020-06-01,17543,15415,2128,12.1
05095,2020-06-01,2784,2542,242,8.7
05097,2020-06-01,3068,2820,248,8.1
05099,2020-06-01,3617,3329,288,8
05101,2020-06-01,3243,3038,205,6.3
05103,2020-06-01,9925,9186,739,7.4
05105,2020-06-01,4169,3885,284,6.8
05107,2020-06-01,6522,5790,732,11.2
05109,2020-06-01,4344,4030,314,7.2
05111,2020-06-01,9815,9113,702,7.2
05113,2020-06-01,7987,7358,629,7.9
05115,2020-06-01,27671,25567,2104,7.6
05117,2020-06-01,3598,3324,274,7.6
05119,2020-06-01,191365,172596,18769,9.8
05121,2020-06-01,7345,6798,547,7.4
05123,2020-06-01,8123,7363,760,9.4
05125,2020-06-01,58495,54510,3985,6.8
05127,2020-06-01,4410,4163,247,5.6
05129,2020-06-01,2999,2772,227,7.6
05131,2020-06-01,56805,52547,4258,7.5
05133,2020-06-01,5535,5157,378,6.8
05135,2020-06-01,5780,5255,525,9.1
05137,2020-06-01,4721,4306,415,8.8
05139,2020-06-01,16053,14325,1728,10.8
05141,2020-06-01,5843,5345,498,8.5
05143,2020-06-01,124958,117165,7793,6.2
05145,2020-06-01,34275,31581,2694,7.9
05147,2020-06-01,2819,2619,200,7.1
05149,2020-06-01,7879,7373,506,6.4
06001,2020-06-01,813661,708245,105416,13
06003,2020-06-01,460,370,90,19.6
06005,2020-06-01,14505,12750,1755,12.1
06007,2020-06-01,92492,81739,10753,11.6
06009,2020-06-01,21373,19235,2138,10
06011,2020-06-01,10069,8434,1635,16.2
06013,2020-06-01,540204,470489,69715,12.9
06015,2020-06-01,9396,8307,1089,11.6
06017,2020-06-01,90943,80051,10892,12
06019,2020-06-01,448085,387783,60302,13.5
06021,2020-06-01,12548,11228,1320,10.5
06023,2020-06-01,59047,52258,6789,11.5
06025,2020-06-01,71298,52400,18898,26.5
06027,2020-06-01,8496,7613,883,10.4
06029,2020-06-01,383066,323075,59991,15.7
06031,2020-06-01,56401,48896,7505,13.3
06033,2020-06-01,28184,24722,3462,12.3
06035,2020-06-01,9387,8611,776,8.3
06037,2020-06-01,NA,NA,865005,17.9
06039,2020-06-01,62082,54082,8000,12.9
06041,2020-06-01,128392,115539,12853,10
06043,2020-06-01,7408,6354,1054,14.2
06045,2020-06-01,37100,32662,4438,12
06047,2020-06-01,113767,97348,16419,14.4
06049,2020-06-01,3222,2943,279,8.7
06051,2020-06-01,7484,5911,1573,21
06053,2020-06-01,221270,194391,26879,12.1
06055,2020-06-01,70002,61331,8671,12.4
06057,2020-06-01,46213,41055,5158,11.2
06059,2020-06-01,NA,NA,205168,13.3
06061,2020-06-01,184063,164782,19281,10.5
06063,2020-06-01,7815,6968,847,10.8
06065,2020-06-01,NA,959697,152114,13.7
06067,2020-06-01,708560,617375,91185,12.9
06069,2020-06-01,31395,27403,3992,12.7
06071,2020-06-01,965348,840279,125069,13
06073,2020-06-01,NA,NA,206976,13.5
06075,2020-06-01,554992,488323,66669,12
06077,2020-06-01,333887,285368,48519,14.5
06079,2020-06-01,132446,117872,14574,11
06081,2020-06-01,430043,385006,45037,10.5
06083,2020-06-01,216810,193636,23174,10.7
06085,2020-06-01,NA,912480,104806,10.3
06087,2020-06-01,134260,117921,16339,12.2
06089,2020-06-01,73539,65724,7815,10.6
06091,2020-06-01,1295,1172,123,9.5
06093,2020-06-01,17216,15335,1881,10.9
06095,2020-06-01,202356,176230,26126,12.9
06097,2020-06-01,245277,217196,28081,11.4
06099,2020-06-01,240824,207888,32936,13.7
06101,2020-06-01,46458,40521,5937,12.8
06103,2020-06-01,25666,22909,2757,10.7
06105,2020-06-01,4608,4198,410,8.9
06107,2020-06-01,202483,172092,30391,15
06109,2020-06-01,20098,17296,2802,13.9
06111,2020-06-01,410485,361525,48960,11.9
06113,2020-06-01,104075,93835,10240,9.8
06115,2020-06-01,30364,26519,3845,12.7
08001,2020-06-01,279813,245031,34782,12.4
08003,2020-06-01,8407,7655,752,8.9
08005,2020-06-01,374676,328431,46245,12.3
08007,2020-06-01,7410,6539,871,11.8
08009,2020-06-01,2052,1973,79,3.8
08011,2020-06-01,1738,1632,106,6.1
08013,2020-06-01,193969,174045,19924,10.3
08014,2020-06-01,40895,36476,4419,10.8
08015,2020-06-01,10152,9131,1021,10.1
08017,2020-06-01,1074,1035,39,3.6
08019,2020-06-01,6342,5469,873,13.8
08021,2020-06-01,4008,3701,307,7.7
08023,2020-06-01,1787,1600,187,10.5
08025,2020-06-01,1536,1426,110,7.2
08027,2020-06-01,2172,1999,173,8
08029,2020-06-01,14749,13327,1422,9.6
08031,2020-06-01,433127,377938,55189,12.7
08033,2020-06-01,1142,1024,118,10.3
08035,2020-06-01,196464,178192,18272,9.3
08037,2020-06-01,35747,29412,6335,17.7
08039,2020-06-01,14894,13769,1125,7.6
08041,2020-06-01,349088,310170,38918,11.1
08043,2020-06-01,16153,14427,1726,10.7
08045,2020-06-01,31805,28425,3380,10.6
08047,2020-06-01,4371,3463,908,20.8
08049,2020-06-01,9410,8028,1382,14.7
08051,2020-06-01,11440,10105,1335,11.7
08053,2020-06-01,488,462,26,5.3
08055,2020-06-01,2682,2328,354,13.2
08057,2020-06-01,951,899,52,5.5
08059,2020-06-01,339439,301317,38122,11.2
08061,2020-06-01,919,884,35,3.8
08063,2020-06-01,4208,4025,183,4.3
08065,2020-06-01,4828,4089,739,15.3
08067,2020-06-01,31846,28427,3419,10.7
08069,2020-06-01,206626,186168,20458,9.9
08071,2020-06-01,6540,5815,725,11.1
08073,2020-06-01,2384,2231,153,6.4
08075,2020-06-01,11197,10394,803,7.2
08077,2020-06-01,76141,67711,8430,11.1
08079,2020-06-01,457,409,48,10.5
08081,2020-06-01,7367,6744,623,8.5
08083,2020-06-01,13027,11780,1247,9.6
08085,2020-06-01,22067,19873,2194,9.9
08087,2020-06-01,15803,14463,1340,8.5
08089,2020-06-01,8250,7558,692,8.4
08091,2020-06-01,2691,2330,361,13.4
08093,2020-06-01,11206,10183,1023,9.1
08095,2020-06-01,2395,2276,119,5
08097,2020-06-01,11781,9705,2076,17.6
08099,2020-06-01,6105,5701,404,6.6
08101,2020-06-01,77620,68746,8874,11.4
08103,2020-06-01,2971,2743,228,7.7
08105,2020-06-01,5444,4930,514,9.4
08107,2020-06-01,16136,13880,2256,14
08109,2020-06-01,3432,3081,351,10.2
08111,2020-06-01,543,484,59,10.9
08113,2020-06-01,5460,4322,1138,20.8
08115,2020-06-01,1166,1101,65,5.6
08117,2020-06-01,21136,16974,4162,19.7
08119,2020-06-01,13330,11706,1624,12.2
08121,2020-06-01,2777,2645,132,4.8
08123,2020-06-01,166729,148520,18209,10.9
08125,2020-06-01,5510,5243,267,4.8
09001,2020-06-01,476625,421496,55129,11.6
09003,2020-06-01,482810,426049,56761,11.8
09005,2020-06-01,103596,93713,9883,9.5
09007,2020-06-01,93078,84289,8789,9.4
09009,2020-06-01,463922,411733,52189,11.2
09011,2020-06-01,136063,116421,19642,14.4
09013,2020-06-01,84952,77319,7633,9
09015,2020-06-01,62766,55864,6902,11
10001,2020-06-01,79449,67685,11764,14.8
10003,2020-06-01,293737,254509,39228,13.4
10005,2020-06-01,107587,94699,12888,12
11001,2020-06-01,400830,364052,36778,9.2
12001,2020-06-01,128716,118819,9897,7.7
12003,2020-06-01,11420,10655,765,6.7
12005,2020-06-01,82248,76005,6243,7.6
12007,2020-06-01,10452,9569,883,8.4
12009,2020-06-01,279449,253010,26439,9.5
12011,2020-06-01,NA,879352,142621,14
12013,2020-06-01,4661,4353,308,6.6
12015,2020-06-01,69955,62616,7339,10.5
12017,2020-06-01,46256,41103,5153,11.1
12019,2020-06-01,103121,95332,7789,7.6
12021,2020-06-01,172660,154217,18443,10.7
12023,2020-06-01,29156,26951,2205,7.6
12027,2020-06-01,13772,12810,962,7
12029,2020-06-01,5575,5163,412,7.4
12031,2020-06-01,476913,431286,45627,9.6
12033,2020-06-01,142705,130134,12571,8.8
12035,2020-06-01,45495,40564,4931,10.8
12037,2020-06-01,4731,4410,321,6.8
12039,2020-06-01,17830,16286,1544,8.7
12041,2020-06-01,6666,6234,432,6.5
12043,2020-06-01,4704,4304,400,8.5
12045,2020-06-01,5007,4615,392,7.8
12047,2020-06-01,4286,3882,404,9.4
12049,2020-06-01,7948,7218,730,9.2
12051,2020-06-01,14434,12773,1661,11.5
12053,2020-06-01,70665,62663,8002,11.3
12055,2020-06-01,34272,30677,3595,10.5
12057,2020-06-01,746387,666638,79749,10.7
12059,2020-06-01,6674,6187,487,7.3
12061,2020-06-01,62967,56374,6593,10.5
12063,2020-06-01,16628,15403,1225,7.4
12065,2020-06-01,5134,4740,394,7.7
12067,2020-06-01,2645,2512,133,5
12069,2020-06-01,151799,127989,23810,15.7
12071,2020-06-01,340256,302787,37469,11
12073,2020-06-01,145147,133130,12017,8.3
12075,2020-06-01,15951,14646,1305,8.2
12077,2020-06-01,2549,2392,157,6.2
12079,2020-06-01,7322,6749,573,7.8
12081,2020-06-01,174140,157303,16837,9.7
12083,2020-06-01,135711,122586,13125,9.7
12085,2020-06-01,71122,64733,6389,9
12086,2020-06-01,NA,NA,120162,10.1
12087,2020-06-01,44034,38563,5471,12.4
12089,2020-06-01,40453,37161,3292,8.1
12091,2020-06-01,95629,88951,6678,7
12093,2020-06-01,16311,15052,1259,7.7
12095,2020-06-01,744975,600201,144774,19.4
12097,2020-06-01,195557,146331,49226,25.2
12099,2020-06-01,706397,624979,81418,11.5
12101,2020-06-01,235274,210908,24366,10.4
12103,2020-06-01,478364,429280,49084,10.3
12105,2020-06-01,321522,272638,48884,15.2
12107,2020-06-01,25832,23141,2691,10.4
12109,2020-06-01,130936,120944,9992,7.6
12111,2020-06-01,143967,128066,15901,11
12113,2020-06-01,81136,75455,5681,7
12115,2020-06-01,182180,164395,17785,9.8
12117,2020-06-01,227334,200952,26382,11.6
12119,2020-06-01,31789,28290,3499,11
12121,2020-06-01,17725,16393,1332,7.5
12123,2020-06-01,8245,7609,636,7.7
12125,2020-06-01,4372,4104,268,6.1
12127,2020-06-01,244357,217535,26822,11
12129,2020-06-01,14250,13360,890,6.2
12131,2020-06-01,31854,29438,2416,7.6
12133,2020-06-01,9260,8542,718,7.8
13001,2020-06-01,9012,8541,471,5.2
13003,2020-06-01,4405,4209,196,4.4
13005,2020-06-01,4574,4321,253,5.5
13007,2020-06-01,1127,1046,81,7.2
13009,2020-06-01,17312,15813,1499,8.7
13011,2020-06-01,9532,9034,498,5.2
13013,2020-06-01,39101,36567,2534,6.5
13015,2020-06-01,48633,44782,3851,7.9
13017,2020-06-01,5467,5067,400,7.3
13019,2020-06-01,7227,6792,435,6
13021,2020-06-01,66706,60489,6217,9.3
13023,2020-06-01,4411,4080,331,7.5
13025,2020-06-01,6906,6458,448,6.5
13027,2020-06-01,6593,6202,391,5.9
13029,2020-06-01,18211,16980,1231,6.8
13031,2020-06-01,35927,32868,3059,8.5
13033,2020-06-01,8867,8097,770,8.7
13035,2020-06-01,10541,9682,859,8.1
13037,2020-06-01,2182,2044,138,6.3
13039,2020-06-01,20707,19574,1133,5.5
13043,2020-06-01,5596,5307,289,5.2
13045,2020-06-01,53371,48955,4416,8.3
13047,2020-06-01,31921,30143,1778,5.6
13049,2020-06-01,4713,4527,186,3.9
13051,2020-06-01,138540,124473,14067,10.2
13053,2020-06-01,1957,1818,139,7.1
13055,2020-06-01,9731,8608,1123,11.5
13057,2020-06-01,130099,121482,8617,6.6
13059,2020-06-01,56716,51858,4858,8.6
13061,2020-06-01,917,777,140,15.3
13063,2020-06-01,139953,120483,19470,13.9
13065,2020-06-01,2959,2841,118,4
13067,2020-06-01,407759,374315,33444,8.2
13069,2020-06-01,18516,17277,1239,6.7
13071,2020-06-01,21780,20693,1087,5
13073,2020-06-01,72685,68746,3939,5.4
13075,2020-06-01,7962,7548,414,5.2
13077,2020-06-01,73035,66669,6366,8.7
13079,2020-06-01,5395,5051,344,6.4
13081,2020-06-01,9470,8625,845,8.9
13083,2020-06-01,7617,7238,379,5
13085,2020-06-01,11958,11243,715,6
13087,2020-06-01,11142,10589,553,5
13089,2020-06-01,393291,349810,43481,11.1
13091,2020-06-01,6804,6358,446,6.6
13093,2020-06-01,4827,4417,410,8.5
13095,2020-06-01,37553,33666,3887,10.4
13097,2020-06-01,71636,64272,7364,10.3
13099,2020-06-01,4402,4121,281,6.4
13101,2020-06-01,1841,1751,90,4.9
13103,2020-06-01,30519,28597,1922,6.3
13105,2020-06-01,7847,7180,667,8.5
13107,2020-06-01,8395,7734,661,7.9
13109,2020-06-01,4897,4606,291,5.9
13111,2020-06-01,10881,10280,601,5.5
13113,2020-06-01,55625,51297,4328,7.8
13115,2020-06-01,42528,39146,3382,8
13117,2020-06-01,118195,110787,7408,6.3
13119,2020-06-01,9727,8983,744,7.6
13121,2020-06-01,553863,492296,61567,11.1
13123,2020-06-01,11623,10957,666,5.7
13125,2020-06-01,1215,1158,57,4.7
13127,2020-06-01,38170,35026,3144,8.2
13129,2020-06-01,27333,25546,1787,6.5
13131,2020-06-01,10358,9828,530,5.1
13133,2020-06-01,7220,6734,486,6.7
13135,2020-06-01,474976,432729,42247,8.9
13137,2020-06-01,18472,17204,1268,6.9
13139,2020-06-01,100112,93964,6148,6.1
13141,2020-06-01,2492,2229,263,10.6
13143,2020-06-01,11930,11055,875,7.3
13145,2020-06-01,16357,15341,1016,6.2
13147,2020-06-01,11286,10561,725,6.4
13149,2020-06-01,5037,4606,431,8.6
13151,2020-06-01,114226,102754,11472,10
13153,2020-06-01,69331,64844,4487,6.5
13155,2020-06-01,3430,3222,208,6.1
13157,2020-06-01,38440,36366,2074,5.4
13159,2020-06-01,6557,6163,394,6
13161,2020-06-01,6042,5709,333,5.5
13163,2020-06-01,6607,6111,496,7.5
13165,2020-06-01,3077,2848,229,7.4
13167,2020-06-01,3890,3676,214,5.5
13169,2020-06-01,13067,12341,726,5.6
13171,2020-06-01,7790,7168,622,8
13173,2020-06-01,3580,3376,204,5.7
13175,2020-06-01,18899,17443,1456,7.7
13177,2020-06-01,14593,13748,845,5.8
13179,2020-06-01,25453,23504,1949,7.7
13181,2020-06-01,3402,3191,211,6.2
13183,2020-06-01,7983,7558,425,5.3
13185,2020-06-01,50262,46474,3788,7.5
13187,2020-06-01,15916,14890,1026,6.4
13189,2020-06-01,8576,7743,833,9.7
13191,2020-06-01,5920,5510,410,6.9
13193,2020-06-01,4571,4208,363,7.9
13195,2020-06-01,12489,11697,792,6.3
13197,2020-06-01,3138,2943,195,6.2
13199,2020-06-01,8732,7729,1003,11.5
13201,2020-06-01,2699,2576,123,4.6
13205,2020-06-01,8185,7586,599,7.3
13207,2020-06-01,12468,11662,806,6.5
13209,2020-06-01,3824,3577,247,6.5
13211,2020-06-01,8873,8278,595,6.7
13213,2020-06-01,15128,13865,1263,8.3
13215,2020-06-01,77423,69364,8059,10.4
13217,2020-06-01,51024,46307,4717,9.2
13219,2020-06-01,18493,17577,916,5
13221,2020-06-01,6536,6158,378,5.8
13223,2020-06-01,83748,77569,6179,7.4
13225,2020-06-01,11590,10739,851,7.3
13227,2020-06-01,14575,13648,927,6.4
13229,2020-06-01,8375,7921,454,5.4
13231,2020-06-01,8516,7935,581,6.8
13233,2020-06-01,17784,16403,1381,7.8
13235,2020-06-01,3873,3677,196,5.1
13237,2020-06-01,8178,7481,697,8.5
13239,2020-06-01,800,728,72,9
13241,2020-06-01,7330,6878,452,6.2
13243,2020-06-01,2464,2285,179,7.3
13245,2020-06-01,83942,76000,7942,9.5
13247,2020-06-01,43417,39045,4372,10.1
13249,2020-06-01,2098,1990,108,5.1
13251,2020-06-01,5029,4544,485,9.6
13253,2020-06-01,2971,2805,166,5.6
13255,2020-06-01,27841,25120,2721,9.8
13257,2020-06-01,10282,9441,841,8.2
13259,2020-06-01,2462,2292,170,6.9
13261,2020-06-01,12290,11268,1022,8.3
13263,2020-06-01,2744,2493,251,9.1
13265,2020-06-01,535,496,39,7.3
13267,2020-06-01,9537,9078,459,4.8
13269,2020-06-01,2694,2488,206,7.6
13271,2020-06-01,3746,3348,398,10.6
13273,2020-06-01,3463,3157,306,8.8
13275,2020-06-01,16526,15335,1191,7.2
13277,2020-06-01,20090,18919,1171,5.8
13279,2020-06-01,11883,10951,932,7.8
13281,2020-06-01,3785,3458,327,8.6
13283,2020-06-01,2642,2463,179,6.8
13285,2020-06-01,37161,33314,3847,10.4
13287,2020-06-01,3266,3005,261,8
13289,2020-06-01,2754,2513,241,8.8
13291,2020-06-01,10517,9970,547,5.2
13293,2020-06-01,11141,10192,949,8.5
13295,2020-06-01,29961,28126,1835,6.1
13297,2020-06-01,43736,40813,2923,6.7
13299,2020-06-01,15087,14108,979,6.5
13301,2020-06-01,2538,2324,214,8.4
13303,2020-06-01,6888,6402,486,7.1
13305,2020-06-01,11586,10854,732,6.3
13307,2020-06-01,991,925,66,6.7
13309,2020-06-01,1584,1458,126,8
13311,2020-06-01,16034,15164,870,5.4
13313,2020-06-01,42626,39234,3392,8
13315,2020-06-01,2665,2492,173,6.5
13317,2020-06-01,3772,3489,283,7.5
13319,2020-06-01,3741,3497,244,6.5
13321,2020-06-01,8701,8167,534,6.1
15001,2020-06-01,89066,76783,12283,13.8
15003,2020-06-01,433923,379534,54389,12.5
15007,2020-06-01,35288,28101,7187,20.4
15009,2020-06-01,80668,62247,18421,22.8
16001,2020-06-01,258047,239289,18758,7.3
16003,2020-06-01,1833,1661,172,9.4
16005,2020-06-01,41583,39059,2524,6.1
16007,2020-06-01,3129,2984,145,4.6
16009,2020-06-01,4200,3856,344,8.2
16011,2020-06-01,23516,22413,1103,4.7
16013,2020-06-01,12794,11361,1433,11.2
16015,2020-06-01,3631,3263,368,10.1
16017,2020-06-01,21464,19499,1965,9.2
16019,2020-06-01,57997,55132,2865,4.9
16021,2020-06-01,5611,5234,377,6.7
16023,2020-06-01,1395,1336,59,4.2
16025,2020-06-01,678,637,41,6
16027,2020-06-01,106357,98303,8054,7.6
16029,2020-06-01,4069,3899,170,4.2
16031,2020-06-01,12357,11793,564,4.6
16033,2020-06-01,389,370,19,4.9
16035,2020-06-01,3030,2753,277,9.1
16037,2020-06-01,2434,2318,116,4.8
16039,2020-06-01,12010,11281,729,6.1
16041,2020-06-01,6999,6670,329,4.7
16043,2020-06-01,7749,7432,317,4.1
16045,2020-06-01,8456,7824,632,7.5
16047,2020-06-01,8190,7828,362,4.4
16049,2020-06-01,6832,6295,537,7.9
16051,2020-06-01,14138,13539,599,4.2
16053,2020-06-01,12153,11590,563,4.6
16055,2020-06-01,82663,75770,6893,8.3
16057,2020-06-01,18657,17433,1224,6.6
16059,2020-06-01,3798,3506,292,7.7
16061,2020-06-01,1706,1558,148,8.7
16063,2020-06-01,2627,2444,183,7
16065,2020-06-01,21925,21136,789,3.6
16067,2020-06-01,11586,11029,557,4.8
16069,2020-06-01,20760,19514,1246,6
16071,2020-06-01,2410,2249,161,6.7
16073,2020-06-01,5711,5288,423,7.4
16075,2020-06-01,11959,11149,810,6.8
16077,2020-06-01,4069,3866,203,5
16079,2020-06-01,5548,4950,598,10.8
16081,2020-06-01,6995,6450,545,7.8
16083,2020-06-01,41206,38395,2811,6.8
16085,2020-06-01,5961,5430,531,8.9
16087,2020-06-01,4778,4450,328,6.9
17001,2020-06-01,32178,29057,3121,9.7
17003,2020-06-01,1993,1709,284,14.2
17005,2020-06-01,7693,6845,848,11
17007,2020-06-01,26398,22159,4239,16.1
17009,2020-06-01,3000,2823,177,5.9
17011,2020-06-01,17093,15294,1799,10.5
17013,2020-06-01,2304,2021,283,12.3
17015,2020-06-01,7859,7080,779,9.9
17017,2020-06-01,6014,5393,621,10.3
17019,2020-06-01,106449,95265,11184,10.5
17021,2020-06-01,14030,12359,1671,11.9
17023,2020-06-01,7467,6639,828,11.1
17025,2020-06-01,6508,5723,785,12.1
17027,2020-06-01,20009,18249,1760,8.8
17029,2020-06-01,22860,20063,2797,12.2
17031,2020-06-01,NA,NA,443089,16.8
17033,2020-06-01,8677,7859,818,9.4
17035,2020-06-01,5992,5478,514,8.6
17037,2020-06-01,53942,47123,6819,12.6
17039,2020-06-01,7083,6398,685,9.7
17041,2020-06-01,10095,9195,900,8.9
17043,2020-06-01,495118,433651,61467,12.4
17045,2020-06-01,9097,8272,825,9.1
17047,2020-06-01,2733,2429,304,11.1
17049,2020-06-01,19549,17475,2074,10.6
17051,2020-06-01,9832,8753,1079,11
17053,2020-06-01,6157,5565,592,9.6
17055,2020-06-01,16506,14023,2483,15
17057,2020-06-01,14899,13044,1855,12.5
17059,2020-06-01,2077,1806,271,13
17061,2020-06-01,6006,5458,548,9.1
17063,2020-06-01,24845,21572,3273,13.2
17065,2020-06-01,4117,3723,394,9.6
17067,2020-06-01,8328,7557,771,9.3
17069,2020-06-01,1313,1126,187,14.2
17071,2020-06-01,3707,3305,402,10.8
17073,2020-06-01,24487,21744,2743,11.2
17075,2020-06-01,14036,12867,1169,8.3
17077,2020-06-01,27666,24287,3379,12.2
17079,2020-06-01,4707,4292,415,8.8
17081,2020-06-01,17237,14782,2455,14.2
17083,2020-06-01,10926,9650,1276,11.7
17085,2020-06-01,10690,9423,1267,11.9
17087,2020-06-01,4137,3595,542,13.1
17089,2020-06-01,267105,229691,37414,14
17091,2020-06-01,55335,48278,7057,12.8
17093,2020-06-01,68037,59195,8842,13
17095,2020-06-01,21770,19024,2746,12.6
17097,2020-06-01,371596,327143,44453,12
17099,2020-06-01,54029,46346,7683,14.2
17101,2020-06-01,5905,5237,668,11.3
17103,2020-06-01,17591,15783,1808,10.3
17105,2020-06-01,16411,14558,1853,11.3
17107,2020-06-01,12016,10778,1238,10.3
17109,2020-06-01,12175,10743,1432,11.8
17111,2020-06-01,161983,141428,20555,12.7
17113,2020-06-01,84912,75653,9259,10.9
17115,2020-06-01,48530,41356,7174,14.8
17117,2020-06-01,22548,20160,2388,10.6
17119,2020-06-01,135129,118121,17008,12.6
17121,2020-06-01,17462,15201,2261,12.9
17123,2020-06-01,5153,4614,539,10.5
17125,2020-06-01,6036,5333,703,11.6
17127,2020-06-01,5549,4605,944,17
17129,2020-06-01,6092,5519,573,9.4
17131,2020-06-01,7899,6995,904,11.4
17133,2020-06-01,18627,16930,1697,9.1
17135,2020-06-01,11907,10393,1514,12.7
17137,2020-06-01,16116,14504,1612,10
17139,2020-06-01,7401,6834,567,7.7
17141,2020-06-01,24474,21569,2905,11.9
17143,2020-06-01,86329,72748,13581,15.7
17145,2020-06-01,8216,7138,1078,13.1
17147,2020-06-01,8237,7569,668,8.1
17149,2020-06-01,7005,6414,591,8.4
17151,2020-06-01,1679,1463,216,12.9
17153,2020-06-01,1852,1553,299,16.1
17155,2020-06-01,3058,2700,358,11.7
17157,2020-06-01,14083,12644,1439,10.2
17159,2020-06-01,7628,6927,701,9.2
17161,2020-06-01,71165,61224,9941,14
17163,2020-06-01,129675,110839,18836,14.5
17165,2020-06-01,9811,8427,1384,14.1
17167,2020-06-01,98006,85550,12456,12.7
17169,2020-06-01,3287,2990,297,9
17171,2020-06-01,2357,2151,206,8.7
17173,2020-06-01,10650,9633,1017,9.5
17175,2020-06-01,2404,2167,237,9.9
17177,2020-06-01,21663,19512,2151,9.9
17179,2020-06-01,63114,55324,7790,12.3
17181,2020-06-01,7373,6505,868,11.8
17183,2020-06-01,33331,29115,4216,12.6
17185,2020-06-01,5831,5201,630,10.8
17187,2020-06-01,8286,7531,755,9.1
17189,2020-06-01,9816,9145,671,6.8
17191,2020-06-01,6904,6121,783,11.3
17193,2020-06-01,6316,5612,704,11.1
17195,2020-06-01,28379,24945,3434,12.1
17197,2020-06-01,354156,303238,50918,14.4
17199,2020-06-01,31888,27771,4117,12.9
17201,2020-06-01,140266,117065,23201,16.5
17203,2020-06-01,18147,16469,1678,9.2
18001,2020-06-01,16811,15638,1173,7
18003,2020-06-01,184842,164729,20113,10.9
18005,2020-06-01,43201,38948,4253,9.8
18007,2020-06-01,4198,3898,300,7.1
18009,2020-06-01,4769,4203,566,11.9
18011,2020-06-01,35150,32881,2269,6.5
18013,2020-06-01,7587,6833,754,9.9
18015,2020-06-01,9450,8697,753,8
18017,2020-06-01,17780,16047,1733,9.7
18019,2020-06-01,61015,54470,6545,10.7
18021,2020-06-01,11398,10388,1010,8.9
18023,2020-06-01,16743,15339,1404,8.4
18025,2020-06-01,4871,4412,459,9.4
18027,2020-06-01,16759,15911,848,5.1
18029,2020-06-01,25371,22763,2608,10.3
18031,2020-06-01,15111,13615,1496,9.9
18033,2020-06-01,22190,20181,2009,9.1
18035,2020-06-01,51133,45896,5237,10.2
18037,2020-06-01,22940,21473,1467,6.4
18039,2020-06-01,110532,100005,10527,9.5
18041,2020-06-01,8621,7416,1205,14
18043,2020-06-01,40888,36903,3985,9.7
18045,2020-06-01,7895,7203,692,8.8
18047,2020-06-01,11414,10568,846,7.4
18049,2020-06-01,10045,9106,939,9.3
18051,2020-06-01,19477,17874,1603,8.2
18053,2020-06-01,31319,28552,2767,8.8
18055,2020-06-01,13016,11920,1096,8.4
18057,2020-06-01,180715,167820,12895,7.1
18059,2020-06-01,39989,36697,3292,8.2
18061,2020-06-01,19737,17913,1824,9.2
18063,2020-06-01,88487,81594,6893,7.8
18065,2020-06-01,21928,19928,2000,9.1
18067,2020-06-01,38034,32234,5800,15.2
18069,2020-06-01,17723,16127,1596,9
18071,2020-06-01,23560,21226,2334,9.9
18073,2020-06-01,15527,14015,1512,9.7
18075,2020-06-01,8926,8163,763,8.5
18077,2020-06-01,14992,13588,1404,9.4
18079,2020-06-01,13564,12291,1273,9.4
18081,2020-06-01,81720,74800,6920,8.5
18083,2020-06-01,18470,16969,1501,8.1
18085,2020-06-01,41661,38286,3375,8.1
18087,2020-06-01,19291,17911,1380,7.2
18089,2020-06-01,227965,194029,33936,14.9
18091,2020-06-01,49002,41906,7096,14.5
18093,2020-06-01,20375,18516,1859,9.1
18095,2020-06-01,58640,52151,6489,11.1
18097,2020-06-01,496800,438565,58235,11.7
18099,2020-06-01,23044,20673,2371,10.3
18101,2020-06-01,5510,5188,322,5.8
18103,2020-06-01,15277,13561,1716,11.2
18105,2020-06-01,64800,59205,5595,8.6
18107,2020-06-01,18817,17410,1407,7.5
18109,2020-06-01,35214,32492,2722,7.7
18111,2020-06-01,6589,5961,628,9.5
18113,2020-06-01,23087,20565,2522,10.9
18115,2020-06-01,3251,2831,420,12.9
18117,2020-06-01,8638,6875,1763,20.4
18119,2020-06-01,8601,7821,780,9.1
18121,2020-06-01,7019,6494,525,7.5
18123,2020-06-01,9093,8228,865,9.5
18125,2020-06-01,6163,5674,489,7.9
18127,2020-06-01,84687,74218,10469,12.4
18129,2020-06-01,12841,11933,908,7.1
18131,2020-06-01,6578,5977,601,9.1
18133,2020-06-01,16276,14788,1488,9.1
18135,2020-06-01,11247,10294,953,8.5
18137,2020-06-01,14248,12972,1276,9
18139,2020-06-01,8786,8012,774,8.8
18141,2020-06-01,134706,118554,16152,12
18143,2020-06-01,10431,9226,1205,11.6
18145,2020-06-01,23273,20674,2599,11.2
18147,2020-06-01,10769,9980,789,7.3
18149,2020-06-01,9926,8803,1123,11.3
18151,2020-06-01,20084,18430,1654,8.2
18153,2020-06-01,7892,7157,735,9.3
18155,2020-06-01,4920,4226,694,14.1
18157,2020-06-01,91716,83368,8348,9.1
18159,2020-06-01,9113,8301,812,8.9
18161,2020-06-01,3425,3165,260,7.6
18163,2020-06-01,92373,82711,9662,10.5
18165,2020-06-01,6571,5938,633,9.6
18167,2020-06-01,45994,40887,5107,11.1
18169,2020-06-01,14383,13155,1228,8.5
18171,2020-06-01,4008,3718,290,7.2
18173,2020-06-01,31584,29160,2424,7.7
18175,2020-06-01,13461,12153,1308,9.7
18177,2020-06-01,30097,27248,2849,9.5
18179,2020-06-01,13856,12811,1045,7.5
18181,2020-06-01,13371,12378,993,7.4
18183,2020-06-01,16960,15591,1369,8.1
19001,2020-06-01,4088,3883,205,5
19003,2020-06-01,2002,1899,103,5.1
19005,2020-06-01,6918,6515,403,5.8
19007,2020-06-01,6065,5635,430,7.1
19009,2020-06-01,2973,2846,127,4.3
19011,2020-06-01,12729,11907,822,6.5
19013,2020-06-01,66932,61256,5676,8.5
19015,2020-06-01,14220,13423,797,5.6
19017,2020-06-01,13210,12519,691,5.2
19019,2020-06-01,10984,10374,610,5.6
19021,2020-06-01,11399,10733,666,5.8
19023,2020-06-01,7572,7144,428,5.7
19025,2020-06-01,4106,3879,227,5.5
19027,2020-06-01,10549,9945,604,5.7
19029,2020-06-01,6740,6416,324,4.8
19031,2020-06-01,10333,9778,555,5.4
19033,2020-06-01,23350,21725,1625,7
19035,2020-06-01,6149,5852,297,4.8
19037,2020-06-01,6245,5935,310,5
19039,2020-06-01,4700,4336,364,7.7
19041,2020-06-01,8397,7957,440,5.2
19043,2020-06-01,9718,9125,593,6.1
19045,2020-06-01,22175,20203,1972,8.9
19047,2020-06-01,7824,7342,482,6.2
19049,2020-06-01,48860,46349,2511,5.1
19051,2020-06-01,4052,3847,205,5.1
19053,2020-06-01,4005,3754,251,6.3
19055,2020-06-01,10413,9897,516,5
19057,2020-06-01,18700,16745,1955,10.5
19059,2020-06-01,10628,10043,585,5.5
19061,2020-06-01,55130,50837,4293,7.8
19063,2020-06-01,5261,4822,439,8.3
19065,2020-06-01,9848,9182,666,6.8
19067,2020-06-01,8080,7502,578,7.2
19069,2020-06-01,5637,5375,262,4.6
19071,2020-06-01,3591,3431,160,4.5
19073,2020-06-01,5321,4990,331,6.2
19075,2020-06-01,6105,5764,341,5.6
19077,2020-06-01,5309,4960,349,6.6
19079,2020-06-01,6659,6265,394,5.9
19081,2020-06-01,5721,5350,371,6.5
19083,2020-06-01,7711,7255,456,5.9
19085,2020-06-01,6973,6571,402,5.8
19087,2020-06-01,9256,8558,698,7.5
19089,2020-06-01,5023,4799,224,4.5
19091,2020-06-01,4965,4689,276,5.6
19093,2020-06-01,3940,3757,183,4.6
19095,2020-06-01,9911,9353,558,5.6
19097,2020-06-01,10695,9805,890,8.3
19099,2020-06-01,19215,17846,1369,7.1
19101,2020-06-01,8986,8109,877,9.8
19103,2020-06-01,84117,78124,5993,7.1
19105,2020-06-01,10095,9365,730,7.2
19107,2020-06-01,5148,4841,307,6
19109,2020-06-01,8104,7717,387,4.8
19111,2020-06-01,15906,14605,1301,8.2
19113,2020-06-01,119078,108605,10473,8.8
19115,2020-06-01,5979,5621,358,6
19117,2020-06-01,4630,4401,229,4.9
19119,2020-06-01,6783,6591,192,2.8
19121,2020-06-01,8270,7639,631,7.6
19123,2020-06-01,11795,10988,807,6.8
19125,2020-06-01,17910,16867,1043,5.8
19127,2020-06-01,17350,15895,1455,8.4
19129,2020-06-01,7084,6674,410,5.8
19131,2020-06-01,6171,5926,245,4
19133,2020-06-01,4334,4090,244,5.6
19135,2020-06-01,3957,3676,281,7.1
19137,2020-06-01,4833,4488,345,7.1
19139,2020-06-01,21187,19401,1786,8.4
19141,2020-06-01,8068,7721,347,4.3
19143,2020-06-01,3479,3347,132,3.8
19145,2020-06-01,6193,5657,536,8.7
19147,2020-06-01,4590,4319,271,5.9
19149,2020-06-01,14047,13361,686,4.9
19151,2020-06-01,4247,4038,209,4.9
19153,2020-06-01,265854,242612,23242,8.7
19155,2020-06-01,47434,43690,3744,7.9
19157,2020-06-01,9597,9006,591,6.2
19159,2020-06-01,2319,2180,139,6
19161,2020-06-01,5142,4906,236,4.6
19163,2020-06-01,86574,78624,7950,9.2
19165,2020-06-01,6262,5993,269,4.3
19167,2020-06-01,20031,19361,670,3.3
19169,2020-06-01,52976,49988,2988,5.6
19171,2020-06-01,9112,8594,518,5.7
19173,2020-06-01,3074,2843,231,7.5
19175,2020-06-01,6105,5604,501,8.2
19177,2020-06-01,3619,3377,242,6.7
19179,2020-06-01,17377,15922,1455,8.4
19181,2020-06-01,27366,25653,1713,6.3
19183,2020-06-01,11240,10692,548,4.9
19185,2020-06-01,2755,2581,174,6.3
19187,2020-06-01,18806,17453,1353,7.2
19189,2020-06-01,5075,4604,471,9.3
19191,2020-06-01,10747,10045,702,6.5
19193,2020-06-01,54453,50365,4088,7.5
19195,2020-06-01,4086,3792,294,7.2
19197,2020-06-01,7004,6649,355,5.1
20001,2020-06-01,6436,6025,411,6.4
20003,2020-06-01,4283,4093,190,4.4
20005,2020-06-01,6852,6331,521,7.6
20007,2020-06-01,2349,2265,84,3.6
20009,2020-06-01,13815,13180,635,4.6
20011,2020-06-01,6680,6280,400,6
20013,2020-06-01,5224,4989,235,4.5
20015,2020-06-01,31736,29306,2430,7.7
20017,2020-06-01,1459,1379,80,5.5
20019,2020-06-01,1483,1374,109,7.3
20021,2020-06-01,10009,9403,606,6.1
20023,2020-06-01,1362,1337,25,1.8
20025,2020-06-01,1133,1111,22,1.9
20027,2020-06-01,3896,3698,198,5.1
20029,2020-06-01,3869,3703,166,4.3
20031,2020-06-01,3933,3713,220,5.6
20033,2020-06-01,900,865,35,3.9
20035,2020-06-01,16709,15402,1307,7.8
20037,2020-06-01,18786,17636,1150,6.1
20039,2020-06-01,1275,1228,47,3.7
20041,2020-06-01,8870,8403,467,5.3
20043,2020-06-01,4168,3950,218,5.2
20045,2020-06-01,60859,56227,4632,7.6
20047,2020-06-01,1512,1462,50,3.3
20049,2020-06-01,1180,1120,60,5.1
20051,2020-06-01,17044,16424,620,3.6
20053,2020-06-01,2766,2681,85,3.1
20055,2020-06-01,20781,19990,791,3.8
20057,2020-06-01,16961,16328,633,3.7
20059,2020-06-01,14309,13456,853,6
20061,2020-06-01,11565,10626,939,8.1
20063,2020-06-01,1485,1445,40,2.7
20065,2020-06-01,1166,1102,64,5.5
20067,2020-06-01,3183,3039,144,4.5
20069,2020-06-01,3302,3237,65,2
20071,2020-06-01,861,846,15,1.7
20073,2020-06-01,3082,2908,174,5.6
20075,2020-06-01,1649,1623,26,1.6
20077,2020-06-01,2815,2677,138,4.9
20079,2020-06-01,16432,15462,970,5.9
20081,2020-06-01,2261,2203,58,2.6
20083,2020-06-01,1032,1007,25,2.4
20085,2020-06-01,7281,6772,509,7
20087,2020-06-01,10172,9642,530,5.2
20089,2020-06-01,1289,1243,46,3.6
20091,2020-06-01,343845,323149,20696,6
20093,2020-06-01,2056,1998,58,2.8
20095,2020-06-01,3255,3075,180,5.5
20097,2020-06-01,1242,1198,44,3.5
20099,2020-06-01,9649,9041,608,6.3
20101,2020-06-01,768,747,21,2.7
20103,2020-06-01,36897,34464,2433,6.6
20105,2020-06-01,1637,1591,46,2.8
20107,2020-06-01,4388,4059,329,7.5
20109,2020-06-01,1675,1638,37,2.2
20111,2020-06-01,16447,15602,845,5.1
20113,2020-06-01,17334,16717,617,3.6
20115,2020-06-01,5840,5589,251,4.3
20117,2020-06-01,5542,5370,172,3.1
20119,2020-06-01,2171,2114,57,2.6
20121,2020-06-01,17673,16722,951,5.4
20123,2020-06-01,3497,3408,89,2.5
20125,2020-06-01,15026,13805,1221,8.1
20127,2020-06-01,3111,2987,124,4
20129,2020-06-01,1160,1127,33,2.8
20131,2020-06-01,5694,5528,166,2.9
20133,2020-06-01,6282,5874,408,6.5
20135,2020-06-01,1347,1301,46,3.4
20137,2020-06-01,2657,2588,69,2.6
20139,2020-06-01,7972,7549,423,5.3
20141,2020-06-01,1989,1932,57,2.9
20143,2020-06-01,2929,2801,128,4.4
20145,2020-06-01,2891,2788,103,3.6
20147,2020-06-01,2699,2599,100,3.7
20149,2020-06-01,11138,10524,614,5.5
20151,2020-06-01,4991,4784,207,4.1
20153,2020-06-01,1579,1539,40,2.5
20155,2020-06-01,30211,28445,1766,5.8
20157,2020-06-01,2373,2290,83,3.5
20159,2020-06-01,5076,4850,226,4.5
20161,2020-06-01,31749,29583,2166,6.8
20163,2020-06-01,2510,2397,113,4.5
20165,2020-06-01,1560,1481,79,5.1
20167,2020-06-01,3341,3177,164,4.9
20169,2020-06-01,29163,27345,1818,6.2
20171,2020-06-01,2871,2789,82,2.9
20173,2020-06-01,252770,226124,26646,10.5
20175,2020-06-01,9715,9231,484,5
20177,2020-06-01,91297,85253,6044,6.6
20179,2020-06-01,1513,1481,32,2.1
20181,2020-06-01,2917,2818,99,3.4
20183,2020-06-01,2004,1957,47,2.3
20185,2020-06-01,2096,2020,76,3.6
20187,2020-06-01,1090,1067,23,2.1
20189,2020-06-01,2876,2800,76,2.6
20191,2020-06-01,10806,9776,1030,9.5
20193,2020-06-01,4209,4085,124,2.9
20195,2020-06-01,1508,1459,49,3.2
20197,2020-06-01,3669,3502,167,4.6
20199,2020-06-01,839,823,16,1.9
20201,2020-06-01,3084,3007,77,2.5
20203,2020-06-01,1239,1218,21,1.7
20205,2020-06-01,3941,3650,291,7.4
20207,2020-06-01,1662,1556,106,6.4
20209,2020-06-01,79290,71990,7300,9.2
21001,2020-06-01,6772,6359,413,6.1
21003,2020-06-01,8574,8161,413,4.8
21005,2020-06-01,11689,11048,641,5.5
21007,2020-06-01,3305,3133,172,5.2
21009,2020-06-01,17963,16818,1145,6.4
21011,2020-06-01,4518,4222,296,6.6
21013,2020-06-01,7976,7451,525,6.6
21015,2020-06-01,69411,65931,3480,5
21017,2020-06-01,9539,9103,436,4.6
21019,2020-06-01,17289,16012,1277,7.4
21021,2020-06-01,12398,11638,760,6.1
21023,2020-06-01,3672,3498,174,4.7
21025,2020-06-01,3186,2906,280,8.8
21027,2020-06-01,7687,7231,456,5.9
21029,2020-06-01,41094,38872,2222,5.4
21031,2020-06-01,4785,4517,268,5.6
21033,2020-06-01,5505,5231,274,5
21035,2020-06-01,17512,16584,928,5.3
21037,2020-06-01,49106,46596,2510,5.1
21039,2020-06-01,2185,2108,77,3.5
21041,2020-06-01,5240,4953,287,5.5
21043,2020-06-01,9395,8618,777,8.3
21045,2020-06-01,6746,6440,306,4.5
21047,2020-06-01,24285,22630,1655,6.8
21049,2020-06-01,16739,15768,971,5.8
21051,2020-06-01,5096,4751,345,6.8
21053,2020-06-01,4002,3835,167,4.2
21055,2020-06-01,3649,3488,161,4.4
21057,2020-06-01,3283,3161,122,3.7
21059,2020-06-01,45252,42907,2345,5.2
21061,2020-06-01,4452,4163,289,6.5
21063,2020-06-01,1897,1734,163,8.6
21065,2020-06-01,4965,4621,344,6.9
21067,2020-06-01,170262,161197,9065,5.3
21069,2020-06-01,6113,5735,378,6.2
21071,2020-06-01,10416,9551,865,8.3
21073,2020-06-01,24585,23134,1451,5.9
21075,2020-06-01,1992,1865,127,6.4
21077,2020-06-01,3979,3767,212,5.3
21079,2020-06-01,7449,7055,394,5.3
21081,2020-06-01,11345,10657,688,6.1
21083,2020-06-01,15480,14703,777,5
21085,2020-06-01,10411,9756,655,6.3
21087,2020-06-01,5075,4854,221,4.4
21089,2020-06-01,13034,12024,1010,7.7
21091,2020-06-01,3750,3577,173,4.6
21093,2020-06-01,46992,44036,2956,6.3
21095,2020-06-01,6240,5603,637,10.2
21097,2020-06-01,8549,8159,390,4.6
21099,2020-06-01,7667,7275,392,5.1
21101,2020-06-01,20741,19672,1069,5.2
21103,2020-06-01,7944,7559,385,4.8
21105,2020-06-01,1730,1649,81,4.7
21107,2020-06-01,17893,16709,1184,6.6
21109,2020-06-01,3966,3690,276,7
21111,2020-06-01,383759,358953,24806,6.5
21113,2020-06-01,25774,24465,1309,5.1
21115,2020-06-01,6536,6064,472,7.2
21117,2020-06-01,85169,80628,4541,5.3
21119,2020-06-01,4218,3913,305,7.2
21121,2020-06-01,9787,9035,752,7.7
21123,2020-06-01,5733,5394,339,5.9
21125,2020-06-01,24250,22849,1401,5.8
21127,2020-06-01,5272,4920,352,6.7
21129,2020-06-01,2033,1908,125,6.1
21131,2020-06-01,2524,2302,222,8.8
21133,2020-06-01,5897,5372,525,8.9
21135,2020-06-01,4615,4270,345,7.5
21137,2020-06-01,9193,8602,591,6.4
21139,2020-06-01,3479,3268,211,6.1
21141,2020-06-01,12095,11542,553,4.6
21143,2020-06-01,3176,3052,124,3.9
21145,2020-06-01,28091,26353,1738,6.2
21147,2020-06-01,4748,4462,286,6
21149,2020-06-01,4011,3818,193,4.8
21151,2020-06-01,44458,41994,2464,5.5
21153,2020-06-01,3083,2666,417,13.5
21155,2020-06-01,9263,8737,526,5.7
21157,2020-06-01,14859,14133,726,4.9
21159,2020-06-01,2510,2248,262,10.4
21161,2020-06-01,6738,6302,436,6.5
21163,2020-06-01,11592,10893,699,6
21165,2020-06-01,2216,2068,148,6.7
21167,2020-06-01,9798,9186,612,6.2
21169,2020-06-01,3953,3715,238,6
21171,2020-06-01,4536,4345,191,4.2
21173,2020-06-01,11247,10506,741,6.6
21175,2020-06-01,4305,4061,244,5.7
21177,2020-06-01,9811,9080,731,7.5
21179,2020-06-01,22489,21157,1332,5.9
21181,2020-06-01,3202,3022,180,5.6
21183,2020-06-01,9094,8539,555,6.1
21185,2020-06-01,31891,30497,1394,4.4
21187,2020-06-01,5093,4817,276,5.4
21189,2020-06-01,1057,992,65,6.1
21191,2020-06-01,6694,6412,282,4.2
21193,2020-06-01,7938,7309,629,7.9
21195,2020-06-01,18624,17221,1403,7.5
21197,2020-06-01,5038,4724,314,6.2
21199,2020-06-01,25439,23807,1632,6.4
21201,2020-06-01,780,745,35,4.5
21203,2020-06-01,6188,5821,367,5.9
21205,2020-06-01,9371,8725,646,6.9
21207,2020-06-01,6111,5673,438,7.2
21209,2020-06-01,28699,27336,1363,4.7
21211,2020-06-01,24787,23609,1178,4.8
21213,2020-06-01,8487,7934,553,6.5
21215,2020-06-01,10026,9540,486,4.8
21217,2020-06-01,12627,12015,612,4.8
21219,2020-06-01,5368,5163,205,3.8
21221,2020-06-01,5964,5632,332,5.6
21223,2020-06-01,3695,3503,192,5.2
21225,2020-06-01,5803,5473,330,5.7
21227,2020-06-01,61558,57859,3699,6
21229,2020-06-01,6108,5835,273,4.5
21231,2020-06-01,7284,6892,392,5.4
21233,2020-06-01,5355,5047,308,5.8
21235,2020-06-01,13503,12656,847,6.3
21237,2020-06-01,2017,1895,122,6
21239,2020-06-01,14918,14267,651,4.4
22001,2020-06-01,22271,20331,1940,8.7
22003,2020-06-01,8026,7134,892,11.1
22005,2020-06-01,60275,55101,5174,8.6
22007,2020-06-01,8395,7375,1020,12.2
22009,2020-06-01,14427,13131,1296,9
22011,2020-06-01,13869,12843,1026,7.4
22013,2020-06-01,5167,4721,446,8.6
22015,2020-06-01,53975,49744,4231,7.8
22017,2020-06-01,98401,87454,10947,11.1
22019,2020-06-01,94426,84771,9655,10.2
22021,2020-06-01,3519,3229,290,8.2
22023,2020-06-01,3364,3148,216,6.4
22025,2020-06-01,3356,3081,275,8.2
22027,2020-06-01,5237,4876,361,6.9
22029,2020-06-01,6559,5920,639,9.7
22031,2020-06-01,10056,9214,842,8.4
22033,2020-06-01,216348,194609,21739,10
22035,2020-06-01,1712,1488,224,13.1
22037,2020-06-01,7287,6681,606,8.3
22039,2020-06-01,11476,10403,1073,9.3
22041,2020-06-01,7044,6387,657,9.3
22043,2020-06-01,7776,7193,583,7.5
22045,2020-06-01,26624,23680,2944,11.1
22047,2020-06-01,13175,11588,1587,12
22049,2020-06-01,6482,6084,398,6.1
22051,2020-06-01,201763,176998,24765,12.3
22053,2020-06-01,12351,11242,1109,9
22055,2020-06-01,108644,99114,9530,8.8
22057,2020-06-01,39194,36075,3119,8
22059,2020-06-01,6646,6284,362,5.4
22061,2020-06-01,19731,18218,1513,7.7
22063,2020-06-01,64220,58882,5338,8.3
22065,2020-06-01,3476,3147,329,9.5
22067,2020-06-01,9631,8603,1028,10.7
22069,2020-06-01,15143,13892,1251,8.3
22071,2020-06-01,174984,147411,27573,15.8
22073,2020-06-01,66436,60578,5858,8.8
22075,2020-06-01,9072,8252,820,9
22077,2020-06-01,9063,8185,878,9.7
22079,2020-06-01,52498,48682,3816,7.3
22081,2020-06-01,3437,3213,224,6.5
22083,2020-06-01,7765,7099,666,8.6
22085,2020-06-01,8764,8205,559,6.4
22087,2020-06-01,19062,16603,2459,12.9
22089,2020-06-01,23317,20942,2375,10.2
22091,2020-06-01,4107,3505,602,14.7
22093,2020-06-01,8523,7520,1003,11.8
22095,2020-06-01,18531,15932,2599,14
22097,2020-06-01,31100,28002,3098,10
22099,2020-06-01,20990,18939,2051,9.8
22101,2020-06-01,18824,16758,2066,11
22103,2020-06-01,109860,100260,9600,8.7
22105,2020-06-01,53975,47373,6602,12.2
22107,2020-06-01,1290,1166,124,9.6
22109,2020-06-01,43734,39627,4107,9.4
22111,2020-06-01,8498,7784,714,8.4
22113,2020-06-01,22595,20624,1971,8.7
22115,2020-06-01,15334,14158,1176,7.7
22117,2020-06-01,16011,14418,1593,9.9
22119,2020-06-01,13316,12146,1170,8.8
22121,2020-06-01,12695,11545,1150,9.1
22123,2020-06-01,3481,3103,378,10.9
22125,2020-06-01,4920,4595,325,6.6
22127,2020-06-01,4531,4194,337,7.4
23001,2020-06-01,53692,50800,2892,5.4
23003,2020-06-01,29241,27914,1327,4.5
23005,2020-06-01,158064,149508,8556,5.4
23007,2020-06-01,13310,12505,805,6
23009,2020-06-01,28534,27239,1295,4.5
23011,2020-06-01,61078,58383,2695,4.4
23013,2020-06-01,20002,19048,954,4.8
23015,2020-06-01,16755,15993,762,4.5
23017,2020-06-01,25327,23663,1664,6.6
23019,2020-06-01,73475,69847,3628,4.9
23021,2020-06-01,7172,6851,321,4.5
23023,2020-06-01,19011,18153,858,4.5
23025,2020-06-01,21896,20570,1326,6.1
23027,2020-06-01,20021,19143,878,4.4
23029,2020-06-01,13527,12895,632,4.7
23031,2020-06-01,109284,103631,5653,5.2
24001,2020-06-01,31851,28767,3084,9.7
24003,2020-06-01,319052,294746,24306,7.6
24005,2020-06-01,458499,418823,39676,8.7
24009,2020-06-01,49110,45867,3243,6.6
24011,2020-06-01,17561,16432,1129,6.4
24013,2020-06-01,94997,88805,6192,6.5
24015,2020-06-01,53196,49441,3755,7.1
24017,2020-06-01,87828,80166,7662,8.7
24019,2020-06-01,16697,15414,1283,7.7
24021,2020-06-01,135437,124855,10582,7.8
24023,2020-06-01,15648,14483,1165,7.4
24025,2020-06-01,141878,131484,10394,7.3
24027,2020-06-01,189434,176392,13042,6.9
24029,2020-06-01,9749,8957,792,8.1
24031,2020-06-01,560277,512899,47378,8.5
24033,2020-06-01,516206,461698,54508,10.6
24035,2020-06-01,27674,25722,1952,7.1
24037,2020-06-01,58968,55490,3478,5.9
24039,2020-06-01,9139,8293,846,9.3
24041,2020-06-01,18105,16791,1314,7.3
24043,2020-06-01,75120,68855,6265,8.3
24045,2020-06-01,52523,48000,4523,8.6
24047,2020-06-01,26201,23283,2918,11.1
24510,2020-06-01,290083,258948,31135,10.7
25001,2020-06-01,113440,95828,17612,15.5
25003,2020-06-01,63231,54512,8719,13.8
25005,2020-06-01,299802,250200,49602,16.5
25007,2020-06-01,11107,9838,1269,11.4
25009,2020-06-01,423431,353298,70133,16.6
25011,2020-06-01,39988,35222,4766,11.9
25013,2020-06-01,224404,187026,37378,16.7
25015,2020-06-01,85713,75330,10383,12.1
25017,2020-06-01,885038,775978,109060,12.3
25019,2020-06-01,9142,8098,1044,11.4
25021,2020-06-01,384325,329847,54478,14.2
25023,2020-06-01,281681,237361,44320,15.7
25025,2020-06-01,459564,381947,77617,16.9
25027,2020-06-01,437916,374890,63026,14.4
26001,2020-06-01,4070,3608,462,11.4
26003,2020-06-01,3507,2975,532,15.2
26005,2020-06-01,64898,58795,6103,9.4
26007,2020-06-01,13505,12225,1280,9.5
26009,2020-06-01,11101,9882,1219,11
26011,2020-06-01,6197,5392,805,13
26013,2020-06-01,3196,2652,544,17
26015,2020-06-01,32224,29214,3010,9.3
26017,2020-06-01,51643,45866,5777,11.2
26019,2020-06-01,9074,8138,936,10.3
26021,2020-06-01,76605,67647,8958,11.7
26023,2020-06-01,20835,18776,2059,9.9
26025,2020-06-01,64656,56449,8207,12.7
26027,2020-06-01,25559,22814,2745,10.7
26029,2020-06-01,13792,12216,1576,11.4
26031,2020-06-01,11210,9711,1499,13.4
26033,2020-06-01,16634,14919,1715,10.3
26035,2020-06-01,12303,10641,1662,13.5
26037,2020-06-01,41065,37690,3375,8.2
26039,2020-06-01,6017,5275,742,12.3
26041,2020-06-01,17626,15853,1773,10.1
26043,2020-06-01,12715,11645,1070,8.4
26045,2020-06-01,57540,52014,5526,9.6
26047,2020-06-01,18515,16427,2088,11.3
26049,2020-06-01,187952,161830,26122,13.9
26051,2020-06-01,10366,9181,1185,11.4
26053,2020-06-01,5984,5433,551,9.2
26055,2020-06-01,51994,46561,5433,10.4
26057,2020-06-01,18661,16890,1771,9.5
26059,2020-06-01,21345,18977,2368,11.1
26061,2020-06-01,15872,14294,1578,9.9
26063,2020-06-01,16579,14845,1734,10.5
26065,2020-06-01,151304,136551,14753,9.8
26067,2020-06-01,31662,28509,3153,10
26069,2020-06-01,10753,9423,1330,12.4
26071,2020-06-01,5212,4749,463,8.9
26073,2020-06-01,34485,30695,3790,11
26075,2020-06-01,77378,68068,9310,12
26077,2020-06-01,135853,122380,13473,9.9
26079,2020-06-01,8390,7295,1095,13.1
26081,2020-06-01,370116,331518,38598,10.4
26083,2020-06-01,887,783,104,11.7
26085,2020-06-01,4207,3689,518,12.3
26087,2020-06-01,40181,32553,7628,19
26089,2020-06-01,10853,9813,1040,9.6
26091,2020-06-01,47313,42084,5229,11.1
26093,2020-06-01,98394,84097,14297,14.5
26095,2020-06-01,2387,2169,218,9.1
26097,2020-06-01,5684,5089,595,10.5
26099,2020-06-01,442446,357985,84461,19.1
26101,2020-06-01,10860,9452,1408,13
26103,2020-06-01,32265,28552,3713,11.5
26105,2020-06-01,14265,12752,1513,10.6
26107,2020-06-01,18290,16117,2173,11.9
26109,2020-06-01,11195,10339,856,7.6
26111,2020-06-01,41041,37247,3794,9.2
26113,2020-06-01,7270,6481,789,10.9
26115,2020-06-01,77045,68532,8513,11
26117,2020-06-01,29167,25728,3439,11.8
26119,2020-06-01,3199,2715,484,15.1
26121,2020-06-01,81976,69623,12353,15.1
26123,2020-06-01,24528,21890,2638,10.8
26125,2020-06-01,644770,544692,100078,15.5
26127,2020-06-01,12924,11393,1531,11.8
26129,2020-06-01,8532,7504,1028,12
26131,2020-06-01,2116,1850,266,12.6
26133,2020-06-01,12195,11024,1171,9.6
26135,2020-06-01,3129,2716,413,13.2
26137,2020-06-01,12507,10957,1550,12.4
26139,2020-06-01,164185,148909,15276,9.3
26141,2020-06-01,5190,4586,604,11.6
26143,2020-06-01,8542,7464,1078,12.6
26145,2020-06-01,87930,77054,10876,12.4
26147,2020-06-01,74025,60232,13793,18.6
26149,2020-06-01,30526,27260,3266,10.7
26151,2020-06-01,20606,18194,2412,11.7
26153,2020-06-01,3421,3051,370,10.8
26155,2020-06-01,34285,30455,3830,11.2
26157,2020-06-01,24728,21697,3031,12.3
26159,2020-06-01,35973,32154,3819,10.6
26161,2020-06-01,196115,178047,18068,9.2
26163,2020-06-01,804665,631975,172690,21.5
26165,2020-06-01,15686,13731,1955,12.5
27001,2020-06-01,7765,7074,691,8.9
27003,2020-06-01,203754,185118,18636,9.1
27005,2020-06-01,19587,18067,1520,7.8
27007,2020-06-01,25714,23736,1978,7.7
27009,2020-06-01,22505,20605,1900,8.4
27011,2020-06-01,2635,2504,131,5
27013,2020-06-01,41243,37895,3348,8.1
27015,2020-06-01,14749,13839,910,6.2
27017,2020-06-01,17938,16152,1786,10
27019,2020-06-01,60047,55550,4497,7.5
27021,2020-06-01,15494,13814,1680,10.8
27023,2020-06-01,7009,6615,394,5.6
27025,2020-06-01,30649,28070,2579,8.4
27027,2020-06-01,36883,34673,2210,6
27029,2020-06-01,4567,4158,409,9
27031,2020-06-01,3112,2763,349,11.2
27033,2020-06-01,6438,6048,390,6.1
27035,2020-06-01,33971,31085,2886,8.5
27037,2020-06-01,249830,226610,23220,9.3
27039,2020-06-01,12220,11301,919,7.5
27041,2020-06-01,22245,20970,1275,5.7
27043,2020-06-01,7424,6881,543,7.3
27045,2020-06-01,11835,11052,783,6.6
27047,2020-06-01,16923,15585,1338,7.9
27049,2020-06-01,27431,25108,2323,8.5
27051,2020-06-01,3444,3242,202,5.9
27053,2020-06-01,736431,661826,74605,10.1
27055,2020-06-01,10434,9877,557,5.3
27057,2020-06-01,10537,9697,840,8
27059,2020-06-01,21752,19935,1817,8.4
27061,2020-06-01,23258,20767,2491,10.7
27063,2020-06-01,6153,5700,453,7.4
27065,2020-06-01,9195,8488,707,7.7
27067,2020-06-01,25781,24305,1476,5.7
27069,2020-06-01,2489,2359,130,5.2
27071,2020-06-01,6196,5664,532,8.6
27073,2020-06-01,3704,3519,185,5
27075,2020-06-01,5510,4873,637,11.6
27077,2020-06-01,2533,2329,204,8.1
27079,2020-06-01,16387,15121,1266,7.7
27081,2020-06-01,3295,3154,141,4.3
27083,2020-06-01,15076,14222,854,5.7
27085,2020-06-01,19813,18415,1398,7.1
27087,2020-06-01,2298,1850,448,19.5
27089,2020-06-01,5709,5356,353,6.2
27091,2020-06-01,10559,9786,773,7.3
27093,2020-06-01,13581,12822,759,5.6
27095,2020-06-01,13100,11842,1258,9.6
27097,2020-06-01,18311,17063,1248,6.8
27099,2020-06-01,21550,20030,1520,7.1
27101,2020-06-01,5096,4857,239,4.7
27103,2020-06-01,21140,19653,1487,7
27105,2020-06-01,12044,11318,726,6
27107,2020-06-01,3435,3174,261,7.6
27109,2020-06-01,93073,84806,8267,8.9
27111,2020-06-01,33205,31197,2008,6
27113,2020-06-01,8965,8404,561,6.3
27115,2020-06-01,14970,13532,1438,9.6
27117,2020-06-01,4958,4753,205,4.1
27119,2020-06-01,16694,15500,1194,7.2
27121,2020-06-01,6785,6451,334,4.9
27123,2020-06-01,301056,269319,31737,10.5
27125,2020-06-01,2264,2120,144,6.4
27127,2020-06-01,8154,7618,536,6.6
27129,2020-06-01,8889,8315,574,6.5
27131,2020-06-01,38167,35383,2784,7.3
27133,2020-06-01,6042,5789,253,4.2
27135,2020-06-01,8407,7600,807,9.6
27137,2020-06-01,102815,92065,10750,10.5
27139,2020-06-01,86167,78699,7468,8.7
27141,2020-06-01,53349,49114,4235,7.9
27143,2020-06-01,8569,8001,568,6.6
27145,2020-06-01,92984,85728,7256,7.8
27147,2020-06-01,20787,19256,1531,7.4
27149,2020-06-01,5656,5445,211,3.7
27151,2020-06-01,5091,4805,286,5.6
27153,2020-06-01,14236,13366,870,6.1
27155,2020-06-01,1849,1755,94,5.1
27157,2020-06-01,12674,11744,930,7.3
27159,2020-06-01,6175,5684,491,8
27161,2020-06-01,9511,8751,760,8
27163,2020-06-01,147321,135081,12240,8.3
27165,2020-06-01,6867,6446,421,6.1
27167,2020-06-01,3578,3390,188,5.3
27169,2020-06-01,28515,26541,1974,6.9
27171,2020-06-01,77020,71420,5600,7.3
27173,2020-06-01,5540,5259,281,5.1
28001,2020-06-01,10409,8983,1426,13.7
28003,2020-06-01,15176,14043,1133,7.5
28005,2020-06-01,4604,4155,449,9.8
28007,2020-06-01,7158,6461,697,9.7
28009,2020-06-01,2945,2626,319,10.8
28011,2020-06-01,11741,10490,1251,10.7
28013,2020-06-01,5906,5380,526,8.9
28015,2020-06-01,3500,3182,318,9.1
28017,2020-06-01,7054,6123,931,13.2
28019,2020-06-01,3644,3366,278,7.6
28021,2020-06-01,3202,2594,608,19
28023,2020-06-01,5811,5193,618,10.6
28025,2020-06-01,8115,6904,1211,14.9
28027,2020-06-01,8618,7317,1301,15.1
28029,2020-06-01,10708,9622,1086,10.1
28031,2020-06-01,8460,7715,745,8.8
28033,2020-06-01,87965,81062,6903,7.8
28035,2020-06-01,32262,28823,3439,10.7
28037,2020-06-01,2825,2562,263,9.3
28039,2020-06-01,9254,8281,973,10.5
28041,2020-06-01,4421,3920,501,11.3
28043,2020-06-01,9356,8512,844,9
28045,2020-06-01,18337,16467,1870,10.2
28047,2020-06-01,86086,76028,10058,11.7
28049,2020-06-01,103827,90679,13148,12.7
28051,2020-06-01,5846,4605,1241,21.2
28053,2020-06-01,2451,2044,407,16.6
28055,2020-06-01,374,344,30,8
28057,2020-06-01,10143,9312,831,8.2
28059,2020-06-01,57475,50736,6739,11.7
28061,2020-06-01,6188,5514,674,10.9
28063,2020-06-01,2033,1590,443,21.8
28065,2020-06-01,4020,3516,504,12.5
28067,2020-06-01,25685,23409,2276,8.9
28069,2020-06-01,3527,3072,455,12.9
28071,2020-06-01,25367,23146,2221,8.8
28073,2020-06-01,29486,27190,2296,7.8
28075,2020-06-01,29065,26214,2851,9.8
28077,2020-06-01,4759,4276,483,10.1
28079,2020-06-01,8425,7572,853,10.1
28081,2020-06-01,40637,36302,4335,10.7
28083,2020-06-01,10003,8699,1304,13
28085,2020-06-01,14592,13285,1307,9
28087,2020-06-01,24428,21696,2732,11.2
28089,2020-06-01,51348,46918,4430,8.6
28091,2020-06-01,10018,9152,866,8.6
28093,2020-06-01,13920,12509,1411,10.1
28095,2020-06-01,15555,13782,1773,11.4
28097,2020-06-01,3988,3605,383,9.6
28099,2020-06-01,10960,9431,1529,14
28101,2020-06-01,8034,7174,860,10.7
28103,2020-06-01,4090,3495,595,14.5
28105,2020-06-01,21067,18783,2284,10.8
28107,2020-06-01,12873,11250,1623,12.6
28109,2020-06-01,22761,20768,1993,8.8
28111,2020-06-01,4152,3723,429,10.3
28113,2020-06-01,14902,13288,1614,10.8
28115,2020-06-01,14592,13240,1352,9.3
28117,2020-06-01,11162,10245,917,8.2
28119,2020-06-01,2507,2186,321,12.8
28121,2020-06-01,72324,67508,4816,6.7
28123,2020-06-01,12813,11882,931,7.3
28125,2020-06-01,1593,1395,198,12.4
28127,2020-06-01,10337,9459,878,8.5
28129,2020-06-01,6352,5909,443,7
28131,2020-06-01,6913,6297,616,8.9
28133,2020-06-01,7888,6935,953,12.1
28135,2020-06-01,5331,4871,460,8.6
28137,2020-06-01,11867,10720,1147,9.7
28139,2020-06-01,9254,8492,762,8.2
28141,2020-06-01,8351,7725,626,7.5
28143,2020-06-01,4728,3852,876,18.5
28145,2020-06-01,13991,12817,1174,8.4
28147,2020-06-01,5035,4528,507,10.1
28149,2020-06-01,20054,17833,2221,11.1
28151,2020-06-01,16618,14434,2184,13.1
28153,2020-06-01,7869,6990,879,11.2
28155,2020-06-01,3805,3456,349,9.2
28157,2020-06-01,2742,2344,398,14.5
28159,2020-06-01,7280,6441,839,11.5
28161,2020-06-01,4829,4310,519,10.7
28163,2020-06-01,10104,8843,1261,12.5
29001,2020-06-01,10015,9329,686,6.8
29003,2020-06-01,9653,9179,474,4.9
29005,2020-06-01,2844,2686,158,5.6
29007,2020-06-01,10382,9466,916,8.8
29009,2020-06-01,16077,14557,1520,9.5
29011,2020-06-01,5265,4938,327,6.2
29013,2020-06-01,7605,7129,476,6.3
29015,2020-06-01,7400,6750,650,8.8
29017,2020-06-01,5358,5026,332,6.2
29019,2020-06-01,93850,88332,5518,5.9
29021,2020-06-01,43407,40745,2662,6.1
29023,2020-06-01,17966,16707,1259,7
29025,2020-06-01,4216,3990,226,5.4
29027,2020-06-01,21383,20120,1263,5.9
29029,2020-06-01,19877,18442,1435,7.2
29031,2020-06-01,39983,37341,2642,6.6
29033,2020-06-01,4559,4304,255,5.6
29035,2020-06-01,2547,2366,181,7.1
29037,2020-06-01,53212,49750,3462,6.5
29039,2020-06-01,5740,5433,307,5.3
29041,2020-06-01,3838,3655,183,4.8
29043,2020-06-01,44658,41539,3119,7
29045,2020-06-01,3215,3023,192,6
29047,2020-06-01,134584,124365,10219,7.6
29049,2020-06-01,10422,9711,711,6.8
29051,2020-06-01,39007,36800,2207,5.7
29053,2020-06-01,7176,6669,507,7.1
29055,2020-06-01,10956,10033,923,8.4
29057,2020-06-01,3665,3459,206,5.6
29059,2020-06-01,7015,6469,546,7.8
29061,2020-06-01,4229,4035,194,4.6
29063,2020-06-01,4765,4540,225,4.7
29065,2020-06-01,6310,5957,353,5.6
29067,2020-06-01,5335,4705,630,11.8
29069,2020-06-01,11784,10801,983,8.3
29071,2020-06-01,52045,47616,4429,8.5
29073,2020-06-01,7741,7095,646,8.3
29075,2020-06-01,3426,3291,135,3.9
29077,2020-06-01,149455,137905,11550,7.7
29079,2020-06-01,4399,4124,275,6.3
29081,2020-06-01,3889,3699,190,4.9
29083,2020-06-01,9797,8943,854,8.7
29085,2020-06-01,4004,3796,208,5.2
29087,2020-06-01,2625,2520,105,4
29089,2020-06-01,4725,4474,251,5.3
29091,2020-06-01,16213,14838,1375,8.5
29093,2020-06-01,3521,3217,304,8.6
29095,2020-06-01,356567,324132,32435,9.1
29097,2020-06-01,55639,51418,4221,7.6
29099,2020-06-01,115001,105397,9604,8.4
29101,2020-06-01,23189,21552,1637,7.1
29103,2020-06-01,1787,1708,79,4.4
29105,2020-06-01,17109,15267,1842,10.8
29107,2020-06-01,16369,15379,990,6
29109,2020-06-01,17899,16380,1519,8.5
29111,2020-06-01,5020,4702,318,6.3
29113,2020-06-01,28224,26004,2220,7.9
29115,2020-06-01,5128,4796,332,6.5
29117,2020-06-01,7573,7264,309,4.1
29119,2020-06-01,10320,9694,626,6.1
29121,2020-06-01,7555,7139,416,5.5
29123,2020-06-01,5391,4950,441,8.2
29125,2020-06-01,3974,3731,243,6.1
29127,2020-06-01,14376,13499,877,6.1
29129,2020-06-01,1956,1882,74,3.8
29131,2020-06-01,12593,11797,796,6.3
29133,2020-06-01,5823,5471,352,6
29135,2020-06-01,7435,7031,404,5.4
29137,2020-06-01,3913,3624,289,7.4
29139,2020-06-01,5713,5358,355,6.2
29141,2020-06-01,8681,7885,796,9.2
29143,2020-06-01,8629,8051,578,6.7
29145,2020-06-01,26461,24538,1923,7.3
29147,2020-06-01,10598,10000,598,5.6
29149,2020-06-01,3888,3550,338,8.7
29151,2020-06-01,7085,6767,318,4.5
29153,2020-06-01,3689,3366,323,8.8
29155,2020-06-01,6239,5642,597,9.6
29157,2020-06-01,9778,9214,564,5.8
29159,2020-06-01,20757,18782,1975,9.5
29161,2020-06-01,19402,18217,1185,6.1
29163,2020-06-01,7623,7070,553,7.3
29165,2020-06-01,57915,53651,4264,7.4
29167,2020-06-01,14206,13290,916,6.4
29169,2020-06-01,14680,13609,1071,7.3
29171,2020-06-01,2326,2200,126,5.4
29173,2020-06-01,5679,5352,327,5.8
29175,2020-06-01,10250,9503,747,7.3
29177,2020-06-01,10744,9940,804,7.5
29179,2020-06-01,3051,2826,225,7.4
29181,2020-06-01,4996,4506,490,9.8
29183,2020-06-01,221208,204942,16266,7.4
29185,2020-06-01,3832,3532,300,7.8
29186,2020-06-01,9243,8706,537,5.8
29187,2020-06-01,26443,24028,2415,9.1
29189,2020-06-01,520171,473116,47055,9
29195,2020-06-01,10549,9906,643,6.1
29197,2020-06-01,2018,1838,180,8.9
29199,2020-06-01,2414,2330,84,3.5
29201,2020-06-01,19934,18643,1291,6.5
29203,2020-06-01,3444,3166,278,8.1
29205,2020-06-01,3120,2951,169,5.4
29207,2020-06-01,13107,12243,864,6.6
29209,2020-06-01,13317,11809,1508,11.3
29211,2020-06-01,2809,2705,104,3.7
29213,2020-06-01,27083,22841,4242,15.7
29215,2020-06-01,9024,8438,586,6.5
29217,2020-06-01,9499,9021,478,5
29219,2020-06-01,17878,16554,1324,7.4
29221,2020-06-01,10040,9092,948,9.4
29223,2020-06-01,5093,4744,349,6.9
29225,2020-06-01,17207,15967,1240,7.2
29227,2020-06-01,1244,1176,68,5.5
29229,2020-06-01,7514,6863,651,8.7
29510,2020-06-01,152741,134014,18727,12.3
30001,2020-06-01,5121,4885,236,4.6
30003,2020-06-01,4917,4511,406,8.3
30005,2020-06-01,2192,2078,114,5.2
30007,2020-06-01,2673,2476,197,7.4
30009,2020-06-01,5673,5281,392,6.9
30011,2020-06-01,622,602,20,3.2
30013,2020-06-01,39077,36233,2844,7.3
30015,2020-06-01,2450,2346,104,4.2
30017,2020-06-01,6392,5996,396,6.2
30019,2020-06-01,894,870,24,2.7
30021,2020-06-01,4614,4233,381,8.3
30023,2020-06-01,5182,4885,297,5.7
30025,2020-06-01,1588,1504,84,5.3
30027,2020-06-01,6061,5763,298,4.9
30029,2020-06-01,52004,47071,4933,9.5
30031,2020-06-01,72331,67344,4987,6.9
30033,2020-06-01,701,681,20,2.9
30035,2020-06-01,5640,5019,621,11
30037,2020-06-01,366,342,24,6.6
30039,2020-06-01,1658,1526,132,8
30041,2020-06-01,7789,7337,452,5.8
30043,2020-06-01,5928,5549,379,6.4
30045,2020-06-01,897,848,49,5.5
30047,2020-06-01,14282,13237,1045,7.3
30049,2020-06-01,37481,35209,2272,6.1
30051,2020-06-01,911,885,26,2.9
30053,2020-06-01,8415,7524,891,10.6
30055,2020-06-01,957,922,35,3.7
30057,2020-06-01,4159,3899,260,6.3
30059,2020-06-01,933,878,55,5.9
30061,2020-06-01,1879,1653,226,12
30063,2020-06-01,66598,61359,5239,7.9
30065,2020-06-01,2376,2207,169,7.1
30067,2020-06-01,9357,8543,814,8.7
30069,2020-06-01,256,247,9,3.5
30071,2020-06-01,1899,1790,109,5.7
30073,2020-06-01,2735,2558,177,6.5
30075,2020-06-01,973,938,35,3.6
30077,2020-06-01,3037,2876,161,5.3
30079,2020-06-01,460,421,39,8.5
30081,2020-06-01,21218,19829,1389,6.5
30083,2020-06-01,6153,5616,537,8.7
30085,2020-06-01,4634,4269,365,7.9
30087,2020-06-01,3931,3657,274,7
30089,2020-06-01,5243,4829,414,7.9
30091,2020-06-01,1764,1661,103,5.8
30093,2020-06-01,17798,16316,1482,8.3
30095,2020-06-01,5293,4976,317,6
30097,2020-06-01,1898,1819,79,4.2
30099,2020-06-01,2801,2658,143,5.1
30101,2020-06-01,2182,2029,153,7
30103,2020-06-01,318,302,16,5
30105,2020-06-01,4111,3912,199,4.8
30107,2020-06-01,712,654,58,8.1
30109,2020-06-01,461,430,31,6.7
30111,2020-06-01,86095,80149,5946,6.9
31001,2020-06-01,17267,16247,1020,5.9
31003,2020-06-01,4095,3978,117,2.9
31005,2020-06-01,235,219,16,6.8
31007,2020-06-01,375,363,12,3.2
31009,2020-06-01,259,252,7,2.7
31011,2020-06-01,3024,2927,97,3.2
31013,2020-06-01,5571,5154,417,7.5
31015,2020-06-01,1092,1047,45,4.1
31017,2020-06-01,1456,1402,54,3.7
31019,2020-06-01,27891,26116,1775,6.4
31021,2020-06-01,3630,3440,190,5.2
31023,2020-06-01,4701,4464,237,5
31025,2020-06-01,13684,12753,931,6.8
31027,2020-06-01,4721,4557,164,3.5
31029,2020-06-01,2360,2303,57,2.4
31031,2020-06-01,3487,3367,120,3.4
31033,2020-06-01,4407,4133,274,6.2
31035,2020-06-01,3368,3225,143,4.2
31037,2020-06-01,5656,5413,243,4.3
31039,2020-06-01,4974,4802,172,3.5
31041,2020-06-01,6537,6207,330,5
31043,2020-06-01,10804,10013,791,7.3
31045,2020-06-01,5120,4879,241,4.7
31047,2020-06-01,13771,13023,748,5.4
31049,2020-06-01,964,928,36,3.7
31051,2020-06-01,2973,2843,130,4.4
31053,2020-06-01,20528,19481,1047,5.1
31055,2020-06-01,307612,282271,25341,8.2
31057,2020-06-01,1198,1166,32,2.7
31059,2020-06-01,3253,3117,136,4.2
31061,2020-06-01,1510,1429,81,5.4
31063,2020-06-01,1560,1490,70,4.5
31065,2020-06-01,2727,2619,108,4
31067,2020-06-01,11166,10518,648,5.8
31069,2020-06-01,1103,1052,51,4.6
31071,2020-06-01,1183,1147,36,3
31073,2020-06-01,1176,1127,49,4.2
31075,2020-06-01,414,404,10,2.4
31077,2020-06-01,1323,1262,61,4.6
31079,2020-06-01,32822,30241,2581,7.9
31081,2020-06-01,4873,4605,268,5.5
31083,2020-06-01,1828,1750,78,4.3
31085,2020-06-01,643,624,19,3
31087,2020-06-01,1354,1293,61,4.5
31089,2020-06-01,5973,5766,207,3.5
31091,2020-06-01,470,458,12,2.6
31093,2020-06-01,3358,3207,151,4.5
31095,2020-06-01,4279,4109,170,4
31097,2020-06-01,2101,1997,104,5
31099,2020-06-01,3843,3638,205,5.3
31101,2020-06-01,4801,4603,198,4.1
31103,2020-06-01,611,595,16,2.6
31105,2020-06-01,2028,1920,108,5.3
31107,2020-06-01,4791,4600,191,4
31109,2020-06-01,178469,166363,12106,6.8
31111,2020-06-01,18961,17788,1173,6.2
31113,2020-06-01,491,471,20,4.1
31115,2020-06-01,436,419,17,3.9
31117,2020-06-01,447,431,16,3.6
31119,2020-06-01,19811,18716,1095,5.5
31121,2020-06-01,4069,3863,206,5.1
31123,2020-06-01,2692,2562,130,4.8
31125,2020-06-01,2017,1928,89,4.4
31127,2020-06-01,3589,3385,204,5.7
31129,2020-06-01,2488,2402,86,3.5
31131,2020-06-01,8613,8150,463,5.4
31133,2020-06-01,1545,1475,70,4.5
31135,2020-06-01,1889,1842,47,2.5
31137,2020-06-01,5095,4848,247,4.8
31139,2020-06-01,4201,4036,165,3.9
31141,2020-06-01,18206,17235,971,5.3
31143,2020-06-01,2992,2848,144,4.8
31145,2020-06-01,5985,5658,327,5.5
31147,2020-06-01,4328,4129,199,4.6
31149,2020-06-01,877,852,25,2.9
31151,2020-06-01,7431,7014,417,5.6
31153,2020-06-01,98360,91980,6380,6.5
31155,2020-06-01,11288,10680,608,5.4
31157,2020-06-01,18541,17427,1114,6
31159,2020-06-01,8935,8372,563,6.3
31161,2020-06-01,2763,2667,96,3.5
31163,2020-06-01,1713,1633,80,4.7
31165,2020-06-01,771,749,22,2.9
31167,2020-06-01,3576,3419,157,4.4
31169,2020-06-01,2852,2741,111,3.9
31171,2020-06-01,432,410,22,5.1
31173,2020-06-01,3071,2784,287,9.3
31175,2020-06-01,2204,2114,90,4.1
31177,2020-06-01,11279,10646,633,5.6
31179,2020-06-01,5392,5155,237,4.4
31181,2020-06-01,1686,1593,93,5.5
31183,2020-06-01,577,563,14,2.4
31185,2020-06-01,7432,6942,490,6.6
32001,2020-06-01,11109,10482,627,5.6
32003,2020-06-01,NA,897854,199804,18.2
32005,2020-06-01,22269,20155,2114,9.5
32007,2020-06-01,27073,25694,1379,5.1
32009,2020-06-01,400,385,15,3.8
32011,2020-06-01,1059,1024,35,3.3
32013,2020-06-01,8146,7746,400,4.9
32015,2020-06-01,3169,3033,136,4.3
32017,2020-06-01,2031,1937,94,4.6
32019,2020-06-01,23126,21200,1926,8.3
32021,2020-06-01,2066,1957,109,5.3
32023,2020-06-01,17565,15903,1662,9.5
32027,2020-06-01,2551,2451,100,3.9
32029,2020-06-01,2007,1832,175,8.7
32031,2020-06-01,250366,228846,21520,8.6
32033,2020-06-01,4646,4468,178,3.8
32510,2020-06-01,26157,23951,2206,8.4
33001,2020-06-01,31371,28272,3099,9.9
33003,2020-06-01,23001,20352,2649,11.5
33005,2020-06-01,39984,36306,3678,9.2
33007,2020-06-01,14545,12886,1659,11.4
33009,2020-06-01,48097,43597,4500,9.4
33011,2020-06-01,241708,215879,25829,10.7
33013,2020-06-01,82668,75282,7386,8.9
33015,2020-06-01,188190,168045,20145,10.7
33017,2020-06-01,73167,66012,7155,9.8
33019,2020-06-01,23495,21560,1935,8.2
34001,2020-06-01,123246,80622,42624,34.6
34003,2020-06-01,479636,402055,77581,16.2
34005,2020-06-01,229926,198638,31288,13.6
34007,2020-06-01,257868,215997,41871,16.2
34009,2020-06-01,48303,39266,9037,18.7
34011,2020-06-01,67303,56498,10805,16.1
34013,2020-06-01,380902,311000,69902,18.4
34015,2020-06-01,151734,128548,23186,15.3
34017,2020-06-01,363776,299806,63970,17.6
34019,2020-06-01,62795,55293,7502,11.9
34021,2020-06-01,204683,180643,24040,11.7
34023,2020-06-01,435392,372816,62576,14.4
34025,2020-06-01,328225,279595,48630,14.8
34027,2020-06-01,252050,219361,32689,13
34029,2020-06-01,280087,235858,44229,15.8
34031,2020-06-01,250000,199354,50646,20.3
34033,2020-06-01,29769,25555,4214,14.2
34035,2020-06-01,167204,145843,21361,12.8
34037,2020-06-01,74294,62987,11307,15.2
34039,2020-06-01,278519,234372,44147,15.9
34041,2020-06-01,55590,47950,7640,13.7
35001,2020-06-01,321347,289485,31862,9.9
35003,2020-06-01,1157,1070,87,7.5
35005,2020-06-01,27077,24472,2605,9.6
35006,2020-06-01,8730,7744,986,11.3
35007,2020-06-01,4915,4492,423,8.6
35009,2020-06-01,21410,20058,1352,6.3
35011,2020-06-01,690,654,36,5.2
35013,2020-06-01,94309,85187,9122,9.7
35015,2020-06-01,32402,29735,2667,8.2
35017,2020-06-01,11217,9880,1337,11.9
35019,2020-06-01,1472,1360,112,7.6
35021,2020-06-01,268,258,10,3.7
35023,2020-06-01,1902,1775,127,6.7
35025,2020-06-01,28534,24639,3895,13.7
35027,2020-06-01,8831,7860,971,11
35028,2020-06-01,9682,9261,421,4.3
35029,2020-06-01,10490,8856,1634,15.6
35031,2020-06-01,22939,20218,2721,11.9
35033,2020-06-01,2043,1856,187,9.2
35035,2020-06-01,25196,22514,2682,10.6
35037,2020-06-01,2978,2722,256,8.6
35039,2020-06-01,16310,14820,1490,9.1
35041,2020-06-01,7510,6932,578,7.7
35043,2020-06-01,64553,57774,6779,10.5
35045,2020-06-01,47601,41640,5961,12.5
35047,2020-06-01,10077,9104,973,9.7
35049,2020-06-01,69813,62415,7398,10.6
35051,2020-06-01,4006,3610,396,9.9
35053,2020-06-01,5993,5485,508,8.5
35055,2020-06-01,14370,12220,2150,15
35057,2020-06-01,5191,4612,579,11.2
35059,2020-06-01,1611,1512,99,6.1
35061,2020-06-01,29398,26466,2932,10
36001,2020-06-01,159525,142814,16711,10.5
36003,2020-06-01,18932,16922,2010,10.6
36005,2020-06-01,590741,454251,136490,23.1
36007,2020-06-01,83883,74144,9739,11.6
36009,2020-06-01,33007,28550,4457,13.5
36011,2020-06-01,36080,32305,3775,10.5
36013,2020-06-01,53130,46951,6179,11.6
36015,2020-06-01,36387,31924,4463,12.3
36017,2020-06-01,22466,20612,1854,8.3
36019,2020-06-01,36339,32560,3779,10.4
36021,2020-06-01,31087,28407,2680,8.6
36023,2020-06-01,22474,20190,2284,10.2
36025,2020-06-01,19169,17423,1746,9.1
36027,2020-06-01,143275,126922,16353,11.4
36029,2020-06-01,445758,385408,60350,13.5
36031,2020-06-01,16760,15032,1728,10.3
36033,2020-06-01,19383,17203,2180,11.2
36035,2020-06-01,23375,20808,2567,11
36037,2020-06-01,29588,26779,2809,9.5
36039,2020-06-01,20828,18465,2363,11.3
36041,2020-06-01,2257,2075,182,8.1
36043,2020-06-01,27730,25035,2695,9.7
36045,2020-06-01,44534,39791,4743,10.7
36047,2020-06-01,NA,925022,215394,18.9
36049,2020-06-01,11639,10612,1027,8.8
36051,2020-06-01,30058,27273,2785,9.3
36053,2020-06-01,32780,29428,3352,10.2
36055,2020-06-01,366577,322940,43637,11.9
36057,2020-06-01,22674,20131,2543,11.2
36059,2020-06-01,710891,618440,92451,13
36061,2020-06-01,834760,714477,120283,14.4
36063,2020-06-01,99829,85243,14586,14.6
36065,2020-06-01,103040,91762,11278,10.9
36067,2020-06-01,225276,198699,26577,11.8
36069,2020-06-01,55117,49609,5508,10
36071,2020-06-01,185149,161910,23239,12.6
36073,2020-06-01,17323,15455,1868,10.8
36075,2020-06-01,52797,46772,6025,11.4
36077,2020-06-01,26782,24268,2514,9.4
36079,2020-06-01,50368,44786,5582,11.1
36081,2020-06-01,NA,882975,216372,19.7
36083,2020-06-01,81512,73516,7996,9.8
36085,2020-06-01,206768,173076,33692,16.3
36087,2020-06-01,154626,135559,19067,12.3
36089,2020-06-01,43551,38910,4641,10.7
36091,2020-06-01,120708,108628,12080,10
36093,2020-06-01,78286,69172,9114,11.6
36095,2020-06-01,14446,13131,1315,9.1
36097,2020-06-01,8211,7302,909,11.1
36099,2020-06-01,15326,13577,1749,11.4
36101,2020-06-01,43096,38368,4728,11
36103,2020-06-01,775633,675901,99732,12.9
36105,2020-06-01,36372,31660,4712,13
36107,2020-06-01,22605,20231,2374,10.5
36109,2020-06-01,47398,43058,4340,9.2
36111,2020-06-01,87564,77407,10157,11.6
36113,2020-06-01,31255,27654,3601,11.5
36115,2020-06-01,27373,24782,2591,9.5
36117,2020-06-01,43250,39089,4161,9.6
36119,2020-06-01,483085,422395,60690,12.6
36121,2020-06-01,18144,16540,1604,8.8
36123,2020-06-01,11588,10629,959,8.3
37001,2020-06-01,78322,71295,7027,9
37003,2020-06-01,17219,15780,1439,8.4
37005,2020-06-01,4080,3759,321,7.9
37007,2020-06-01,10076,9160,916,9.1
37009,2020-06-01,12205,11408,797,6.5
37011,2020-06-01,7267,6749,518,7.1
37013,2020-06-01,18885,17484,1401,7.4
37015,2020-06-01,7290,6774,516,7.1
37017,2020-06-01,13693,12487,1206,8.8
37019,2020-06-01,53039,47935,5104,9.6
37021,2020-06-01,133242,118165,15077,11.3
37023,2020-06-01,38878,35760,3118,8
37025,2020-06-01,106767,97543,9224,8.6
37027,2020-06-01,35068,31837,3231,9.2
37029,2020-06-01,4448,4167,281,6.3
37031,2020-06-01,31537,29434,2103,6.7
37033,2020-06-01,9305,8499,806,8.7
37035,2020-06-01,76396,69323,7073,9.3
37037,2020-06-01,34089,31854,2235,6.6
37039,2020-06-01,10882,9885,997,9.2
37041,2020-06-01,5304,4939,365,6.9
37043,2020-06-01,4009,3669,340,8.5
37045,2020-06-01,47431,43092,4339,9.1
37047,2020-06-01,22325,20275,2050,9.2
37049,2020-06-01,40080,37040,3040,7.6
37051,2020-06-01,124687,110703,13984,11.2
37053,2020-06-01,13441,12494,947,7
37055,2020-06-01,21194,19348,1846,8.7
37057,2020-06-01,76722,70300,6422,8.4
37059,2020-06-01,19581,17909,1672,8.5
37061,2020-06-01,23661,22163,1498,6.3
37063,2020-06-01,166706,152728,13978,8.4
37065,2020-06-01,20161,17573,2588,12.8
37067,2020-06-01,180310,163592,16718,9.3
37069,2020-06-01,30023,27604,2419,8.1
37071,2020-06-01,107816,97503,10313,9.6
37073,2020-06-01,4900,4575,325,6.6
37075,2020-06-01,3092,2739,353,11.4
37077,2020-06-01,28784,26754,2030,7.1
37079,2020-06-01,9019,8408,611,6.8
37081,2020-06-01,252923,225536,27387,10.8
37083,2020-06-01,19525,17501,2024,10.4
37085,2020-06-01,51436,46933,4503,8.8
37087,2020-06-01,27610,25011,2599,9.4
37089,2020-06-01,50463,46029,4434,8.8
37091,2020-06-01,8753,8038,715,8.2
37093,2020-06-01,19367,17422,1945,10
37095,2020-06-01,1856,1678,178,9.6
37097,2020-06-01,87310,79593,7717,8.8
37099,2020-06-01,19173,17326,1847,9.6
37101,2020-06-01,95024,87748,7276,7.7
37103,2020-06-01,4053,3778,275,6.8
37105,2020-06-01,25422,22969,2453,9.6
37107,2020-06-01,26860,24892,1968,7.3
37109,2020-06-01,42220,39046,3174,7.5
37111,2020-06-01,20252,18630,1622,8
37113,2020-06-01,15198,14020,1178,7.8
37115,2020-06-01,9211,8416,795,8.6
37117,2020-06-01,8466,7765,701,8.3
37119,2020-06-01,610759,551467,59292,9.7
37121,2020-06-01,5655,5128,527,9.3
37123,2020-06-01,11116,10283,833,7.5
37125,2020-06-01,39674,36197,3477,8.8
37127,2020-06-01,40852,36719,4133,10.1
37129,2020-06-01,118605,108401,10204,8.6
37131,2020-06-01,7259,6666,593,8.2
37133,2020-06-01,62568,57425,5143,8.2
37135,2020-06-01,75652,70585,5067,6.7
37137,2020-06-01,5100,4781,319,6.3
37139,2020-06-01,16195,14845,1350,8.3
37141,2020-06-01,27207,25167,2040,7.5
37143,2020-06-01,4692,4337,355,7.6
37145,2020-06-01,17523,16023,1500,8.6
37147,2020-06-01,83698,76740,6958,8.3
37149,2020-06-01,8747,8113,634,7.2
37151,2020-06-01,62261,56748,5513,8.9
37153,2020-06-01,16621,14847,1774,10.7
37155,2020-06-01,49229,44196,5033,10.2
37157,2020-06-01,38129,34226,3903,10.2
37159,2020-06-01,63960,57886,6074,9.5
37161,2020-06-01,24014,21287,2727,11.4
37163,2020-06-01,27166,25332,1834,6.8
37165,2020-06-01,11251,9696,1555,13.8
37167,2020-06-01,29020,26885,2135,7.4
37169,2020-06-01,20410,18821,1589,7.8
37171,2020-06-01,31961,29400,2561,8
37173,2020-06-01,6961,6253,708,10.2
37175,2020-06-01,13929,12936,993,7.1
37177,2020-06-01,1425,1308,117,8.2
37179,2020-06-01,118406,110038,8368,7.1
37181,2020-06-01,16921,14971,1950,11.5
37183,2020-06-01,568935,522589,46346,8.1
37185,2020-06-01,6478,5698,780,12
37187,2020-06-01,4302,3925,377,8.8
37189,2020-06-01,26730,24666,2064,7.7
37191,2020-06-01,49575,45815,3760,7.6
37193,2020-06-01,27919,25728,2191,7.8
37195,2020-06-01,33760,30321,3439,10.2
37197,2020-06-01,16797,15340,1457,8.7
37199,2020-06-01,7941,7297,644,8.1
38001,2020-06-01,1025,985,40,3.9
38003,2020-06-01,5187,4951,236,4.5
38005,2020-06-01,2186,2002,184,8.4
38007,2020-06-01,528,507,21,4
38009,2020-06-01,3136,2959,177,5.6
38011,2020-06-01,1703,1649,54,3.2
38013,2020-06-01,1026,961,65,6.3
38015,2020-06-01,51702,49190,2512,4.9
38017,2020-06-01,105557,99692,5865,5.6
38019,2020-06-01,1974,1909,65,3.3
38021,2020-06-01,2428,2345,83,3.4
38023,2020-06-01,1439,1379,60,4.2
38025,2020-06-01,3120,2926,194,6.2
38027,2020-06-01,1286,1225,61,4.7
38029,2020-06-01,1502,1438,64,4.3
38031,2020-06-01,1619,1566,53,3.3
38033,2020-06-01,892,859,33,3.7
38035,2020-06-01,36904,34658,2246,6.1
38037,2020-06-01,1230,1200,30,2.4
38039,2020-06-01,1036,1003,33,3.2
38041,2020-06-01,1435,1377,58,4
38043,2020-06-01,1297,1235,62,4.8
38045,2020-06-01,2066,2009,57,2.8
38047,2020-06-01,879,850,29,3.3
38049,2020-06-01,3180,3003,177,5.6
38051,2020-06-01,1125,1097,28,2.5
38053,2020-06-01,9348,8354,994,10.6
38055,2020-06-01,4909,4682,227,4.6
38057,2020-06-01,3764,3540,224,6
38059,2020-06-01,17083,16138,945,5.5
38061,2020-06-01,6977,6501,476,6.8
38063,2020-06-01,1423,1364,59,4.1
38065,2020-06-01,888,848,40,4.5
38067,2020-06-01,3437,3241,196,5.7
38069,2020-06-01,1739,1662,77,4.4
38071,2020-06-01,5884,5584,300,5.1
38073,2020-06-01,2972,2855,117,3.9
38075,2020-06-01,1219,1143,76,6.2
38077,2020-06-01,8679,8312,367,4.2
38079,2020-06-01,5052,4326,726,14.4
38081,2020-06-01,2900,2784,116,4
38083,2020-06-01,707,677,30,4.2
38085,2020-06-01,1233,1178,55,4.5
38087,2020-06-01,397,381,16,4
38089,2020-06-01,18800,16944,1856,9.9
38091,2020-06-01,963,929,34,3.5
38093,2020-06-01,10706,10304,402,3.8
38095,2020-06-01,1201,1170,31,2.6
38097,2020-06-01,4479,4279,200,4.5
38099,2020-06-01,5421,5127,294,5.4
38101,2020-06-01,32599,30233,2366,7.3
38103,2020-06-01,1948,1869,79,4.1
38105,2020-06-01,23361,20154,3207,13.7
39001,2020-06-01,10832,9765,1067,9.9
39003,2020-06-01,47887,43002,4885,10.2
39005,2020-06-01,26175,24163,2012,7.7
39007,2020-06-01,43818,39481,4337,9.9
39009,2020-06-01,24660,22184,2476,10
39011,2020-06-01,24609,22427,2182,8.9
39013,2020-06-01,28828,25433,3395,11.8
39015,2020-06-01,19179,17326,1853,9.7
39017,2020-06-01,193272,175310,17962,9.3
39019,2020-06-01,12811,11430,1381,10.8
39021,2020-06-01,19904,18222,1682,8.5
39023,2020-06-01,62977,56777,6200,9.8
39025,2020-06-01,105639,96384,9255,8.8
39027,2020-06-01,17725,15881,1844,10.4
39029,2020-06-01,47455,42187,5268,11.1
39031,2020-06-01,14164,12592,1572,11.1
39033,2020-06-01,18831,16696,2135,11.3
39035,2020-06-01,600127,516157,83970,14
39037,2020-06-01,25623,23682,1941,7.6
39039,2020-06-01,17732,16080,1652,9.3
39041,2020-06-01,110119,102586,7533,6.8
39043,2020-06-01,37269,32885,4384,11.8
39045,2020-06-01,77778,71359,6419,8.3
39047,2020-06-01,13854,12612,1242,9
39049,2020-06-01,704677,635320,69357,9.8
39051,2020-06-01,21361,19509,1852,8.7
39053,2020-06-01,12310,11185,1125,9.1
39055,2020-06-01,45857,41960,3897,8.5
39057,2020-06-01,82341,75606,6735,8.2
39059,2020-06-01,18260,16461,1799,9.9
39061,2020-06-01,416532,373727,42805,10.3
39063,2020-06-01,41613,38104,3509,8.4
39065,2020-06-01,13435,12093,1342,10
39067,2020-06-01,6777,6045,732,10.8
39069,2020-06-01,12983,11864,1119,8.6
39071,2020-06-01,17300,15548,1752,10.1
39073,2020-06-01,12803,11688,1115,8.7
39075,2020-06-01,20825,19850,975,4.7
39077,2020-06-01,27742,24949,2793,10.1
39079,2020-06-01,13062,11760,1302,10
39081,2020-06-01,27552,24259,3293,12
39083,2020-06-01,30711,28416,2295,7.5
39085,2020-06-01,120466,107541,12925,10.7
39087,2020-06-01,23858,21310,2548,10.7
39089,2020-06-01,89988,82422,7566,8.4
39091,2020-06-01,22503,20512,1991,8.8
39093,2020-06-01,148698,130386,18312,12.3
39095,2020-06-01,208056,181444,26612,12.8
39097,2020-06-01,20455,18990,1465,7.2
39099,2020-06-01,100982,88365,12617,12.5
39101,2020-06-01,28081,25561,2520,9
39103,2020-06-01,92925,83723,9202,9.9
39105,2020-06-01,8851,7896,955,10.8
39107,2020-06-01,23742,22044,1698,7.2
39109,2020-06-01,53773,49229,4544,8.5
39111,2020-06-01,5930,5268,662,11.2
39113,2020-06-01,254390,226739,27651,10.9
39115,2020-06-01,6574,5899,675,10.3
39117,2020-06-01,16606,15251,1355,8.2
39119,2020-06-01,40114,36565,3549,8.8
39121,2020-06-01,4615,4143,472,10.2
39123,2020-06-01,21718,19717,2001,9.2
39125,2020-06-01,8662,7903,759,8.8
39127,2020-06-01,15713,14205,1508,9.6
39129,2020-06-01,26179,24014,2165,8.3
39131,2020-06-01,10741,9533,1208,11.2
39133,2020-06-01,84690,77138,7552,8.9
39135,2020-06-01,21065,19312,1753,8.3
39137,2020-06-01,18776,17533,1243,6.6
39139,2020-06-01,51726,46225,5501,10.6
39141,2020-06-01,34743,31344,3399,9.8
39143,2020-06-01,29884,27051,2833,9.5
39145,2020-06-01,28916,25983,2933,10.1
39147,2020-06-01,27284,24707,2577,9.4
39149,2020-06-01,24182,21898,2284,9.4
39151,2020-06-01,183335,165045,18290,10
39153,2020-06-01,269110,240658,28452,10.6
39155,2020-06-01,84878,74163,10715,12.6
39157,2020-06-01,44510,40566,3944,8.9
39159,2020-06-01,28795,26881,1914,6.6
39161,2020-06-01,15374,13553,1821,11.8
39163,2020-06-01,5585,5001,584,10.5
39165,2020-06-01,118037,108356,9681,8.2
39167,2020-06-01,27014,24325,2689,10
39169,2020-06-01,59619,55152,4467,7.5
39171,2020-06-01,18666,17050,1616,8.7
39173,2020-06-01,68375,62346,6029,8.8
39175,2020-06-01,12900,11927,973,7.5
40001,2020-06-01,8251,7637,614,7.4
40003,2020-06-01,2721,2568,153,5.6
40005,2020-06-01,5178,4713,465,9
40007,2020-06-01,2550,2452,98,3.8
40009,2020-06-01,10070,9088,982,9.8
40011,2020-06-01,4436,4065,371,8.4
40013,2020-06-01,22354,20860,1494,6.7
40015,2020-06-01,11957,11055,902,7.5
40017,2020-06-01,76249,69854,6395,8.4
40019,2020-06-01,21376,19446,1930,9
40021,2020-06-01,19562,18149,1413,7.2
40023,2020-06-01,5609,5089,520,9.3
40025,2020-06-01,1407,1359,48,3.4
40027,2020-06-01,143634,131693,11941,8.3
40029,2020-06-01,2219,2040,179,8.1
40031,2020-06-01,48162,43974,4188,8.7
40033,2020-06-01,2738,2486,252,9.2
40035,2020-06-01,5955,5511,444,7.5
40037,2020-06-01,31320,28663,2657,8.5
40039,2020-06-01,15463,14345,1118,7.2
40041,2020-06-01,18843,17678,1165,6.2
40043,2020-06-01,2681,2504,177,6.6
40045,2020-06-01,2189,2066,123,5.6
40047,2020-06-01,27457,25431,2026,7.4
40049,2020-06-01,12723,11726,997,7.8
40051,2020-06-01,26605,24476,2129,8
40053,2020-06-01,2797,2655,142,5.1
40055,2020-06-01,1935,1743,192,9.9
40057,2020-06-01,1238,1184,54,4.4
40059,2020-06-01,1742,1654,88,5.1
40061,2020-06-01,4121,3701,420,10.2
40063,2020-06-01,5172,4711,461,8.9
40065,2020-06-01,10917,10308,609,5.6
40067,2020-06-01,2574,2354,220,8.5
40069,2020-06-01,3753,3392,361,9.6
40071,2020-06-01,18570,16963,1607,8.7
40073,2020-06-01,8964,8422,542,6
40075,2020-06-01,3528,3291,237,6.7
40077,2020-06-01,3163,2796,367,11.6
40079,2020-06-01,19176,17539,1637,8.5
40081,2020-06-01,15512,14446,1066,6.9
40083,2020-06-01,22183,20607,1576,7.1
40085,2020-06-01,6584,6255,329,5
40087,2020-06-01,20015,18397,1618,8.1
40089,2020-06-01,14913,13815,1098,7.4
40091,2020-06-01,7125,6459,666,9.3
40093,2020-06-01,3706,3472,234,6.3
40095,2020-06-01,6896,6387,509,7.4
40097,2020-06-01,19503,18242,1261,6.5
40099,2020-06-01,6379,5836,543,8.5
40101,2020-06-01,29128,26883,2245,7.7
40103,2020-06-01,5537,5223,314,5.7
40105,2020-06-01,4673,4375,298,6.4
40107,2020-06-01,4387,4048,339,7.7
40109,2020-06-01,388790,353213,35577,9.2
40111,2020-06-01,15479,14158,1321,8.5
40113,2020-06-01,20352,18762,1590,7.8
40115,2020-06-01,14397,13383,1014,7
40117,2020-06-01,7267,6700,567,7.8
40119,2020-06-01,38098,35018,3080,8.1
40121,2020-06-01,16467,14912,1555,9.4
40123,2020-06-01,19090,17621,1469,7.7
40125,2020-06-01,32162,29595,2567,8
40127,2020-06-01,4275,3943,332,7.8
40129,2020-06-01,1825,1708,117,6.4
40131,2020-06-01,44810,41280,3530,7.9
40133,2020-06-01,9091,8297,794,8.7
40135,2020-06-01,16443,15181,1262,7.7
40137,2020-06-01,18312,16524,1788,9.8
40139,2020-06-01,11431,11000,431,3.8
40141,2020-06-01,2929,2708,221,7.5
40143,2020-06-01,326011,296067,29944,9.2
40145,2020-06-01,38109,35118,2991,7.8
40147,2020-06-01,22419,20621,1798,8
40149,2020-06-01,5119,4693,426,8.3
40151,2020-06-01,4539,4230,309,6.8
40153,2020-06-01,9256,8466,790,8.5
41001,2020-06-01,7446,6791,655,8.8
41003,2020-06-01,46763,43054,3709,7.9
41005,2020-06-01,219726,197695,22031,10
41007,2020-06-01,19903,17255,2648,13.3
41009,2020-06-01,24129,21618,2511,10.4
41011,2020-06-01,26638,23633,3005,11.3
41013,2020-06-01,10617,9443,1174,11.1
41015,2020-06-01,9263,8239,1024,11.1
41017,2020-06-01,99547,88826,10721,10.8
41019,2020-06-01,48801,44272,4529,9.3
41021,2020-06-01,1089,1007,82,7.5
41023,2020-06-01,3370,3087,283,8.4
41025,2020-06-01,3742,3509,233,6.2
41027,2020-06-01,14364,13106,1258,8.8
41029,2020-06-01,107130,96070,11060,10.3
41031,2020-06-01,10739,9627,1112,10.4
41033,2020-06-01,37074,33445,3629,9.8
41035,2020-06-01,30606,27609,2997,9.8
41037,2020-06-01,3805,3562,243,6.4
41039,2020-06-01,180444,160963,19481,10.8
41041,2020-06-01,21529,18293,3236,15
41043,2020-06-01,59959,54031,5928,9.9
41045,2020-06-01,13061,12258,803,6.1
41047,2020-06-01,166399,151213,15186,9.1
41049,2020-06-01,5866,5514,352,6
41051,2020-06-01,466454,407674,58780,12.6
41053,2020-06-01,40601,37128,3473,8.6
41055,2020-06-01,1039,967,72,6.9
41057,2020-06-01,12059,10758,1301,10.8
41059,2020-06-01,38102,35379,2723,7.1
41061,2020-06-01,12087,11030,1057,8.7
41063,2020-06-01,3646,3357,289,7.9
41065,2020-06-01,16996,15671,1325,7.8
41067,2020-06-01,323782,293909,29873,9.2
41069,2020-06-01,702,665,37,5.3
41071,2020-06-01,54766,49747,5019,9.2
42001,2020-06-01,54189,48468,5721,10.6
42003,2020-06-01,645243,564027,81216,12.6
42005,2020-06-01,31585,27724,3861,12.2
42007,2020-06-01,84960,72593,12367,14.6
42009,2020-06-01,23815,21010,2805,11.8
42011,2020-06-01,214918,185147,29771,13.9
42013,2020-06-01,60116,53125,6991,11.6
42015,2020-06-01,28564,25786,2778,9.7
42017,2020-06-01,341938,298021,43917,12.8
42019,2020-06-01,97706,87365,10341,10.6
42021,2020-06-01,56789,49647,7142,12.6
42023,2020-06-01,2087,1758,329,15.8
42025,2020-06-01,31477,27216,4261,13.5
42027,2020-06-01,73335,67081,6254,8.5
42029,2020-06-01,280491,252350,28141,10
42031,2020-06-01,16763,15061,1702,10.2
42033,2020-06-01,35813,31672,4141,11.6
42035,2020-06-01,17822,15894,1928,10.8
42037,2020-06-01,33436,29872,3564,10.7
42039,2020-06-01,38980,34407,4573,11.7
42041,2020-06-01,130622,117557,13065,10
42043,2020-06-01,146571,126729,19842,13.5
42045,2020-06-01,296275,254072,42203,14.2
42047,2020-06-01,15741,12907,2834,18
42049,2020-06-01,127176,108903,18273,14.4
42051,2020-06-01,57275,48550,8725,15.2
42053,2020-06-01,1842,1600,242,13.1
42055,2020-06-01,78373,69498,8875,11.3
42057,2020-06-01,7716,6378,1338,17.3
42059,2020-06-01,15797,13577,2220,14.1
42061,2020-06-01,19767,17042,2725,13.8
42063,2020-06-01,37327,32643,4684,12.5
42065,2020-06-01,20472,18133,2339,11.4
42067,2020-06-01,12672,11616,1056,8.3
42069,2020-06-01,105028,90406,14622,13.9
42071,2020-06-01,283722,250504,33218,11.7
42073,2020-06-01,41023,35703,5320,13
42075,2020-06-01,72877,64166,8711,12
42077,2020-06-01,193634,165217,28417,14.7
42079,2020-06-01,159766,135031,24735,15.5
42081,2020-06-01,56664,50154,6510,11.5
42083,2020-06-01,17381,15171,2210,12.7
42085,2020-06-01,48839,42498,6341,13
42087,2020-06-01,21223,19124,2099,9.9
42089,2020-06-01,82270,67362,14908,18.1
42091,2020-06-01,449112,395829,53283,11.9
42093,2020-06-01,9011,8279,732,8.1
42095,2020-06-01,160375,138110,22265,13.9
42097,2020-06-01,42708,37535,5173,12.1
42099,2020-06-01,24086,21773,2313,9.6
42101,2020-06-01,739660,603278,136382,18.4
42103,2020-06-01,25223,21332,3891,15.4
42105,2020-06-01,7287,6486,801,11
42107,2020-06-01,67404,58836,8568,12.7
42109,2020-06-01,19427,17559,1868,9.6
42111,2020-06-01,32695,28688,4007,12.3
42113,2020-06-01,2665,2395,270,10.1
42115,2020-06-01,19728,17838,1890,9.6
42117,2020-06-01,19207,16855,2352,12.2
42119,2020-06-01,18918,17086,1832,9.7
42121,2020-06-01,22626,20113,2513,11.1
42123,2020-06-01,18895,16880,2015,10.7
42125,2020-06-01,106391,92903,13488,12.7
42127,2020-06-01,22543,19816,2727,12.1
42129,2020-06-01,178609,156775,21834,12.2
42131,2020-06-01,13251,11747,1504,11.4
42133,2020-06-01,235736,208226,27510,11.7
44001,2020-06-01,23561,21670,1891,8
44003,2020-06-01,83861,75905,7956,9.5
44005,2020-06-01,40316,36781,3535,8.8
44007,2020-06-01,305282,271022,34260,11.2
44009,2020-06-01,62392,57259,5133,8.2
45001,2020-06-01,10304,9451,853,8.3
45003,2020-06-01,75934,71342,4592,6
45005,2020-06-01,2686,2411,275,10.2
45007,2020-06-01,91540,84571,6969,7.6
45009,2020-06-01,4881,4355,526,10.8
45011,2020-06-01,8125,7474,651,8
45013,2020-06-01,79473,74216,5257,6.6
45015,2020-06-01,106171,98565,7606,7.2
45017,2020-06-01,6639,6135,504,7.6
45019,2020-06-01,215364,197452,17912,8.3
45021,2020-06-01,25609,23067,2542,9.9
45023,2020-06-01,13938,12349,1589,11.4
45025,2020-06-01,22124,20433,1691,7.6
45027,2020-06-01,12910,11866,1044,8.1
45029,2020-06-01,17003,15783,1220,7.2
45031,2020-06-01,30966,28385,2581,8.3
45033,2020-06-01,13588,12669,919,6.8
45035,2020-06-01,78798,72803,5995,7.6
45037,2020-06-01,10824,10154,670,6.2
45039,2020-06-01,9778,8833,945,9.7
45041,2020-06-01,67868,63161,4707,6.9
45043,2020-06-01,27155,24795,2360,8.7
45045,2020-06-01,257907,238882,19025,7.4
45047,2020-06-01,32099,29583,2516,7.8
45049,2020-06-01,8445,7914,531,6.3
45051,2020-06-01,155131,139794,15337,9.9
45053,2020-06-01,13144,12309,835,6.4
45055,2020-06-01,29698,27794,1904,6.4
45057,2020-06-01,43267,39373,3894,9
45059,2020-06-01,30433,27799,2634,8.7
45061,2020-06-01,6971,6360,611,8.8
45063,2020-06-01,151784,143342,8442,5.6
45065,2020-06-01,3437,3161,276,8
45067,2020-06-01,13624,12367,1257,9.2
45069,2020-06-01,9646,8463,1183,12.3
45071,2020-06-01,19394,18271,1123,5.8
45073,2020-06-01,36080,33738,2342,6.5
45075,2020-06-01,35537,31652,3885,10.9
45077,2020-06-01,57442,53510,3932,6.8
45079,2020-06-01,202837,187633,15204,7.5
45081,2020-06-01,8672,8208,464,5.4
45083,2020-06-01,162243,148678,13565,8.4
45085,2020-06-01,44051,40592,3459,7.9
45087,2020-06-01,12364,10958,1406,11.4
45089,2020-06-01,12362,11166,1196,9.7
45091,2020-06-01,146386,134439,11947,8.2
46003,2020-06-01,1448,1389,59,4.1
46005,2020-06-01,9382,8919,463,4.9
46007,2020-06-01,1044,974,70,6.7
46009,2020-06-01,2846,2712,134,4.7
46011,2020-06-01,18025,17001,1024,5.7
46013,2020-06-01,20608,19410,1198,5.8
46015,2020-06-01,2496,2355,141,5.6
46017,2020-06-01,664,581,83,12.5
46019,2020-06-01,4972,4641,331,6.7
46021,2020-06-01,775,747,28,3.6
46023,2020-06-01,3936,3597,339,8.6
46025,2020-06-01,2155,2053,102,4.7
46027,2020-06-01,6564,6123,441,6.7
46029,2020-06-01,15311,14382,929,6.1
46031,2020-06-01,1284,1212,72,5.6
46033,2020-06-01,4055,3765,290,7.2
46035,2020-06-01,10874,10307,567,5.2
46037,2020-06-01,2711,2563,148,5.5
46039,2020-06-01,2278,2165,113,5
46041,2020-06-01,2265,2017,248,10.9
46043,2020-06-01,1555,1511,44,2.8
46045,2020-06-01,1933,1872,61,3.2
46047,2020-06-01,3065,2856,209,6.8
46049,2020-06-01,1010,966,44,4.4
46051,2020-06-01,4327,4158,169,3.9
46053,2020-06-01,2025,1939,86,4.2
46055,2020-06-01,1048,1023,25,2.4
46057,2020-06-01,3358,3226,132,3.9
46059,2020-06-01,1740,1683,57,3.3
46061,2020-06-01,1706,1608,98,5.7
46063,2020-06-01,686,656,30,4.4
46065,2020-06-01,10051,9621,430,4.3
46067,2020-06-01,3594,3432,162,4.5
46069,2020-06-01,662,639,23,3.5
46071,2020-06-01,1225,1176,49,4
46073,2020-06-01,1090,1054,36,3.3
46075,2020-06-01,521,499,22,4.2
46077,2020-06-01,2666,2544,122,4.6
46079,2020-06-01,6407,6101,306,4.8
46081,2020-06-01,13514,12498,1016,7.5
46083,2020-06-01,35656,34054,1602,4.5
46085,2020-06-01,1625,1504,121,7.4
46087,2020-06-01,3028,2889,139,4.6
46089,2020-06-01,970,915,55,5.7
46091,2020-06-01,2391,2285,106,4.4
46093,2020-06-01,14095,13214,881,6.3
46095,2020-06-01,622,573,49,7.9
46097,2020-06-01,1134,1068,66,5.8
46099,2020-06-01,113535,106999,6536,5.8
46101,2020-06-01,4004,3750,254,6.3
46102,2020-06-01,3618,3222,396,10.9
46103,2020-06-01,58034,54155,3879,6.7
46105,2020-06-01,1349,1297,52,3.9
46107,2020-06-01,1037,1002,35,3.4
46109,2020-06-01,4749,4445,304,6.4
46111,2020-06-01,1130,1077,53,4.7
46115,2020-06-01,3080,2943,137,4.4
46117,2020-06-01,1880,1796,84,4.5
46119,2020-06-01,762,738,24,3.1
46121,2020-06-01,3001,2789,212,7.1
46123,2020-06-01,2971,2849,122,4.1
46125,2020-06-01,4594,4356,238,5.2
46127,2020-06-01,8400,7898,502,6
46129,2020-06-01,2186,2049,137,6.3
46135,2020-06-01,11838,11219,619,5.2
46137,2020-06-01,925,866,59,6.4
47001,2020-06-01,33142,30409,2733,8.2
47003,2020-06-01,20734,18594,2140,10.3
47005,2020-06-01,6541,5932,609,9.3
47007,2020-06-01,4030,3647,383,9.5
47009,2020-06-01,61596,56445,5151,8.4
47011,2020-06-01,52358,48136,4222,8.1
47013,2020-06-01,14108,12910,1198,8.5
47015,2020-06-01,6259,5712,547,8.7
47017,2020-06-01,11232,10236,996,8.9
47019,2020-06-01,22547,20514,2033,9
47021,2020-06-01,20393,18843,1550,7.6
47023,2020-06-01,8140,7562,578,7.1
47025,2020-06-01,12192,11224,968,7.9
47027,2020-06-01,2540,2301,239,9.4
47029,2020-06-01,14422,12627,1795,12.4
47031,2020-06-01,25005,22465,2540,10.2
47033,2020-06-01,6612,6180,432,6.5
47035,2020-06-01,21715,19721,1994,9.2
47037,2020-06-01,393326,346271,47055,12
47039,2020-06-01,4352,3913,439,10.1
47041,2020-06-01,7512,6692,820,10.9
47043,2020-06-01,25104,23247,1857,7.4
47045,2020-06-01,15385,13858,1527,9.9
47047,2020-06-01,18291,16799,1492,8.2
47049,2020-06-01,7238,6681,557,7.7
47051,2020-06-01,19240,17307,1933,10
47053,2020-06-01,21202,19407,1795,8.5
47055,2020-06-01,14213,12725,1488,10.5
47057,2020-06-01,9164,8364,800,8.7
47059,2020-06-01,27757,24936,2821,10.2
47061,2020-06-01,4892,4278,614,12.6
47063,2020-06-01,27159,24733,2426,8.9
47065,2020-06-01,176889,160526,16363,9.3
47067,2020-06-01,2017,1812,205,10.2
47069,2020-06-01,9108,8246,862,9.5
47071,2020-06-01,9892,9077,815,8.2
47073,2020-06-01,22771,20447,2324,10.2
47075,2020-06-01,7538,6669,869,11.5
47077,2020-06-01,11686,10448,1238,10.6
47079,2020-06-01,13347,12191,1156,8.7
47081,2020-06-01,10578,9809,769,7.3
47083,2020-06-01,3077,2799,278,9
47085,2020-06-01,8131,7535,596,7.3
47087,2020-06-01,4444,4015,429,9.7
47089,2020-06-01,23972,21715,2257,9.4
47091,2020-06-01,7247,6666,581,8
47093,2020-06-01,234704,216672,18032,7.7
47095,2020-06-01,1615,1463,152,9.4
47097,2020-06-01,9398,8318,1080,11.5
47099,2020-06-01,18076,16265,1811,10
47101,2020-06-01,5068,4640,428,8.4
47103,2020-06-01,15310,13699,1611,10.5
47105,2020-06-01,22758,21017,1741,7.7
47107,2020-06-01,22928,20710,2218,9.7
47109,2020-06-01,7993,7188,805,10.1
47111,2020-06-01,10745,9853,892,8.3
47113,2020-06-01,47831,43214,4617,9.7
47115,2020-06-01,11941,10813,1128,9.4
47117,2020-06-01,14732,12843,1889,12.8
47119,2020-06-01,48233,42984,5249,10.9
47121,2020-06-01,4960,4440,520,10.5
47123,2020-06-01,19256,17359,1897,9.9
47125,2020-06-01,83935,75740,8195,9.8
47127,2020-06-01,3416,3169,247,7.2
47129,2020-06-01,7366,6807,559,7.6
47131,2020-06-01,11727,10793,934,8
47133,2020-06-01,9256,8585,671,7.2
47135,2020-06-01,2833,2542,291,10.3
47137,2020-06-01,2209,2060,149,6.7
47139,2020-06-01,7393,6802,591,8
47141,2020-06-01,33306,30549,2757,8.3
47143,2020-06-01,12118,10752,1366,11.3
47145,2020-06-01,22130,20437,1693,7.7
47147,2020-06-01,35987,32907,3080,8.6
47149,2020-06-01,179180,160894,18286,10.2
47151,2020-06-01,7935,7115,820,10.3
47153,2020-06-01,5901,5369,532,9
47155,2020-06-01,52097,45661,6436,12.4
47157,2020-06-01,436712,380558,56154,12.9
47159,2020-06-01,8847,8171,676,7.6
47161,2020-06-01,5167,4791,376,7.3
47163,2020-06-01,66777,60709,6068,9.1
47165,2020-06-01,98199,89380,8819,9
47167,2020-06-01,26393,24141,2252,8.5
47169,2020-06-01,5153,4746,407,7.9
47171,2020-06-01,6772,6096,676,10
47173,2020-06-01,7358,6724,634,8.6
47175,2020-06-01,1901,1695,206,10.8
47177,2020-06-01,16443,14573,1870,11.4
47179,2020-06-01,56995,52167,4828,8.5
47181,2020-06-01,6162,5639,523,8.5
47183,2020-06-01,14487,13394,1093,7.5
47185,2020-06-01,11432,10457,975,8.5
47187,2020-06-01,121082,113233,7849,6.5
47189,2020-06-01,73998,67402,6596,8.9
48001,2020-06-01,23661,21910,1751,7.4
48003,2020-06-01,9247,8095,1152,12.5
48005,2020-06-01,36274,32685,3589,9.9
48007,2020-06-01,9161,8202,959,10.5
48009,2020-06-01,3943,3667,276,7
48011,2020-06-01,907,861,46,5.1
48013,2020-06-01,22011,19491,2520,11.4
48015,2020-06-01,13654,12492,1162,8.5
48017,2020-06-01,2442,2295,147,6
48019,2020-06-01,9784,9034,750,7.7
48021,2020-06-01,42496,38942,3554,8.4
48023,2020-06-01,1796,1716,80,4.5
48025,2020-06-01,9960,8610,1350,13.6
48027,2020-06-01,145612,132162,13450,9.2
48029,2020-06-01,948422,850226,98196,10.4
48031,2020-06-01,6529,6215,314,4.8
48033,2020-06-01,383,365,18,4.7
48035,2020-06-01,8373,7794,579,6.9
48037,2020-06-01,38698,34991,3707,9.6
48039,2020-06-01,179115,159411,19704,11
48041,2020-06-01,113383,104589,8794,7.8
48043,2020-06-01,4103,3727,376,9.2
48045,2020-06-01,574,543,31,5.4
48047,2020-06-01,2592,2222,370,14.3
48049,2020-06-01,15231,13952,1279,8.4
48051,2020-06-01,7933,7269,664,8.4
48053,2020-06-01,23678,22267,1411,6
48055,2020-06-01,19278,17612,1666,8.6
48057,2020-06-01,11629,10749,880,7.6
48059,2020-06-01,5967,5523,444,7.4
48061,2020-06-01,172060,150682,21378,12.4
48063,2020-06-01,5090,4597,493,9.7
48065,2020-06-01,2930,2765,165,5.6
48067,2020-06-01,12345,11110,1235,10
48069,2020-06-01,3314,3164,150,4.5
48071,2020-06-01,20029,17608,2421,12.1
48073,2020-06-01,21683,19489,2194,10.1
48075,2020-06-01,2835,2691,144,5.1
48077,2020-06-01,4818,4481,337,7
48079,2020-06-01,1124,1013,111,9.9
48081,2020-06-01,1360,1257,103,7.6
48083,2020-06-01,2912,2641,271,9.3
48085,2020-06-01,570162,520086,50076,8.8
48087,2020-06-01,1103,1051,52,4.7
48089,2020-06-01,9934,9251,683,6.9
48091,2020-06-01,74889,68614,6275,8.4
48093,2020-06-01,5632,5235,397,7
48095,2020-06-01,1307,1231,76,5.8
48097,2020-06-01,19337,17592,1745,9
48099,2020-06-01,24083,22016,2067,8.6
48101,2020-06-01,584,552,32,5.5
48103,2020-06-01,1690,1354,336,19.9
48105,2020-06-01,1613,1425,188,11.7
48107,2020-06-01,2358,2218,140,5.9
48109,2020-06-01,1161,1056,105,9
48111,2020-06-01,3755,3625,130,3.5
48113,2020-06-01,NA,NA,145635,10.7
48115,2020-06-01,4596,4061,535,11.6
48117,2020-06-01,8608,8244,364,4.2
48119,2020-06-01,2376,2208,168,7.1
48121,2020-06-01,504314,458499,45815,9.1
48123,2020-06-01,9369,8625,744,7.9
48125,2020-06-01,692,639,53,7.7
48127,2020-06-01,6454,5877,577,8.9
48129,2020-06-01,1440,1352,88,6.1
48131,2020-06-01,4946,4155,791,16
48133,2020-06-01,7194,6515,679,9.4
48135,2020-06-01,83539,70461,13078,15.7
48137,2020-06-01,1238,1183,55,4.4
48139,2020-06-01,93199,85541,7658,8.2
48141,2020-06-01,366594,325780,40814,11.1
48143,2020-06-01,19624,18062,1562,8
48145,2020-06-01,6583,6067,516,7.8
48147,2020-06-01,16703,15669,1034,6.2
48149,2020-06-01,11827,11145,682,5.8
48151,2020-06-01,1595,1502,93,5.8
48153,2020-06-01,2522,2340,182,7.2
48155,2020-06-01,581,549,32,5.5
48157,2020-06-01,398852,357561,41291,10.4
48159,2020-06-01,4878,4553,325,6.7
48161,2020-06-01,6414,5703,711,11.1
48163,2020-06-01,9462,8728,734,7.8
48165,2020-06-01,9777,9044,733,7.5
48167,2020-06-01,166071,147388,18683,11.3
48169,2020-06-01,2005,1811,194,9.7
48171,2020-06-01,13372,12538,834,6.2
48173,2020-06-01,773,736,37,4.8
48175,2020-06-01,3171,2853,318,10
48177,2020-06-01,9376,8714,662,7.1
48179,2020-06-01,7930,7047,883,11.1
48181,2020-06-01,64020,59009,5011,7.8
48183,2020-06-01,56731,50433,6298,11.1
48185,2020-06-01,11049,9887,1162,10.5
48187,2020-06-01,80525,73873,6652,8.3
48189,2020-06-01,11853,10759,1094,9.2
48191,2020-06-01,1068,992,76,7.1
48193,2020-06-01,3755,3545,210,5.6
48195,2020-06-01,2494,2377,117,4.7
48197,2020-06-01,1702,1600,102,6
48199,2020-06-01,24964,22012,2952,11.8
48201,2020-06-01,NA,NA,281214,12.1
48203,2020-06-01,29470,26430,3040,10.3
48205,2020-06-01,2628,2559,69,2.6
48207,2020-06-01,2675,2529,146,5.5
48209,2020-06-01,121586,110604,10982,9
48211,2020-06-01,1798,1693,105,5.8
48213,2020-06-01,37529,34357,3172,8.5
48215,2020-06-01,366147,313724,52423,14.3
48217,2020-06-01,16351,14976,1375,8.4
48219,2020-06-01,10506,9280,1226,11.7
48221,2020-06-01,27558,25119,2439,8.9
48223,2020-06-01,17443,16310,1133,6.5
48225,2020-06-01,10162,9513,649,6.4
48227,2020-06-01,13623,12094,1529,11.2
48229,2020-06-01,1856,1661,195,10.5
48231,2020-06-01,43404,39550,3854,8.9
48233,2020-06-01,8714,7893,821,9.4
48235,2020-06-01,755,690,65,8.6
48237,2020-06-01,3406,3092,314,9.2
48239,2020-06-01,7341,6804,537,7.3
48241,2020-06-01,13149,11364,1785,13.6
48243,2020-06-01,977,915,62,6.3
48245,2020-06-01,106561,89935,16626,15.6
48247,2020-06-01,1924,1691,233,12.1
48249,2020-06-01,16409,13570,2839,17.3
48251,2020-06-01,83037,75688,7349,8.9
48253,2020-06-01,5729,5214,515,9
48255,2020-06-01,6861,6268,593,8.6
48257,2020-06-01,67165,61179,5986,8.9
48259,2020-06-01,21984,20490,1494,6.8
48261,2020-06-01,165,153,12,7.3
48263,2020-06-01,472,450,22,4.7
48265,2020-06-01,21826,20134,1692,7.8
48267,2020-06-01,1822,1712,110,6
48269,2020-06-01,211,207,4,1.9
48271,2020-06-01,1246,1150,96,7.7
48273,2020-06-01,13372,11895,1477,11
48275,2020-06-01,1463,1354,109,7.5
48277,2020-06-01,23560,21422,2138,9.1
48279,2020-06-01,5278,4939,339,6.4
48281,2020-06-01,9023,8403,620,6.9
48283,2020-06-01,3550,3196,354,10
48285,2020-06-01,8471,7904,567,6.7
48287,2020-06-01,9272,8702,570,6.1
48289,2020-06-01,6068,5469,599,9.9
48291,2020-06-01,33958,29440,4518,13.3
48293,2020-06-01,8436,7653,783,9.3
48295,2020-06-01,1538,1460,78,5.1
48297,2020-06-01,5097,4596,501,9.8
48299,2020-06-01,8494,7912,582,6.9
48301,2020-06-01,208,201,7,3.4
48303,2020-06-01,157368,145041,12327,7.8
48305,2020-06-01,2746,2539,207,7.5
48307,2020-06-01,3239,2944,295,9.1
48309,2020-06-01,121492,111667,9825,8.1
48311,2020-06-01,735,709,26,3.5
48313,2020-06-01,4473,4050,423,9.5
48315,2020-06-01,4325,3863,462,10.7
48317,2020-06-01,2467,2252,215,8.7
48319,2020-06-01,1727,1612,115,6.7
48321,2020-06-01,16746,14491,2255,13.5
48323,2020-06-01,24900,20314,4586,18.4
48325,2020-06-01,21453,19622,1831,8.5
48327,2020-06-01,852,790,62,7.3
48329,2020-06-01,96390,84789,11601,12
48331,2020-06-01,9862,8978,884,9
48333,2020-06-01,1835,1744,91,5
48335,2020-06-01,2420,2166,254,10.5
48337,2020-06-01,9062,8259,803,8.9
48339,2020-06-01,287164,258484,28680,10
48341,2020-06-01,10576,10045,531,5
48343,2020-06-01,4886,4188,698,14.3
48345,2020-06-01,439,413,26,5.9
48347,2020-06-01,27601,25156,2445,8.9
48349,2020-06-01,22906,20960,1946,8.5
48351,2020-06-01,5056,4348,708,14
48353,2020-06-01,7096,6598,498,7
48355,2020-06-01,166845,147857,18988,11.4
48357,2020-06-01,4117,3802,315,7.7
48359,2020-06-01,880,843,37,4.2
48361,2020-06-01,36157,31172,4985,13.8
48363,2020-06-01,13498,12232,1266,9.4
48365,2020-06-01,9605,8581,1024,10.7
48367,2020-06-01,67973,62587,5386,7.9
48369,2020-06-01,4790,4646,144,3
48371,2020-06-01,6455,5726,729,11.3
48373,2020-06-01,18489,16446,2043,11
48375,2020-06-01,54629,50485,4144,7.6
48377,2020-06-01,3293,2664,629,19.1
48379,2020-06-01,5972,5609,363,6.1
48381,2020-06-01,72666,68211,4455,6.1
48383,2020-06-01,1853,1606,247,13.3
48385,2020-06-01,1071,983,88,8.2
48387,2020-06-01,5147,4729,418,8.1
48389,2020-06-01,8485,7598,887,10.5
48391,2020-06-01,3121,2781,340,10.9
48393,2020-06-01,404,384,20,5
48395,2020-06-01,7128,6523,605,8.5
48397,2020-06-01,53072,48647,4425,8.3
48399,2020-06-01,4600,4298,302,6.6
48401,2020-06-01,21985,19932,2053,9.3
48403,2020-06-01,4001,3481,520,13
48405,2020-06-01,3074,2717,357,11.6
48407,2020-06-01,11631,10444,1187,10.2
48409,2020-06-01,29739,25984,3755,12.6
48411,2020-06-01,2109,1970,139,6.6
48413,2020-06-01,1246,1125,121,9.7
48415,2020-06-01,6311,5589,722,11.4
48417,2020-06-01,1759,1629,130,7.4
48419,2020-06-01,11355,10320,1035,9.1
48421,2020-06-01,1270,1222,48,3.8
48423,2020-06-01,110050,100087,9963,9.1
48425,2020-06-01,4340,3951,389,9
48427,2020-06-01,26543,21101,5442,20.5
48429,2020-06-01,4015,3698,317,7.9
48431,2020-06-01,571,519,52,9.1
48433,2020-06-01,585,546,39,6.7
48435,2020-06-01,1250,1086,164,13.1
48437,2020-06-01,2528,2371,157,6.2
48439,2020-06-01,NA,979368,111451,10.2
48441,2020-06-01,65986,61136,4850,7.4
48443,2020-06-01,390,367,23,5.9
48445,2020-06-01,4910,4415,495,10.1
48447,2020-06-01,628,588,40,6.4
48449,2020-06-01,13276,12072,1204,9.1
48451,2020-06-01,53938,49222,4716,8.7
48453,2020-06-01,741853,675868,65985,8.9
48455,2020-06-01,5337,4809,528,9.9
48457,2020-06-01,7437,6517,920,12.4
48459,2020-06-01,17425,15650,1775,10.2
48461,2020-06-01,1828,1681,147,8
48463,2020-06-01,11669,10744,925,7.9
48465,2020-06-01,22508,19975,2533,11.3
48467,2020-06-01,26531,24387,2144,8.1
48469,2020-06-01,41295,36957,4338,10.5
48471,2020-06-01,24157,21933,2224,9.2
48473,2020-06-01,23956,21537,2419,10.1
48475,2020-06-01,6226,5393,833,13.4
48477,2020-06-01,15397,14262,1135,7.4
48479,2020-06-01,117294,103734,13560,11.6
48481,2020-06-01,21342,19487,1855,8.7
48483,2020-06-01,2168,2012,156,7.2
48485,2020-06-01,55879,51153,4726,8.5
48487,2020-06-01,4940,4592,348,7
48489,2020-06-01,6703,5711,992,14.8
48491,2020-06-01,317294,291820,25474,8
48493,2020-06-01,24437,22520,1917,7.8
48495,2020-06-01,3953,3415,538,13.6
48497,2020-06-01,32171,29316,2855,8.9
48499,2020-06-01,18100,16580,1520,8.4
48501,2020-06-01,3663,2995,668,18.2
48503,2020-06-01,7907,7372,535,6.8
48505,2020-06-01,4529,3779,750,16.6
48507,2020-06-01,3460,2822,638,18.4
49001,2020-06-01,2944,2797,147,5
49003,2020-06-01,27064,25401,1663,6.1
49005,2020-06-01,65770,63175,2595,3.9
49007,2020-06-01,8778,8208,570,6.5
49009,2020-06-01,482,462,20,4.1
49011,2020-06-01,179042,169180,9862,5.5
49013,2020-06-01,8104,7309,795,9.8
49015,2020-06-01,4519,4280,239,5.3
49017,2020-06-01,2986,2723,263,8.8
49019,2020-06-01,6678,6016,662,9.9
49021,2020-06-01,24767,23249,1518,6.1
49023,2020-06-01,5861,5648,213,3.6
49025,2020-06-01,4123,3857,266,6.5
49027,2020-06-01,6278,6044,234,3.7
49029,2020-06-01,5634,5393,241,4.3
49031,2020-06-01,500,465,35,7
49033,2020-06-01,1491,1446,45,3
49035,2020-06-01,651663,604627,47036,7.2
49037,2020-06-01,5800,5091,709,12.2
49039,2020-06-01,12904,12286,618,4.8
49041,2020-06-01,10225,9707,518,5.1
49043,2020-06-01,23875,21105,2770,11.6
49045,2020-06-01,35447,33131,2316,6.5
49047,2020-06-01,14005,12413,1592,11.4
49049,2020-06-01,314984,298988,15996,5.1
49051,2020-06-01,16820,15227,1593,9.5
49053,2020-06-01,79238,73613,5625,7.1
49055,2020-06-01,1531,1419,112,7.3
49057,2020-06-01,132127,124054,8073,6.1
50001,2020-06-01,19969,18694,1275,6.4
50003,2020-06-01,17444,15908,1536,8.8
50005,2020-06-01,14366,13229,1137,7.9
50007,2020-06-01,93720,86934,6786,7.2
50009,2020-06-01,2644,2423,221,8.4
50011,2020-06-01,26643,24771,1872,7
50013,2020-06-01,3992,3693,299,7.5
50015,2020-06-01,13580,12075,1505,11.1
50017,2020-06-01,15419,14493,926,6
50019,2020-06-01,12723,11531,1192,9.4
50021,2020-06-01,29735,26823,2912,9.8
50023,2020-06-01,32989,30786,2203,6.7
50025,2020-06-01,21214,19186,2028,9.6
50027,2020-06-01,28092,25687,2405,8.6
51001,2020-06-01,16215,14823,1392,8.6
51003,2020-06-01,55673,51112,4561,8.2
51005,2020-06-01,6818,6187,631,9.3
51007,2020-06-01,6188,5717,471,7.6
51009,2020-06-01,14673,13542,1131,7.7
51011,2020-06-01,7001,6480,521,7.4
51013,2020-06-01,150277,140823,9454,6.3
51015,2020-06-01,36837,34449,2388,6.5
51017,2020-06-01,2226,1798,428,19.2
51019,2020-06-01,37615,35052,2563,6.8
51021,2020-06-01,2756,2547,209,7.6
51023,2020-06-01,16891,15839,1052,6.2
51025,2020-06-01,6063,5449,614,10.1
51027,2020-06-01,6335,5602,733,11.6
51029,2020-06-01,6299,5668,631,10
51031,2020-06-01,25546,23447,2099,8.2
51033,2020-06-01,15073,13641,1432,9.5
51035,2020-06-01,13031,11535,1496,11.5
51036,2020-06-01,3642,3284,358,9.8
51037,2020-06-01,5058,4678,380,7.5
51041,2020-06-01,186266,170523,15743,8.5
51043,2020-06-01,7501,7019,482,6.4
51045,2020-06-01,2261,2110,151,6.7
51047,2020-06-01,24593,22897,1696,6.9
51049,2020-06-01,4567,4175,392,8.6
51051,2020-06-01,4762,4310,452,9.5
51053,2020-06-01,13497,12316,1181,8.8
51057,2020-06-01,5520,5026,494,8.9
51059,2020-06-01,632483,578789,53694,8.5
51061,2020-06-01,36805,34354,2451,6.7
51063,2020-06-01,7812,7273,539,6.9
51065,2020-06-01,13674,12578,1096,8
51067,2020-06-01,25785,23862,1923,7.5
51069,2020-06-01,48608,45349,3259,6.7
51071,2020-06-01,7494,6844,650,8.7
51073,2020-06-01,19282,17824,1458,7.6
51075,2020-06-01,11173,10392,781,7
51077,2020-06-01,7886,7287,599,7.6
51079,2020-06-01,10216,9371,845,8.3
51081,2020-06-01,4078,3697,381,9.3
51083,2020-06-01,15354,13944,1410,9.2
51085,2020-06-01,57658,53706,3952,6.9
51087,2020-06-01,181100,164071,17029,9.4
51089,2020-06-01,23636,21118,2518,10.7
51091,2020-06-01,1241,1178,63,5.1
51093,2020-06-01,19057,17755,1302,6.8
51095,2020-06-01,37139,33326,3813,10.3
51097,2020-06-01,3853,3574,279,7.2
51099,2020-06-01,13853,13028,825,6
51101,2020-06-01,9085,8406,679,7.5
51103,2020-06-01,5397,4901,496,9.2
51105,2020-06-01,8304,7633,671,8.1
51107,2020-06-01,223852,206030,17822,8
51109,2020-06-01,20044,18563,1481,7.4
51111,2020-06-01,5235,4866,369,7
51113,2020-06-01,7329,6937,392,5.3
51115,2020-06-01,4038,3774,264,6.5
51117,2020-06-01,12819,11666,1153,9
51119,2020-06-01,5235,4862,373,7.1
51121,2020-06-01,46684,43455,3229,6.9
51125,2020-06-01,7360,6756,604,8.2
51127,2020-06-01,12502,11642,860,6.9
51131,2020-06-01,5539,4989,550,9.9
51133,2020-06-01,5839,5405,434,7.4
51135,2020-06-01,7128,6659,469,6.6
51137,2020-06-01,17117,15752,1365,8
51139,2020-06-01,12032,10855,1177,9.8
51141,2020-06-01,7223,6621,602,8.3
51143,2020-06-01,29749,27254,2495,8.4
51145,2020-06-01,13973,12997,976,7
51147,2020-06-01,9988,9107,881,8.8
51149,2020-06-01,14889,13545,1344,9
51153,2020-06-01,247971,224217,23754,9.6
51155,2020-06-01,15476,13941,1535,9.9
51157,2020-06-01,3726,3496,230,6.2
51159,2020-06-01,4063,3792,271,6.7
51161,2020-06-01,48213,44755,3458,7.2
51163,2020-06-01,10229,9455,774,7.6
51165,2020-06-01,40726,37802,2924,7.2
51167,2020-06-01,11247,10286,961,8.5
51169,2020-06-01,8922,8313,609,6.8
51171,2020-06-01,22181,20525,1656,7.5
51173,2020-06-01,13385,12157,1228,9.2
51175,2020-06-01,8965,8384,581,6.5
51177,2020-06-01,67465,61658,5807,8.6
51179,2020-06-01,72254,66426,5828,8.1
51181,2020-06-01,3580,3293,287,8
51183,2020-06-01,3793,3367,426,11.2
51185,2020-06-01,15625,14098,1527,9.8
51187,2020-06-01,20356,18691,1665,8.2
51191,2020-06-01,26096,23949,2147,8.2
51193,2020-06-01,9535,8813,722,7.6
51195,2020-06-01,13136,11891,1245,9.5
51197,2020-06-01,13623,12223,1400,10.3
51199,2020-06-01,32544,29863,2681,8.2
51510,2020-06-01,100601,91916,8685,8.6
51520,2020-06-01,7409,6643,766,10.3
51530,2020-06-01,3063,2821,242,7.9
51540,2020-06-01,25508,22920,2588,10.1
51550,2020-06-01,122307,111746,10561,8.6
51570,2020-06-01,8509,7671,838,9.8
51580,2020-06-01,2454,2113,341,13.9
51590,2020-06-01,19128,16735,2393,12.5
51595,2020-06-01,2269,1905,364,16
51600,2020-06-01,13173,12040,1133,8.6
51610,2020-06-01,8236,7799,437,5.3
51620,2020-06-01,3662,3253,409,11.2
51630,2020-06-01,14112,12679,1433,10.2
51640,2020-06-01,2871,2559,312,10.9
51650,2020-06-01,65314,57635,7679,11.8
51660,2020-06-01,23985,21593,2392,10
51670,2020-06-01,9992,8502,1490,14.9
51678,2020-06-01,2000,1798,202,10.1
51680,2020-06-01,36221,32550,3671,10.1
51683,2020-06-01,21901,19805,2096,9.6
51685,2020-06-01,9650,8653,997,10.3
51690,2020-06-01,5713,4861,852,14.9
51700,2020-06-01,91027,79872,11155,12.3
51710,2020-06-01,113123,99517,13606,12
51720,2020-06-01,1683,1519,164,9.7
51730,2020-06-01,13804,11264,2540,18.4
51735,2020-06-01,6233,5860,373,6
51740,2020-06-01,45196,39444,5752,12.7
51750,2020-06-01,8156,7398,758,9.3
51760,2020-06-01,122033,106574,15459,12.7
51770,2020-06-01,49335,43941,5394,10.9
51775,2020-06-01,12564,11531,1033,8.2
51790,2020-06-01,12333,11167,1166,9.5
51800,2020-06-01,44612,40592,4020,9
51810,2020-06-01,231513,211052,20461,8.8
51820,2020-06-01,10769,9720,1049,9.7
51830,2020-06-01,6851,6014,837,12.2
51840,2020-06-01,14994,13738,1256,8.4
53001,2020-06-01,9816,9143,673,6.9
53003,2020-06-01,10174,9594,580,5.7
53005,2020-06-01,104459,93908,10551,10.1
53007,2020-06-01,45512,40858,4654,10.2
53009,2020-06-01,28467,25070,3397,11.9
53011,2020-06-01,236982,210464,26518,11.2
53013,2020-06-01,1689,1558,131,7.8
53015,2020-06-01,47786,42618,5168,10.8
53017,2020-06-01,21812,19714,2098,9.6
53019,2020-06-01,2359,2057,302,12.8
53021,2020-06-01,44734,40159,4575,10.2
53023,2020-06-01,802,734,68,8.5
53025,2020-06-01,49859,45523,4336,8.7
53027,2020-06-01,28151,24267,3884,13.8
53029,2020-06-01,35344,31951,3393,9.6
53031,2020-06-01,12523,11057,1466,11.7
53033,2020-06-01,NA,NA,135659,10.6
53035,2020-06-01,126674,115189,11485,9.1
53037,2020-06-01,21434,19251,2183,10.2
53039,2020-06-01,10290,9323,967,9.4
53041,2020-06-01,34238,30490,3748,10.9
53043,2020-06-01,4488,4173,315,7
53045,2020-06-01,24786,21937,2849,11.5
53047,2020-06-01,19522,17652,1870,9.6
53049,2020-06-01,8125,7015,1110,13.7
53051,2020-06-01,4822,4276,546,11.3
53053,2020-06-01,444903,390202,54701,12.3
53055,2020-06-01,8051,7237,814,10.1
53057,2020-06-01,62092,54577,7515,12.1
53059,2020-06-01,5346,4741,605,11.3
53061,2020-06-01,438434,389224,49210,11.2
53063,2020-06-01,253304,227166,26138,10.3
53065,2020-06-01,17959,16238,1721,9.6
53067,2020-06-01,140612,126863,13749,9.8
53069,2020-06-01,1341,1205,136,10.1
53071,2020-06-01,29694,27588,2106,7.1
53073,2020-06-01,112724,99763,12961,11.5
53075,2020-06-01,19559,18253,1306,6.7
53077,2020-06-01,137559,122247,15312,11.1
54001,2020-06-01,7161,6474,687,9.6
54003,2020-06-01,58372,53360,5012,8.6
54005,2020-06-01,7580,6636,944,12.5
54007,2020-06-01,5355,4813,542,10.1
54009,2020-06-01,9905,8878,1027,10.4
54011,2020-06-01,42132,37889,4243,10.1
54013,2020-06-01,2588,2231,357,13.8
54015,2020-06-01,3183,2739,444,13.9
54017,2020-06-01,3950,3686,264,6.7
54019,2020-06-01,16333,14452,1881,11.5
54021,2020-06-01,2262,1997,265,11.7
54023,2020-06-01,6060,5611,449,7.4
54025,2020-06-01,15127,13771,1356,9
54027,2020-06-01,10652,9945,707,6.6
54029,2020-06-01,13242,11640,1602,12.1
54031,2020-06-01,5960,5442,518,8.7
54033,2020-06-01,34922,31745,3177,9.1
54035,2020-06-01,13309,12081,1228,9.2
54037,2020-06-01,29964,27490,2474,8.3
54039,2020-06-01,84200,74905,9295,11
54041,2020-06-01,6444,5634,810,12.6
54043,2020-06-01,7272,6446,826,11.4
54045,2020-06-01,11513,9896,1617,14
54047,2020-06-01,4621,4013,608,13.2
54049,2020-06-01,25351,22563,2788,11
54051,2020-06-01,13618,12079,1539,11.3
54053,2020-06-01,10316,9349,967,9.4
54055,2020-06-01,21324,18935,2389,11.2
54057,2020-06-01,12084,10964,1120,9.3
54059,2020-06-01,6845,5683,1162,17
54061,2020-06-01,54013,49164,4849,9
54063,2020-06-01,6001,5526,475,7.9
54065,2020-06-01,8272,7629,643,7.8
54067,2020-06-01,9523,8422,1101,11.6
54069,2020-06-01,20566,18437,2129,10.4
54071,2020-06-01,3694,3464,230,6.2
54073,2020-06-01,2726,2382,344,12.6
54075,2020-06-01,3590,3103,487,13.6
54077,2020-06-01,15269,13869,1400,9.2
54079,2020-06-01,26999,24584,2415,8.9
54081,2020-06-01,30749,27418,3331,10.8
54083,2020-06-01,12530,11176,1354,10.8
54085,2020-06-01,4399,4015,384,8.7
54087,2020-06-01,5287,4562,725,13.7
54089,2020-06-01,4442,4049,393,8.8
54091,2020-06-01,7805,7114,691,8.9
54093,2020-06-01,3329,3004,325,9.8
54095,2020-06-01,3172,2815,357,11.3
54097,2020-06-01,9811,8661,1150,11.7
54099,2020-06-01,15792,14234,1558,9.9
54101,2020-06-01,3303,2965,338,10.2
54103,2020-06-01,6759,6052,707,10.5
54105,2020-06-01,2245,2020,225,10
54107,2020-06-01,36813,33046,3767,10.2
54109,2020-06-01,6732,5952,780,11.6
55001,2020-06-01,8364,7434,930,11.1
55003,2020-06-01,7950,7130,820,10.3
55005,2020-06-01,24542,22860,1682,6.9
55007,2020-06-01,7554,6799,755,10
55009,2020-06-01,141448,129203,12245,8.7
55011,2020-06-01,6573,5968,605,9.2
55013,2020-06-01,7387,6618,769,10.4
55015,2020-06-01,27480,25711,1769,6.4
55017,2020-06-01,32622,30036,2586,7.9
55019,2020-06-01,18204,17123,1081,5.9
55021,2020-06-01,31080,28580,2500,8
55023,2020-06-01,7653,6998,655,8.6
55025,2020-06-01,315259,292917,22342,7.1
55027,2020-06-01,48303,44894,3409,7.1
55029,2020-06-01,15959,14791,1168,7.3
55031,2020-06-01,22565,19801,2764,12.2
55033,2020-06-01,22850,21023,1827,8
55035,2020-06-01,57859,53064,4795,8.3
55037,2020-06-01,2291,2059,232,10.1
55039,2020-06-01,56716,51934,4782,8.4
55041,2020-06-01,4008,3176,832,20.8
55043,2020-06-01,26863,24915,1948,7.3
55045,2020-06-01,20476,19155,1321,6.5
55047,2020-06-01,9585,8859,726,7.6
55049,2020-06-01,13488,12504,984,7.3
55051,2020-06-01,2623,2255,368,14
55053,2020-06-01,10300,8885,1415,13.7
55055,2020-06-01,45583,42301,3282,7.2
55057,2020-06-01,13571,12237,1334,9.8
55059,2020-06-01,88522,79847,8675,9.8
55061,2020-06-01,10876,10174,702,6.5
55063,2020-06-01,64291,59310,4981,7.7
55065,2020-06-01,10042,9466,576,5.7
55067,2020-06-01,9619,8873,746,7.8
55069,2020-06-01,14866,13829,1037,7
55071,2020-06-01,41031,37698,3333,8.1
55073,2020-06-01,73296,68318,4978,6.8
55075,2020-06-01,19871,17887,1984,10
55077,2020-06-01,7744,7118,626,8.1
55078,2020-06-01,1780,1416,364,20.4
55079,2020-06-01,468495,414175,54320,11.6
55081,2020-06-01,23948,22225,1723,7.2
55083,2020-06-01,20373,18718,1655,8.1
55085,2020-06-01,18540,17084,1456,7.9
55087,2020-06-01,103745,96007,7738,7.5
55089,2020-06-01,48010,44245,3765,7.8
55091,2020-06-01,4271,3944,327,7.7
55093,2020-06-01,25104,22564,2540,10.1
55095,2020-06-01,24643,22565,2078,8.4
55097,2020-06-01,36953,34072,2881,7.8
55099,2020-06-01,6369,5834,535,8.4
55101,2020-06-01,98041,88711,9330,9.5
55103,2020-06-01,9191,8618,573,6.2
55105,2020-06-01,85516,77430,8086,9.5
55107,2020-06-01,6693,6145,548,8.2
55109,2020-06-01,49801,44980,4821,9.7
55111,2020-06-01,34832,31219,3613,10.4
55113,2020-06-01,8118,7480,638,7.9
55115,2020-06-01,21394,19638,1756,8.2
55117,2020-06-01,62402,57484,4918,7.9
55119,2020-06-01,11296,10638,658,5.8
55121,2020-06-01,16035,14639,1396,8.7
55123,2020-06-01,15320,14283,1037,6.8
55125,2020-06-01,10824,9987,837,7.7
55127,2020-06-01,56413,51739,4674,8.3
55129,2020-06-01,7972,7364,608,7.6
55131,2020-06-01,75780,69765,6015,7.9
55133,2020-06-01,220196,202654,17542,8
55135,2020-06-01,25897,24094,1803,7
55137,2020-06-01,11312,10456,856,7.6
55139,2020-06-01,91367,84417,6950,7.6
55141,2020-06-01,35323,32269,3054,8.6
56001,2020-06-01,19289,18337,952,4.9
56003,2020-06-01,5615,5328,287,5.1
56005,2020-06-01,23764,21521,2243,9.4
56007,2020-06-01,8359,7922,437,5.2
56009,2020-06-01,8133,7478,655,8.1
56011,2020-06-01,4139,3951,188,4.5
56013,2020-06-01,19473,18012,1461,7.5
56015,2020-06-01,6701,6386,315,4.7
56017,2020-06-01,2259,2130,129,5.7
56019,2020-06-01,4466,4183,283,6.3
56021,2020-06-01,51073,47867,3206,6.3
56023,2020-06-01,9762,9182,580,5.9
56025,2020-06-01,40752,36564,4188,10.3
56027,2020-06-01,1348,1288,60,4.5
56029,2020-06-01,16239,15317,922,5.7
56031,2020-06-01,4876,4615,261,5.4
56033,2020-06-01,16689,15794,895,5.4
56035,2020-06-01,4283,3942,341,8
56037,2020-06-01,20948,19001,1947,9.3
56039,2020-06-01,15845,14522,1323,8.3
56041,2020-06-01,9399,8655,744,7.9
56043,2020-06-01,4077,3830,247,6.1
56045,2020-06-01,3823,3637,186,4.9
72001,2020-06-01,3944,3544,400,10.1
72003,2020-06-01,11949,10888,1061,8.9
72005,2020-06-01,14481,13134,1347,9.3
72007,2020-06-01,6463,5822,641,9.9
72009,2020-06-01,6139,5611,528,8.6
72011,2020-06-01,8910,8231,679,7.6
72013,2020-06-01,23552,21343,2209,9.4
72015,2020-06-01,4535,4157,378,8.3
72017,2020-06-01,5833,5178,655,11.2
72019,2020-06-01,7268,6517,751,10.3
72021,2020-06-01,65933,60016,5917,9
72023,2020-06-01,13645,12516,1129,8.3
72025,2020-06-01,47643,43897,3746,7.9
72027,2020-06-01,9371,8586,785,8.4
72029,2020-06-01,16256,14856,1400,8.6
72031,2020-06-01,62127,56684,5443,8.8
72033,2020-06-01,7981,7172,809,10.1
72035,2020-06-01,15976,14840,1136,7.1
72037,2020-06-01,3618,3282,336,9.3
72039,2020-06-01,3659,3232,427,11.7
72041,2020-06-01,15174,14222,952,6.3
72043,2020-06-01,9736,8864,872,9
72045,2020-06-01,4830,4368,462,9.6
72047,2020-06-01,8917,7860,1057,11.9
72049,2020-06-01,921,852,69,7.5
72051,2020-06-01,13365,12384,981,7.3
72053,2020-06-01,10681,9618,1063,10
72054,2020-06-01,3248,2876,372,11.5
72055,2020-06-01,3707,3314,393,10.6
72057,2020-06-01,10773,9949,824,7.6
72059,2020-06-01,4937,4495,442,9
72061,2020-06-01,38133,35900,2233,5.9
72063,2020-06-01,18130,17078,1052,5.8
72065,2020-06-01,12863,11859,1004,7.8
72067,2020-06-01,5480,5039,441,8
72069,2020-06-01,16711,15395,1316,7.9
72071,2020-06-01,11748,10783,965,8.2
72073,2020-06-01,4111,3822,289,7
72075,2020-06-01,14842,13791,1051,7.1
72077,2020-06-01,12147,11082,1065,8.8
72079,2020-06-01,5026,4508,518,10.3
72081,2020-06-01,6590,5845,745,11.3
72083,2020-06-01,2546,2267,279,11
72085,2020-06-01,11146,10243,903,8.1
72087,2020-06-01,8322,7568,754,9.1
72089,2020-06-01,6179,5567,612,9.9
72091,2020-06-01,11246,10287,959,8.5
72093,2020-06-01,1850,1716,134,7.2
72095,2020-06-01,2696,2447,249,9.2
72097,2020-06-01,21674,19859,1815,8.4
72099,2020-06-01,10440,9453,987,9.5
72101,2020-06-01,7950,7107,843,10.6
72103,2020-06-01,8052,7438,614,7.6
72105,2020-06-01,7252,6302,950,13.1
72107,2020-06-01,4884,4302,582,11.9
72109,2020-06-01,4064,3691,373,9.2
72111,2020-06-01,5464,4947,517,9.5
72113,2020-06-01,44086,40424,3662,8.3
72115,2020-06-01,6002,5377,625,10.4
72117,2020-06-01,4618,4172,446,9.7
72119,2020-06-01,16988,15388,1600,9.4
72121,2020-06-01,5722,5224,498,8.7
72123,2020-06-01,6658,6012,646,9.7
72125,2020-06-01,9410,8658,752,8
72127,2020-06-01,136763,125682,11081,8.1
72129,2020-06-01,11370,10446,924,8.1
72131,2020-06-01,9927,8893,1034,10.4
72133,2020-06-01,8296,7779,517,6.2
72135,2020-06-01,27486,25406,2080,7.6
72137,2020-06-01,29188,26847,2341,8
72139,2020-06-01,27065,25352,1713,6.3
72141,2020-06-01,6406,5862,544,8.5
72143,2020-06-01,9764,8766,998,10.2
72145,2020-06-01,13161,11590,1571,11.9
72147,2020-06-01,2503,2252,251,10
72149,2020-06-01,6780,6197,583,8.6
72151,2020-06-01,8339,7570,769,9.2
72153,2020-06-01,9043,8138,905,10
01001,2020-07-01,25811,24190,1621,6.3
01003,2020-07-01,99493,92439,7054,7.1
01005,2020-07-01,8664,7813,851,9.8
01007,2020-07-01,8629,7913,716,8.3
01009,2020-07-01,24583,23279,1304,5.3
01011,2020-07-01,4885,4525,360,7.4
01013,2020-07-01,9166,8074,1092,11.9
01015,2020-07-01,46599,42490,4109,8.8
01017,2020-07-01,15746,14366,1380,8.8
01019,2020-07-01,11456,10846,610,5.3
01021,2020-07-01,19579,18310,1269,6.5
01023,2020-07-01,4652,4245,407,8.7
01025,2020-07-01,7765,6753,1012,13
01027,2020-07-01,6028,5738,290,4.8
01029,2020-07-01,5716,5408,308,5.4
01031,2020-07-01,21347,20137,1210,5.7
01033,2020-07-01,23541,21570,1971,8.4
01035,2020-07-01,4626,4159,467,10.1
01037,2020-07-01,4367,4075,292,6.7
01039,2020-07-01,15017,14060,957,6.4
01041,2020-07-01,6401,5942,459,7.2
01043,2020-07-01,37806,35861,1945,5.1
01045,2020-07-01,20841,19494,1347,6.5
01047,2020-07-01,14784,12582,2202,14.9
01049,2020-07-01,30472,28756,1716,5.6
01051,2020-07-01,36638,34267,2371,6.5
01053,2020-07-01,14420,13233,1187,8.2
01055,2020-07-01,40587,36578,4009,9.9
01057,2020-07-01,6508,6107,401,6.2
01059,2020-07-01,14272,13476,796,5.6
01061,2020-07-01,10970,10375,595,5.4
01063,2020-07-01,3035,2595,440,14.5
01065,2020-07-01,6138,5389,749,12.2
01067,2020-07-01,6840,6453,387,5.7
01069,2020-07-01,46791,43406,3385,7.2
01071,2020-07-01,22727,21274,1453,6.4
01073,2020-07-01,318163,290199,27964,8.8
01075,2020-07-01,5739,5392,347,6
01077,2020-07-01,41799,38873,2926,7
01079,2020-07-01,14408,13500,908,6.3
01081,2020-07-01,74839,69660,5179,6.9
01083,2020-07-01,44285,42029,2256,5.1
01085,2020-07-01,3830,3127,703,18.4
01087,2020-07-01,8198,7047,1151,14
01089,2020-07-01,186965,175425,11540,6.2
01091,2020-07-01,7713,7053,660,8.6
01093,2020-07-01,13122,12254,868,6.6
01095,2020-07-01,44263,41931,2332,5.3
01097,2020-07-01,193381,170701,22680,11.7
01099,2020-07-01,7585,6748,837,11
01101,2020-07-01,109188,96961,12227,11.2
01103,2020-07-01,58892,55437,3455,5.9
01105,2020-07-01,3477,2962,515,14.8
01107,2020-07-01,7579,6964,615,8.1
01109,2020-07-01,15583,14502,1081,6.9
01111,2020-07-01,9397,8891,506,5.4
01113,2020-07-01,23354,21769,1585,6.8
01115,2020-07-01,39908,37417,2491,6.2
01117,2020-07-01,113198,107434,5764,5.1
01119,2020-07-01,4800,4361,439,9.1
01121,2020-07-01,36097,33043,3054,8.5
01123,2020-07-01,18054,16411,1643,9.1
01125,2020-07-01,101196,92218,8978,8.9
01127,2020-07-01,24890,23015,1875,7.5
01129,2020-07-01,6788,5949,839,12.4
01131,2020-07-01,2998,2413,585,19.5
01133,2020-07-01,9802,9217,585,6
02013,2020-07-01,3315,3214,101,3
02016,2020-07-01,3861,3717,144,3.7
02020,2020-07-01,148495,133686,14809,10
02050,2020-07-01,6956,5924,1032,14.8
02060,2020-07-01,1139,1107,32,2.8
02068,2020-07-01,813,681,132,16.2
02070,2020-07-01,2309,2123,186,8.1
02090,2020-07-01,44315,40540,3775,8.5
02100,2020-07-01,1186,981,205,17.3
02105,2020-07-01,1181,1006,175,14.8
02110,2020-07-01,16341,14713,1628,10
02122,2020-07-01,26992,23935,3057,11.3
02130,2020-07-01,6896,6032,864,12.5
02150,2020-07-01,7048,6591,457,6.5
02158,2020-07-01,2131,1576,555,26
02164,2020-07-01,976,889,87,8.9
02170,2020-07-01,47859,42685,5174,10.8
02180,2020-07-01,3817,3262,555,14.5
02185,2020-07-01,2851,2620,231,8.1
02188,2020-07-01,2797,2335,462,16.5
02195,2020-07-01,1564,1434,130,8.3
02198,2020-07-01,2894,2564,330,11.4
02220,2020-07-01,4509,4122,387,8.6
02230,2020-07-01,712,526,186,26.1
02240,2020-07-01,3078,2833,245,8
02261,2020-07-01,5466,5040,426,7.8
02275,2020-07-01,986,883,103,10.4
02282,2020-07-01,289,263,26,9
02290,2020-07-01,2294,1924,370,16.1
04001,2020-07-01,20030,16510,3520,17.6
04003,2020-07-01,52447,47661,4786,9.1
04005,2020-07-01,75980,66317,9663,12.7
04007,2020-07-01,21232,19089,2143,10.1
04009,2020-07-01,15333,13883,1450,9.5
04011,2020-07-01,4434,4060,374,8.4
04012,2020-07-01,8323,7538,785,9.4
04013,2020-07-01,NA,NA,243508,10.3
04015,2020-07-01,90985,79807,11178,12.3
04017,2020-07-01,40711,35188,5523,13.6
04019,2020-07-01,499389,446115,53274,10.7
04021,2020-07-01,191355,171335,20020,10.5
04023,2020-07-01,18974,15964,3010,15.9
04025,2020-07-01,108907,98338,10569,9.7
04027,2020-07-01,99582,74898,24684,24.8
05001,2020-07-01,9405,8948,457,4.9
05003,2020-07-01,7092,6271,821,11.6
05005,2020-07-01,16503,15371,1132,6.9
05007,2020-07-01,140257,132453,7804,5.6
05009,2020-07-01,15255,14312,943,6.2
05011,2020-07-01,4216,3913,303,7.2
05013,2020-07-01,2381,2242,139,5.8
05015,2020-07-01,12705,11864,841,6.6
05017,2020-07-01,3285,2873,412,12.5
05019,2020-07-01,9034,8324,710,7.9
05021,2020-07-01,5444,5048,396,7.3
05023,2020-07-01,9278,8512,766,8.3
05025,2020-07-01,3194,2976,218,6.8
05027,2020-07-01,8553,7783,770,9
05029,2020-07-01,8299,7716,583,7
05031,2020-07-01,56439,52556,3883,6.9
05033,2020-07-01,26514,24752,1762,6.6
05035,2020-07-01,21551,19174,2377,11
05037,2020-07-01,7140,6600,540,7.6
05039,2020-07-01,2850,2672,178,6.2
05041,2020-07-01,5169,4673,496,9.6
05043,2020-07-01,7483,6872,611,8.2
05045,2020-07-01,62141,58029,4112,6.6
05047,2020-07-01,7384,6869,515,7
05049,2020-07-01,4821,4522,299,6.2
05051,2020-07-01,42803,38734,4069,9.5
05053,2020-07-01,8264,7730,534,6.5
05055,2020-07-01,19481,18061,1420,7.3
05057,2020-07-01,9411,8823,588,6.2
05059,2020-07-01,14147,13137,1010,7.1
05061,2020-07-01,5478,5134,344,6.3
05063,2020-07-01,16353,15268,1085,6.6
05065,2020-07-01,4448,4002,446,10
05067,2020-07-01,5823,5344,479,8.2
05069,2020-07-01,27742,24993,2749,9.9
05071,2020-07-01,9789,8972,817,8.3
05073,2020-07-01,2370,2153,217,9.2
05075,2020-07-01,6431,5921,510,7.9
05077,2020-07-01,2851,2595,256,9
05079,2020-07-01,3824,3567,257,6.7
05081,2020-07-01,5488,5064,424,7.7
05083,2020-07-01,8514,7814,700,8.2
05085,2020-07-01,33820,31464,2356,7
05087,2020-07-01,7368,7024,344,4.7
05089,2020-07-01,6240,5753,487,7.8
05091,2020-07-01,19809,18172,1637,8.3
05093,2020-07-01,17274,15261,2013,11.7
05095,2020-07-01,2688,2462,226,8.4
05097,2020-07-01,3009,2765,244,8.1
05099,2020-07-01,3525,3248,277,7.9
05101,2020-07-01,3133,2961,172,5.5
05103,2020-07-01,9756,9029,727,7.5
05105,2020-07-01,4205,3935,270,6.4
05107,2020-07-01,6293,5579,714,11.3
05109,2020-07-01,4200,3897,303,7.2
05111,2020-07-01,9962,9293,669,6.7
05113,2020-07-01,7844,7223,621,7.9
05115,2020-07-01,27112,25078,2034,7.5
05117,2020-07-01,3490,3262,228,6.5
05119,2020-07-01,192608,174017,18591,9.7
05121,2020-07-01,7433,6905,528,7.1
05123,2020-07-01,8031,7255,776,9.7
05125,2020-07-01,58817,54977,3840,6.5
05127,2020-07-01,4221,3985,236,5.6
05129,2020-07-01,2881,2677,204,7.1
05131,2020-07-01,56351,52348,4003,7.1
05133,2020-07-01,5508,5147,361,6.6
05135,2020-07-01,5633,5157,476,8.5
05137,2020-07-01,4585,4217,368,8
05139,2020-07-01,15573,13969,1604,10.3
05141,2020-07-01,5712,5263,449,7.9
05143,2020-07-01,126510,119206,7304,5.8
05145,2020-07-01,33287,30774,2513,7.5
05147,2020-07-01,2653,2462,191,7.2
05149,2020-07-01,7752,7266,486,6.3
06001,2020-07-01,811525,714399,97126,12
06003,2020-07-01,456,390,66,14.5
06005,2020-07-01,14408,12743,1665,11.6
06007,2020-07-01,90377,80324,10053,11.1
06009,2020-07-01,21410,19464,1946,9.1
06011,2020-07-01,10339,8945,1394,13.5
06013,2020-07-01,539228,474876,64352,11.9
06015,2020-07-01,9198,8177,1021,11.1
06017,2020-07-01,90186,81243,8943,9.9
06019,2020-07-01,440989,383692,57297,13
06021,2020-07-01,12207,10972,1235,10.1
06023,2020-07-01,58208,52021,6187,10.6
06025,2020-07-01,68647,49784,18863,27.5
06027,2020-07-01,8354,7577,777,9.3
06029,2020-07-01,379667,321968,57699,15.2
06031,2020-07-01,56419,49442,6977,12.4
06033,2020-07-01,27777,24727,3050,11
06035,2020-07-01,9299,8559,740,8
06037,2020-07-01,NA,NA,899935,18.2
06039,2020-07-01,60659,53147,7512,12.4
06041,2020-07-01,129179,117441,11738,9.1
06043,2020-07-01,7355,6521,834,11.3
06045,2020-07-01,36752,32749,4003,10.9
06047,2020-07-01,110828,95432,15396,13.9
06049,2020-07-01,3205,2956,249,7.8
06051,2020-07-01,8080,6973,1107,13.7
06053,2020-07-01,219315,196535,22780,10.4
06055,2020-07-01,69621,62192,7429,10.7
06057,2020-07-01,46265,41623,4642,10
06059,2020-07-01,NA,NA,190254,12.3
06061,2020-07-01,184405,167087,17318,9.4
06063,2020-07-01,7872,7087,785,10
06065,2020-07-01,NA,961098,145751,13.2
06067,2020-07-01,711750,625835,85915,12.1
06069,2020-07-01,31367,27832,3535,11.3
06071,2020-07-01,964009,841757,122252,12.7
06073,2020-07-01,NA,NA,189612,12.3
06075,2020-07-01,553239,492322,60917,11
06077,2020-07-01,331605,285703,45902,13.8
06079,2020-07-01,131828,118795,13033,9.9
06081,2020-07-01,428551,388347,40204,9.4
06083,2020-07-01,219400,198404,20996,9.6
06085,2020-07-01,NA,922684,94776,9.3
06087,2020-07-01,134720,120422,14298,10.6
06089,2020-07-01,72095,64849,7246,10.1
06091,2020-07-01,1256,1148,108,8.6
06093,2020-07-01,17077,15316,1761,10.3
06095,2020-07-01,202729,178219,24510,12.1
06097,2020-07-01,245233,220646,24587,10
06099,2020-07-01,240646,209602,31044,12.9
06101,2020-07-01,46234,40808,5426,11.7
06103,2020-07-01,25110,22522,2588,10.3
06105,2020-07-01,4613,4243,370,8
06107,2020-07-01,195971,166647,29324,15
06109,2020-07-01,20220,17752,2468,12.2
06111,2020-07-01,405592,359970,45622,11.2
06113,2020-07-01,105058,95454,9604,9.1
06115,2020-07-01,30166,26475,3691,12.2
08001,2020-07-01,271162,248223,22939,8.5
08003,2020-07-01,8310,7840,470,5.7
08005,2020-07-01,363263,332440,30823,8.5
08007,2020-07-01,7371,6845,526,7.1
08009,2020-07-01,2140,2102,38,1.8
08011,2020-07-01,1784,1715,69,3.9
08013,2020-07-01,187992,175349,12643,6.7
08014,2020-07-01,39671,36893,2778,7
08015,2020-07-01,10236,9666,570,5.6
08017,2020-07-01,1127,1105,22,2
08019,2020-07-01,6084,5543,541,8.9
08021,2020-07-01,4024,3841,183,4.5
08023,2020-07-01,1842,1698,144,7.8
08025,2020-07-01,1485,1426,59,4
08027,2020-07-01,2170,2076,94,4.3
08029,2020-07-01,14347,13502,845,5.9
08031,2020-07-01,420074,382549,37525,8.9
08033,2020-07-01,1124,1053,71,6.3
08035,2020-07-01,191574,180354,11220,5.9
08037,2020-07-01,35110,31700,3410,9.7
08039,2020-07-01,14758,14093,665,4.5
08041,2020-07-01,341765,317826,23939,7
08043,2020-07-01,15779,14727,1052,6.7
08045,2020-07-01,31711,29728,1983,6.3
08047,2020-07-01,3996,3511,485,12.1
08049,2020-07-01,9455,8634,821,8.7
08051,2020-07-01,11472,10790,682,5.9
08053,2020-07-01,511,498,13,2.5
08055,2020-07-01,2681,2445,236,8.8
08057,2020-07-01,980,948,32,3.3
08059,2020-07-01,329512,305168,24344,7.4
08061,2020-07-01,959,940,19,2
08063,2020-07-01,4295,4186,109,2.5
08065,2020-07-01,4703,4307,396,8.4
08067,2020-07-01,31358,29400,1958,6.2
08069,2020-07-01,199414,187053,12361,6.2
08071,2020-07-01,6428,5975,453,7
08073,2020-07-01,2371,2283,88,3.7
08075,2020-07-01,10803,10306,497,4.6
08077,2020-07-01,73903,68571,5332,7.2
08079,2020-07-01,447,421,26,5.8
08081,2020-07-01,7237,6843,394,5.4
08083,2020-07-01,12822,12056,766,6
08085,2020-07-01,21756,20479,1277,5.9
08087,2020-07-01,15918,14998,920,5.8
08089,2020-07-01,8111,7658,453,5.6
08091,2020-07-01,2685,2498,187,7
08093,2020-07-01,10999,10374,625,5.7
08095,2020-07-01,2484,2429,55,2.2
08097,2020-07-01,11206,10138,1068,9.5
08099,2020-07-01,6132,5891,241,3.9
08101,2020-07-01,75682,69741,5941,7.8
08103,2020-07-01,2935,2793,142,4.8
08105,2020-07-01,5570,5225,345,6.2
08107,2020-07-01,16150,14871,1279,7.9
08109,2020-07-01,3416,3159,257,7.5
08111,2020-07-01,615,586,29,4.7
08113,2020-07-01,5316,4766,550,10.3
08115,2020-07-01,1179,1143,36,3.1
08117,2020-07-01,21244,18982,2262,10.6
08119,2020-07-01,12832,12004,828,6.5
08121,2020-07-01,2928,2838,90,3.1
08123,2020-07-01,162291,150203,12088,7.4
08125,2020-07-01,5670,5527,143,2.5
09001,2020-07-01,482665,426281,56384,11.7
09003,2020-07-01,488552,429728,58824,12
09005,2020-07-01,104287,94093,10194,9.8
09007,2020-07-01,93835,84971,8864,9.4
09009,2020-07-01,471410,416441,54969,11.7
09011,2020-07-01,138374,119691,18683,13.5
09013,2020-07-01,85679,77960,7719,9
09015,2020-07-01,63784,56684,7100,11.1
10001,2020-07-01,80601,72830,7771,9.6
10003,2020-07-01,299417,272958,26459,8.8
10005,2020-07-01,112021,103905,8116,7.2
11001,2020-07-01,407168,368356,38812,9.5
12001,2020-07-01,132302,121522,10780,8.1
12003,2020-07-01,11717,10886,831,7.1
12005,2020-07-01,83985,77438,6547,7.8
12007,2020-07-01,10675,9777,898,8.4
12009,2020-07-01,283508,256742,26766,9.4
12011,2020-07-01,NA,893460,140820,13.6
12013,2020-07-01,4611,4277,334,7.2
12015,2020-07-01,70435,63178,7257,10.3
12017,2020-07-01,45929,40575,5354,11.7
12019,2020-07-01,105377,97365,8012,7.6
12021,2020-07-01,173682,155501,18181,10.5
12023,2020-07-01,29076,26567,2509,8.6
12027,2020-07-01,13643,12595,1048,7.7
12029,2020-07-01,5662,5198,464,8.2
12031,2020-07-01,489694,440449,49245,10.1
12033,2020-07-01,146885,132532,14353,9.8
12035,2020-07-01,46444,41591,4853,10.4
12037,2020-07-01,4707,4395,312,6.6
12039,2020-07-01,18306,16443,1863,10.2
12041,2020-07-01,6861,6379,482,7
12043,2020-07-01,4754,4307,447,9.4
12045,2020-07-01,5132,4701,431,8.4
12047,2020-07-01,4199,3694,505,12
12049,2020-07-01,8093,7228,865,10.7
12051,2020-07-01,15226,13138,2088,13.7
12053,2020-07-01,71846,63744,8102,11.3
12055,2020-07-01,34279,30322,3957,11.5
12057,2020-07-01,759602,676052,83550,11
12059,2020-07-01,6695,6139,556,8.3
12061,2020-07-01,63435,56650,6785,10.7
12063,2020-07-01,16953,15606,1347,7.9
12065,2020-07-01,5274,4834,440,8.3
12067,2020-07-01,2677,2493,184,6.9
12069,2020-07-01,152492,132972,19520,12.8
12071,2020-07-01,343658,306695,36963,10.8
12073,2020-07-01,149705,135943,13762,9.2
12075,2020-07-01,16158,14801,1357,8.4
12077,2020-07-01,2521,2340,181,7.2
12079,2020-07-01,7748,6987,761,9.8
12081,2020-07-01,175018,157944,17074,9.8
12083,2020-07-01,137473,123601,13872,10.1
12085,2020-07-01,71963,65672,6291,8.7
12086,2020-07-01,NA,NA,192170,15.2
12087,2020-07-01,44205,39581,4624,10.5
12089,2020-07-01,41157,37962,3195,7.8
12091,2020-07-01,98161,91242,6919,7
12093,2020-07-01,16254,14874,1380,8.5
12095,2020-07-01,747667,624247,123420,16.5
12097,2020-07-01,191127,152288,38839,20.3
12099,2020-07-01,716980,634278,82702,11.5
12101,2020-07-01,238760,214312,24448,10.2
12103,2020-07-01,485499,436297,49202,10.1
12105,2020-07-01,319892,277162,42730,13.4
12107,2020-07-01,26508,23415,3093,11.7
12109,2020-07-01,133105,123200,9905,7.4
12111,2020-07-01,146158,129853,16305,11.2
12113,2020-07-01,82895,76807,6088,7.3
12115,2020-07-01,182940,165474,17466,9.5
12117,2020-07-01,234498,209070,25428,10.8
12119,2020-07-01,31916,28414,3502,11
12121,2020-07-01,17121,15644,1477,8.6
12123,2020-07-01,8331,7531,800,9.6
12125,2020-07-01,4425,4108,317,7.2
12127,2020-07-01,249686,222430,27256,10.9
12129,2020-07-01,14570,13637,933,6.4
12131,2020-07-01,32582,30191,2391,7.3
12133,2020-07-01,9428,8657,771,8.2
13001,2020-07-01,8771,8314,457,5.2
13003,2020-07-01,4297,4124,173,4
13005,2020-07-01,4420,4164,256,5.8
13007,2020-07-01,1065,986,79,7.4
13009,2020-07-01,17093,15640,1453,8.5
13011,2020-07-01,9402,8963,439,4.7
13013,2020-07-01,39030,36730,2300,5.9
13015,2020-07-01,48502,44948,3554,7.3
13017,2020-07-01,5378,4979,399,7.4
13019,2020-07-01,7070,6654,416,5.9
13021,2020-07-01,66684,60325,6359,9.5
13023,2020-07-01,4341,4011,330,7.6
13025,2020-07-01,6850,6456,394,5.8
13027,2020-07-01,6527,6106,421,6.5
13029,2020-07-01,18138,17053,1085,6
13031,2020-07-01,35794,32787,3007,8.4
13033,2020-07-01,8834,8026,808,9.1
13035,2020-07-01,10515,9711,804,7.6
13037,2020-07-01,2056,1917,139,6.8
13039,2020-07-01,20682,19677,1005,4.9
13043,2020-07-01,5426,5110,316,5.8
13045,2020-07-01,53230,49210,4020,7.6
13047,2020-07-01,31883,30292,1591,5
13049,2020-07-01,4699,4514,185,3.9
13051,2020-07-01,137824,125049,12775,9.3
13053,2020-07-01,1925,1789,136,7.1
13055,2020-07-01,9648,8701,947,9.8
13057,2020-07-01,129821,122347,7474,5.8
13059,2020-07-01,56026,51489,4537,8.1
13061,2020-07-01,884,737,147,16.6
13063,2020-07-01,139871,121034,18837,13.5
13065,2020-07-01,2806,2681,125,4.5
13067,2020-07-01,407046,376859,30187,7.4
13069,2020-07-01,18531,17281,1250,6.7
13071,2020-07-01,21036,19964,1072,5.1
13073,2020-07-01,72426,68921,3505,4.8
13075,2020-07-01,7871,7416,455,5.8
13077,2020-07-01,73030,66995,6035,8.3
13079,2020-07-01,5310,5003,307,5.8
13081,2020-07-01,9332,8407,925,9.9
13083,2020-07-01,7680,7324,356,4.6
13085,2020-07-01,11949,11319,630,5.3
13087,2020-07-01,10915,10314,601,5.5
13089,2020-07-01,392913,352046,40867,10.4
13091,2020-07-01,6850,6392,458,6.7
13093,2020-07-01,4722,4257,465,9.8
13095,2020-07-01,37337,33252,4085,10.9
13097,2020-07-01,71419,64691,6728,9.4
13099,2020-07-01,4357,4034,323,7.4
13101,2020-07-01,1775,1689,86,4.8
13103,2020-07-01,30416,28679,1737,5.7
13105,2020-07-01,7807,7162,645,8.3
13107,2020-07-01,8364,7601,763,9.1
13109,2020-07-01,4891,4594,297,6.1
13111,2020-07-01,10971,10419,552,5
13113,2020-07-01,55282,51575,3707,6.7
13115,2020-07-01,42764,39599,3165,7.4
13117,2020-07-01,117503,111405,6098,5.2
13119,2020-07-01,9529,8885,644,6.8
13121,2020-07-01,552710,495198,57512,10.4
13123,2020-07-01,11753,11177,576,4.9
13125,2020-07-01,1197,1140,57,4.8
13127,2020-07-01,38081,35142,2939,7.7
13129,2020-07-01,27309,25611,1698,6.2
13131,2020-07-01,10238,9751,487,4.8
13133,2020-07-01,7078,6607,471,6.7
13135,2020-07-01,473511,435869,37642,7.9
13137,2020-07-01,18111,17017,1094,6
13139,2020-07-01,99697,94182,5515,5.5
13141,2020-07-01,2421,2153,268,11.1
13143,2020-07-01,11932,11138,794,6.7
13145,2020-07-01,16088,15224,864,5.4
13147,2020-07-01,11084,10408,676,6.1
13149,2020-07-01,5012,4618,394,7.9
13151,2020-07-01,113702,103147,10555,9.3
13153,2020-07-01,69450,65285,4165,6
13155,2020-07-01,3315,3117,198,6
13157,2020-07-01,38725,36831,1894,4.9
13159,2020-07-01,6547,6175,372,5.7
13161,2020-07-01,5910,5574,336,5.7
13163,2020-07-01,6538,5932,606,9.3
13165,2020-07-01,3120,2870,250,8
13167,2020-07-01,3898,3673,225,5.8
13169,2020-07-01,12948,12275,673,5.2
13171,2020-07-01,7819,7228,591,7.6
13173,2020-07-01,3603,3391,212,5.9
13175,2020-07-01,19026,17552,1474,7.7
13177,2020-07-01,14346,13574,772,5.4
13179,2020-07-01,25279,23425,1854,7.3
13181,2020-07-01,3370,3153,217,6.4
13183,2020-07-01,7864,7480,384,4.9
13185,2020-07-01,50586,46738,3848,7.6
13187,2020-07-01,16201,15318,883,5.5
13189,2020-07-01,8618,7740,878,10.2
13191,2020-07-01,5845,5457,388,6.6
13193,2020-07-01,4401,4050,351,8
13195,2020-07-01,12377,11636,741,6
13197,2020-07-01,3100,2920,180,5.8
13199,2020-07-01,8717,7753,964,11.1
13201,2020-07-01,2673,2537,136,5.1
13205,2020-07-01,7889,7273,616,7.8
13207,2020-07-01,12356,11615,741,6
13209,2020-07-01,3780,3537,243,6.4
13211,2020-07-01,8862,8282,580,6.5
13213,2020-07-01,14942,13749,1193,8
13215,2020-07-01,76602,69025,7577,9.9
13217,2020-07-01,51055,46507,4548,8.9
13219,2020-07-01,18248,17487,761,4.2
13221,2020-07-01,6417,6063,354,5.5
13223,2020-07-01,83391,77915,5476,6.6
13225,2020-07-01,11570,10745,825,7.1
13227,2020-07-01,14507,13729,778,5.4
13229,2020-07-01,8308,7887,421,5.1
13231,2020-07-01,8500,7974,526,6.2
13233,2020-07-01,17963,16761,1202,6.7
13235,2020-07-01,3855,3674,181,4.7
13237,2020-07-01,8011,7377,634,7.9
13239,2020-07-01,800,722,78,9.8
13241,2020-07-01,7324,6909,415,5.7
13243,2020-07-01,2345,2170,175,7.5
13245,2020-07-01,84128,76048,8080,9.6
13247,2020-07-01,43419,39286,4133,9.5
13249,2020-07-01,2024,1932,92,4.5
13251,2020-07-01,4807,4264,543,11.3
13253,2020-07-01,3021,2852,169,5.6
13255,2020-07-01,27947,25239,2708,9.7
13257,2020-07-01,10173,9414,759,7.5
13259,2020-07-01,2432,2261,171,7
13261,2020-07-01,11997,10889,1108,9.2
13263,2020-07-01,2692,2474,218,8.1
13265,2020-07-01,527,485,42,8
13267,2020-07-01,9256,8810,446,4.8
13269,2020-07-01,2683,2480,203,7.6
13271,2020-07-01,3693,3284,409,11.1
13273,2020-07-01,3439,3108,331,9.6
13275,2020-07-01,16742,15506,1236,7.4
13277,2020-07-01,19853,18618,1235,6.2
13279,2020-07-01,11774,10858,916,7.8
13281,2020-07-01,3777,3504,273,7.2
13283,2020-07-01,2643,2465,178,6.7
13285,2020-07-01,36952,33671,3281,8.9
13287,2020-07-01,3193,2935,258,8.1
13289,2020-07-01,2724,2487,237,8.7
13291,2020-07-01,10241,9759,482,4.7
13293,2020-07-01,11150,10236,914,8.2
13295,2020-07-01,29832,28209,1623,5.4
13297,2020-07-01,43758,40997,2761,6.3
13299,2020-07-01,14993,14050,943,6.3
13301,2020-07-01,2589,2374,215,8.3
13303,2020-07-01,6776,6235,541,8
13305,2020-07-01,11432,10731,701,6.1
13307,2020-07-01,962,898,64,6.7
13309,2020-07-01,1532,1417,115,7.5
13311,2020-07-01,15963,15245,718,4.5
13313,2020-07-01,42314,39002,3312,7.8
13315,2020-07-01,2633,2438,195,7.4
13317,2020-07-01,3669,3389,280,7.6
13319,2020-07-01,3703,3466,237,6.4
13321,2020-07-01,8503,7996,507,6
15001,2020-07-01,88834,76507,12327,13.9
15003,2020-07-01,439012,386020,52992,12.1
15007,2020-07-01,35175,28008,7167,20.4
15009,2020-07-01,80959,62089,18870,23.3
16001,2020-07-01,257455,241716,15739,6.1
16003,2020-07-01,1825,1675,150,8.2
16005,2020-07-01,42164,39969,2195,5.2
16007,2020-07-01,3171,3050,121,3.8
16009,2020-07-01,4205,3935,270,6.4
16011,2020-07-01,23586,22629,957,4.1
16013,2020-07-01,12924,11964,960,7.4
16015,2020-07-01,3593,3295,298,8.3
16017,2020-07-01,21809,20225,1584,7.3
16019,2020-07-01,58586,56267,2319,4
16021,2020-07-01,5622,5311,311,5.5
16023,2020-07-01,1409,1361,48,3.4
16025,2020-07-01,692,660,32,4.6
16027,2020-07-01,106728,99769,6959,6.5
16029,2020-07-01,4060,3925,135,3.3
16031,2020-07-01,12427,11953,474,3.8
16033,2020-07-01,388,373,15,3.9
16035,2020-07-01,3038,2814,224,7.4
16037,2020-07-01,2500,2401,99,4
16039,2020-07-01,12064,11469,595,4.9
16041,2020-07-01,6789,6555,234,3.4
16043,2020-07-01,7698,7443,255,3.3
16045,2020-07-01,8421,7897,524,6.2
16047,2020-07-01,8183,7867,316,3.9
16049,2020-07-01,6910,6461,449,6.5
16051,2020-07-01,14287,13815,472,3.3
16053,2020-07-01,12135,11645,490,4
16055,2020-07-01,82551,76844,5707,6.9
16057,2020-07-01,18535,17547,988,5.3
16059,2020-07-01,3917,3688,229,5.8
16061,2020-07-01,1727,1603,124,7.2
16063,2020-07-01,2687,2549,138,5.1
16065,2020-07-01,21929,21288,641,2.9
16067,2020-07-01,11632,11150,482,4.1
16069,2020-07-01,20731,19742,989,4.8
16071,2020-07-01,2333,2242,91,3.9
16073,2020-07-01,5796,5431,365,6.3
16075,2020-07-01,11884,11172,712,6
16077,2020-07-01,4028,3856,172,4.3
16079,2020-07-01,5481,5012,469,8.6
16081,2020-07-01,7131,6779,352,4.9
16083,2020-07-01,41204,38851,2353,5.7
16085,2020-07-01,6101,5701,400,6.6
16087,2020-07-01,4763,4474,289,6.1
17001,2020-07-01,31027,28404,2623,8.5
17003,2020-07-01,1897,1631,266,14
17005,2020-07-01,7488,6799,689,9.2
17007,2020-07-01,26310,22112,4198,16
17009,2020-07-01,2966,2802,164,5.5
17011,2020-07-01,16549,15003,1546,9.3
17013,2020-07-01,2204,1999,205,9.3
17015,2020-07-01,7456,6870,586,7.9
17017,2020-07-01,5802,5286,516,8.9
17019,2020-07-01,104418,94728,9690,9.3
17021,2020-07-01,13723,12193,1530,11.1
17023,2020-07-01,7387,6706,681,9.2
17025,2020-07-01,6156,5501,655,10.6
17027,2020-07-01,19498,18080,1418,7.3
17029,2020-07-01,22378,19880,2498,11.2
17031,2020-07-01,NA,NA,366824,14.4
17033,2020-07-01,8357,7632,725,8.7
17035,2020-07-01,5835,5371,464,8
17037,2020-07-01,52979,46799,6180,11.7
17039,2020-07-01,7006,6419,587,8.4
17041,2020-07-01,9863,9119,744,7.5
17043,2020-07-01,477779,429928,47851,10
17045,2020-07-01,8879,8193,686,7.7
17047,2020-07-01,2804,2533,271,9.7
17049,2020-07-01,19084,17413,1671,8.8
17051,2020-07-01,9767,8782,985,10.1
17053,2020-07-01,6083,5558,525,8.6
17055,2020-07-01,15963,13858,2105,13.2
17057,2020-07-01,14583,12926,1657,11.4
17059,2020-07-01,2016,1769,247,12.3
17061,2020-07-01,5945,5418,527,8.9
17063,2020-07-01,23878,21417,2461,10.3
17065,2020-07-01,4163,3808,355,8.5
17067,2020-07-01,8032,7369,663,8.3
17069,2020-07-01,1302,1124,178,13.7
17071,2020-07-01,3596,3312,284,7.9
17073,2020-07-01,23749,21380,2369,10
17075,2020-07-01,13743,12734,1009,7.3
17077,2020-07-01,27046,24153,2893,10.7
17079,2020-07-01,4549,4201,348,7.7
17081,2020-07-01,16832,14746,2086,12.4
17083,2020-07-01,10546,9531,1015,9.6
17085,2020-07-01,10657,9617,1040,9.8
17087,2020-07-01,3889,3447,442,11.4
17089,2020-07-01,259960,228105,31855,12.3
17091,2020-07-01,53923,47794,6129,11.4
17093,2020-07-01,65659,58886,6773,10.3
17095,2020-07-01,21325,18905,2420,11.3
17097,2020-07-01,364755,325787,38968,10.7
17099,2020-07-01,52784,46623,6161,11.7
17101,2020-07-01,5721,5159,562,9.8
17103,2020-07-01,17097,15559,1538,9
17105,2020-07-01,15961,14584,1377,8.6
17107,2020-07-01,11953,10841,1112,9.3
17109,2020-07-01,11725,10430,1295,11
17111,2020-07-01,156432,140248,16184,10.3
17113,2020-07-01,83628,75873,7755,9.3
17115,2020-07-01,47611,41073,6538,13.7
17117,2020-07-01,21916,19951,1965,9
17119,2020-07-01,130995,116760,14235,10.9
17121,2020-07-01,16971,15120,1851,10.9
17123,2020-07-01,5087,4622,465,9.1
17125,2020-07-01,5873,5243,630,10.7
17127,2020-07-01,5562,4861,701,12.6
17129,2020-07-01,6045,5572,473,7.8
17131,2020-07-01,7627,6886,741,9.7
17133,2020-07-01,18112,16750,1362,7.5
17135,2020-07-01,11568,10256,1312,11.3
17137,2020-07-01,15832,14268,1564,9.9
17139,2020-07-01,7163,6641,522,7.3
17141,2020-07-01,23901,21182,2719,11.4
17143,2020-07-01,84748,72939,11809,13.9
17145,2020-07-01,8011,7112,899,11.2
17147,2020-07-01,8151,7544,607,7.4
17149,2020-07-01,6838,6337,501,7.3
17151,2020-07-01,1643,1470,173,10.5
17153,2020-07-01,1740,1461,279,16
17155,2020-07-01,2964,2665,299,10.1
17157,2020-07-01,13546,12340,1206,8.9
17159,2020-07-01,7438,6825,613,8.2
17161,2020-07-01,68361,59997,8364,12.2
17163,2020-07-01,125755,109499,16256,12.9
17165,2020-07-01,9464,8220,1244,13.1
17167,2020-07-01,96961,86289,10672,11
17169,2020-07-01,3105,2861,244,7.9
17171,2020-07-01,2359,2160,199,8.4
17173,2020-07-01,10322,9421,901,8.7
17175,2020-07-01,2400,2181,219,9.1
17177,2020-07-01,21325,19256,2069,9.7
17179,2020-07-01,62167,55516,6651,10.7
17181,2020-07-01,7017,6273,744,10.6
17183,2020-07-01,32551,28832,3719,11.4
17185,2020-07-01,5603,5067,536,9.6
17187,2020-07-01,8060,7384,676,8.4
17189,2020-07-01,9641,9113,528,5.5
17191,2020-07-01,6738,6039,699,10.4
17193,2020-07-01,6123,5517,606,9.9
17195,2020-07-01,27169,24330,2839,10.4
17197,2020-07-01,341062,301439,39623,11.6
17199,2020-07-01,30943,27614,3329,10.8
17201,2020-07-01,138995,116685,22310,16.1
17203,2020-07-01,17964,16525,1439,8
18001,2020-07-01,16956,16024,932,5.5
18003,2020-07-01,187146,169363,17783,9.5
18005,2020-07-01,43968,40602,3366,7.7
18007,2020-07-01,4198,3912,286,6.8
18009,2020-07-01,4740,4370,370,7.8
18011,2020-07-01,35747,33797,1950,5.5
18013,2020-07-01,7658,7038,620,8.1
18015,2020-07-01,9407,8743,664,7.1
18017,2020-07-01,17553,16203,1350,7.7
18019,2020-07-01,61665,55938,5727,9.3
18021,2020-07-01,11411,10466,945,8.3
18023,2020-07-01,16572,15500,1072,6.5
18025,2020-07-01,4870,4460,410,8.4
18027,2020-07-01,16556,15787,769,4.6
18029,2020-07-01,25383,23332,2051,8.1
18031,2020-07-01,14880,13852,1028,6.9
18033,2020-07-01,22274,20602,1672,7.5
18035,2020-07-01,51388,46617,4771,9.3
18037,2020-07-01,23090,21521,1569,6.8
18039,2020-07-01,111555,101849,9706,8.7
18041,2020-07-01,8484,7478,1006,11.9
18043,2020-07-01,41346,37892,3454,8.4
18045,2020-07-01,7818,7269,549,7
18047,2020-07-01,11311,10641,670,5.9
18049,2020-07-01,9749,8974,775,7.9
18051,2020-07-01,19336,18013,1323,6.8
18053,2020-07-01,30576,28195,2381,7.8
18055,2020-07-01,12927,11952,975,7.5
18057,2020-07-01,183506,172463,11043,6
18059,2020-07-01,40505,37709,2796,6.9
18061,2020-07-01,19864,18395,1469,7.4
18063,2020-07-01,89786,83831,5955,6.6
18065,2020-07-01,21752,20120,1632,7.5
18067,2020-07-01,36412,32734,3678,10.1
18069,2020-07-01,18056,16809,1247,6.9
18071,2020-07-01,23417,21748,1669,7.1
18073,2020-07-01,15587,14264,1323,8.5
18075,2020-07-01,8966,8450,516,5.8
18077,2020-07-01,14817,13559,1258,8.5
18079,2020-07-01,13676,12646,1030,7.5
18081,2020-07-01,82764,76848,5916,7.1
18083,2020-07-01,18266,17024,1242,6.8
18085,2020-07-01,41360,38298,3062,7.4
18087,2020-07-01,19409,18344,1065,5.5
18089,2020-07-01,227610,197824,29786,13.1
18091,2020-07-01,48191,42439,5752,11.9
18093,2020-07-01,20428,18694,1734,8.5
18095,2020-07-01,59024,53579,5445,9.2
18097,2020-07-01,506878,450785,56093,11.1
18099,2020-07-01,22702,20957,1745,7.7
18101,2020-07-01,5508,5202,306,5.6
18103,2020-07-01,14850,13565,1285,8.7
18105,2020-07-01,64967,59917,5050,7.8
18107,2020-07-01,18574,17422,1152,6.2
18109,2020-07-01,35787,33405,2382,6.7
18111,2020-07-01,6600,6074,526,8
18113,2020-07-01,22706,20735,1971,8.7
18115,2020-07-01,3194,2903,291,9.1
18117,2020-07-01,8812,7321,1491,16.9
18119,2020-07-01,8632,7919,713,8.3
18121,2020-07-01,7134,6676,458,6.4
18123,2020-07-01,9081,8403,678,7.5
18125,2020-07-01,6161,5699,462,7.5
18127,2020-07-01,84702,75680,9022,10.7
18129,2020-07-01,12885,12123,762,5.9
18131,2020-07-01,6492,6030,462,7.1
18133,2020-07-01,16411,15191,1220,7.4
18135,2020-07-01,11035,10230,805,7.3
18137,2020-07-01,13807,12876,931,6.7
18139,2020-07-01,8694,8138,556,6.4
18141,2020-07-01,135167,120261,14906,11
18143,2020-07-01,10453,9472,981,9.4
18145,2020-07-01,23147,21239,1908,8.2
18147,2020-07-01,10902,10198,704,6.5
18149,2020-07-01,9784,8822,962,9.8
18151,2020-07-01,20260,18860,1400,6.9
18153,2020-07-01,7831,7200,631,8.1
18155,2020-07-01,4759,4333,426,9
18157,2020-07-01,91313,83748,7565,8.3
18159,2020-07-01,8999,8444,555,6.2
18161,2020-07-01,3476,3240,236,6.8
18163,2020-07-01,92730,84019,8711,9.4
18165,2020-07-01,6530,5980,550,8.4
18167,2020-07-01,45720,41192,4528,9.9
18169,2020-07-01,14169,13190,979,6.9
18171,2020-07-01,4020,3742,278,6.9
18173,2020-07-01,31742,29643,2099,6.6
18175,2020-07-01,13530,12465,1065,7.9
18177,2020-07-01,29914,27346,2568,8.6
18179,2020-07-01,14071,13154,917,6.5
18181,2020-07-01,13459,12669,790,5.9
18183,2020-07-01,17182,16015,1167,6.8
19001,2020-07-01,4047,3879,168,4.2
19003,2020-07-01,1959,1866,93,4.7
19005,2020-07-01,6705,6392,313,4.7
19007,2020-07-01,5794,5459,335,5.8
19009,2020-07-01,2915,2805,110,3.8
19011,2020-07-01,12621,11937,684,5.4
19013,2020-07-01,66668,62028,4640,7
19015,2020-07-01,14126,13486,640,4.5
19017,2020-07-01,13161,12595,566,4.3
19019,2020-07-01,10825,10301,524,4.8
19021,2020-07-01,11067,10510,557,5
19023,2020-07-01,7366,7015,351,4.8
19025,2020-07-01,3896,3715,181,4.6
19027,2020-07-01,10391,9913,478,4.6
19029,2020-07-01,6624,6350,274,4.1
19031,2020-07-01,10082,9596,486,4.8
19033,2020-07-01,23104,21730,1374,5.9
19035,2020-07-01,6041,5798,243,4
19037,2020-07-01,5958,5715,243,4.1
19039,2020-07-01,4669,4402,267,5.7
19041,2020-07-01,8222,7824,398,4.8
19043,2020-07-01,9543,9070,473,5
19045,2020-07-01,21619,19974,1645,7.6
19047,2020-07-01,7594,7199,395,5.2
19049,2020-07-01,49231,47177,2054,4.2
19051,2020-07-01,3985,3812,173,4.3
19053,2020-07-01,4013,3816,197,4.9
19055,2020-07-01,10097,9676,421,4.2
19057,2020-07-01,18817,17391,1426,7.6
19059,2020-07-01,10477,10007,470,4.5
19061,2020-07-01,54232,50743,3489,6.4
19063,2020-07-01,4912,4613,299,6.1
19065,2020-07-01,9527,8939,588,6.2
19067,2020-07-01,7944,7484,460,5.8
19069,2020-07-01,5458,5240,218,4
19071,2020-07-01,3591,3452,139,3.9
19073,2020-07-01,5119,4875,244,4.8
19075,2020-07-01,6025,5747,278,4.6
19077,2020-07-01,5239,4974,265,5.1
19079,2020-07-01,6579,6249,330,5
19081,2020-07-01,5580,5306,274,4.9
19083,2020-07-01,7483,7079,404,5.4
19085,2020-07-01,6888,6592,296,4.3
19087,2020-07-01,9116,8602,514,5.6
19089,2020-07-01,4985,4776,209,4.2
19091,2020-07-01,4719,4517,202,4.3
19093,2020-07-01,3838,3689,149,3.9
19095,2020-07-01,9740,9309,431,4.4
19097,2020-07-01,10455,9743,712,6.8
19099,2020-07-01,18922,17785,1137,6
19101,2020-07-01,9110,8465,645,7.1
19103,2020-07-01,84267,79167,5100,6.1
19105,2020-07-01,9964,9356,608,6.1
19107,2020-07-01,4949,4707,242,4.9
19109,2020-07-01,7678,7369,309,4
19111,2020-07-01,15502,14464,1038,6.7
19113,2020-07-01,118362,109718,8644,7.3
19115,2020-07-01,5800,5520,280,4.8
19117,2020-07-01,4582,4386,196,4.3
19119,2020-07-01,6651,6472,179,2.7
19121,2020-07-01,8233,7744,489,5.9
19123,2020-07-01,11621,10946,675,5.8
19125,2020-07-01,18039,16962,1077,6
19127,2020-07-01,17254,16157,1097,6.4
19129,2020-07-01,7056,6722,334,4.7
19131,2020-07-01,6156,5945,211,3.4
19133,2020-07-01,4255,4046,209,4.9
19135,2020-07-01,3920,3664,256,6.5
19137,2020-07-01,4790,4537,253,5.3
19139,2020-07-01,20765,19471,1294,6.2
19141,2020-07-01,7946,7650,296,3.7
19143,2020-07-01,3342,3234,108,3.2
19145,2020-07-01,6135,5822,313,5.1
19147,2020-07-01,4336,4110,226,5.2
19149,2020-07-01,13958,13390,568,4.1
19151,2020-07-01,4090,3918,172,4.2
19153,2020-07-01,265527,247494,18033,6.8
19155,2020-07-01,47239,44255,2984,6.3
19157,2020-07-01,9390,8913,477,5.1
19159,2020-07-01,2318,2214,104,4.5
19161,2020-07-01,4999,4820,179,3.6
19163,2020-07-01,85821,79150,6671,7.8
19165,2020-07-01,6236,6005,231,3.7
19167,2020-07-01,19607,19029,578,2.9
19169,2020-07-01,52528,50083,2445,4.7
19171,2020-07-01,8947,8453,494,5.5
19173,2020-07-01,2962,2819,143,4.8
19175,2020-07-01,5967,5571,396,6.6
19177,2020-07-01,3627,3453,174,4.8
19179,2020-07-01,17532,16367,1165,6.6
19181,2020-07-01,27530,26147,1383,5
19183,2020-07-01,11193,10728,465,4.2
19185,2020-07-01,2658,2517,141,5.3
19187,2020-07-01,18519,17408,1111,6
19189,2020-07-01,4941,4628,313,6.3
19191,2020-07-01,10565,10007,558,5.3
19193,2020-07-01,54212,50964,3248,6
19195,2020-07-01,3996,3800,196,4.9
19197,2020-07-01,6755,6457,298,4.4
20001,2020-07-01,6356,5862,494,7.8
20003,2020-07-01,4287,4087,200,4.7
20005,2020-07-01,6838,6284,554,8.1
20007,2020-07-01,2317,2221,96,4.1
20009,2020-07-01,13928,13159,769,5.5
20011,2020-07-01,6817,6353,464,6.8
20013,2020-07-01,5162,4907,255,4.9
20015,2020-07-01,32903,30314,2589,7.9
20017,2020-07-01,1467,1378,89,6.1
20019,2020-07-01,1486,1362,124,8.3
20021,2020-07-01,10166,9482,684,6.7
20023,2020-07-01,1309,1277,32,2.4
20025,2020-07-01,1147,1115,32,2.8
20027,2020-07-01,3680,3463,217,5.9
20029,2020-07-01,3916,3704,212,5.4
20031,2020-07-01,3889,3645,244,6.3
20033,2020-07-01,854,817,37,4.3
20035,2020-07-01,16983,15635,1348,7.9
20037,2020-07-01,19038,17756,1282,6.7
20039,2020-07-01,1293,1235,58,4.5
20041,2020-07-01,8929,8440,489,5.5
20043,2020-07-01,4216,3989,227,5.4
20045,2020-07-01,61990,57052,4938,8
20047,2020-07-01,1459,1401,58,4
20049,2020-07-01,1026,946,80,7.8
20051,2020-07-01,16931,16235,696,4.1
20053,2020-07-01,2793,2687,106,3.8
20055,2020-07-01,20748,19895,853,4.1
20057,2020-07-01,17081,16349,732,4.3
20059,2020-07-01,14367,13422,945,6.6
20061,2020-07-01,11598,10542,1056,9.1
20063,2020-07-01,1438,1388,50,3.5
20065,2020-07-01,1159,1084,75,6.5
20067,2020-07-01,3063,2884,179,5.8
20069,2020-07-01,2951,2867,84,2.8
20071,2020-07-01,801,785,16,2
20073,2020-07-01,3039,2837,202,6.6
20075,2020-07-01,1593,1561,32,2
20077,2020-07-01,2807,2645,162,5.8
20079,2020-07-01,17173,15981,1192,6.9
20081,2020-07-01,2200,2130,70,3.2
20083,2020-07-01,1009,978,31,3.1
20085,2020-07-01,7362,6952,410,5.6
20087,2020-07-01,10466,9898,568,5.4
20089,2020-07-01,1226,1174,52,4.2
20091,2020-07-01,351258,329358,21900,6.2
20093,2020-07-01,1998,1931,67,3.4
20095,2020-07-01,3372,3143,229,6.8
20097,2020-07-01,1201,1148,53,4.4
20099,2020-07-01,9718,9047,671,6.9
20101,2020-07-01,721,693,28,3.9
20103,2020-07-01,37701,35085,2616,6.9
20105,2020-07-01,1651,1588,63,3.8
20107,2020-07-01,4490,4125,365,8.1
20109,2020-07-01,1484,1441,43,2.9
20111,2020-07-01,16579,15647,932,5.6
20113,2020-07-01,17283,16534,749,4.3
20115,2020-07-01,5840,5506,334,5.7
20117,2020-07-01,5647,5454,193,3.4
20119,2020-07-01,2144,2073,71,3.3
20121,2020-07-01,18095,17029,1066,5.9
20123,2020-07-01,3525,3403,122,3.5
20125,2020-07-01,15221,13858,1363,9
20127,2020-07-01,3082,2942,140,4.5
20129,2020-07-01,1102,1059,43,3.9
20131,2020-07-01,5672,5491,181,3.2
20133,2020-07-01,6440,5883,557,8.6
20135,2020-07-01,1329,1275,54,4.1
20137,2020-07-01,2672,2586,86,3.2
20139,2020-07-01,8222,7756,466,5.7
20141,2020-07-01,1982,1919,63,3.2
20143,2020-07-01,2986,2804,182,6.1
20145,2020-07-01,2912,2781,131,4.5
20147,2020-07-01,2529,2439,90,3.6
20149,2020-07-01,11287,10621,666,5.9
20151,2020-07-01,4869,4645,224,4.6
20153,2020-07-01,1522,1473,49,3.2
20155,2020-07-01,29979,27916,2063,6.9
20157,2020-07-01,2347,2237,110,4.7
20159,2020-07-01,5283,4982,301,5.7
20161,2020-07-01,32233,29877,2356,7.3
20163,2020-07-01,2500,2373,127,5.1
20165,2020-07-01,1561,1472,89,5.7
20167,2020-07-01,3334,3153,181,5.4
20169,2020-07-01,30023,27985,2038,6.8
20171,2020-07-01,2819,2731,88,3.1
20173,2020-07-01,263441,234290,29151,11.1
20175,2020-07-01,9999,9457,542,5.4
20177,2020-07-01,94179,87771,6408,6.8
20179,2020-07-01,1472,1425,47,3.2
20181,2020-07-01,2947,2828,119,4
20183,2020-07-01,1935,1876,59,3
20185,2020-07-01,2011,1915,96,4.8
20187,2020-07-01,1046,1021,25,2.4
20189,2020-07-01,2749,2646,103,3.7
20191,2020-07-01,11328,10068,1260,11.1
20193,2020-07-01,4229,4076,153,3.6
20195,2020-07-01,1512,1454,58,3.8
20197,2020-07-01,3740,3565,175,4.7
20199,2020-07-01,816,796,20,2.5
20201,2020-07-01,3033,2946,87,2.9
20203,2020-07-01,1180,1152,28,2.4
20205,2020-07-01,3954,3592,362,9.2
20207,2020-07-01,1637,1510,127,7.8
20209,2020-07-01,81453,73296,8157,10
21001,2020-07-01,6707,6293,414,6.2
21003,2020-07-01,8585,8151,434,5.1
21005,2020-07-01,11462,10824,638,5.6
21007,2020-07-01,3362,3173,189,5.6
21009,2020-07-01,17840,16660,1180,6.6
21011,2020-07-01,4524,4213,311,6.9
21013,2020-07-01,8098,7513,585,7.2
21015,2020-07-01,69267,65738,3529,5.1
21017,2020-07-01,9615,9149,466,4.8
21019,2020-07-01,17056,15723,1333,7.8
21021,2020-07-01,12177,11344,833,6.8
21023,2020-07-01,3686,3491,195,5.3
21025,2020-07-01,3166,2853,313,9.9
21027,2020-07-01,7720,7274,446,5.8
21029,2020-07-01,40951,38828,2123,5.2
21031,2020-07-01,4744,4477,267,5.6
21033,2020-07-01,5474,5168,306,5.6
21035,2020-07-01,17411,16389,1022,5.9
21037,2020-07-01,49030,46426,2604,5.3
21039,2020-07-01,2156,2064,92,4.3
21041,2020-07-01,5268,4980,288,5.5
21043,2020-07-01,9329,8541,788,8.4
21045,2020-07-01,6672,6355,317,4.8
21047,2020-07-01,23845,22112,1733,7.3
21049,2020-07-01,16674,15649,1025,6.1
21051,2020-07-01,5011,4605,406,8.1
21053,2020-07-01,4020,3828,192,4.8
21055,2020-07-01,3604,3426,178,4.9
21057,2020-07-01,3215,3076,139,4.3
21059,2020-07-01,45554,43035,2519,5.5
21061,2020-07-01,4421,4135,286,6.5
21063,2020-07-01,1892,1731,161,8.5
21065,2020-07-01,5023,4677,346,6.9
21067,2020-07-01,169434,160023,9411,5.6
21069,2020-07-01,6127,5757,370,6
21071,2020-07-01,10447,9508,939,9
21073,2020-07-01,24176,22660,1516,6.3
21075,2020-07-01,1983,1849,134,6.8
21077,2020-07-01,3981,3765,216,5.4
21079,2020-07-01,7313,6895,418,5.7
21081,2020-07-01,11319,10630,689,6.1
21083,2020-07-01,15413,14569,844,5.5
21085,2020-07-01,10454,9753,701,6.7
21087,2020-07-01,4950,4729,221,4.5
21089,2020-07-01,12839,11821,1018,7.9
21091,2020-07-01,3764,3590,174,4.6
21093,2020-07-01,47055,44166,2889,6.1
21095,2020-07-01,6297,5548,749,11.9
21097,2020-07-01,8441,8027,414,4.9
21099,2020-07-01,7460,7085,375,5
21101,2020-07-01,20517,19461,1056,5.1
21103,2020-07-01,7956,7572,384,4.8
21105,2020-07-01,1727,1638,89,5.2
21107,2020-07-01,17979,16838,1141,6.3
21109,2020-07-01,3852,3561,291,7.6
21111,2020-07-01,383281,358285,24996,6.5
21113,2020-07-01,25621,24255,1366,5.3
21115,2020-07-01,6517,5986,531,8.1
21117,2020-07-01,85048,80372,4676,5.5
21119,2020-07-01,4168,3809,359,8.6
21121,2020-07-01,9756,8979,777,8
21123,2020-07-01,5740,5402,338,5.9
21125,2020-07-01,24216,22702,1514,6.3
21127,2020-07-01,5238,4858,380,7.3
21129,2020-07-01,2015,1886,129,6.4
21131,2020-07-01,2494,2240,254,10.2
21133,2020-07-01,5901,5290,611,10.4
21135,2020-07-01,4531,4180,351,7.7
21137,2020-07-01,9059,8394,665,7.3
21139,2020-07-01,3537,3309,228,6.4
21141,2020-07-01,11921,11352,569,4.8
21143,2020-07-01,3257,3117,140,4.3
21145,2020-07-01,28434,26640,1794,6.3
21147,2020-07-01,4651,4333,318,6.8
21149,2020-07-01,4040,3843,197,4.9
21151,2020-07-01,44144,41682,2462,5.6
21153,2020-07-01,3023,2580,443,14.7
21155,2020-07-01,9164,8650,514,5.6
21157,2020-07-01,14672,13907,765,5.2
21159,2020-07-01,2432,2156,276,11.3
21161,2020-07-01,6765,6301,464,6.9
21163,2020-07-01,11632,10938,694,6
21165,2020-07-01,2220,2058,162,7.3
21167,2020-07-01,9643,8965,678,7
21169,2020-07-01,3936,3692,244,6.2
21171,2020-07-01,4481,4278,203,4.5
21173,2020-07-01,11212,10446,766,6.8
21175,2020-07-01,4216,3949,267,6.3
21177,2020-07-01,9569,8764,805,8.4
21179,2020-07-01,22298,21006,1292,5.8
21181,2020-07-01,3191,2993,198,6.2
21183,2020-07-01,9170,8575,595,6.5
21185,2020-07-01,31774,30461,1313,4.1
21187,2020-07-01,4998,4719,279,5.6
21189,2020-07-01,1060,988,72,6.8
21191,2020-07-01,6696,6389,307,4.6
21193,2020-07-01,7800,7098,702,9
21195,2020-07-01,18684,17180,1504,8
21197,2020-07-01,5052,4706,346,6.8
21199,2020-07-01,25433,23670,1763,6.9
21201,2020-07-01,784,744,40,5.1
21203,2020-07-01,6174,5781,393,6.4
21205,2020-07-01,9646,9014,632,6.6
21207,2020-07-01,6061,5671,390,6.4
21209,2020-07-01,28567,27150,1417,5
21211,2020-07-01,24779,23631,1148,4.6
21213,2020-07-01,8378,7854,524,6.3
21215,2020-07-01,9977,9527,450,4.5
21217,2020-07-01,12495,11887,608,4.9
21219,2020-07-01,5350,5122,228,4.3
21221,2020-07-01,5891,5530,361,6.1
21223,2020-07-01,3704,3508,196,5.3
21225,2020-07-01,5965,5682,283,4.7
21227,2020-07-01,61032,57447,3585,5.9
21229,2020-07-01,6098,5815,283,4.6
21231,2020-07-01,7398,6948,450,6.1
21233,2020-07-01,5274,4977,297,5.6
21235,2020-07-01,13496,12585,911,6.8
21237,2020-07-01,1950,1813,137,7
21239,2020-07-01,14973,14303,670,4.5
22001,2020-07-01,22421,20461,1960,8.7
22003,2020-07-01,7701,6839,862,11.2
22005,2020-07-01,60576,55635,4941,8.2
22007,2020-07-01,8395,7386,1009,12
22009,2020-07-01,14383,13103,1280,8.9
22011,2020-07-01,13793,12744,1049,7.6
22013,2020-07-01,5199,4730,469,9
22015,2020-07-01,54280,50251,4029,7.4
22017,2020-07-01,99181,88392,10789,10.9
22019,2020-07-01,95115,85498,9617,10.1
22021,2020-07-01,3483,3201,282,8.1
22023,2020-07-01,3381,3171,210,6.2
22025,2020-07-01,3377,3097,280,8.3
22027,2020-07-01,5141,4777,364,7.1
22029,2020-07-01,6573,5903,670,10.2
22031,2020-07-01,10131,9291,840,8.3
22033,2020-07-01,217866,196528,21338,9.8
22035,2020-07-01,1695,1455,240,14.2
22037,2020-07-01,7352,6739,613,8.3
22039,2020-07-01,11223,10118,1105,9.8
22041,2020-07-01,7010,6331,679,9.7
22043,2020-07-01,7858,7291,567,7.2
22045,2020-07-01,27010,23882,3128,11.6
22047,2020-07-01,13247,11662,1585,12
22049,2020-07-01,6379,5980,399,6.3
22051,2020-07-01,201167,178134,23033,11.4
22053,2020-07-01,12353,11247,1106,9
22055,2020-07-01,109869,100320,9549,8.7
22057,2020-07-01,39576,36483,3093,7.8
22059,2020-07-01,6628,6254,374,5.6
22061,2020-07-01,19370,17873,1497,7.7
22063,2020-07-01,64497,59423,5074,7.9
22065,2020-07-01,3366,3043,323,9.6
22067,2020-07-01,9678,8621,1057,10.9
22069,2020-07-01,15067,13805,1262,8.4
22071,2020-07-01,174698,148404,26294,15.1
22073,2020-07-01,67469,61616,5853,8.7
22075,2020-07-01,9009,8251,758,8.4
22077,2020-07-01,9085,8218,867,9.5
22079,2020-07-01,53210,49353,3857,7.2
22081,2020-07-01,3398,3166,232,6.8
22083,2020-07-01,7823,7139,684,8.7
22085,2020-07-01,8738,8167,571,6.5
22087,2020-07-01,19043,16691,2352,12.4
22089,2020-07-01,23295,21070,2225,9.6
22091,2020-07-01,4144,3532,612,14.8
22093,2020-07-01,8534,7549,985,11.5
22095,2020-07-01,18540,16033,2507,13.5
22097,2020-07-01,31406,28251,3155,10
22099,2020-07-01,21232,19108,2124,10
22101,2020-07-01,18724,16667,2057,11
22103,2020-07-01,109820,100934,8886,8.1
22105,2020-07-01,54281,47861,6420,11.8
22107,2020-07-01,1253,1134,119,9.5
22109,2020-07-01,44105,40009,4096,9.3
22111,2020-07-01,8577,7865,712,8.3
22113,2020-07-01,22808,20828,1980,8.7
22115,2020-07-01,15248,13999,1249,8.2
22117,2020-07-01,15872,14318,1554,9.8
22119,2020-07-01,13487,12267,1220,9
22121,2020-07-01,12793,11662,1131,8.8
22123,2020-07-01,3384,3043,341,10.1
22125,2020-07-01,4931,4625,306,6.2
22127,2020-07-01,4448,4087,361,8.1
23001,2020-07-01,56047,50835,5212,9.3
23003,2020-07-01,30492,28110,2382,7.8
23005,2020-07-01,165950,151319,14631,8.8
23007,2020-07-01,14180,12787,1393,9.8
23009,2020-07-01,30634,28449,2185,7.1
23011,2020-07-01,63359,58634,4725,7.5
23013,2020-07-01,21130,19493,1637,7.7
23015,2020-07-01,17954,16626,1328,7.4
23017,2020-07-01,27199,24304,2895,10.6
23019,2020-07-01,75777,69592,6185,8.2
23021,2020-07-01,7527,6956,571,7.6
23023,2020-07-01,20051,18551,1500,7.5
23025,2020-07-01,23342,21216,2126,9.1
23027,2020-07-01,21005,19452,1553,7.4
23029,2020-07-01,14197,13042,1155,8.1
23031,2020-07-01,114599,104880,9719,8.5
24001,2020-07-01,30723,28020,2703,8.8
24003,2020-07-01,310437,286989,23448,7.6
24005,2020-07-01,447297,407689,39608,8.9
24009,2020-07-01,48228,44971,3257,6.8
24011,2020-07-01,17602,16458,1144,6.5
24013,2020-07-01,92884,86797,6087,6.6
24015,2020-07-01,52098,48293,3805,7.3
24017,2020-07-01,86265,78507,7758,9
24019,2020-07-01,16517,15247,1270,7.7
24021,2020-07-01,133434,123203,10231,7.7
24023,2020-07-01,15749,14609,1140,7.2
24025,2020-07-01,138251,127998,10253,7.4
24027,2020-07-01,184379,171714,12665,6.9
24029,2020-07-01,9779,8961,818,8.4
24031,2020-07-01,553262,505877,47385,8.6
24033,2020-07-01,508069,452473,55596,10.9
24035,2020-07-01,27134,25293,1841,6.8
24037,2020-07-01,57400,53714,3686,6.4
24039,2020-07-01,9285,8425,860,9.3
24041,2020-07-01,17985,16685,1300,7.2
24043,2020-07-01,73003,66980,6023,8.3
24045,2020-07-01,52311,48153,4158,7.9
24047,2020-07-01,25973,23422,2551,9.8
24510,2020-07-01,284442,251804,32638,11.5
25001,2020-07-01,114733,104035,10698,9.3
25003,2020-07-01,62275,56074,6201,10
25005,2020-07-01,287291,255375,31916,11.1
25007,2020-07-01,11892,11100,792,6.7
25009,2020-07-01,407979,361975,46004,11.3
25011,2020-07-01,38663,35457,3206,8.3
25013,2020-07-01,215612,190007,25605,11.9
25015,2020-07-01,83395,76526,6869,8.2
25017,2020-07-01,866228,793019,73209,8.5
25019,2020-07-01,9795,9248,547,5.6
25021,2020-07-01,373242,337377,35865,9.6
25023,2020-07-01,272091,243767,28324,10.4
25025,2020-07-01,443903,390700,53203,12
25027,2020-07-01,423454,380960,42494,10
26001,2020-07-01,3949,3617,332,8.4
26003,2020-07-01,3331,3063,268,8
26005,2020-07-01,62726,58648,4078,6.5
26007,2020-07-01,13054,12072,982,7.5
26009,2020-07-01,10945,10119,826,7.5
26011,2020-07-01,5981,5447,534,8.9
26013,2020-07-01,3202,2852,350,10.9
26015,2020-07-01,31207,29056,2151,6.9
26017,2020-07-01,49679,45659,4020,8.1
26019,2020-07-01,8939,8288,651,7.3
26021,2020-07-01,74242,67796,6446,8.7
26023,2020-07-01,20015,18524,1491,7.4
26025,2020-07-01,61634,55904,5730,9.3
26027,2020-07-01,24499,22401,2098,8.6
26029,2020-07-01,13505,12540,965,7.1
26031,2020-07-01,10977,10043,934,8.5
26033,2020-07-01,16148,14851,1297,8
26035,2020-07-01,11820,10635,1185,10
26037,2020-07-01,39013,36602,2411,6.2
26039,2020-07-01,5777,5256,521,9
26041,2020-07-01,17094,15870,1224,7.2
26043,2020-07-01,12383,11590,793,6.4
26045,2020-07-01,54235,50313,3922,7.2
26047,2020-07-01,18381,17016,1365,7.4
26049,2020-07-01,179117,160500,18617,10.4
26051,2020-07-01,10082,9231,851,8.4
26053,2020-07-01,5796,5368,428,7.4
26055,2020-07-01,51090,47370,3720,7.3
26057,2020-07-01,17890,16635,1255,7
26059,2020-07-01,20401,18866,1535,7.5
26061,2020-07-01,15557,14360,1197,7.7
26063,2020-07-01,15939,14840,1099,6.9
26065,2020-07-01,143174,132046,11128,7.8
26067,2020-07-01,30517,28471,2046,6.7
26069,2020-07-01,10376,9475,901,8.7
26071,2020-07-01,5102,4739,363,7.1
26073,2020-07-01,33248,30692,2556,7.7
26075,2020-07-01,72917,66465,6452,8.8
26077,2020-07-01,131642,121555,10087,7.7
26079,2020-07-01,8171,7421,750,9.2
26081,2020-07-01,356076,328811,27265,7.7
26083,2020-07-01,863,787,76,8.8
26085,2020-07-01,4099,3703,396,9.7
26087,2020-07-01,39848,35756,4092,10.3
26089,2020-07-01,10707,10017,690,6.4
26091,2020-07-01,45090,41560,3530,7.8
26093,2020-07-01,100458,92260,8198,8.2
26095,2020-07-01,2369,2199,170,7.2
26097,2020-07-01,6023,5712,311,5.2
26099,2020-07-01,442237,392196,50041,11.3
26101,2020-07-01,10564,9589,975,9.2
26103,2020-07-01,31402,29069,2333,7.4
26105,2020-07-01,14060,12978,1082,7.7
26107,2020-07-01,17933,16476,1457,8.1
26109,2020-07-01,10867,10224,643,5.9
26111,2020-07-01,39942,37223,2719,6.8
26113,2020-07-01,7070,6507,563,8
26115,2020-07-01,73584,67793,5791,7.9
26117,2020-07-01,28085,25730,2355,8.4
26119,2020-07-01,2902,2548,354,12.2
26121,2020-07-01,78164,69452,8712,11.1
26123,2020-07-01,23235,21420,1815,7.8
26125,2020-07-01,658874,597045,61829,9.4
26127,2020-07-01,12760,11651,1109,8.7
26129,2020-07-01,8326,7600,726,8.7
26131,2020-07-01,2080,1894,186,8.9
26133,2020-07-01,11707,10905,802,6.9
26135,2020-07-01,2975,2670,305,10.3
26137,2020-07-01,12002,10980,1022,8.5
26139,2020-07-01,158289,147941,10348,6.5
26141,2020-07-01,5101,4677,424,8.3
26143,2020-07-01,8281,7493,788,9.5
26145,2020-07-01,84575,76786,7789,9.2
26147,2020-07-01,73638,66085,7553,10.3
26149,2020-07-01,29976,27609,2367,7.9
26151,2020-07-01,19866,18315,1551,7.8
26153,2020-07-01,3247,2978,269,8.3
26155,2020-07-01,32268,29714,2554,7.9
26157,2020-07-01,23580,21569,2011,8.5
26159,2020-07-01,34792,32122,2670,7.7
26161,2020-07-01,190919,177282,13637,7.1
26163,2020-07-01,805556,691952,113604,14.1
26165,2020-07-01,15004,13628,1376,9.2
27001,2020-07-01,7655,7101,554,7.2
27003,2020-07-01,202403,186041,16362,8.1
27005,2020-07-01,19353,18215,1138,5.9
27007,2020-07-01,25432,23742,1690,6.6
27009,2020-07-01,22105,20610,1495,6.8
27011,2020-07-01,2660,2572,88,3.3
27013,2020-07-01,39804,37094,2710,6.8
27015,2020-07-01,14610,13891,719,4.9
27017,2020-07-01,17646,16243,1403,8
27019,2020-07-01,59857,55963,3894,6.5
27021,2020-07-01,15163,13828,1335,8.8
27023,2020-07-01,6796,6452,344,5.1
27025,2020-07-01,30414,28284,2130,7
27027,2020-07-01,36546,34730,1816,5
27029,2020-07-01,4514,4209,305,6.8
27031,2020-07-01,3224,2986,238,7.4
27033,2020-07-01,5975,5625,350,5.9
27035,2020-07-01,33325,31010,2315,6.9
27037,2020-07-01,247304,227695,19609,7.9
27039,2020-07-01,12403,11684,719,5.8
27041,2020-07-01,22263,21253,1010,4.5
27043,2020-07-01,7570,7114,456,6
27045,2020-07-01,12122,11492,630,5.2
27047,2020-07-01,16671,15580,1091,6.5
27049,2020-07-01,27324,25555,1769,6.5
27051,2020-07-01,3403,3229,174,5.1
27053,2020-07-01,731468,665390,66078,9
27055,2020-07-01,10461,9999,462,4.4
27057,2020-07-01,10594,9964,630,5.9
27059,2020-07-01,21613,20065,1548,7.2
27061,2020-07-01,22731,20759,1972,8.7
27063,2020-07-01,5831,5463,368,6.3
27065,2020-07-01,9022,8415,607,6.7
27067,2020-07-01,25424,24233,1191,4.7
27069,2020-07-01,2489,2381,108,4.3
27071,2020-07-01,5998,5549,449,7.5
27073,2020-07-01,3548,3386,162,4.6
27075,2020-07-01,5591,5060,531,9.5
27077,2020-07-01,2529,2369,160,6.3
27079,2020-07-01,16343,15297,1046,6.4
27081,2020-07-01,3280,3157,123,3.8
27083,2020-07-01,14496,13778,718,5
27085,2020-07-01,19620,18419,1201,6.1
27087,2020-07-01,2224,1869,355,16
27089,2020-07-01,5540,5281,259,4.7
27091,2020-07-01,10609,9947,662,6.2
27093,2020-07-01,13503,12881,622,4.6
27095,2020-07-01,12989,11941,1048,8.1
27097,2020-07-01,18201,17203,998,5.5
27099,2020-07-01,21160,19919,1241,5.9
27101,2020-07-01,4990,4775,215,4.3
27103,2020-07-01,20585,19310,1275,6.2
27105,2020-07-01,11984,11416,568,4.7
27107,2020-07-01,3470,3251,219,6.3
27109,2020-07-01,93660,87159,6501,6.9
27111,2020-07-01,33201,31622,1579,4.8
27113,2020-07-01,8710,8291,419,4.8
27115,2020-07-01,14792,13595,1197,8.1
27117,2020-07-01,4920,4753,167,3.4
27119,2020-07-01,16448,15390,1058,6.4
27121,2020-07-01,6886,6566,320,4.6
27123,2020-07-01,298787,270745,28042,9.4
27125,2020-07-01,2226,2113,113,5.1
27127,2020-07-01,8131,7695,436,5.4
27129,2020-07-01,8836,8367,469,5.3
27131,2020-07-01,37687,35362,2325,6.2
27133,2020-07-01,6064,5853,211,3.5
27135,2020-07-01,7955,7458,497,6.2
27137,2020-07-01,101160,92424,8736,8.6
27139,2020-07-01,85283,79107,6176,7.2
27141,2020-07-01,52888,49391,3497,6.6
27143,2020-07-01,8688,8192,496,5.7
27145,2020-07-01,91657,85815,5842,6.4
27147,2020-07-01,20473,19156,1317,6.4
27149,2020-07-01,5636,5462,174,3.1
27151,2020-07-01,5148,4839,309,6
27153,2020-07-01,14066,13389,677,4.8
27155,2020-07-01,1852,1773,79,4.3
27157,2020-07-01,12919,12198,721,5.6
27159,2020-07-01,6053,5650,403,6.7
27161,2020-07-01,9397,8757,640,6.8
27163,2020-07-01,146184,135766,10418,7.1
27165,2020-07-01,6869,6515,354,5.2
27167,2020-07-01,3566,3407,159,4.5
27169,2020-07-01,28735,26990,1745,6.1
27171,2020-07-01,76731,71943,4788,6.2
27173,2020-07-01,5458,5215,243,4.5
28001,2020-07-01,10653,9280,1373,12.9
28003,2020-07-01,15379,14270,1109,7.2
28005,2020-07-01,4485,4065,420,9.4
28007,2020-07-01,6825,6132,693,10.2
28009,2020-07-01,2970,2665,305,10.3
28011,2020-07-01,11562,10342,1220,10.6
28013,2020-07-01,5760,5240,520,9
28015,2020-07-01,3465,3160,305,8.8
28017,2020-07-01,7139,6247,892,12.5
28019,2020-07-01,3627,3343,284,7.8
28021,2020-07-01,3179,2616,563,17.7
28023,2020-07-01,5860,5280,580,9.9
28025,2020-07-01,8142,7043,1099,13.5
28027,2020-07-01,8473,7179,1294,15.3
28029,2020-07-01,10892,9804,1088,10
28031,2020-07-01,8565,7835,730,8.5
28033,2020-07-01,89137,82511,6626,7.4
28035,2020-07-01,32938,29624,3314,10.1
28037,2020-07-01,2814,2551,263,9.3
28039,2020-07-01,9143,8224,919,10.1
28041,2020-07-01,4388,3907,481,11
28043,2020-07-01,9402,8515,887,9.4
28045,2020-07-01,18779,17056,1723,9.2
28047,2020-07-01,87922,78956,8966,10.2
28049,2020-07-01,105905,93659,12246,11.6
28051,2020-07-01,5416,4384,1032,19.1
28053,2020-07-01,2328,1894,434,18.6
28055,2020-07-01,339,309,30,8.8
28057,2020-07-01,10329,9558,771,7.5
28059,2020-07-01,58924,52747,6177,10.5
28061,2020-07-01,6147,5519,628,10.2
28063,2020-07-01,2026,1581,445,22
28065,2020-07-01,4037,3571,466,11.5
28067,2020-07-01,25929,23620,2309,8.9
28069,2020-07-01,3466,3065,401,11.6
28071,2020-07-01,25527,23480,2047,8
28073,2020-07-01,30152,28021,2131,7.1
28075,2020-07-01,29657,26950,2707,9.1
28077,2020-07-01,4701,4237,464,9.9
28079,2020-07-01,8206,7409,797,9.7
28081,2020-07-01,41636,37639,3997,9.6
28083,2020-07-01,10018,8701,1317,13.1
28085,2020-07-01,14675,13445,1230,8.4
28087,2020-07-01,24951,22305,2646,10.6
28089,2020-07-01,52239,48425,3814,7.3
28091,2020-07-01,10295,9444,851,8.3
28093,2020-07-01,14062,12685,1377,9.8
28095,2020-07-01,15739,14105,1634,10.4
28097,2020-07-01,3963,3593,370,9.3
28099,2020-07-01,10946,9496,1450,13.2
28101,2020-07-01,7990,7206,784,9.8
28103,2020-07-01,3995,3417,578,14.5
28105,2020-07-01,21648,19538,2110,9.7
28107,2020-07-01,13008,11350,1658,12.7
28109,2020-07-01,23125,21191,1934,8.4
28111,2020-07-01,4214,3795,419,9.9
28113,2020-07-01,14860,13235,1625,10.9
28115,2020-07-01,14955,13644,1311,8.8
28117,2020-07-01,11303,10432,871,7.7
28119,2020-07-01,2385,2083,302,12.7
28121,2020-07-01,74104,69708,4396,5.9
28123,2020-07-01,12787,11939,848,6.6
28125,2020-07-01,1517,1338,179,11.8
28127,2020-07-01,10498,9657,841,8
28129,2020-07-01,6661,6240,421,6.3
28131,2020-07-01,6962,6375,587,8.4
28133,2020-07-01,7655,6612,1043,13.6
28135,2020-07-01,5253,4783,470,8.9
28137,2020-07-01,11939,10783,1156,9.7
28139,2020-07-01,9407,8661,746,7.9
28141,2020-07-01,8433,7827,606,7.2
28143,2020-07-01,4629,3823,806,17.4
28145,2020-07-01,14164,13026,1138,8
28147,2020-07-01,4978,4475,503,10.1
28149,2020-07-01,20237,18128,2109,10.4
28151,2020-07-01,16383,14126,2257,13.8
28153,2020-07-01,7691,6871,820,10.7
28155,2020-07-01,3886,3517,369,9.5
28157,2020-07-01,2689,2281,408,15.2
28159,2020-07-01,7502,6716,786,10.5
28161,2020-07-01,4873,4434,439,9
28163,2020-07-01,10025,8887,1138,11.4
29001,2020-07-01,10114,9381,733,7.2
29003,2020-07-01,10020,9521,499,5
29005,2020-07-01,2610,2474,136,5.2
29007,2020-07-01,10340,9651,689,6.7
29009,2020-07-01,15693,14406,1287,8.2
29011,2020-07-01,5153,4863,290,5.6
29013,2020-07-01,7838,7342,496,6.3
29015,2020-07-01,7242,6617,625,8.6
29017,2020-07-01,5402,5058,344,6.4
29019,2020-07-01,98359,93319,5040,5.1
29021,2020-07-01,45181,42592,2589,5.7
29023,2020-07-01,18352,17113,1239,6.8
29025,2020-07-01,4348,4088,260,6
29027,2020-07-01,22143,20947,1196,5.4
29029,2020-07-01,20930,19672,1258,6
29031,2020-07-01,40526,38165,2361,5.8
29033,2020-07-01,4487,4193,294,6.6
29035,2020-07-01,2569,2376,193,7.5
29037,2020-07-01,55867,52396,3471,6.2
29039,2020-07-01,5626,5308,318,5.7
29041,2020-07-01,3696,3500,196,5.3
29043,2020-07-01,46679,44042,2637,5.6
29045,2020-07-01,3055,2864,191,6.3
29047,2020-07-01,141303,131422,9881,7
29049,2020-07-01,10847,10119,728,6.7
29051,2020-07-01,40847,38519,2328,5.7
29053,2020-07-01,7169,6690,479,6.7
29055,2020-07-01,11129,10267,862,7.7
29057,2020-07-01,3469,3271,198,5.7
29059,2020-07-01,7244,6712,532,7.3
29061,2020-07-01,3970,3794,176,4.4
29063,2020-07-01,4865,4630,235,4.8
29065,2020-07-01,6375,6040,335,5.3
29067,2020-07-01,5022,4700,322,6.4
29069,2020-07-01,11258,10267,991,8.8
29071,2020-07-01,54241,50284,3957,7.3
29073,2020-07-01,7702,7073,629,8.2
29075,2020-07-01,3246,3096,150,4.6
29077,2020-07-01,156370,146157,10213,6.5
29079,2020-07-01,4135,3927,208,5
29081,2020-07-01,3817,3607,210,5.5
29083,2020-07-01,9843,9094,749,7.6
29085,2020-07-01,4079,3875,204,5
29087,2020-07-01,2555,2441,114,4.5
29089,2020-07-01,4755,4498,257,5.4
29091,2020-07-01,16151,14794,1357,8.4
29093,2020-07-01,3476,3180,296,8.5
29095,2020-07-01,375584,343128,32456,8.6
29097,2020-07-01,57551,53804,3747,6.5
29099,2020-07-01,120489,111877,8612,7.1
29101,2020-07-01,23099,21529,1570,6.8
29103,2020-07-01,1681,1591,90,5.4
29105,2020-07-01,17048,15256,1792,10.5
29107,2020-07-01,16993,15977,1016,6
29109,2020-07-01,17744,16351,1393,7.9
29111,2020-07-01,4983,4651,332,6.7
29113,2020-07-01,29326,27371,1955,6.7
29115,2020-07-01,5117,4700,417,8.1
29117,2020-07-01,7471,7137,334,4.5
29119,2020-07-01,10725,10086,639,6
29121,2020-07-01,7513,7026,487,6.5
29123,2020-07-01,5540,5083,457,8.2
29125,2020-07-01,3889,3628,261,6.7
29127,2020-07-01,14684,13796,888,6
29129,2020-07-01,1754,1676,78,4.4
29131,2020-07-01,12921,12222,699,5.4
29133,2020-07-01,5653,5266,387,6.8
29135,2020-07-01,7546,7160,386,5.1
29137,2020-07-01,3782,3489,293,7.7
29139,2020-07-01,5749,5396,353,6.1
29141,2020-07-01,8367,7917,450,5.4
29143,2020-07-01,8457,7888,569,6.7
29145,2020-07-01,27369,25487,1882,6.9
29147,2020-07-01,10635,10126,509,4.8
29149,2020-07-01,3761,3450,311,8.3
29151,2020-07-01,7330,6953,377,5.1
29153,2020-07-01,3366,3117,249,7.4
29155,2020-07-01,6275,5659,616,9.8
29157,2020-07-01,9888,9401,487,4.9
29159,2020-07-01,20840,19070,1770,8.5
29161,2020-07-01,20032,18920,1112,5.6
29163,2020-07-01,7527,7070,457,6.1
29165,2020-07-01,60705,56645,4060,6.7
29167,2020-07-01,14722,13884,838,5.7
29169,2020-07-01,14538,13510,1028,7.1
29171,2020-07-01,2224,2084,140,6.3
29173,2020-07-01,5747,5424,323,5.6
29175,2020-07-01,10378,9647,731,7
29177,2020-07-01,11260,10439,821,7.3
29179,2020-07-01,2876,2696,180,6.3
29181,2020-07-01,4968,4477,491,9.9
29183,2020-07-01,230653,216832,13821,6
29185,2020-07-01,3739,3438,301,8.1
29186,2020-07-01,9472,8970,502,5.3
29187,2020-07-01,26888,24546,2342,8.7
29189,2020-07-01,544611,501670,42941,7.9
29195,2020-07-01,10460,9660,800,7.6
29197,2020-07-01,1994,1789,205,10.3
29199,2020-07-01,2439,2346,93,3.8
29201,2020-07-01,19965,18738,1227,6.1
29203,2020-07-01,3359,3072,287,8.5
29205,2020-07-01,2975,2805,170,5.7
29207,2020-07-01,13224,12431,793,6
29209,2020-07-01,14138,12935,1203,8.5
29211,2020-07-01,2697,2578,119,4.4
29213,2020-07-01,28207,25106,3101,11
29215,2020-07-01,8564,7938,626,7.3
29217,2020-07-01,9148,8656,492,5.4
29219,2020-07-01,18669,17439,1230,6.6
29221,2020-07-01,10182,9361,821,8.1
29223,2020-07-01,4983,4636,347,7
29225,2020-07-01,17818,16670,1148,6.4
29227,2020-07-01,1103,1046,57,5.2
29229,2020-07-01,7028,6455,573,8.2
29510,2020-07-01,159927,142118,17809,11.1
30001,2020-07-01,5038,4833,205,4.1
30003,2020-07-01,4788,4422,366,7.6
30005,2020-07-01,2145,2028,117,5.5
30007,2020-07-01,2663,2490,173,6.5
30009,2020-07-01,5641,5303,338,6
30011,2020-07-01,581,560,21,3.6
30013,2020-07-01,37932,35418,2514,6.6
30015,2020-07-01,2295,2198,97,4.2
30017,2020-07-01,6377,6026,351,5.5
30019,2020-07-01,874,849,25,2.9
30021,2020-07-01,4876,4504,372,7.6
30023,2020-07-01,5199,4921,278,5.3
30025,2020-07-01,1613,1523,90,5.6
30027,2020-07-01,5982,5737,245,4.1
30029,2020-07-01,52123,48334,3789,7.3
30031,2020-07-01,73749,69989,3760,5.1
30033,2020-07-01,674,658,16,2.4
30035,2020-07-01,5495,4855,640,11.6
30037,2020-07-01,356,342,14,3.9
30039,2020-07-01,1612,1505,107,6.6
30041,2020-07-01,7684,7226,458,6
30043,2020-07-01,5988,5661,327,5.5
30045,2020-07-01,860,814,46,5.3
30047,2020-07-01,13853,12872,981,7.1
30049,2020-07-01,38037,36019,2018,5.3
30051,2020-07-01,904,877,27,3
30053,2020-07-01,8245,7468,777,9.4
30055,2020-07-01,908,870,38,4.2
30057,2020-07-01,4499,4283,216,4.8
30059,2020-07-01,960,915,45,4.7
30061,2020-07-01,1892,1726,166,8.8
30063,2020-07-01,64614,60195,4419,6.8
30065,2020-07-01,2304,2157,147,6.4
30067,2020-07-01,9414,8723,691,7.3
30069,2020-07-01,246,238,8,3.3
30071,2020-07-01,1814,1719,95,5.2
30073,2020-07-01,2588,2437,151,5.8
30075,2020-07-01,928,900,28,3
30077,2020-07-01,3063,2935,128,4.2
30079,2020-07-01,465,424,41,8.8
30081,2020-07-01,20811,19600,1211,5.8
30083,2020-07-01,5977,5445,532,8.9
30085,2020-07-01,4339,4010,329,7.6
30087,2020-07-01,3657,3432,225,6.2
30089,2020-07-01,5143,4762,381,7.4
30091,2020-07-01,1719,1621,98,5.7
30093,2020-07-01,17943,16683,1260,7
30095,2020-07-01,5343,5030,313,5.9
30097,2020-07-01,1887,1818,69,3.7
30099,2020-07-01,2661,2542,119,4.5
30101,2020-07-01,2193,2060,133,6.1
30103,2020-07-01,306,292,14,4.6
30105,2020-07-01,4158,3980,178,4.3
30107,2020-07-01,701,645,56,8
30109,2020-07-01,466,438,28,6
30111,2020-07-01,86103,80903,5200,6
31001,2020-07-01,17139,16425,714,4.2
31003,2020-07-01,3886,3808,78,2
31005,2020-07-01,225,210,15,6.7
31007,2020-07-01,359,350,9,2.5
31009,2020-07-01,239,232,7,2.9
31011,2020-07-01,2893,2824,69,2.4
31013,2020-07-01,5470,5163,307,5.6
31015,2020-07-01,1016,988,28,2.8
31017,2020-07-01,1408,1379,29,2.1
31019,2020-07-01,27282,26221,1061,3.9
31021,2020-07-01,3515,3391,124,3.5
31023,2020-07-01,4520,4359,161,3.6
31025,2020-07-01,13552,12907,645,4.8
31027,2020-07-01,4535,4430,105,2.3
31029,2020-07-01,2229,2195,34,1.5
31031,2020-07-01,3352,3274,78,2.3
31033,2020-07-01,4229,4032,197,4.7
31035,2020-07-01,3274,3172,102,3.1
31037,2020-07-01,5636,5446,190,3.4
31039,2020-07-01,4823,4710,113,2.3
31041,2020-07-01,6313,6021,292,4.6
31043,2020-07-01,10697,10137,560,5.2
31045,2020-07-01,4930,4766,164,3.3
31047,2020-07-01,13363,12832,531,4
31049,2020-07-01,959,932,27,2.8
31051,2020-07-01,2901,2811,90,3.1
31053,2020-07-01,20176,19408,768,3.8
31055,2020-07-01,305599,287089,18510,6.1
31057,2020-07-01,1119,1097,22,2
31059,2020-07-01,3171,3074,97,3.1
31061,2020-07-01,1442,1386,56,3.9
31063,2020-07-01,1476,1433,43,2.9
31065,2020-07-01,2565,2495,70,2.7
31067,2020-07-01,10919,10475,444,4.1
31069,2020-07-01,1056,1020,36,3.4
31071,2020-07-01,1168,1149,19,1.6
31073,2020-07-01,1156,1127,29,2.5
31075,2020-07-01,375,368,7,1.9
31077,2020-07-01,1190,1157,33,2.8
31079,2020-07-01,32225,30368,1857,5.8
31081,2020-07-01,4720,4558,162,3.4
31083,2020-07-01,1751,1701,50,2.9
31085,2020-07-01,593,580,13,2.2
31087,2020-07-01,1288,1243,45,3.5
31089,2020-07-01,5679,5534,145,2.6
31091,2020-07-01,455,446,9,2
31093,2020-07-01,3275,3176,99,3
31095,2020-07-01,4227,4101,126,3
31097,2020-07-01,2069,1987,82,4
31099,2020-07-01,3721,3586,135,3.6
31101,2020-07-01,4698,4558,140,3
31103,2020-07-01,549,541,8,1.5
31105,2020-07-01,1998,1912,86,4.3
31107,2020-07-01,4706,4589,117,2.5
31109,2020-07-01,177674,168961,8713,4.9
31111,2020-07-01,18797,17996,801,4.3
31113,2020-07-01,452,442,10,2.2
31115,2020-07-01,403,391,12,3
31117,2020-07-01,441,428,13,2.9
31119,2020-07-01,19684,18904,780,4
31121,2020-07-01,3956,3820,136,3.4
31123,2020-07-01,2602,2511,91,3.5
31125,2020-07-01,1945,1882,63,3.2
31127,2020-07-01,3608,3443,165,4.6
31129,2020-07-01,2406,2341,65,2.7
31131,2020-07-01,8466,8148,318,3.8
31133,2020-07-01,1458,1415,43,2.9
31135,2020-07-01,1830,1801,29,1.6
31137,2020-07-01,4951,4789,162,3.3
31139,2020-07-01,4128,4024,104,2.5
31141,2020-07-01,17944,17217,727,4.1
31143,2020-07-01,2841,2762,79,2.8
31145,2020-07-01,5873,5676,197,3.4
31147,2020-07-01,4210,4059,151,3.6
31149,2020-07-01,852,839,13,1.5
31151,2020-07-01,7166,6875,291,4.1
31153,2020-07-01,97931,93546,4385,4.5
31155,2020-07-01,11206,10775,431,3.8
31157,2020-07-01,18239,17403,836,4.6
31159,2020-07-01,8751,8391,360,4.1
31161,2020-07-01,2649,2581,68,2.6
31163,2020-07-01,1659,1608,51,3.1
31165,2020-07-01,730,717,13,1.8
31167,2020-07-01,3497,3398,99,2.8
31169,2020-07-01,2776,2674,102,3.7
31171,2020-07-01,393,375,18,4.6
31173,2020-07-01,3131,2936,195,6.2
31175,2020-07-01,2145,2089,56,2.6
31177,2020-07-01,11166,10755,411,3.7
31179,2020-07-01,5221,5074,147,2.8
31181,2020-07-01,1640,1577,63,3.8
31183,2020-07-01,508,498,10,2
31185,2020-07-01,7421,7169,252,3.4
32001,2020-07-01,10799,10075,724,6.7
32003,2020-07-01,NA,898606,218572,19.6
32005,2020-07-01,22160,19959,2201,9.9
32007,2020-07-01,26381,24856,1525,5.8
32009,2020-07-01,353,334,19,5.4
32011,2020-07-01,948,903,45,4.7
32013,2020-07-01,7609,7151,458,6
32015,2020-07-01,3063,2897,166,5.4
32017,2020-07-01,1906,1793,113,5.9
32019,2020-07-01,22488,20261,2227,9.9
32021,2020-07-01,2040,1903,137,6.7
32023,2020-07-01,17203,15174,2029,11.8
32027,2020-07-01,2351,2227,124,5.3
32029,2020-07-01,1996,1795,201,10.1
32031,2020-07-01,247656,223893,23763,9.6
32033,2020-07-01,4517,4308,209,4.6
32510,2020-07-01,25775,23325,2450,9.5
33001,2020-07-01,32209,29704,2505,7.8
33003,2020-07-01,24390,22352,2038,8.4
33005,2020-07-01,40030,36945,3085,7.7
33007,2020-07-01,14776,13463,1313,8.9
33009,2020-07-01,48866,45396,3470,7.1
33011,2020-07-01,240502,219733,20769,8.6
33013,2020-07-01,83184,77288,5896,7.1
33015,2020-07-01,188969,172874,16095,8.5
33017,2020-07-01,74090,68170,5920,8
33019,2020-07-01,23323,21798,1525,6.5
34001,2020-07-01,128333,98643,29690,23.1
34003,2020-07-01,490935,423224,67711,13.8
34005,2020-07-01,237905,210559,27346,11.5
34007,2020-07-01,265528,229185,36343,13.7
34009,2020-07-01,54653,47735,6918,12.7
34011,2020-07-01,67079,57557,9522,14.2
34013,2020-07-01,390977,326966,64011,16.4
34015,2020-07-01,155935,136334,19601,12.6
34017,2020-07-01,372908,315579,57329,15.4
34019,2020-07-01,64476,57958,6518,10.1
34021,2020-07-01,213005,190584,22421,10.5
34023,2020-07-01,453622,397722,55900,12.3
34025,2020-07-01,339240,298209,41031,12.1
34027,2020-07-01,258771,230566,28205,10.9
34029,2020-07-01,287621,251685,35936,12.5
34031,2020-07-01,254195,209731,44464,17.5
34033,2020-07-01,30652,26781,3871,12.6
34035,2020-07-01,172213,153232,18981,11
34037,2020-07-01,75670,66107,9563,12.6
34039,2020-07-01,285797,246350,39447,13.8
34041,2020-07-01,57518,50929,6589,11.5
35001,2020-07-01,332342,289488,42854,12.9
35003,2020-07-01,1211,1082,129,10.7
35005,2020-07-01,28392,24677,3715,13.1
35006,2020-07-01,9139,7862,1277,14
35007,2020-07-01,5175,4593,582,11.2
35009,2020-07-01,21858,19889,1969,9
35011,2020-07-01,692,638,54,7.8
35013,2020-07-01,96772,84387,12385,12.8
35015,2020-07-01,32566,28670,3896,12
35017,2020-07-01,11685,9825,1860,15.9
35019,2020-07-01,1499,1347,152,10.1
35021,2020-07-01,269,249,20,7.4
35023,2020-07-01,1972,1782,190,9.6
35025,2020-07-01,29473,23768,5705,19.4
35027,2020-07-01,9013,7854,1159,12.9
35028,2020-07-01,9850,9247,603,6.1
35029,2020-07-01,11086,8879,2207,19.9
35031,2020-07-01,23853,19986,3867,16.2
35033,2020-07-01,2077,1835,242,11.7
35035,2020-07-01,25660,22408,3252,12.7
35037,2020-07-01,3089,2714,375,12.1
35039,2020-07-01,16893,14730,2163,12.8
35041,2020-07-01,7692,6881,811,10.5
35043,2020-07-01,66963,57811,9152,13.7
35045,2020-07-01,51270,43338,7932,15.5
35047,2020-07-01,10365,8988,1377,13.3
35049,2020-07-01,72035,62198,9837,13.7
35051,2020-07-01,4204,3641,563,13.4
35053,2020-07-01,6132,5426,706,11.5
35055,2020-07-01,15119,12398,2721,18
35057,2020-07-01,5393,4606,787,14.6
35059,2020-07-01,1689,1555,134,7.9
35061,2020-07-01,30397,26455,3942,13
36001,2020-07-01,163158,145801,17357,10.6
36003,2020-07-01,18557,16469,2088,11.3
36005,2020-07-01,599524,456691,142833,23.8
36007,2020-07-01,84525,74388,10137,12
36009,2020-07-01,33097,28998,4099,12.4
36011,2020-07-01,36444,32444,4000,11
36013,2020-07-01,53691,47451,6240,11.6
36015,2020-07-01,36293,31983,4310,11.9
36017,2020-07-01,21704,19677,2027,9.3
36019,2020-07-01,35214,31395,3819,10.8
36021,2020-07-01,30809,28020,2789,9.1
36023,2020-07-01,22132,19742,2390,10.8
36025,2020-07-01,18645,16798,1847,9.9
36027,2020-07-01,146545,129871,16674,11.4
36029,2020-07-01,453102,393685,59417,13.1
36031,2020-07-01,16949,15273,1676,9.9
36033,2020-07-01,19048,16798,2250,11.8
36035,2020-07-01,22779,20089,2690,11.8
36037,2020-07-01,29625,26787,2838,9.6
36039,2020-07-01,20697,18236,2461,11.9
36041,2020-07-01,2351,2178,173,7.4
36043,2020-07-01,28046,25244,2802,10
36045,2020-07-01,45061,40225,4836,10.7
36047,2020-07-01,NA,929911,221844,19.3
36049,2020-07-01,11167,10171,996,8.9
36051,2020-07-01,30190,27390,2800,9.3
36053,2020-07-01,33529,29988,3541,10.6
36055,2020-07-01,369834,323670,46164,12.5
36057,2020-07-01,22479,19746,2733,12.2
36059,2020-07-01,732557,638593,93964,12.8
36061,2020-07-01,842632,718240,124392,14.8
36063,2020-07-01,100747,87090,13657,13.6
36065,2020-07-01,104283,92465,11818,11.3
36067,2020-07-01,229591,202289,27302,11.9
36069,2020-07-01,55316,49774,5542,10
36071,2020-07-01,189775,166241,23534,12.4
36073,2020-07-01,17555,15528,2027,11.5
36075,2020-07-01,53915,47629,6286,11.7
36077,2020-07-01,26448,23794,2654,10
36079,2020-07-01,51522,45817,5705,11.1
36081,2020-07-01,NA,887669,210323,19.2
36083,2020-07-01,83402,75058,8344,10
36085,2020-07-01,207127,174004,33123,16
36087,2020-07-01,159177,139130,20047,12.6
36089,2020-07-01,42304,37407,4897,11.6
36091,2020-07-01,122457,110915,11542,9.4
36093,2020-07-01,80257,70621,9636,12
36095,2020-07-01,14857,13421,1436,9.7
36097,2020-07-01,8327,7463,864,10.4
36099,2020-07-01,15492,13762,1730,11.2
36101,2020-07-01,42237,37677,4560,10.8
36103,2020-07-01,797029,698026,99003,12.4
36105,2020-07-01,37272,32241,5031,13.5
36107,2020-07-01,22687,20304,2383,10.5
36109,2020-07-01,48449,43953,4496,9.3
36111,2020-07-01,89056,78637,10419,11.7
36113,2020-07-01,32557,29238,3319,10.2
36115,2020-07-01,28902,26191,2711,9.4
36117,2020-07-01,43665,39243,4422,10.1
36119,2020-07-01,497987,433482,64505,13
36121,2020-07-01,18201,16551,1650,9.1
36123,2020-07-01,11700,10711,989,8.5
37001,2020-07-01,80927,73490,7437,9.2
37003,2020-07-01,17685,16175,1510,8.5
37005,2020-07-01,4178,3850,328,7.9
37007,2020-07-01,10351,9246,1105,10.7
37009,2020-07-01,12402,11465,937,7.6
37011,2020-07-01,7533,6968,565,7.5
37013,2020-07-01,19504,17965,1539,7.9
37015,2020-07-01,7544,6976,568,7.5
37017,2020-07-01,14609,13314,1295,8.9
37019,2020-07-01,54914,49571,5343,9.7
37021,2020-07-01,136709,122142,14567,10.7
37023,2020-07-01,39963,36614,3349,8.4
37025,2020-07-01,109438,99701,9737,8.9
37027,2020-07-01,36110,32585,3525,9.8
37029,2020-07-01,4550,4258,292,6.4
37031,2020-07-01,32308,30139,2169,6.7
37033,2020-07-01,9496,8624,872,9.2
37035,2020-07-01,78240,70934,7306,9.3
37037,2020-07-01,34819,32427,2392,6.9
37039,2020-07-01,10977,9896,1081,9.8
37041,2020-07-01,5458,5034,424,7.8
37043,2020-07-01,4110,3743,367,8.9
37045,2020-07-01,48330,43638,4692,9.7
37047,2020-07-01,23076,20777,2299,10
37049,2020-07-01,41305,38051,3254,7.9
37051,2020-07-01,127075,111701,15374,12.1
37053,2020-07-01,13924,12977,947,6.8
37055,2020-07-01,22136,20352,1784,8.1
37057,2020-07-01,79072,72134,6938,8.8
37059,2020-07-01,20063,18390,1673,8.3
37061,2020-07-01,24365,22668,1697,7
37063,2020-07-01,170267,155226,15041,8.8
37065,2020-07-01,20958,18005,2953,14.1
37067,2020-07-01,185602,167808,17794,9.6
37069,2020-07-01,31221,28588,2633,8.4
37071,2020-07-01,110728,99624,11104,10
37073,2020-07-01,5135,4763,372,7.2
37075,2020-07-01,3183,2838,345,10.8
37077,2020-07-01,29576,27369,2207,7.5
37079,2020-07-01,9265,8619,646,7
37081,2020-07-01,257661,228448,29213,11.3
37083,2020-07-01,20343,18002,2341,11.5
37085,2020-07-01,52706,47824,4882,9.3
37087,2020-07-01,28505,25864,2641,9.3
37089,2020-07-01,51937,47620,4317,8.3
37091,2020-07-01,8993,8180,813,9
37093,2020-07-01,19772,17602,2170,11
37095,2020-07-01,1768,1596,172,9.7
37097,2020-07-01,89349,81361,7988,8.9
37099,2020-07-01,19702,17909,1793,9.1
37101,2020-07-01,98863,90928,7935,8
37103,2020-07-01,4199,3907,292,7
37105,2020-07-01,25861,23267,2594,10
37107,2020-07-01,27707,25479,2228,8
37109,2020-07-01,43305,39916,3389,7.8
37111,2020-07-01,20677,18957,1720,8.3
37113,2020-07-01,15688,14446,1242,7.9
37115,2020-07-01,9513,8705,808,8.5
37117,2020-07-01,8734,7983,751,8.6
37119,2020-07-01,627010,563361,63649,10.2
37121,2020-07-01,5884,5332,552,9.4
37123,2020-07-01,11238,10172,1066,9.5
37125,2020-07-01,40587,37033,3554,8.8
37127,2020-07-01,42166,37581,4585,10.9
37129,2020-07-01,122305,111572,10733,8.8
37131,2020-07-01,7546,6868,678,9
37133,2020-07-01,62729,57220,5509,8.8
37135,2020-07-01,77104,71748,5356,6.9
37137,2020-07-01,5281,4922,359,6.8
37139,2020-07-01,16587,15128,1459,8.8
37141,2020-07-01,28156,25954,2202,7.8
37143,2020-07-01,4818,4440,378,7.8
37145,2020-07-01,17926,16309,1617,9
37147,2020-07-01,85999,78221,7778,9
37149,2020-07-01,8904,8251,653,7.3
37151,2020-07-01,63305,57554,5751,9.1
37153,2020-07-01,16761,14784,1977,11.8
37155,2020-07-01,50687,44672,6015,11.9
37157,2020-07-01,38737,34702,4035,10.4
37159,2020-07-01,65577,59179,6398,9.8
37161,2020-07-01,24225,21371,2854,11.8
37163,2020-07-01,27935,25797,2138,7.7
37165,2020-07-01,11536,9739,1797,15.6
37167,2020-07-01,29466,27145,2321,7.9
37169,2020-07-01,20974,19314,1660,7.9
37171,2020-07-01,32635,29961,2674,8.2
37173,2020-07-01,7121,6476,645,9.1
37175,2020-07-01,14372,13337,1035,7.2
37177,2020-07-01,1513,1388,125,8.3
37179,2020-07-01,121545,112512,9033,7.4
37181,2020-07-01,17318,15088,2230,12.9
37183,2020-07-01,589397,540892,48505,8.2
37185,2020-07-01,6672,5839,833,12.5
37187,2020-07-01,4458,4046,412,9.2
37189,2020-07-01,27831,25733,2098,7.5
37191,2020-07-01,50386,46289,4097,8.1
37193,2020-07-01,28193,25897,2296,8.1
37195,2020-07-01,34761,30896,3865,11.1
37197,2020-07-01,17204,15773,1431,8.3
37199,2020-07-01,8111,7459,652,8
38001,2020-07-01,1030,986,44,4.3
38003,2020-07-01,5146,4862,284,5.5
38005,2020-07-01,2185,2028,157,7.2
38007,2020-07-01,537,521,16,3
38009,2020-07-01,3056,2882,174,5.7
38011,2020-07-01,1648,1593,55,3.3
38013,2020-07-01,997,939,58,5.8
38015,2020-07-01,52661,50364,2297,4.4
38017,2020-07-01,107347,102045,5302,4.9
38019,2020-07-01,1894,1825,69,3.6
38021,2020-07-01,2341,2265,76,3.2
38023,2020-07-01,1458,1397,61,4.2
38025,2020-07-01,3020,2832,188,6.2
38027,2020-07-01,1174,1127,47,4
38029,2020-07-01,1465,1404,61,4.2
38031,2020-07-01,1583,1532,51,3.2
38033,2020-07-01,867,831,36,4.2
38035,2020-07-01,36638,34626,2012,5.5
38037,2020-07-01,1162,1132,30,2.6
38039,2020-07-01,1005,972,33,3.3
38041,2020-07-01,1351,1287,64,4.7
38043,2020-07-01,1255,1194,61,4.9
38045,2020-07-01,2010,1955,55,2.7
38047,2020-07-01,843,819,24,2.8
38049,2020-07-01,3046,2890,156,5.1
38051,2020-07-01,1105,1075,30,2.7
38053,2020-07-01,9335,8336,999,10.7
38055,2020-07-01,4820,4612,208,4.3
38057,2020-07-01,3772,3557,215,5.7
38059,2020-07-01,17373,16483,890,5.1
38061,2020-07-01,6739,6250,489,7.3
38063,2020-07-01,1398,1334,64,4.6
38065,2020-07-01,908,858,50,5.5
38067,2020-07-01,3350,3176,174,5.2
38069,2020-07-01,1750,1682,68,3.9
38071,2020-07-01,5931,5655,276,4.7
38073,2020-07-01,2895,2788,107,3.7
38075,2020-07-01,1197,1121,76,6.3
38077,2020-07-01,8681,8351,330,3.8
38079,2020-07-01,4697,3785,912,19.4
38081,2020-07-01,2850,2751,99,3.5
38083,2020-07-01,672,641,31,4.6
38085,2020-07-01,1256,1197,59,4.7
38087,2020-07-01,385,373,12,3.1
38089,2020-07-01,18795,16923,1872,10
38091,2020-07-01,954,916,38,4
38093,2020-07-01,10735,10353,382,3.6
38095,2020-07-01,1168,1134,34,2.9
38097,2020-07-01,4433,4244,189,4.3
38099,2020-07-01,5150,4869,281,5.5
38101,2020-07-01,32747,30485,2262,6.9
38103,2020-07-01,1929,1857,72,3.7
38105,2020-07-01,23175,19851,3324,14.3
39001,2020-07-01,11089,9980,1109,10
39003,2020-07-01,47923,43228,4695,9.8
39005,2020-07-01,26526,24493,2033,7.7
39007,2020-07-01,44827,40372,4455,9.9
39009,2020-07-01,24189,21601,2588,10.7
39011,2020-07-01,24811,22762,2049,8.3
39013,2020-07-01,29037,25591,3446,11.9
39015,2020-07-01,19575,17710,1865,9.5
39017,2020-07-01,196915,178723,18192,9.2
39019,2020-07-01,13015,11641,1374,10.6
39021,2020-07-01,19959,18408,1551,7.8
39023,2020-07-01,63751,57679,6072,9.5
39025,2020-07-01,107517,98362,9155,8.5
39027,2020-07-01,17894,16142,1752,9.8
39029,2020-07-01,48108,42722,5386,11.2
39031,2020-07-01,14342,12846,1496,10.4
39033,2020-07-01,18929,16954,1975,10.4
39035,2020-07-01,590277,530025,60252,10.2
39037,2020-07-01,25857,23957,1900,7.3
39039,2020-07-01,17931,16412,1519,8.5
39041,2020-07-01,112485,104902,7583,6.7
39043,2020-07-01,38649,34626,4023,10.4
39045,2020-07-01,79371,72904,6467,8.1
39047,2020-07-01,14003,12765,1238,8.8
39049,2020-07-01,720896,649208,71688,9.9
39051,2020-07-01,21649,19885,1764,8.1
39053,2020-07-01,11976,10866,1110,9.3
39055,2020-07-01,45924,43246,2678,5.8
39057,2020-07-01,83422,76689,6733,8.1
39059,2020-07-01,18563,16791,1772,9.5
39061,2020-07-01,425105,381299,43806,10.3
39063,2020-07-01,42097,38788,3309,7.9
39065,2020-07-01,13563,12288,1275,9.4
39067,2020-07-01,6866,6107,759,11.1
39069,2020-07-01,13075,12016,1059,8.1
39071,2020-07-01,17776,16054,1722,9.7
39073,2020-07-01,13003,11956,1047,8.1
39075,2020-07-01,21124,20145,979,4.6
39077,2020-07-01,28227,25559,2668,9.5
39079,2020-07-01,13201,11922,1279,9.7
39081,2020-07-01,27969,24593,3376,12.1
39083,2020-07-01,31027,28752,2275,7.3
39085,2020-07-01,119433,110406,9027,7.6
39087,2020-07-01,24002,21453,2549,10.6
39089,2020-07-01,91712,84283,7429,8.1
39091,2020-07-01,22759,20917,1842,8.1
39093,2020-07-01,146952,133825,13127,8.9
39095,2020-07-01,210914,185019,25895,12.3
39097,2020-07-01,20816,19385,1431,6.9
39099,2020-07-01,102997,90359,12638,12.3
39101,2020-07-01,28499,26014,2485,8.7
39103,2020-07-01,92126,85983,6143,6.7
39105,2020-07-01,8943,7914,1029,11.5
39107,2020-07-01,23739,22241,1498,6.3
39109,2020-07-01,54359,49889,4470,8.2
39111,2020-07-01,5957,5265,692,11.6
39113,2020-07-01,258041,229972,28069,10.9
39115,2020-07-01,6656,6025,631,9.5
39117,2020-07-01,16901,15603,1298,7.7
39119,2020-07-01,40351,36931,3420,8.5
39121,2020-07-01,4658,4186,472,10.1
39123,2020-07-01,22135,20221,1914,8.6
39125,2020-07-01,8712,8023,689,7.9
39127,2020-07-01,15978,14508,1470,9.2
39129,2020-07-01,26647,24536,2111,7.9
39131,2020-07-01,10994,9877,1117,10.2
39133,2020-07-01,86095,78458,7637,8.9
39135,2020-07-01,21428,19743,1685,7.9
39137,2020-07-01,18709,17629,1080,5.8
39139,2020-07-01,52966,47466,5500,10.4
39141,2020-07-01,35339,32116,3223,9.1
39143,2020-07-01,30345,27777,2568,8.5
39145,2020-07-01,29583,26676,2907,9.8
39147,2020-07-01,27598,25078,2520,9.1
39149,2020-07-01,24534,22434,2100,8.6
39151,2020-07-01,186121,167965,18156,9.8
39153,2020-07-01,273195,244671,28524,10.4
39155,2020-07-01,86427,75879,10548,12.2
39157,2020-07-01,45688,41580,4108,9
39159,2020-07-01,29367,27491,1876,6.4
39161,2020-07-01,14863,13727,1136,7.6
39163,2020-07-01,5677,5102,575,10.1
39165,2020-07-01,119962,110530,9432,7.9
39167,2020-07-01,27362,24534,2828,10.3
39169,2020-07-01,60406,56011,4395,7.3
39171,2020-07-01,18925,17312,1613,8.5
39173,2020-07-01,69295,63559,5736,8.3
39175,2020-07-01,12991,12127,864,6.7
40001,2020-07-01,8027,7533,494,6.2
40003,2020-07-01,2615,2505,110,4.2
40005,2020-07-01,5046,4599,447,8.9
40007,2020-07-01,2428,2353,75,3.1
40009,2020-07-01,9936,8989,947,9.5
40011,2020-07-01,4430,4080,350,7.9
40013,2020-07-01,22498,21185,1313,5.8
40015,2020-07-01,11479,10670,809,7
40017,2020-07-01,76409,70954,5455,7.1
40019,2020-07-01,21420,19744,1676,7.8
40021,2020-07-01,19978,18777,1201,6
40023,2020-07-01,5627,5119,508,9
40025,2020-07-01,1386,1355,31,2.2
40027,2020-07-01,143386,133773,9613,6.7
40029,2020-07-01,2158,1976,182,8.4
40031,2020-07-01,48544,44911,3633,7.5
40033,2020-07-01,2747,2532,215,7.8
40035,2020-07-01,5881,5526,355,6
40037,2020-07-01,31560,29193,2367,7.5
40039,2020-07-01,15032,14031,1001,6.7
40041,2020-07-01,19016,17968,1048,5.5
40043,2020-07-01,2595,2434,161,6.2
40045,2020-07-01,2091,1972,119,5.7
40047,2020-07-01,27500,25749,1751,6.4
40049,2020-07-01,12564,11622,942,7.5
40051,2020-07-01,26807,24837,1970,7.3
40053,2020-07-01,2705,2603,102,3.8
40055,2020-07-01,1838,1677,161,8.8
40057,2020-07-01,1162,1116,46,4
40059,2020-07-01,1756,1689,67,3.8
40061,2020-07-01,4112,3720,392,9.5
40063,2020-07-01,5167,4694,473,9.2
40065,2020-07-01,10398,9903,495,4.8
40067,2020-07-01,2506,2302,204,8.1
40069,2020-07-01,3579,3253,326,9.1
40071,2020-07-01,18429,17018,1411,7.7
40073,2020-07-01,8416,7959,457,5.4
40075,2020-07-01,3544,3346,198,5.6
40077,2020-07-01,3111,2739,372,12
40079,2020-07-01,19169,17592,1577,8.2
40081,2020-07-01,15655,14652,1003,6.4
40083,2020-07-01,22215,20919,1296,5.8
40085,2020-07-01,6591,6310,281,4.3
40087,2020-07-01,19954,18659,1295,6.5
40089,2020-07-01,15043,13846,1197,8
40091,2020-07-01,7133,6453,680,9.5
40093,2020-07-01,3714,3495,219,5.9
40095,2020-07-01,6816,6360,456,6.7
40097,2020-07-01,19134,17960,1174,6.1
40099,2020-07-01,6145,5690,455,7.4
40101,2020-07-01,29471,27414,2057,7
40103,2020-07-01,5419,5161,258,4.8
40105,2020-07-01,4551,4258,293,6.4
40107,2020-07-01,4369,4042,327,7.5
40109,2020-07-01,388736,358708,30028,7.7
40111,2020-07-01,15693,14420,1273,8.1
40113,2020-07-01,20678,19117,1561,7.5
40115,2020-07-01,14237,13356,881,6.2
40117,2020-07-01,7374,6818,556,7.5
40119,2020-07-01,38091,35769,2322,6.1
40121,2020-07-01,16191,14687,1504,9.3
40123,2020-07-01,19101,17982,1119,5.9
40125,2020-07-01,31649,29331,2318,7.3
40127,2020-07-01,4415,4075,340,7.7
40129,2020-07-01,1781,1679,102,5.7
40131,2020-07-01,45145,42089,3056,6.8
40133,2020-07-01,8983,8193,790,8.8
40135,2020-07-01,16455,15221,1234,7.5
40137,2020-07-01,18295,16559,1736,9.5
40139,2020-07-01,11206,10933,273,2.4
40141,2020-07-01,2986,2825,161,5.4
40143,2020-07-01,327788,301637,26151,8
40145,2020-07-01,38371,35783,2588,6.7
40147,2020-07-01,22796,21211,1585,7
40149,2020-07-01,4906,4468,438,8.9
40151,2020-07-01,4447,4259,188,4.2
40153,2020-07-01,8970,8184,786,8.8
41001,2020-07-01,7105,6487,618,8.7
41003,2020-07-01,43548,40026,3522,8.1
41005,2020-07-01,211337,190961,20376,9.6
41007,2020-07-01,19024,16884,2140,11.2
41009,2020-07-01,23161,20859,2302,9.9
41011,2020-07-01,25619,22875,2744,10.7
41013,2020-07-01,10146,9111,1035,10.2
41015,2020-07-01,8889,7982,907,10.2
41017,2020-07-01,96393,87057,9336,9.7
41019,2020-07-01,45744,41588,4156,9.1
41021,2020-07-01,1019,943,76,7.5
41023,2020-07-01,3180,2925,255,8
41025,2020-07-01,3566,3348,218,6.1
41027,2020-07-01,15178,14031,1147,7.6
41029,2020-07-01,102191,91824,10367,10.1
41031,2020-07-01,10015,9071,944,9.4
41033,2020-07-01,35075,31671,3404,9.7
41035,2020-07-01,28635,25865,2770,9.7
41037,2020-07-01,3666,3430,236,6.4
41039,2020-07-01,171660,153683,17977,10.5
41041,2020-07-01,20678,17837,2841,13.7
41043,2020-07-01,57274,51645,5629,9.8
41045,2020-07-01,12244,11409,835,6.8
41047,2020-07-01,160662,146768,13894,8.6
41049,2020-07-01,5606,5253,353,6.3
41051,2020-07-01,448039,393636,54403,12.1
41053,2020-07-01,39405,36124,3281,8.3
41055,2020-07-01,993,927,66,6.6
41057,2020-07-01,11625,10462,1163,10
41059,2020-07-01,35984,33266,2718,7.6
41061,2020-07-01,11629,10568,1061,9.1
41063,2020-07-01,3524,3290,234,6.6
41065,2020-07-01,17154,16002,1152,6.7
41067,2020-07-01,311438,283779,27659,8.9
41069,2020-07-01,640,610,30,4.7
41071,2020-07-01,52710,48037,4673,8.9
42001,2020-07-01,54419,49021,5398,9.9
42003,2020-07-01,652387,561165,91222,14
42005,2020-07-01,31967,27583,4384,13.7
42007,2020-07-01,85231,72217,13014,15.3
42009,2020-07-01,23712,20633,3079,13
42011,2020-07-01,216070,186495,29575,13.7
42013,2020-07-01,60823,53339,7484,12.3
42015,2020-07-01,28636,25568,3068,10.7
42017,2020-07-01,345526,302618,42908,12.4
42019,2020-07-01,97957,86923,11034,11.3
42021,2020-07-01,57252,49458,7794,13.6
42023,2020-07-01,2122,1762,360,17
42025,2020-07-01,31885,27525,4360,13.7
42027,2020-07-01,74175,67499,6676,9
42029,2020-07-01,283941,255848,28093,9.9
42031,2020-07-01,16853,14989,1864,11.1
42033,2020-07-01,36200,31702,4498,12.4
42035,2020-07-01,17831,15783,2048,11.5
42037,2020-07-01,33644,29924,3720,11.1
42039,2020-07-01,39027,34183,4844,12.4
42041,2020-07-01,132645,119483,13162,9.9
42043,2020-07-01,148352,128838,19514,13.2
42045,2020-07-01,300020,257134,42886,14.3
42047,2020-07-01,15854,13179,2675,16.9
42049,2020-07-01,129725,111551,18174,14
42051,2020-07-01,57719,48305,9414,16.3
42053,2020-07-01,1835,1576,259,14.1
42055,2020-07-01,78727,69760,8967,11.4
42057,2020-07-01,7753,6250,1503,19.4
42059,2020-07-01,15912,13514,2398,15.1
42061,2020-07-01,20345,17275,3070,15.1
42063,2020-07-01,37894,32719,5175,13.7
42065,2020-07-01,20543,18062,2481,12.1
42067,2020-07-01,12727,11628,1099,8.6
42069,2020-07-01,105351,90817,14534,13.8
42071,2020-07-01,287269,255217,32052,11.2
42073,2020-07-01,41295,35551,5744,13.9
42075,2020-07-01,73057,64608,8449,11.6
42077,2020-07-01,194679,167138,27541,14.1
42079,2020-07-01,159993,135651,24342,15.2
42081,2020-07-01,56238,49499,6739,12
42083,2020-07-01,17336,15014,2322,13.4
42085,2020-07-01,49277,42628,6649,13.5
42087,2020-07-01,21654,19213,2441,11.3
42089,2020-07-01,83971,70416,13555,16.1
42091,2020-07-01,454564,401949,52615,11.6
42093,2020-07-01,9054,8293,761,8.4
42095,2020-07-01,161294,139712,21582,13.4
42097,2020-07-01,43761,38348,5413,12.4
42099,2020-07-01,24403,22104,2299,9.4
42101,2020-07-01,748571,602939,145632,19.5
42103,2020-07-01,25084,21282,3802,15.2
42105,2020-07-01,7343,6480,863,11.8
42107,2020-07-01,67591,58813,8778,13
42109,2020-07-01,19692,17821,1871,9.5
42111,2020-07-01,33140,28980,4160,12.6
42113,2020-07-01,2698,2384,314,11.6
42115,2020-07-01,19893,17950,1943,9.8
42117,2020-07-01,19111,16668,2443,12.8
42119,2020-07-01,19611,17706,1905,9.7
42121,2020-07-01,22521,19730,2791,12.4
42123,2020-07-01,18901,16707,2194,11.6
42125,2020-07-01,107021,92437,14584,13.6
42127,2020-07-01,23004,20258,2746,11.9
42129,2020-07-01,179393,156019,23374,13
42131,2020-07-01,13302,11797,1505,11.3
42133,2020-07-01,236662,209258,27404,11.6
44001,2020-07-01,24416,21738,2678,11
44003,2020-07-01,87169,76147,11022,12.6
44005,2020-07-01,41632,36897,4735,11.4
44007,2020-07-01,320610,271883,48727,15.2
44009,2020-07-01,65070,57952,7118,10.9
45001,2020-07-01,10074,9276,798,7.9
45003,2020-07-01,76755,72170,4585,6
45005,2020-07-01,2721,2379,342,12.6
45007,2020-07-01,92976,86237,6739,7.2
45009,2020-07-01,4945,4364,581,11.7
45011,2020-07-01,8077,7202,875,10.8
45013,2020-07-01,80249,75104,5145,6.4
45015,2020-07-01,108451,100234,8217,7.6
45017,2020-07-01,6789,6255,534,7.9
45019,2020-07-01,219494,200917,18577,8.5
45021,2020-07-01,25129,22403,2726,10.8
45023,2020-07-01,14144,12449,1695,12
45025,2020-07-01,22395,20660,1735,7.7
45027,2020-07-01,12883,11749,1134,8.8
45029,2020-07-01,17439,16020,1419,8.1
45031,2020-07-01,31221,28459,2762,8.8
45033,2020-07-01,13209,12179,1030,7.8
45035,2020-07-01,80356,74049,6307,7.8
45037,2020-07-01,10969,10298,671,6.1
45039,2020-07-01,10018,8999,1019,10.2
45041,2020-07-01,68291,63267,5024,7.4
45043,2020-07-01,27675,25193,2482,9
45045,2020-07-01,262275,243543,18732,7.1
45047,2020-07-01,31744,29041,2703,8.5
45049,2020-07-01,8460,7873,587,6.9
45051,2020-07-01,157751,142698,15053,9.5
45053,2020-07-01,13392,12484,908,6.8
45055,2020-07-01,30324,28311,2013,6.6
45057,2020-07-01,43629,39694,3935,9
45059,2020-07-01,31004,28365,2639,8.5
45061,2020-07-01,7069,6386,683,9.7
45063,2020-07-01,154409,145925,8484,5.5
45065,2020-07-01,3388,3115,273,8.1
45067,2020-07-01,13761,12362,1399,10.2
45069,2020-07-01,9512,8293,1219,12.8
45071,2020-07-01,20004,18805,1199,6
45073,2020-07-01,35592,33179,2413,6.8
45075,2020-07-01,36259,31930,4329,11.9
45077,2020-07-01,58340,54560,3780,6.5
45079,2020-07-01,206803,190822,15981,7.7
45081,2020-07-01,8890,8414,476,5.4
45083,2020-07-01,160921,147531,13390,8.3
45085,2020-07-01,44318,40321,3997,9
45087,2020-07-01,12355,10877,1478,12
45089,2020-07-01,12507,11191,1316,10.5
45091,2020-07-01,147363,135465,11898,8.1
46003,2020-07-01,1422,1369,53,3.7
46005,2020-07-01,9295,8899,396,4.3
46007,2020-07-01,1057,998,59,5.6
46009,2020-07-01,2811,2696,115,4.1
46011,2020-07-01,17781,16839,942,5.3
46013,2020-07-01,20244,19254,990,4.9
46015,2020-07-01,2414,2307,107,4.4
46017,2020-07-01,781,699,82,10.5
46019,2020-07-01,4992,4671,321,6.4
46021,2020-07-01,757,732,25,3.3
46023,2020-07-01,3782,3437,345,9.1
46025,2020-07-01,2229,2139,90,4
46027,2020-07-01,6587,6206,381,5.8
46029,2020-07-01,15297,14449,848,5.5
46031,2020-07-01,1262,1179,83,6.6
46033,2020-07-01,4093,3852,241,5.9
46035,2020-07-01,10870,10347,523,4.8
46037,2020-07-01,2713,2570,143,5.3
46039,2020-07-01,2373,2267,106,4.5
46041,2020-07-01,2296,1972,324,14.1
46043,2020-07-01,1518,1480,38,2.5
46045,2020-07-01,1917,1872,45,2.3
46047,2020-07-01,3018,2820,198,6.6
46049,2020-07-01,990,957,33,3.3
46051,2020-07-01,4274,4126,148,3.5
46053,2020-07-01,1978,1898,80,4
46055,2020-07-01,1038,1025,13,1.3
46057,2020-07-01,3337,3227,110,3.3
46059,2020-07-01,1703,1661,42,2.5
46061,2020-07-01,1717,1620,97,5.6
46063,2020-07-01,681,649,32,4.7
46065,2020-07-01,10016,9690,326,3.3
46067,2020-07-01,3561,3427,134,3.8
46069,2020-07-01,648,629,19,2.9
46071,2020-07-01,1220,1180,40,3.3
46073,2020-07-01,1144,1119,25,2.2
46075,2020-07-01,524,510,14,2.7
46077,2020-07-01,2603,2491,112,4.3
46079,2020-07-01,6348,6097,251,4
46081,2020-07-01,13801,12933,868,6.3
46083,2020-07-01,35588,34223,1365,3.8
46085,2020-07-01,1664,1547,117,7
46087,2020-07-01,3024,2915,109,3.6
46089,2020-07-01,952,907,45,4.7
46091,2020-07-01,2437,2272,165,6.8
46093,2020-07-01,14204,13490,714,5
46095,2020-07-01,700,641,59,8.4
46097,2020-07-01,1145,1064,81,7.1
46099,2020-07-01,113097,107495,5602,5
46101,2020-07-01,3924,3682,242,6.2
46102,2020-07-01,3740,3171,569,15.2
46103,2020-07-01,58611,55267,3344,5.7
46105,2020-07-01,1339,1295,44,3.3
46107,2020-07-01,1042,1009,33,3.2
46109,2020-07-01,4619,4319,300,6.5
46111,2020-07-01,1136,1091,45,4
46115,2020-07-01,3041,2926,115,3.8
46117,2020-07-01,1878,1816,62,3.3
46119,2020-07-01,770,751,19,2.5
46121,2020-07-01,3071,2820,251,8.2
46123,2020-07-01,2948,2844,104,3.5
46125,2020-07-01,4584,4396,188,4.1
46127,2020-07-01,8367,7932,435,5.2
46129,2020-07-01,2179,2039,140,6.4
46135,2020-07-01,11744,11108,636,5.4
46137,2020-07-01,916,849,67,7.3
47001,2020-07-01,33095,30565,2530,7.6
47003,2020-07-01,20243,18503,1740,8.6
47005,2020-07-01,6387,5853,534,8.4
47007,2020-07-01,3997,3646,351,8.8
47009,2020-07-01,61231,56653,4578,7.5
47011,2020-07-01,51980,47859,4121,7.9
47013,2020-07-01,14091,12966,1125,8
47015,2020-07-01,6155,5738,417,6.8
47017,2020-07-01,11312,10402,910,8
47019,2020-07-01,22718,20809,1909,8.4
47021,2020-07-01,20545,19073,1472,7.2
47023,2020-07-01,8051,7517,534,6.6
47025,2020-07-01,12257,11374,883,7.2
47027,2020-07-01,2568,2360,208,8.1
47029,2020-07-01,14199,12669,1530,10.8
47031,2020-07-01,24773,22773,2000,8.1
47033,2020-07-01,6508,6090,418,6.4
47035,2020-07-01,21647,19871,1776,8.2
47037,2020-07-01,395498,349799,45699,11.6
47039,2020-07-01,4275,3873,402,9.4
47041,2020-07-01,7440,6745,695,9.3
47043,2020-07-01,25165,23428,1737,6.9
47045,2020-07-01,15247,13853,1394,9.1
47047,2020-07-01,18148,16651,1497,8.2
47049,2020-07-01,7016,6514,502,7.2
47051,2020-07-01,18786,17355,1431,7.6
47053,2020-07-01,21039,19342,1697,8.1
47055,2020-07-01,14129,12845,1284,9.1
47057,2020-07-01,9136,8377,759,8.3
47059,2020-07-01,27445,24827,2618,9.5
47061,2020-07-01,4711,4242,469,10
47063,2020-07-01,27047,24803,2244,8.3
47065,2020-07-01,177156,161568,15588,8.8
47067,2020-07-01,2040,1806,234,11.5
47069,2020-07-01,9016,8086,930,10.3
47071,2020-07-01,10036,9228,808,8.1
47073,2020-07-01,22649,20605,2044,9
47075,2020-07-01,7527,6626,901,12
47077,2020-07-01,11506,10461,1045,9.1
47079,2020-07-01,13263,12252,1011,7.6
47081,2020-07-01,10591,9901,690,6.5
47083,2020-07-01,3017,2744,273,9
47085,2020-07-01,8193,7607,586,7.2
47087,2020-07-01,4478,4084,394,8.8
47089,2020-07-01,23760,21783,1977,8.3
47091,2020-07-01,7431,6955,476,6.4
47093,2020-07-01,234497,217595,16902,7.2
47095,2020-07-01,1602,1448,154,9.6
47097,2020-07-01,9176,8128,1048,11.4
47099,2020-07-01,18303,16707,1596,8.7
47101,2020-07-01,5073,4688,385,7.6
47103,2020-07-01,15209,13903,1306,8.6
47105,2020-07-01,22573,20970,1603,7.1
47107,2020-07-01,22240,20262,1978,8.9
47109,2020-07-01,7952,7069,883,11.1
47111,2020-07-01,10615,9792,823,7.8
47113,2020-07-01,47805,43222,4583,9.6
47115,2020-07-01,11945,10893,1052,8.8
47117,2020-07-01,14670,13277,1393,9.5
47119,2020-07-01,47769,43323,4446,9.3
47121,2020-07-01,4967,4481,486,9.8
47123,2020-07-01,19208,17603,1605,8.4
47125,2020-07-01,82774,75135,7639,9.2
47127,2020-07-01,3365,3169,196,5.8
47129,2020-07-01,7324,6790,534,7.3
47131,2020-07-01,11600,10669,931,8
47133,2020-07-01,9165,8587,578,6.3
47135,2020-07-01,2866,2593,273,9.5
47137,2020-07-01,2171,2046,125,5.8
47139,2020-07-01,7294,6756,538,7.4
47141,2020-07-01,33458,30947,2511,7.5
47143,2020-07-01,12121,10831,1290,10.6
47145,2020-07-01,22063,20470,1593,7.2
47147,2020-07-01,35733,32999,2734,7.7
47149,2020-07-01,177238,162188,15050,8.5
47151,2020-07-01,7890,7155,735,9.3
47153,2020-07-01,5922,5414,508,8.6
47155,2020-07-01,53262,48036,5226,9.8
47157,2020-07-01,441238,380031,61207,13.9
47159,2020-07-01,8797,8216,581,6.6
47161,2020-07-01,5108,4726,382,7.5
47163,2020-07-01,67076,61312,5764,8.6
47165,2020-07-01,98421,90302,8119,8.2
47167,2020-07-01,26272,24019,2253,8.6
47169,2020-07-01,5162,4771,391,7.6
47171,2020-07-01,6727,6100,627,9.3
47173,2020-07-01,7404,6777,627,8.5
47175,2020-07-01,1887,1713,174,9.2
47177,2020-07-01,16291,14831,1460,9
47179,2020-07-01,57052,52740,4312,7.6
47181,2020-07-01,6100,5610,490,8
47183,2020-07-01,14532,13478,1054,7.3
47185,2020-07-01,11368,10480,888,7.8
47187,2020-07-01,121642,114465,7177,5.9
47189,2020-07-01,73968,67879,6089,8.2
48001,2020-07-01,23463,21819,1644,7
48003,2020-07-01,9072,8028,1044,11.5
48005,2020-07-01,35799,32448,3351,9.4
48007,2020-07-01,9102,8168,934,10.3
48009,2020-07-01,3926,3671,255,6.5
48011,2020-07-01,908,866,42,4.6
48013,2020-07-01,21998,19594,2404,10.9
48015,2020-07-01,13568,12457,1111,8.2
48017,2020-07-01,2448,2311,137,5.6
48019,2020-07-01,9776,9094,682,7
48021,2020-07-01,42498,39323,3175,7.5
48023,2020-07-01,1774,1699,75,4.2
48025,2020-07-01,10039,8759,1280,12.8
48027,2020-07-01,145714,133443,12271,8.4
48029,2020-07-01,945119,853124,91995,9.7
48031,2020-07-01,6590,6298,292,4.4
48033,2020-07-01,404,389,15,3.7
48035,2020-07-01,8362,7816,546,6.5
48037,2020-07-01,38787,35442,3345,8.6
48039,2020-07-01,177348,158547,18801,10.6
48041,2020-07-01,112719,104867,7852,7
48043,2020-07-01,4055,3703,352,8.7
48045,2020-07-01,566,538,28,4.9
48047,2020-07-01,2589,2228,361,13.9
48049,2020-07-01,15350,14167,1183,7.7
48051,2020-07-01,7923,7303,620,7.8
48053,2020-07-01,24040,22725,1315,5.5
48055,2020-07-01,19321,17781,1540,8
48057,2020-07-01,12015,11149,866,7.2
48059,2020-07-01,5984,5593,391,6.5
48061,2020-07-01,170587,149234,21353,12.5
48063,2020-07-01,5086,4621,465,9.1
48065,2020-07-01,2921,2781,140,4.8
48067,2020-07-01,12334,11197,1137,9.2
48069,2020-07-01,3272,3136,136,4.2
48071,2020-07-01,19866,17518,2348,11.8
48073,2020-07-01,21349,19338,2011,9.4
48075,2020-07-01,3162,3038,124,3.9
48077,2020-07-01,4804,4486,318,6.6
48079,2020-07-01,1120,1018,102,9.1
48081,2020-07-01,1391,1295,96,6.9
48083,2020-07-01,2934,2675,259,8.8
48085,2020-07-01,568748,524814,43934,7.7
48087,2020-07-01,1092,1043,49,4.5
48089,2020-07-01,9832,9160,672,6.8
48091,2020-07-01,74653,68972,5681,7.6
48093,2020-07-01,5616,5249,367,6.5
48095,2020-07-01,1351,1275,76,5.6
48097,2020-07-01,19306,17676,1630,8.4
48099,2020-07-01,24143,22233,1910,7.9
48101,2020-07-01,590,559,31,5.3
48103,2020-07-01,1667,1364,303,18.2
48105,2020-07-01,1590,1414,176,11.1
48107,2020-07-01,2380,2237,143,6
48109,2020-07-01,1202,1092,110,9.2
48111,2020-07-01,3782,3665,117,3.1
48113,2020-07-01,NA,NA,131848,9.7
48115,2020-07-01,4595,4087,508,11.1
48117,2020-07-01,8631,8279,352,4.1
48119,2020-07-01,2394,2232,162,6.8
48121,2020-07-01,502768,462511,40257,8
48123,2020-07-01,9375,8615,760,8.1
48125,2020-07-01,682,631,51,7.5
48127,2020-07-01,6291,5748,543,8.6
48129,2020-07-01,1392,1311,81,5.8
48131,2020-07-01,4953,4168,785,15.8
48133,2020-07-01,7143,6549,594,8.3
48135,2020-07-01,81848,69164,12684,15.5
48137,2020-07-01,1307,1253,54,4.1
48139,2020-07-01,93183,86360,6823,7.3
48141,2020-07-01,365441,328974,36467,10
48143,2020-07-01,19274,17862,1412,7.3
48145,2020-07-01,6543,6067,476,7.3
48147,2020-07-01,16832,15884,948,5.6
48149,2020-07-01,11833,11181,652,5.5
48151,2020-07-01,1606,1513,93,5.8
48153,2020-07-01,2529,2353,176,7
48155,2020-07-01,576,554,22,3.8
48157,2020-07-01,394707,355899,38808,9.8
48159,2020-07-01,4913,4617,296,6
48161,2020-07-01,6439,5771,668,10.4
48163,2020-07-01,9453,8737,716,7.6
48165,2020-07-01,9749,9065,684,7
48167,2020-07-01,164486,146713,17773,10.8
48169,2020-07-01,2029,1849,180,8.9
48171,2020-07-01,13308,12588,720,5.4
48173,2020-07-01,775,743,32,4.1
48175,2020-07-01,3154,2830,324,10.3
48177,2020-07-01,9538,8890,648,6.8
48179,2020-07-01,7884,7070,814,10.3
48181,2020-07-01,64613,60194,4419,6.8
48183,2020-07-01,56513,50668,5845,10.3
48185,2020-07-01,10972,9879,1093,10
48187,2020-07-01,80159,74087,6072,7.6
48189,2020-07-01,11870,10854,1016,8.6
48191,2020-07-01,1074,1004,70,6.5
48193,2020-07-01,3772,3575,197,5.2
48195,2020-07-01,2527,2422,105,4.2
48197,2020-07-01,1718,1636,82,4.8
48199,2020-07-01,24884,22120,2764,11.1
48201,2020-07-01,NA,NA,267441,11.6
48203,2020-07-01,29179,26351,2828,9.7
48205,2020-07-01,2645,2579,66,2.5
48207,2020-07-01,2686,2546,140,5.2
48209,2020-07-01,121435,111627,9808,8.1
48211,2020-07-01,1728,1633,95,5.5
48213,2020-07-01,37297,34384,2913,7.8
48215,2020-07-01,362393,310828,51565,14.2
48217,2020-07-01,16275,15015,1260,7.7
48219,2020-07-01,10499,9384,1115,10.6
48221,2020-07-01,27628,25345,2283,8.3
48223,2020-07-01,17530,16476,1054,6
48225,2020-07-01,10078,9461,617,6.1
48227,2020-07-01,13449,11979,1470,10.9
48229,2020-07-01,1872,1679,193,10.3
48231,2020-07-01,43400,39938,3462,8
48233,2020-07-01,8570,7858,712,8.3
48235,2020-07-01,756,698,58,7.7
48237,2020-07-01,3414,3120,294,8.6
48239,2020-07-01,7365,6804,561,7.6
48241,2020-07-01,13079,11360,1719,13.1
48243,2020-07-01,979,923,56,5.7
48245,2020-07-01,105980,90407,15573,14.7
48247,2020-07-01,1926,1690,236,12.3
48249,2020-07-01,16184,13393,2791,17.2
48251,2020-07-01,82809,76199,6610,8
48253,2020-07-01,5773,5267,506,8.8
48255,2020-07-01,6872,6270,602,8.8
48257,2020-07-01,67118,61708,5410,8.1
48259,2020-07-01,21963,20632,1331,6.1
48261,2020-07-01,169,156,13,7.7
48263,2020-07-01,478,458,20,4.2
48265,2020-07-01,22204,20689,1515,6.8
48267,2020-07-01,1857,1742,115,6.2
48269,2020-07-01,207,204,3,1.4
48271,2020-07-01,1274,1191,83,6.5
48273,2020-07-01,13328,11859,1469,11
48275,2020-07-01,1447,1355,92,6.4
48277,2020-07-01,23872,21882,1990,8.3
48279,2020-07-01,5269,4966,303,5.8
48281,2020-07-01,9065,8499,566,6.2
48283,2020-07-01,3541,3203,338,9.5
48285,2020-07-01,8471,7922,549,6.5
48287,2020-07-01,9095,8536,559,6.1
48289,2020-07-01,6105,5552,553,9.1
48291,2020-07-01,33729,29321,4408,13.1
48293,2020-07-01,8342,7598,744,8.9
48295,2020-07-01,1499,1422,77,5.1
48297,2020-07-01,5072,4575,497,9.8
48299,2020-07-01,8624,8063,561,6.5
48301,2020-07-01,286,281,5,1.7
48303,2020-07-01,157446,145823,11623,7.4
48305,2020-07-01,2744,2559,185,6.7
48307,2020-07-01,3285,2975,310,9.4
48309,2020-07-01,120900,111668,9232,7.6
48311,2020-07-01,686,659,27,3.9
48313,2020-07-01,4467,4075,392,8.8
48315,2020-07-01,4333,3905,428,9.9
48317,2020-07-01,2462,2244,218,8.9
48319,2020-07-01,1729,1620,109,6.3
48321,2020-07-01,16643,14437,2206,13.3
48323,2020-07-01,24375,19976,4399,18
48325,2020-07-01,21349,19710,1639,7.7
48327,2020-07-01,876,817,59,6.7
48329,2020-07-01,95355,84205,11150,11.7
48331,2020-07-01,9794,8960,834,8.5
48333,2020-07-01,1908,1821,87,4.6
48335,2020-07-01,2430,2170,260,10.7
48337,2020-07-01,9038,8292,746,8.3
48339,2020-07-01,284193,257562,26631,9.4
48341,2020-07-01,10612,10130,482,4.5
48343,2020-07-01,4827,4126,701,14.5
48345,2020-07-01,431,408,23,5.3
48347,2020-07-01,28256,25979,2277,8.1
48349,2020-07-01,23312,21581,1731,7.4
48351,2020-07-01,5049,4369,680,13.5
48353,2020-07-01,7106,6637,469,6.6
48355,2020-07-01,165715,146729,18986,11.5
48357,2020-07-01,4093,3798,295,7.2
48359,2020-07-01,881,846,35,4
48361,2020-07-01,35971,31341,4630,12.9
48363,2020-07-01,13415,12232,1183,8.8
48365,2020-07-01,9464,8489,975,10.3
48367,2020-07-01,67976,63057,4919,7.2
48369,2020-07-01,4960,4823,137,2.8
48371,2020-07-01,6747,6037,710,10.5
48373,2020-07-01,18584,16632,1952,10.5
48375,2020-07-01,54277,50709,3568,6.6
48377,2020-07-01,3239,2664,575,17.8
48379,2020-07-01,5985,5650,335,5.6
48381,2020-07-01,72159,68414,3745,5.2
48383,2020-07-01,1801,1564,237,13.2
48385,2020-07-01,1152,1056,96,8.3
48387,2020-07-01,5173,4791,382,7.4
48389,2020-07-01,8288,7450,838,10.1
48391,2020-07-01,3106,2773,333,10.7
48393,2020-07-01,414,392,22,5.3
48395,2020-07-01,7126,6553,573,8
48397,2020-07-01,52980,49115,3865,7.3
48399,2020-07-01,4531,4263,268,5.9
48401,2020-07-01,21987,20047,1940,8.8
48403,2020-07-01,3960,3453,507,12.8
48405,2020-07-01,3059,2724,335,11
48407,2020-07-01,11677,10501,1176,10.1
48409,2020-07-01,29435,25763,3672,12.5
48411,2020-07-01,2114,1986,128,6.1
48413,2020-07-01,1181,1074,107,9.1
48415,2020-07-01,6253,5582,671,10.7
48417,2020-07-01,1857,1735,122,6.6
48419,2020-07-01,11499,10524,975,8.5
48421,2020-07-01,1285,1240,45,3.5
48423,2020-07-01,108967,100036,8931,8.2
48425,2020-07-01,4326,3981,345,8
48427,2020-07-01,26557,21381,5176,19.5
48429,2020-07-01,3980,3656,324,8.1
48431,2020-07-01,561,513,48,8.6
48433,2020-07-01,605,569,36,6
48435,2020-07-01,1234,1091,143,11.6
48437,2020-07-01,2529,2379,150,5.9
48439,2020-07-01,NA,985868,99466,9.2
48441,2020-07-01,66242,61736,4506,6.8
48443,2020-07-01,406,382,24,5.9
48445,2020-07-01,4864,4423,441,9.1
48447,2020-07-01,647,606,41,6.3
48449,2020-07-01,13383,12275,1108,8.3
48451,2020-07-01,53925,49500,4425,8.2
48453,2020-07-01,742269,682448,59821,8.1
48455,2020-07-01,5336,4827,509,9.5
48457,2020-07-01,7418,6549,869,11.7
48459,2020-07-01,17390,15741,1649,9.5
48461,2020-07-01,1833,1700,133,7.3
48463,2020-07-01,11491,10611,880,7.7
48465,2020-07-01,22935,20801,2134,9.3
48467,2020-07-01,26478,24545,1933,7.3
48469,2020-07-01,41191,36572,4619,11.2
48471,2020-07-01,23915,21782,2133,8.9
48473,2020-07-01,23808,21451,2357,9.9
48475,2020-07-01,5968,5166,802,13.4
48477,2020-07-01,15347,14296,1051,6.8
48479,2020-07-01,116719,104298,12421,10.6
48481,2020-07-01,21189,19355,1834,8.7
48483,2020-07-01,2203,2056,147,6.7
48485,2020-07-01,55864,51184,4680,8.4
48487,2020-07-01,4942,4618,324,6.6
48489,2020-07-01,6563,5631,932,14.2
48491,2020-07-01,317120,294314,22806,7.2
48493,2020-07-01,24378,22617,1761,7.2
48495,2020-07-01,3940,3416,524,13.3
48497,2020-07-01,32104,29543,2561,8
48499,2020-07-01,18030,16626,1404,7.8
48501,2020-07-01,3545,2949,596,16.8
48503,2020-07-01,7933,7436,497,6.3
48505,2020-07-01,4665,3936,729,15.6
48507,2020-07-01,3373,2769,604,17.9
49001,2020-07-01,2757,2631,126,4.6
49003,2020-07-01,26538,25473,1065,4
49005,2020-07-01,63598,61557,2041,3.2
49007,2020-07-01,8612,8094,518,6
49009,2020-07-01,468,455,13,2.8
49011,2020-07-01,179191,170808,8383,4.7
49013,2020-07-01,7941,7139,802,10.1
49015,2020-07-01,4523,4327,196,4.3
49017,2020-07-01,3009,2808,201,6.7
49019,2020-07-01,6781,6236,545,8
49021,2020-07-01,24373,23137,1236,5.1
49023,2020-07-01,5860,5684,176,3
49025,2020-07-01,4153,3954,199,4.8
49027,2020-07-01,6000,5789,211,3.5
49029,2020-07-01,5603,5435,168,3
49031,2020-07-01,471,444,27,5.7
49033,2020-07-01,1519,1488,31,2
49035,2020-07-01,652166,610905,41261,6.3
49037,2020-07-01,5514,4852,662,12
49039,2020-07-01,12459,11959,500,4
49041,2020-07-01,9917,9470,447,4.5
49043,2020-07-01,24055,21922,2133,8.9
49045,2020-07-01,35327,33441,1886,5.3
49047,2020-07-01,13678,12150,1528,11.2
49049,2020-07-01,314904,301264,13640,4.3
49051,2020-07-01,16856,15677,1179,7
49053,2020-07-01,78993,74069,4924,6.2
49055,2020-07-01,1522,1436,86,5.7
49057,2020-07-01,131930,125068,6862,5.2
50001,2020-07-01,19993,18857,1136,5.7
50003,2020-07-01,17263,15936,1327,7.7
50005,2020-07-01,14173,13243,930,6.6
50007,2020-07-01,93332,87597,5735,6.1
50009,2020-07-01,2606,2430,176,6.8
50011,2020-07-01,26306,24658,1648,6.3
50013,2020-07-01,3994,3721,273,6.8
50015,2020-07-01,13388,12303,1085,8.1
50017,2020-07-01,15334,14536,798,5.2
50019,2020-07-01,12531,11508,1023,8.2
50021,2020-07-01,29613,27237,2376,8
50023,2020-07-01,32862,30990,1872,5.7
50025,2020-07-01,20973,19269,1704,8.1
50027,2020-07-01,27743,25893,1850,6.7
51001,2020-07-01,16283,15071,1212,7.4
51003,2020-07-01,55149,51125,4024,7.3
51005,2020-07-01,6718,6164,554,8.2
51007,2020-07-01,6244,5790,454,7.3
51009,2020-07-01,14656,13636,1020,7
51011,2020-07-01,7020,6525,495,7.1
51013,2020-07-01,150391,141752,8639,5.7
51015,2020-07-01,36831,34766,2065,5.6
51017,2020-07-01,2230,1967,263,11.8
51019,2020-07-01,37473,35216,2257,6
51021,2020-07-01,2782,2600,182,6.5
51023,2020-07-01,17050,16142,908,5.3
51025,2020-07-01,6019,5392,627,10.4
51027,2020-07-01,6173,5429,744,12.1
51029,2020-07-01,6261,5668,593,9.5
51031,2020-07-01,25494,23595,1899,7.4
51033,2020-07-01,15127,13852,1275,8.4
51035,2020-07-01,12870,11592,1278,9.9
51036,2020-07-01,3638,3340,298,8.2
51037,2020-07-01,5024,4674,350,7
51041,2020-07-01,187423,173287,14136,7.5
51043,2020-07-01,7465,7044,421,5.6
51045,2020-07-01,2274,2143,131,5.8
51047,2020-07-01,24408,22934,1474,6
51049,2020-07-01,4611,4230,381,8.3
51051,2020-07-01,4723,4281,442,9.4
51053,2020-07-01,13568,12462,1106,8.2
51057,2020-07-01,5440,4979,461,8.5
51059,2020-07-01,629560,581719,47841,7.6
51061,2020-07-01,36608,34516,2092,5.7
51063,2020-07-01,7867,7402,465,5.9
51065,2020-07-01,13504,12584,920,6.8
51067,2020-07-01,25992,24253,1739,6.7
51069,2020-07-01,48971,46277,2694,5.5
51071,2020-07-01,7540,6998,542,7.2
51073,2020-07-01,19345,18029,1316,6.8
51075,2020-07-01,11166,10505,661,5.9
51077,2020-07-01,7746,7218,528,6.8
51079,2020-07-01,10060,9363,697,6.9
51081,2020-07-01,4246,3869,377,8.9
51083,2020-07-01,14972,13682,1290,8.6
51085,2020-07-01,58046,54566,3480,6
51087,2020-07-01,182668,166825,15843,8.7
51089,2020-07-01,23754,21375,2379,10
51091,2020-07-01,1212,1160,52,4.3
51093,2020-07-01,19173,17946,1227,6.4
51095,2020-07-01,36983,33703,3280,8.9
51097,2020-07-01,3921,3672,249,6.4
51099,2020-07-01,13945,13181,764,5.5
51101,2020-07-01,9105,8499,606,6.7
51103,2020-07-01,5361,4935,426,7.9
51105,2020-07-01,8276,7670,606,7.3
51107,2020-07-01,222956,207496,15460,6.9
51109,2020-07-01,19887,18580,1307,6.6
51111,2020-07-01,5229,4896,333,6.4
51113,2020-07-01,7173,6847,326,4.5
51115,2020-07-01,4043,3816,227,5.6
51117,2020-07-01,12598,11556,1042,8.3
51119,2020-07-01,5245,4933,312,5.9
51121,2020-07-01,47438,44592,2846,6
51125,2020-07-01,7223,6708,515,7.1
51127,2020-07-01,12526,11810,716,5.7
51131,2020-07-01,5574,5056,518,9.3
51133,2020-07-01,5766,5366,400,6.9
51135,2020-07-01,7159,6693,466,6.5
51137,2020-07-01,17037,15879,1158,6.8
51139,2020-07-01,12034,11120,914,7.6
51141,2020-07-01,7170,6628,542,7.6
51143,2020-07-01,28982,26707,2275,7.8
51145,2020-07-01,13991,13170,821,5.9
51147,2020-07-01,10018,9161,857,8.6
51149,2020-07-01,15028,13779,1249,8.3
51153,2020-07-01,247134,225797,21337,8.6
51155,2020-07-01,15660,14277,1383,8.8
51157,2020-07-01,3673,3477,196,5.3
51159,2020-07-01,4017,3774,243,6
51161,2020-07-01,48648,45605,3043,6.3
51163,2020-07-01,10194,9494,700,6.9
51165,2020-07-01,40601,38269,2332,5.7
51167,2020-07-01,10980,10097,883,8
51169,2020-07-01,8885,8345,540,6.1
51171,2020-07-01,22213,20805,1408,6.3
51173,2020-07-01,13283,12205,1078,8.1
51175,2020-07-01,9105,8536,569,6.2
51177,2020-07-01,67213,62056,5157,7.7
51179,2020-07-01,72265,66990,5275,7.3
51181,2020-07-01,3581,3319,262,7.3
51183,2020-07-01,3844,3418,426,11.1
51185,2020-07-01,15120,13648,1472,9.7
51187,2020-07-01,20190,18761,1429,7.1
51191,2020-07-01,25880,24049,1831,7.1
51193,2020-07-01,9534,8882,652,6.8
51195,2020-07-01,12973,11766,1207,9.3
51197,2020-07-01,13654,12475,1179,8.6
51199,2020-07-01,32581,30271,2310,7.1
51510,2020-07-01,100395,92498,7897,7.9
51520,2020-07-01,7350,6645,705,9.6
51530,2020-07-01,3004,2771,233,7.8
51540,2020-07-01,25350,22990,2360,9.3
51550,2020-07-01,123491,113352,10139,8.2
51570,2020-07-01,8608,7796,812,9.4
51580,2020-07-01,2414,2115,299,12.4
51590,2020-07-01,19044,16705,2339,12.3
51595,2020-07-01,2414,2040,374,15.5
51600,2020-07-01,13086,12095,991,7.6
51610,2020-07-01,8219,7834,385,4.7
51620,2020-07-01,3768,3318,450,11.9
51630,2020-07-01,14122,12779,1343,9.5
51640,2020-07-01,2838,2570,268,9.4
51650,2020-07-01,66049,58467,7582,11.5
51660,2020-07-01,23903,21912,1991,8.3
51670,2020-07-01,10188,8661,1527,15
51678,2020-07-01,2006,1826,180,9
51680,2020-07-01,36238,32816,3422,9.4
51683,2020-07-01,21813,19923,1890,8.7
51685,2020-07-01,9555,8687,868,9.1
51690,2020-07-01,5808,4931,877,15.1
51700,2020-07-01,91958,81056,10902,11.9
51710,2020-07-01,114896,100987,13909,12.1
51720,2020-07-01,1657,1495,162,9.8
51730,2020-07-01,14200,11457,2743,19.3
51735,2020-07-01,6254,5929,325,5.2
51740,2020-07-01,46130,40004,6126,13.3
51750,2020-07-01,8307,7613,694,8.4
51760,2020-07-01,123336,108241,15095,12.2
51770,2020-07-01,49959,44773,5186,10.4
51775,2020-07-01,12697,11770,927,7.3
51790,2020-07-01,12289,11282,1007,8.2
51800,2020-07-01,45164,41198,3966,8.8
51810,2020-07-01,232231,213798,18433,7.9
51820,2020-07-01,10770,9827,943,8.8
51830,2020-07-01,6777,6091,686,10.1
51840,2020-07-01,15108,14012,1096,7.3
53001,2020-07-01,10274,9386,888,8.6
53003,2020-07-01,10363,9650,713,6.9
53005,2020-07-01,105232,93633,11599,11
53007,2020-07-01,49242,44772,4470,9.1
53009,2020-07-01,29317,25620,3697,12.6
53011,2020-07-01,242028,212870,29158,12
53013,2020-07-01,1745,1590,155,8.9
53015,2020-07-01,48653,42821,5832,12
53017,2020-07-01,22821,20648,2173,9.5
53019,2020-07-01,2468,2134,334,13.5
53021,2020-07-01,43837,38591,5246,12
53023,2020-07-01,854,761,93,10.9
53025,2020-07-01,51241,45788,5453,10.6
53027,2020-07-01,29460,25175,4285,14.5
53029,2020-07-01,36181,32389,3792,10.5
53031,2020-07-01,13670,12072,1598,11.7
53033,2020-07-01,NA,NA,119931,9.3
53035,2020-07-01,128235,115558,12677,9.9
53037,2020-07-01,22143,19637,2506,11.3
53039,2020-07-01,10386,9304,1082,10.4
53041,2020-07-01,35263,31203,4060,11.5
53043,2020-07-01,4718,4325,393,8.3
53045,2020-07-01,25422,22264,3158,12.4
53047,2020-07-01,21102,19007,2095,9.9
53049,2020-07-01,8661,7530,1131,13.1
53051,2020-07-01,4981,4252,729,14.6
53053,2020-07-01,450238,393070,57168,12.7
53055,2020-07-01,8584,7807,777,9.1
53057,2020-07-01,63234,55340,7894,12.5
53059,2020-07-01,5484,4796,688,12.5
53061,2020-07-01,438920,395782,43138,9.8
53063,2020-07-01,255075,225662,29413,11.5
53065,2020-07-01,18267,16175,2092,11.5
53067,2020-07-01,142935,127492,15443,10.8
53069,2020-07-01,1424,1258,166,11.7
53071,2020-07-01,30608,28089,2519,8.2
53073,2020-07-01,114130,100022,14108,12.4
53075,2020-07-01,19770,18056,1714,8.7
53077,2020-07-01,138302,121211,17091,12.4
54001,2020-07-01,6977,6306,671,9.6
54003,2020-07-01,58821,54448,4373,7.4
54005,2020-07-01,7533,6595,938,12.5
54007,2020-07-01,5163,4619,544,10.5
54009,2020-07-01,9992,9002,990,9.9
54011,2020-07-01,42121,38187,3934,9.3
54013,2020-07-01,2504,2174,330,13.2
54015,2020-07-01,3122,2724,398,12.7
54017,2020-07-01,3861,3626,235,6.1
54019,2020-07-01,16406,14677,1729,10.5
54021,2020-07-01,2265,2006,259,11.4
54023,2020-07-01,6026,5624,402,6.7
54025,2020-07-01,16177,14892,1285,7.9
54027,2020-07-01,10886,10236,650,6
54029,2020-07-01,13304,11803,1501,11.3
54031,2020-07-01,5794,5365,429,7.4
54033,2020-07-01,34352,31302,3050,8.9
54035,2020-07-01,13309,12084,1225,9.2
54037,2020-07-01,30222,28022,2200,7.3
54039,2020-07-01,83122,74458,8664,10.4
54041,2020-07-01,6512,5757,755,11.6
54043,2020-07-01,7326,6503,823,11.2
54045,2020-07-01,11261,9680,1581,14
54047,2020-07-01,4504,3834,670,14.9
54049,2020-07-01,25216,22630,2586,10.3
54051,2020-07-01,13612,12181,1431,10.5
54053,2020-07-01,10247,9343,904,8.8
54055,2020-07-01,20657,18353,2304,11.2
54057,2020-07-01,12161,11182,979,8.1
54059,2020-07-01,7149,6017,1132,15.8
54061,2020-07-01,54092,49469,4623,8.5
54063,2020-07-01,6059,5614,445,7.3
54065,2020-07-01,8529,7953,576,6.8
54067,2020-07-01,9859,8805,1054,10.7
54069,2020-07-01,20566,18593,1973,9.6
54071,2020-07-01,3662,3475,187,5.1
54073,2020-07-01,2731,2374,357,13.1
54075,2020-07-01,3625,3242,383,10.6
54077,2020-07-01,15230,13966,1264,8.3
54079,2020-07-01,26960,24754,2206,8.2
54081,2020-07-01,30921,27829,3092,10
54083,2020-07-01,12223,10955,1268,10.4
54085,2020-07-01,4396,4034,362,8.2
54087,2020-07-01,5101,4448,653,12.8
54089,2020-07-01,4506,4160,346,7.7
54091,2020-07-01,7763,7116,647,8.3
54093,2020-07-01,3272,2996,276,8.4
54095,2020-07-01,3083,2692,391,12.7
54097,2020-07-01,9504,8416,1088,11.4
54099,2020-07-01,15791,14338,1453,9.2
54101,2020-07-01,3261,2927,334,10.2
54103,2020-07-01,6887,6170,717,10.4
54105,2020-07-01,2253,2020,233,10.3
54107,2020-07-01,36779,33137,3642,9.9
54109,2020-07-01,6371,5572,799,12.5
55001,2020-07-01,8082,7340,742,9.2
55003,2020-07-01,7999,7284,715,8.9
55005,2020-07-01,23608,22274,1334,5.7
55007,2020-07-01,7568,6924,644,8.5
55009,2020-07-01,142519,132502,10017,7
55011,2020-07-01,6233,5751,482,7.7
55013,2020-07-01,7270,6616,654,9
55015,2020-07-01,27245,25831,1414,5.2
55017,2020-07-01,32738,30488,2250,6.9
55019,2020-07-01,17183,16413,770,4.5
55021,2020-07-01,31190,29228,1962,6.3
55023,2020-07-01,7378,6887,491,6.7
55025,2020-07-01,321757,302891,18866,5.9
55027,2020-07-01,47930,44509,3421,7.1
55029,2020-07-01,16335,15406,929,5.7
55031,2020-07-01,22648,20257,2391,10.6
55033,2020-07-01,22624,21180,1444,6.4
55035,2020-07-01,58335,54432,3903,6.7
55037,2020-07-01,2215,2035,180,8.1
55039,2020-07-01,56771,53257,3514,6.2
55041,2020-07-01,3947,3257,690,17.5
55043,2020-07-01,26180,24739,1441,5.5
55045,2020-07-01,20418,19363,1055,5.2
55047,2020-07-01,9372,8817,555,5.9
55049,2020-07-01,13270,12503,767,5.8
55051,2020-07-01,2550,2222,328,12.9
55053,2020-07-01,9738,8720,1018,10.5
55055,2020-07-01,45170,42420,2750,6.1
55057,2020-07-01,13274,12290,984,7.4
55059,2020-07-01,89311,82133,7178,8
55061,2020-07-01,10605,10102,503,4.7
55063,2020-07-01,64471,60442,4029,6.2
55065,2020-07-01,9576,9160,416,4.3
55067,2020-07-01,9314,8627,687,7.4
55069,2020-07-01,14652,13704,948,6.5
55071,2020-07-01,39985,37243,2742,6.9
55073,2020-07-01,72649,68529,4120,5.7
55075,2020-07-01,19604,18024,1580,8.1
55077,2020-07-01,7543,7086,457,6.1
55078,2020-07-01,1726,1389,337,19.5
55079,2020-07-01,473392,424260,49132,10.4
55081,2020-07-01,23651,22166,1485,6.3
55083,2020-07-01,20258,18943,1315,6.5
55085,2020-07-01,18588,17338,1250,6.7
55087,2020-07-01,103993,97520,6473,6.2
55089,2020-07-01,48343,45169,3174,6.6
55091,2020-07-01,4088,3840,248,6.1
55093,2020-07-01,24688,22790,1898,7.7
55095,2020-07-01,24165,22476,1689,7
55097,2020-07-01,36742,34592,2150,5.9
55099,2020-07-01,6182,5743,439,7.1
55101,2020-07-01,98665,90534,8131,8.2
55103,2020-07-01,8999,8529,470,5.2
55105,2020-07-01,86467,79228,7239,8.4
55107,2020-07-01,6348,5934,414,6.5
55109,2020-07-01,49781,45794,3987,8
55111,2020-07-01,35109,32570,2539,7.2
55113,2020-07-01,8274,7640,634,7.7
55115,2020-07-01,20772,19396,1376,6.6
55117,2020-07-01,62517,58552,3965,6.3
55119,2020-07-01,10813,10344,469,4.3
55121,2020-07-01,15301,14167,1134,7.4
55123,2020-07-01,14542,13738,804,5.5
55125,2020-07-01,10862,10162,700,6.4
55127,2020-07-01,56383,52525,3858,6.8
55129,2020-07-01,7962,7441,521,6.5
55131,2020-07-01,76250,71144,5106,6.7
55133,2020-07-01,222413,207632,14781,6.6
55135,2020-07-01,25985,24485,1500,5.8
55137,2020-07-01,10891,10185,706,6.5
55139,2020-07-01,92058,86336,5722,6.2
55141,2020-07-01,34854,32451,2403,6.9
56001,2020-07-01,19226,18356,870,4.5
56003,2020-07-01,5707,5422,285,5
56005,2020-07-01,23246,21096,2150,9.2
56007,2020-07-01,8727,8352,375,4.3
56009,2020-07-01,7875,7221,654,8.3
56011,2020-07-01,4155,3974,181,4.4
56013,2020-07-01,19091,17717,1374,7.2
56015,2020-07-01,6813,6486,327,4.8
56017,2020-07-01,2318,2181,137,5.9
56019,2020-07-01,4448,4178,270,6.1
56021,2020-07-01,51335,48443,2892,5.6
56023,2020-07-01,9487,8996,491,5.2
56025,2020-07-01,41181,37085,4096,9.9
56027,2020-07-01,1292,1236,56,4.3
56029,2020-07-01,16782,15933,849,5.1
56031,2020-07-01,4691,4421,270,5.8
56033,2020-07-01,16660,15808,852,5.1
56035,2020-07-01,4288,3963,325,7.6
56037,2020-07-01,20179,18284,1895,9.4
56039,2020-07-01,16508,15678,830,5
56041,2020-07-01,9389,8655,734,7.8
56043,2020-07-01,4107,3858,249,6.1
56045,2020-07-01,3754,3577,177,4.7
72001,2020-07-01,3900,3555,345,8.8
72003,2020-07-01,11601,10731,870,7.5
72005,2020-07-01,14085,12950,1135,8.1
72007,2020-07-01,6325,5794,531,8.4
72009,2020-07-01,6096,5643,453,7.4
72011,2020-07-01,8669,8108,561,6.5
72013,2020-07-01,23151,21359,1792,7.7
72015,2020-07-01,4490,4186,304,6.8
72017,2020-07-01,5689,5161,528,9.3
72019,2020-07-01,7082,6470,612,8.6
72021,2020-07-01,64567,59609,4958,7.7
72023,2020-07-01,13213,12277,936,7.1
72025,2020-07-01,46766,43628,3138,6.7
72027,2020-07-01,9219,8580,639,6.9
72029,2020-07-01,15947,14774,1173,7.4
72031,2020-07-01,60869,56346,4523,7.4
72033,2020-07-01,7803,7114,689,8.8
72035,2020-07-01,15655,14735,920,5.9
72037,2020-07-01,3539,3258,281,7.9
72039,2020-07-01,3591,3209,382,10.6
72041,2020-07-01,14930,14146,784,5.3
72043,2020-07-01,9649,8879,770,8
72045,2020-07-01,4743,4350,393,8.3
72047,2020-07-01,8728,7832,896,10.3
72049,2020-07-01,853,790,63,7.4
72051,2020-07-01,13114,12302,812,6.2
72053,2020-07-01,10463,9559,904,8.6
72054,2020-07-01,3180,2871,309,9.7
72055,2020-07-01,3682,3339,343,9.3
72057,2020-07-01,10706,10011,695,6.5
72059,2020-07-01,4773,4394,379,7.9
72061,2020-07-01,37431,35578,1853,5
72063,2020-07-01,17878,16994,884,4.9
72065,2020-07-01,12684,11852,832,6.6
72067,2020-07-01,5304,4931,373,7
72069,2020-07-01,16405,15324,1081,6.6
72071,2020-07-01,11457,10638,819,7.1
72073,2020-07-01,4081,3827,254,6.2
72075,2020-07-01,14676,13768,908,6.2
72077,2020-07-01,11950,11061,889,7.4
72079,2020-07-01,4849,4401,448,9.2
72081,2020-07-01,6474,5855,619,9.6
72083,2020-07-01,2646,2423,223,8.4
72085,2020-07-01,10940,10189,751,6.9
72087,2020-07-01,8202,7537,665,8.1
72089,2020-07-01,6061,5531,530,8.7
72091,2020-07-01,11055,10254,801,7.2
72093,2020-07-01,1855,1739,116,6.3
72095,2020-07-01,2630,2431,199,7.6
72097,2020-07-01,20950,19463,1487,7.1
72099,2020-07-01,10132,9312,820,8.1
72101,2020-07-01,7826,7089,737,9.4
72103,2020-07-01,7905,7391,514,6.5
72105,2020-07-01,7053,6276,777,11
72107,2020-07-01,4741,4263,478,10.1
72109,2020-07-01,4012,3712,300,7.5
72111,2020-07-01,5373,4916,457,8.5
72113,2020-07-01,43198,40125,3073,7.1
72115,2020-07-01,5868,5356,512,8.7
72117,2020-07-01,4465,4114,351,7.9
72119,2020-07-01,16678,15326,1352,8.1
72121,2020-07-01,5572,5149,423,7.6
72123,2020-07-01,6630,6075,555,8.4
72125,2020-07-01,9130,8490,640,7
72127,2020-07-01,133710,124419,9291,6.9
72129,2020-07-01,11170,10404,766,6.9
72131,2020-07-01,9644,8773,871,9
72133,2020-07-01,7271,6805,466,6.4
72135,2020-07-01,26969,25275,1694,6.3
72137,2020-07-01,28648,26712,1936,6.8
72139,2020-07-01,26644,25186,1458,5.5
72141,2020-07-01,6323,5860,463,7.3
72143,2020-07-01,9584,8737,847,8.8
72145,2020-07-01,12870,11585,1285,10
72147,2020-07-01,2370,2161,209,8.8
72149,2020-07-01,6673,6151,522,7.8
72151,2020-07-01,8180,7523,657,8
72153,2020-07-01,8930,8135,795,8.9
01001,2020-08-01,25774,24282,1492,5.8
01003,2020-08-01,98278,91978,6300,6.4
01005,2020-08-01,8631,7780,851,9.9
01007,2020-08-01,8628,7948,680,7.9
01009,2020-08-01,24483,23337,1146,4.7
01011,2020-08-01,4861,4503,358,7.4
01013,2020-08-01,9147,8143,1004,11
01015,2020-08-01,46513,42664,3849,8.3
01017,2020-08-01,15899,14639,1260,7.9
01019,2020-08-01,11452,10915,537,4.7
01021,2020-08-01,19503,18350,1153,5.9
01023,2020-08-01,4588,4227,361,7.9
01025,2020-08-01,7721,6728,993,12.9
01027,2020-08-01,5996,5718,278,4.6
01029,2020-08-01,5651,5387,264,4.7
01031,2020-08-01,21459,20318,1141,5.3
01033,2020-08-01,23620,21813,1807,7.7
01035,2020-08-01,4579,4140,439,9.6
01037,2020-08-01,4380,4098,282,6.4
01039,2020-08-01,15030,14192,838,5.6
01041,2020-08-01,6274,5873,401,6.4
01043,2020-08-01,37916,36122,1794,4.7
01045,2020-08-01,20795,19495,1300,6.3
01047,2020-08-01,14837,12770,2067,13.9
01049,2020-08-01,30081,28552,1529,5.1
01051,2020-08-01,36560,34423,2137,5.8
01053,2020-08-01,14392,13267,1125,7.8
01055,2020-08-01,40569,36878,3691,9.1
01057,2020-08-01,6482,6117,365,5.6
01059,2020-08-01,14203,13514,689,4.9
01061,2020-08-01,10798,10276,522,4.8
01063,2020-08-01,3044,2611,433,14.2
01065,2020-08-01,6121,5401,720,11.8
01067,2020-08-01,6802,6415,387,5.7
01069,2020-08-01,46523,43287,3236,7
01071,2020-08-01,22670,21345,1325,5.8
01073,2020-08-01,318180,291874,26306,8.3
01075,2020-08-01,5655,5340,315,5.6
01077,2020-08-01,41929,39297,2632,6.3
01079,2020-08-01,14323,13487,836,5.8
01081,2020-08-01,75794,71084,4710,6.2
01083,2020-08-01,44481,42356,2125,4.8
01085,2020-08-01,3774,3132,642,17
01087,2020-08-01,8174,7152,1022,12.5
01089,2020-08-01,187910,177023,10887,5.8
01091,2020-08-01,7688,7060,628,8.2
01093,2020-08-01,12962,12236,726,5.6
01095,2020-08-01,44134,42033,2101,4.8
01097,2020-08-01,192367,172469,19898,10.3
01099,2020-08-01,7508,6733,775,10.3
01101,2020-08-01,108903,97454,11449,10.5
01103,2020-08-01,58686,55494,3192,5.4
01105,2020-08-01,3504,3004,500,14.3
01107,2020-08-01,7622,7024,598,7.8
01109,2020-08-01,15770,14763,1007,6.4
01111,2020-08-01,9303,8847,456,4.9
01113,2020-08-01,23354,21932,1422,6.1
01115,2020-08-01,39915,37601,2314,5.8
01117,2020-08-01,113361,108038,5323,4.7
01119,2020-08-01,4789,4382,407,8.5
01121,2020-08-01,35978,33113,2865,8
01123,2020-08-01,18106,16570,1536,8.5
01125,2020-08-01,101865,93542,8323,8.2
01127,2020-08-01,24836,23118,1718,6.9
01129,2020-08-01,6748,6009,739,11
01131,2020-08-01,2940,2369,571,19.4
01133,2020-08-01,9808,9268,540,5.5
02013,2020-08-01,3029,2974,55,1.8
02016,2020-08-01,3785,3707,78,2.1
02020,2020-08-01,142607,133582,9025,6.3
02050,2020-08-01,6389,5762,627,9.8
02060,2020-08-01,480,460,20,4.2
02068,2020-08-01,734,659,75,10.2
02070,2020-08-01,1827,1716,111,6.1
02090,2020-08-01,43781,41671,2110,4.8
02100,2020-08-01,1082,964,118,10.9
02105,2020-08-01,1099,995,104,9.5
02110,2020-08-01,16025,15143,882,5.5
02122,2020-08-01,26989,25242,1747,6.5
02130,2020-08-01,6427,5930,497,7.7
02150,2020-08-01,6178,5932,246,4
02158,2020-08-01,2119,1780,339,16
02164,2020-08-01,802,753,49,6.1
02170,2020-08-01,45574,42641,2933,6.4
02180,2020-08-01,3608,3294,314,8.7
02185,2020-08-01,2721,2583,138,5.1
02188,2020-08-01,2872,2602,270,9.4
02195,2020-08-01,1444,1371,73,5.1
02198,2020-08-01,2885,2695,190,6.6
02220,2020-08-01,4595,4388,207,4.5
02230,2020-08-01,639,530,109,17.1
02240,2020-08-01,2912,2770,142,4.9
02261,2020-08-01,5519,5276,243,4.4
02275,2020-08-01,895,837,58,6.5
02282,2020-08-01,274,258,16,5.8
02290,2020-08-01,2252,2051,201,8.9
04001,2020-08-01,19948,17644,2304,11.6
04003,2020-08-01,51675,48638,3037,5.9
04005,2020-08-01,74350,68193,6157,8.3
04007,2020-08-01,21137,19752,1385,6.6
04009,2020-08-01,15664,14769,895,5.7
04011,2020-08-01,4371,4132,239,5.5
04012,2020-08-01,8426,7839,587,7
04013,2020-08-01,NA,NA,153031,6.7
04015,2020-08-01,87367,80113,7254,8.3
04017,2020-08-01,40774,37120,3654,9
04019,2020-08-01,486417,453555,32862,6.8
04021,2020-08-01,187117,174683,12434,6.6
04023,2020-08-01,18674,16489,2185,11.7
04025,2020-08-01,106230,99618,6612,6.2
04027,2020-08-01,95324,78001,17323,18.2
05001,2020-08-01,9400,9024,376,4
05003,2020-08-01,7261,6595,666,9.2
05005,2020-08-01,16595,15697,898,5.4
05007,2020-08-01,138652,132212,6440,4.6
05009,2020-08-01,15482,14705,777,5
05011,2020-08-01,4228,4001,227,5.4
05013,2020-08-01,2398,2286,112,4.7
05015,2020-08-01,13155,12441,714,5.4
05017,2020-08-01,3253,2925,328,10.1
05019,2020-08-01,9224,8692,532,5.8
05021,2020-08-01,5555,5254,301,5.4
05023,2020-08-01,9141,8516,625,6.8
05025,2020-08-01,3193,3002,191,6
05027,2020-08-01,8880,8235,645,7.3
05029,2020-08-01,8390,7934,456,5.4
05031,2020-08-01,55453,52244,3209,5.8
05033,2020-08-01,26308,24899,1409,5.4
05035,2020-08-01,21230,19234,1996,9.4
05037,2020-08-01,7309,6864,445,6.1
05039,2020-08-01,2866,2726,140,4.9
05041,2020-08-01,5278,4866,412,7.8
05043,2020-08-01,7646,7144,502,6.6
05045,2020-08-01,61015,57827,3188,5.2
05047,2020-08-01,7464,7067,397,5.3
05049,2020-08-01,4724,4491,233,4.9
05051,2020-08-01,41997,38353,3644,8.7
05053,2020-08-01,8139,7724,415,5.1
05055,2020-08-01,19224,18116,1108,5.8
05057,2020-08-01,9374,8891,483,5.2
05059,2020-08-01,14119,13272,847,6
05061,2020-08-01,5571,5282,289,5.2
05063,2020-08-01,16166,15307,859,5.3
05065,2020-08-01,4647,4273,374,8
05067,2020-08-01,5890,5493,397,6.7
05069,2020-08-01,27394,25034,2360,8.6
05071,2020-08-01,9742,9154,588,6
05073,2020-08-01,2409,2217,192,8
05075,2020-08-01,6615,6186,429,6.5
05077,2020-08-01,2869,2652,217,7.6
05079,2020-08-01,3834,3605,229,6
05081,2020-08-01,5362,5020,342,6.4
05083,2020-08-01,8776,8246,530,6
05085,2020-08-01,33345,31444,1901,5.7
05087,2020-08-01,7378,7084,294,4
05089,2020-08-01,6149,5774,375,6.1
05091,2020-08-01,19306,18024,1282,6.6
05093,2020-08-01,17068,15470,1598,9.4
05095,2020-08-01,2740,2549,191,7
05097,2020-08-01,3044,2846,198,6.5
05099,2020-08-01,3483,3261,222,6.4
05101,2020-08-01,3187,3052,135,4.2
05103,2020-08-01,9690,9138,552,5.7
05105,2020-08-01,4151,3936,215,5.2
05107,2020-08-01,6419,5856,563,8.8
05109,2020-08-01,4348,4106,242,5.6
05111,2020-08-01,9863,9303,560,5.7
05113,2020-08-01,8075,7560,515,6.4
05115,2020-08-01,27105,25524,1581,5.8
05117,2020-08-01,3619,3439,180,5
05119,2020-08-01,189556,173249,16307,8.6
05121,2020-08-01,7429,6988,441,5.9
05123,2020-08-01,8030,7378,652,8.1
05125,2020-08-01,57716,54739,2977,5.2
05127,2020-08-01,4283,4099,184,4.3
05129,2020-08-01,3006,2837,169,5.6
05131,2020-08-01,55865,52574,3291,5.9
05133,2020-08-01,5543,5236,307,5.5
05135,2020-08-01,5588,5214,374,6.7
05137,2020-08-01,4779,4475,304,6.4
05139,2020-08-01,15478,14148,1330,8.6
05141,2020-08-01,5766,5398,368,6.4
05143,2020-08-01,125220,118985,6235,5
05145,2020-08-01,33825,31823,2002,5.9
05147,2020-08-01,2780,2626,154,5.5
05149,2020-08-01,7840,7449,391,5
06001,2020-08-01,803837,718905,84932,10.6
06003,2020-08-01,456,403,53,11.6
06005,2020-08-01,14376,12962,1414,9.8
06007,2020-08-01,91344,82410,8934,9.8
06009,2020-08-01,21337,19667,1670,7.8
06011,2020-08-01,10459,9339,1120,10.7
06013,2020-08-01,534088,477905,56183,10.5
06015,2020-08-01,9419,8493,926,9.8
06017,2020-08-01,89037,81496,7541,8.5
06019,2020-08-01,439517,389014,50503,11.5
06021,2020-08-01,12275,11215,1060,8.6
06023,2020-08-01,57959,52517,5442,9.4
06025,2020-08-01,68175,51290,16885,24.8
06027,2020-08-01,8224,7568,656,8
06029,2020-08-01,385614,335450,50164,13
06031,2020-08-01,55466,49354,6112,11
06033,2020-08-01,28320,25631,2689,9.5
06035,2020-08-01,9329,8694,635,6.8
06037,2020-08-01,NA,NA,862109,17.5
06039,2020-08-01,61747,55268,6479,10.5
06041,2020-08-01,128138,118118,10020,7.8
06043,2020-08-01,7233,6512,721,10
06045,2020-08-01,36872,33373,3499,9.5
06047,2020-08-01,112481,99151,13330,11.9
06049,2020-08-01,3193,2979,214,6.7
06051,2020-08-01,7916,7043,873,11
06053,2020-08-01,217046,197897,19149,8.8
06055,2020-08-01,68417,62049,6368,9.3
06057,2020-08-01,46226,42256,3970,8.6
06059,2020-08-01,NA,NA,164026,10.7
06061,2020-08-01,182517,167577,14940,8.2
06063,2020-08-01,7953,7274,679,8.5
06065,2020-08-01,NA,970834,127913,11.6
06067,2020-08-01,704260,627597,76663,10.9
06069,2020-08-01,30874,27897,2977,9.6
06071,2020-08-01,960651,851882,108769,11.3
06073,2020-08-01,NA,NA,164732,10.8
06075,2020-08-01,546571,493683,52888,9.7
06077,2020-08-01,331302,290900,40402,12.2
06079,2020-08-01,129399,118310,11089,8.6
06081,2020-08-01,424587,389429,35158,8.3
06083,2020-08-01,216272,198384,17888,8.3
06085,2020-08-01,NA,926958,82002,8.1
06087,2020-08-01,132158,120009,12149,9.2
06089,2020-08-01,72526,66183,6343,8.7
06091,2020-08-01,1280,1182,98,7.7
06093,2020-08-01,16941,15406,1535,9.1
06095,2020-08-01,200438,178485,21953,11
06097,2020-08-01,243406,222299,21107,8.7
06099,2020-08-01,241678,214690,26988,11.2
06101,2020-08-01,45578,40969,4609,10.1
06103,2020-08-01,25662,23385,2277,8.9
06105,2020-08-01,4713,4386,327,6.9
06107,2020-08-01,196826,171047,25779,13.1
06109,2020-08-01,20080,17933,2147,10.7
06111,2020-08-01,401451,362133,39318,9.8
06113,2020-08-01,103916,95663,8253,7.9
06115,2020-08-01,29879,26656,3223,10.8
08001,2020-08-01,274882,252816,22066,8
08003,2020-08-01,8289,7813,476,5.7
08005,2020-08-01,368688,338901,29787,8.1
08007,2020-08-01,7388,6903,485,6.6
08009,2020-08-01,2038,1999,39,1.9
08011,2020-08-01,1738,1667,71,4.1
08013,2020-08-01,191671,179936,11735,6.1
08014,2020-08-01,40195,37637,2558,6.4
08015,2020-08-01,10289,9746,543,5.3
08017,2020-08-01,1035,1008,27,2.6
08019,2020-08-01,6147,5642,505,8.2
08021,2020-08-01,3960,3779,181,4.6
08023,2020-08-01,1816,1672,144,7.9
08025,2020-08-01,1507,1442,65,4.3
08027,2020-08-01,2135,2045,90,4.2
08029,2020-08-01,14300,13467,833,5.8
08031,2020-08-01,425932,389985,35947,8.4
08033,2020-08-01,1137,1072,65,5.7
08035,2020-08-01,194467,183868,10599,5.5
08037,2020-08-01,35523,32662,2861,8.1
08039,2020-08-01,14822,14199,623,4.2
08041,2020-08-01,346896,323950,22946,6.6
08043,2020-08-01,15976,14924,1052,6.6
08045,2020-08-01,32126,30254,1872,5.8
08047,2020-08-01,4032,3573,459,11.4
08049,2020-08-01,9373,8753,620,6.6
08051,2020-08-01,11523,10947,576,5
08053,2020-08-01,495,481,14,2.8
08055,2020-08-01,2636,2402,234,8.9
08057,2020-08-01,994,961,33,3.3
08059,2020-08-01,334018,310923,23095,6.9
08061,2020-08-01,940,920,20,2.1
08063,2020-08-01,4113,4012,101,2.5
08065,2020-08-01,4701,4371,330,7
08067,2020-08-01,31531,29743,1788,5.7
08069,2020-08-01,203395,191563,11832,5.8
08071,2020-08-01,6511,6043,468,7.2
08073,2020-08-01,2362,2273,89,3.8
08075,2020-08-01,10793,10317,476,4.4
08077,2020-08-01,76126,70978,5148,6.8
08079,2020-08-01,434,413,21,4.8
08081,2020-08-01,7221,6844,377,5.2
08083,2020-08-01,13028,12270,758,5.8
08085,2020-08-01,21799,20584,1215,5.6
08087,2020-08-01,16112,15195,917,5.7
08089,2020-08-01,8106,7647,459,5.7
08091,2020-08-01,2670,2507,163,6.1
08093,2020-08-01,11083,10507,576,5.2
08095,2020-08-01,2388,2331,57,2.4
08097,2020-08-01,11232,10325,907,8.1
08099,2020-08-01,6068,5811,257,4.2
08101,2020-08-01,76601,70749,5852,7.6
08103,2020-08-01,2881,2732,149,5.2
08105,2020-08-01,5434,5077,357,6.6
08107,2020-08-01,16098,15016,1082,6.7
08109,2020-08-01,3389,3129,260,7.7
08111,2020-08-01,605,577,28,4.6
08113,2020-08-01,5447,4997,450,8.3
08115,2020-08-01,1139,1105,34,3
08117,2020-08-01,21529,19661,1868,8.7
08119,2020-08-01,13040,12222,818,6.3
08121,2020-08-01,2833,2741,92,3.2
08123,2020-08-01,164852,153034,11818,7.2
08125,2020-08-01,5442,5292,150,2.8
09001,2020-08-01,463227,424139,39088,8.4
09003,2020-08-01,469235,427893,41342,8.8
09005,2020-08-01,101190,94293,6897,6.8
09007,2020-08-01,90714,84713,6001,6.6
09009,2020-08-01,453868,415250,38618,8.5
09011,2020-08-01,132321,119383,12938,9.8
09013,2020-08-01,82798,77618,5180,6.3
09015,2020-08-01,61476,56703,4773,7.8
10001,2020-08-01,80337,73422,6915,8.6
10003,2020-08-01,298711,274968,23743,7.9
10005,2020-08-01,111400,104283,7117,6.4
11001,2020-08-01,406441,370306,36135,8.9
12001,2020-08-01,131975,124736,7239,5.5
12003,2020-08-01,11699,11123,576,4.9
12005,2020-08-01,82628,78060,4568,5.5
12007,2020-08-01,10789,10153,636,5.9
12009,2020-08-01,280876,262773,18103,6.4
12011,2020-08-01,NA,911785,96088,9.5
12013,2020-08-01,4684,4439,245,5.2
12015,2020-08-01,70040,65057,4983,7.1
12017,2020-08-01,46297,42615,3682,8
12019,2020-08-01,104804,99509,5295,5.1
12021,2020-08-01,171373,158976,12397,7.2
12023,2020-08-01,29581,27811,1770,6
12027,2020-08-01,13882,13159,723,5.2
12029,2020-08-01,5758,5446,312,5.4
12031,2020-08-01,484279,450159,34120,7
12033,2020-08-01,145288,135433,9855,6.8
12035,2020-08-01,46064,42784,3280,7.1
12037,2020-08-01,4721,4496,225,4.8
12039,2020-08-01,18355,16923,1432,7.8
12041,2020-08-01,6879,6553,326,4.7
12043,2020-08-01,5050,4750,300,5.9
12045,2020-08-01,5058,4738,320,6.3
12047,2020-08-01,4226,3834,392,9.3
12049,2020-08-01,8522,7929,593,7
12051,2020-08-01,15511,14002,1509,9.7
12053,2020-08-01,70833,65294,5539,7.8
12055,2020-08-01,33821,31113,2708,8
12057,2020-08-01,748757,693044,55713,7.4
12059,2020-08-01,6880,6519,361,5.2
12061,2020-08-01,62682,58027,4655,7.4
12063,2020-08-01,17161,16231,930,5.4
12065,2020-08-01,5309,4983,326,6.1
12067,2020-08-01,2804,2682,122,4.4
12069,2020-08-01,149317,136367,12950,8.7
12071,2020-08-01,337518,312569,24949,7.4
12073,2020-08-01,149292,139950,9342,6.3
12075,2020-08-01,16491,15556,935,5.7
12077,2020-08-01,2510,2380,130,5.2
12079,2020-08-01,7765,7211,554,7.1
12081,2020-08-01,172945,161476,11469,6.6
12083,2020-08-01,136739,127019,9720,7.1
12085,2020-08-01,70843,66775,4068,5.7
12086,2020-08-01,NA,NA,118303,9.1
12087,2020-08-01,43703,40669,3034,6.9
12089,2020-08-01,40910,38795,2115,5.2
12091,2020-08-01,96995,92359,4636,4.8
12093,2020-08-01,16924,15976,948,5.6
12095,2020-08-01,721833,640354,81479,11.3
12097,2020-08-01,182128,156258,25870,14.2
12099,2020-08-01,701601,644629,56972,8.1
12101,2020-08-01,236011,219540,16471,7
12103,2020-08-01,480076,447007,33069,6.9
12105,2020-08-01,315869,286394,29475,9.3
12107,2020-08-01,26742,24559,2183,8.2
12109,2020-08-01,132288,125889,6399,4.8
12111,2020-08-01,143357,132064,11293,7.9
12113,2020-08-01,82523,78492,4031,4.9
12115,2020-08-01,180702,169082,11620,6.4
12117,2020-08-01,231409,214417,16992,7.3
12119,2020-08-01,31645,29258,2387,7.5
12121,2020-08-01,17665,16637,1028,5.8
12123,2020-08-01,8184,7584,600,7.3
12125,2020-08-01,4550,4328,222,4.9
12127,2020-08-01,247430,228938,18492,7.5
12129,2020-08-01,14702,14051,651,4.4
12131,2020-08-01,32127,30552,1575,4.9
12133,2020-08-01,9426,8897,529,5.6
13001,2020-08-01,8835,8407,428,4.8
13003,2020-08-01,4303,4152,151,3.5
13005,2020-08-01,4443,4223,220,5
13007,2020-08-01,1077,1008,69,6.4
13009,2020-08-01,17155,15928,1227,7.2
13011,2020-08-01,9365,9005,360,3.8
13013,2020-08-01,38635,36718,1917,5
13015,2020-08-01,47859,44967,2892,6
13017,2020-08-01,5353,4977,376,7
13019,2020-08-01,7123,6758,365,5.1
13021,2020-08-01,65816,60313,5503,8.4
13023,2020-08-01,4337,4064,273,6.3
13025,2020-08-01,6853,6510,343,5
13027,2020-08-01,6581,6216,365,5.5
13029,2020-08-01,18136,17192,944,5.2
13031,2020-08-01,36287,33875,2412,6.6
13033,2020-08-01,8687,8034,653,7.5
13035,2020-08-01,10384,9711,673,6.5
13037,2020-08-01,2087,1967,120,5.7
13039,2020-08-01,20586,19661,925,4.5
13043,2020-08-01,5447,5181,266,4.9
13045,2020-08-01,52744,49340,3404,6.5
13047,2020-08-01,31523,30187,1336,4.2
13049,2020-08-01,4677,4511,166,3.5
13051,2020-08-01,137117,125849,11268,8.2
13053,2020-08-01,1906,1786,120,6.3
13055,2020-08-01,9407,8602,805,8.6
13057,2020-08-01,128649,122551,6098,4.7
13059,2020-08-01,56254,52463,3791,6.7
13061,2020-08-01,879,751,128,14.6
13063,2020-08-01,137603,120888,16715,12.1
13065,2020-08-01,2823,2717,106,3.8
13067,2020-08-01,402466,377214,25252,6.3
13069,2020-08-01,18597,17465,1132,6.1
13071,2020-08-01,21144,20180,964,4.6
13073,2020-08-01,71813,68941,2872,4
13075,2020-08-01,7884,7493,391,5
13077,2020-08-01,71441,66991,4450,6.2
13079,2020-08-01,5282,5022,260,4.9
13081,2020-08-01,9211,8373,838,9.1
13083,2020-08-01,7692,7397,295,3.8
13085,2020-08-01,11911,11397,514,4.3
13087,2020-08-01,10851,10301,550,5.1
13089,2020-08-01,387246,351979,35267,9.1
13091,2020-08-01,6828,6435,393,5.8
13093,2020-08-01,4655,4280,375,8.1
13095,2020-08-01,36765,33123,3642,9.9
13097,2020-08-01,70471,64706,5765,8.2
13099,2020-08-01,4299,3984,315,7.3
13101,2020-08-01,1792,1720,72,4
13103,2020-08-01,30329,28830,1499,4.9
13105,2020-08-01,7760,7195,565,7.3
13107,2020-08-01,8375,7702,673,8
13109,2020-08-01,4955,4680,275,5.5
13111,2020-08-01,10955,10491,464,4.2
13113,2020-08-01,54546,51540,3006,5.5
13115,2020-08-01,41670,39206,2464,5.9
13117,2020-08-01,116582,111500,5082,4.4
13119,2020-08-01,9559,9033,526,5.5
13121,2020-08-01,545746,495329,50417,9.2
13123,2020-08-01,11752,11280,472,4
13125,2020-08-01,1193,1148,45,3.8
13127,2020-08-01,37307,34834,2473,6.6
13129,2020-08-01,27194,25803,1391,5.1
13131,2020-08-01,10255,9839,416,4.1
13133,2020-08-01,6858,6442,416,6.1
13135,2020-08-01,468567,436616,31951,6.8
13137,2020-08-01,18008,17065,943,5.2
13139,2020-08-01,98537,94127,4410,4.5
13141,2020-08-01,2449,2212,237,9.7
13143,2020-08-01,11868,11172,696,5.9
13145,2020-08-01,15892,15223,669,4.2
13147,2020-08-01,11035,10458,577,5.2
13149,2020-08-01,4918,4633,285,5.8
13151,2020-08-01,112021,102842,9179,8.2
13153,2020-08-01,68071,64513,3558,5.2
13155,2020-08-01,3334,3148,186,5.6
13157,2020-08-01,38523,36950,1573,4.1
13159,2020-08-01,6543,6207,336,5.1
13161,2020-08-01,5889,5596,293,5
13163,2020-08-01,6449,5967,482,7.5
13165,2020-08-01,3121,2911,210,6.7
13167,2020-08-01,3902,3703,199,5.1
13169,2020-08-01,12877,12312,565,4.4
13171,2020-08-01,7729,7254,475,6.1
13173,2020-08-01,3585,3403,182,5.1
13175,2020-08-01,18892,17655,1237,6.5
13177,2020-08-01,14202,13535,667,4.7
13179,2020-08-01,25043,23355,1688,6.7
13181,2020-08-01,3367,3176,191,5.7
13183,2020-08-01,7855,7521,334,4.3
13185,2020-08-01,49721,46586,3135,6.3
13187,2020-08-01,16141,15412,729,4.5
13189,2020-08-01,8421,7725,696,8.3
13191,2020-08-01,5787,5446,341,5.9
13193,2020-08-01,4428,4114,314,7.1
13195,2020-08-01,12528,11905,623,5
13197,2020-08-01,3080,2931,149,4.8
13199,2020-08-01,8591,7801,790,9.2
13201,2020-08-01,2643,2530,113,4.3
13205,2020-08-01,7839,7264,575,7.3
13207,2020-08-01,12310,11679,631,5.1
13209,2020-08-01,3749,3551,198,5.3
13211,2020-08-01,8853,8377,476,5.4
13213,2020-08-01,14724,13810,914,6.2
13215,2020-08-01,75200,68799,6401,8.5
13217,2020-08-01,50490,46519,3971,7.9
13219,2020-08-01,18493,17888,605,3.3
13221,2020-08-01,6518,6206,312,4.8
13223,2020-08-01,82399,77857,4542,5.5
13225,2020-08-01,11447,10710,737,6.4
13227,2020-08-01,14383,13729,654,4.5
13229,2020-08-01,8293,7928,365,4.4
13231,2020-08-01,8397,8012,385,4.6
13233,2020-08-01,17746,16785,961,5.4
13235,2020-08-01,3831,3669,162,4.2
13237,2020-08-01,7921,7396,525,6.6
13239,2020-08-01,790,722,68,8.6
13241,2020-08-01,7211,6860,351,4.9
13243,2020-08-01,2363,2199,164,6.9
13245,2020-08-01,82867,75784,7083,8.5
13247,2020-08-01,42881,39298,3583,8.4
13249,2020-08-01,2054,1972,82,4
13251,2020-08-01,4853,4423,430,8.9
13253,2020-08-01,3031,2867,164,5.4
13255,2020-08-01,27542,25260,2282,8.3
13257,2020-08-01,10132,9481,651,6.4
13259,2020-08-01,2423,2271,152,6.3
13261,2020-08-01,12078,11093,985,8.2
13263,2020-08-01,2671,2492,179,6.7
13265,2020-08-01,509,475,34,6.7
13267,2020-08-01,9285,8891,394,4.2
13269,2020-08-01,2673,2484,189,7.1
13271,2020-08-01,3630,3274,356,9.8
13273,2020-08-01,3402,3106,296,8.7
13275,2020-08-01,16601,15471,1130,6.8
13277,2020-08-01,19888,18857,1031,5.2
13279,2020-08-01,11700,10929,771,6.6
13281,2020-08-01,3850,3637,213,5.5
13283,2020-08-01,2646,2494,152,5.7
13285,2020-08-01,36313,33699,2614,7.2
13287,2020-08-01,3178,2933,245,7.7
13289,2020-08-01,2680,2476,204,7.6
13291,2020-08-01,10255,9852,403,3.9
13293,2020-08-01,11055,10329,726,6.6
13295,2020-08-01,29551,28135,1416,4.8
13297,2020-08-01,43312,40984,2328,5.4
13299,2020-08-01,14923,14078,845,5.7
13301,2020-08-01,2554,2372,182,7.1
13303,2020-08-01,6703,6239,464,6.9
13305,2020-08-01,11337,10718,619,5.5
13307,2020-08-01,961,898,63,6.6
13309,2020-08-01,1549,1445,104,6.7
13311,2020-08-01,15846,15288,558,3.5
13313,2020-08-01,41647,39106,2541,6.1
13315,2020-08-01,2652,2473,179,6.7
13317,2020-08-01,3573,3330,243,6.8
13319,2020-08-01,3680,3475,205,5.6
13321,2020-08-01,8464,8007,457,5.4
15001,2020-08-01,89653,77572,12081,13.5
15003,2020-08-01,438829,385911,52918,12.1
15007,2020-08-01,35306,28209,7097,20.1
15009,2020-08-01,81261,62202,19059,23.5
16001,2020-08-01,256111,244198,11913,4.7
16003,2020-08-01,1817,1702,115,6.3
16005,2020-08-01,41921,40255,1666,4
16007,2020-08-01,3207,3093,114,3.6
16009,2020-08-01,4167,3966,201,4.8
16011,2020-08-01,23732,23015,717,3
16013,2020-08-01,12905,12179,726,5.6
16015,2020-08-01,3580,3338,242,6.8
16017,2020-08-01,21581,20375,1206,5.6
16019,2020-08-01,58564,56666,1898,3.2
16021,2020-08-01,5653,5406,247,4.4
16023,2020-08-01,1416,1375,41,2.9
16025,2020-08-01,692,670,22,3.2
16027,2020-08-01,105955,100760,5195,4.9
16029,2020-08-01,4106,4004,102,2.5
16031,2020-08-01,12474,12098,376,3
16033,2020-08-01,391,378,13,3.3
16035,2020-08-01,3029,2856,173,5.7
16037,2020-08-01,2555,2470,85,3.3
16039,2020-08-01,12169,11685,484,4
16041,2020-08-01,6887,6678,209,3
16043,2020-08-01,7407,7201,206,2.8
16045,2020-08-01,8395,7983,412,4.9
16047,2020-08-01,8238,7982,256,3.1
16049,2020-08-01,6930,6569,361,5.2
16051,2020-08-01,14320,13945,375,2.6
16053,2020-08-01,12189,11802,387,3.2
16055,2020-08-01,81973,77602,4371,5.3
16057,2020-08-01,19022,18270,752,4
16059,2020-08-01,3884,3706,178,4.6
16061,2020-08-01,1727,1627,100,5.8
16063,2020-08-01,2689,2585,104,3.9
16065,2020-08-01,20882,20372,510,2.4
16067,2020-08-01,11657,11288,369,3.2
16069,2020-08-01,20727,19965,762,3.7
16071,2020-08-01,2325,2245,80,3.4
16073,2020-08-01,5675,5404,271,4.8
16075,2020-08-01,11989,11471,518,4.3
16077,2020-08-01,4110,3978,132,3.2
16079,2020-08-01,5450,5078,372,6.8
16081,2020-08-01,7146,6889,257,3.6
16083,2020-08-01,41182,39452,1730,4.2
16085,2020-08-01,6036,5731,305,5.1
16087,2020-08-01,4796,4584,212,4.4
17001,2020-08-01,32225,30217,2008,6.2
17003,2020-08-01,1966,1767,199,10.1
17005,2020-08-01,7756,7211,545,7
17007,2020-08-01,25782,23373,2409,9.3
17009,2020-08-01,3076,2958,118,3.8
17011,2020-08-01,17017,15820,1197,7
17013,2020-08-01,2276,2124,152,6.7
17015,2020-08-01,7767,7321,446,5.7
17017,2020-08-01,5983,5580,403,6.7
17019,2020-08-01,106356,98747,7609,7.2
17021,2020-08-01,14115,12936,1179,8.4
17023,2020-08-01,7565,7045,520,6.9
17025,2020-08-01,6319,5828,491,7.8
17027,2020-08-01,20251,19170,1081,5.3
17029,2020-08-01,23030,21109,1921,8.3
17031,2020-08-01,NA,NA,359635,14.2
17033,2020-08-01,8637,8047,590,6.8
17035,2020-08-01,6089,5756,333,5.5
17037,2020-08-01,54164,49574,4590,8.5
17039,2020-08-01,7359,6864,495,6.7
17041,2020-08-01,10193,9606,587,5.8
17043,2020-08-01,473761,428581,45180,9.5
17045,2020-08-01,9151,8598,553,6
17047,2020-08-01,2752,2584,168,6.1
17049,2020-08-01,19632,18360,1272,6.5
17051,2020-08-01,10023,9250,773,7.7
17053,2020-08-01,6221,5830,391,6.3
17055,2020-08-01,16115,14547,1568,9.7
17057,2020-08-01,14954,13737,1217,8.1
17059,2020-08-01,2054,1862,192,9.3
17061,2020-08-01,6154,5741,413,6.7
17063,2020-08-01,23610,21351,2259,9.6
17065,2020-08-01,4392,4156,236,5.4
17067,2020-08-01,8304,7770,534,6.4
17069,2020-08-01,1328,1204,124,9.3
17071,2020-08-01,3684,3475,209,5.7
17073,2020-08-01,24390,22608,1782,7.3
17075,2020-08-01,14161,13336,825,5.8
17077,2020-08-01,27601,25308,2293,8.3
17079,2020-08-01,4734,4470,264,5.6
17081,2020-08-01,17442,15892,1550,8.9
17083,2020-08-01,10866,10110,756,7
17085,2020-08-01,10954,10160,794,7.2
17087,2020-08-01,4089,3739,350,8.6
17089,2020-08-01,266632,241452,25180,9.4
17091,2020-08-01,54954,50028,4926,9
17093,2020-08-01,64950,58619,6331,9.7
17095,2020-08-01,21927,20005,1922,8.8
17097,2020-08-01,374322,343269,31053,8.3
17099,2020-08-01,54028,49225,4803,8.9
17101,2020-08-01,5868,5425,443,7.5
17103,2020-08-01,17680,16485,1195,6.8
17105,2020-08-01,16667,15576,1091,6.5
17107,2020-08-01,12488,11642,846,6.8
17109,2020-08-01,12460,11483,977,7.8
17111,2020-08-01,154565,139852,14713,9.5
17113,2020-08-01,86933,80972,5961,6.9
17115,2020-08-01,49144,43915,5229,10.6
17117,2020-08-01,22672,21164,1508,6.7
17119,2020-08-01,134550,123668,10882,8.1
17121,2020-08-01,17369,15937,1432,8.2
17123,2020-08-01,5272,4912,360,6.8
17125,2020-08-01,6147,5643,504,8.2
17127,2020-08-01,5630,5123,507,9
17129,2020-08-01,6286,5914,372,5.9
17131,2020-08-01,7846,7292,554,7.1
17133,2020-08-01,18735,17741,994,5.3
17135,2020-08-01,11899,10894,1005,8.4
17137,2020-08-01,16408,15219,1189,7.2
17139,2020-08-01,7449,7051,398,5.3
17141,2020-08-01,24306,22413,1893,7.8
17143,2020-08-01,86410,77181,9229,10.7
17145,2020-08-01,8201,7514,687,8.4
17147,2020-08-01,8346,7887,459,5.5
17149,2020-08-01,7011,6621,390,5.6
17151,2020-08-01,1705,1577,128,7.5
17153,2020-08-01,1813,1597,216,11.9
17155,2020-08-01,3047,2828,219,7.2
17157,2020-08-01,14267,13342,925,6.5
17159,2020-08-01,7525,7045,480,6.4
17161,2020-08-01,69706,63370,6336,9.1
17163,2020-08-01,128728,115988,12740,9.9
17165,2020-08-01,9790,8804,986,10.1
17167,2020-08-01,100029,91493,8536,8.5
17169,2020-08-01,3211,3033,178,5.5
17171,2020-08-01,2432,2290,142,5.8
17173,2020-08-01,10661,9974,687,6.4
17175,2020-08-01,2474,2318,156,6.3
17177,2020-08-01,22135,20504,1631,7.4
17179,2020-08-01,63667,58761,4906,7.7
17181,2020-08-01,7247,6702,545,7.5
17183,2020-08-01,33129,30164,2965,8.9
17185,2020-08-01,5759,5387,372,6.5
17187,2020-08-01,8236,7745,491,6
17189,2020-08-01,10042,9646,396,3.9
17191,2020-08-01,6847,6355,492,7.2
17193,2020-08-01,6226,5789,437,7
17195,2020-08-01,28205,26010,2195,7.8
17197,2020-08-01,337548,300129,37419,11.1
17199,2020-08-01,31502,28918,2584,8.2
17201,2020-08-01,138907,123303,15604,11.2
17203,2020-08-01,18594,17505,1089,5.9
18001,2020-08-01,17004,16278,726,4.3
18003,2020-08-01,187366,173518,13848,7.4
18005,2020-08-01,44092,41493,2599,5.9
18007,2020-08-01,4133,3914,219,5.3
18009,2020-08-01,4807,4485,322,6.7
18011,2020-08-01,35952,34359,1593,4.4
18013,2020-08-01,7644,7164,480,6.3
18015,2020-08-01,9332,8840,492,5.3
18017,2020-08-01,17625,16604,1021,5.8
18019,2020-08-01,61592,57074,4518,7.3
18021,2020-08-01,11396,10600,796,7
18023,2020-08-01,16730,15871,859,5.1
18025,2020-08-01,4909,4605,304,6.2
18027,2020-08-01,16575,15949,626,3.8
18029,2020-08-01,25167,23536,1631,6.5
18031,2020-08-01,14831,14026,805,5.4
18033,2020-08-01,22215,20954,1261,5.7
18035,2020-08-01,51283,47313,3970,7.7
18037,2020-08-01,22546,21437,1109,4.9
18039,2020-08-01,111907,104756,7151,6.4
18041,2020-08-01,8485,7705,780,9.2
18043,2020-08-01,41356,38640,2716,6.6
18045,2020-08-01,7721,7329,392,5.1
18047,2020-08-01,11419,10876,543,4.8
18049,2020-08-01,9719,9112,607,6.2
18051,2020-08-01,19453,18452,1001,5.1
18053,2020-08-01,31000,29041,1959,6.3
18055,2020-08-01,13319,12492,827,6.2
18057,2020-08-01,184952,175883,9069,4.9
18059,2020-08-01,40669,38386,2283,5.6
18061,2020-08-01,19932,18742,1190,6
18063,2020-08-01,90375,85521,4854,5.4
18065,2020-08-01,21929,20588,1341,6.1
18067,2020-08-01,36323,33340,2983,8.2
18069,2020-08-01,18299,17314,985,5.4
18071,2020-08-01,23463,22062,1401,6
18073,2020-08-01,15477,14464,1013,6.5
18075,2020-08-01,8712,8265,447,5.1
18077,2020-08-01,14773,13801,972,6.6
18079,2020-08-01,13640,12808,832,6.1
18081,2020-08-01,83045,78288,4757,5.7
18083,2020-08-01,18103,17133,970,5.4
18085,2020-08-01,41317,38915,2402,5.8
18087,2020-08-01,19440,18627,813,4.2
18089,2020-08-01,226903,202838,24065,10.6
18091,2020-08-01,47294,42838,4456,9.4
18093,2020-08-01,20789,19425,1364,6.6
18095,2020-08-01,59074,54539,4535,7.7
18097,2020-08-01,506983,460130,46853,9.2
18099,2020-08-01,22584,21277,1307,5.8
18101,2020-08-01,5416,5185,231,4.3
18103,2020-08-01,14986,13902,1084,7.2
18105,2020-08-01,67536,63454,4082,6
18107,2020-08-01,18595,17656,939,5
18109,2020-08-01,35979,34010,1969,5.5
18111,2020-08-01,6570,6144,426,6.5
18113,2020-08-01,22497,21094,1403,6.2
18115,2020-08-01,3154,2936,218,6.9
18117,2020-08-01,8339,7511,828,9.9
18119,2020-08-01,8920,8326,594,6.7
18121,2020-08-01,7024,6655,369,5.3
18123,2020-08-01,9158,8603,555,6.1
18125,2020-08-01,6126,5784,342,5.6
18127,2020-08-01,84202,77563,6639,7.9
18129,2020-08-01,12824,12208,616,4.8
18131,2020-08-01,6391,6026,365,5.7
18133,2020-08-01,16402,15428,974,5.9
18135,2020-08-01,11029,10340,689,6.2
18137,2020-08-01,13911,13158,753,5.4
18139,2020-08-01,8669,8218,451,5.2
18141,2020-08-01,134289,122484,11805,8.8
18143,2020-08-01,10442,9653,789,7.6
18145,2020-08-01,23092,21605,1487,6.4
18147,2020-08-01,10675,10126,549,5.1
18149,2020-08-01,9825,9117,708,7.2
18151,2020-08-01,20126,19094,1032,5.1
18153,2020-08-01,7776,7255,521,6.7
18155,2020-08-01,4752,4412,340,7.2
18157,2020-08-01,92416,86056,6360,6.9
18159,2020-08-01,9038,8590,448,5
18161,2020-08-01,3415,3249,166,4.9
18163,2020-08-01,92075,85176,6899,7.5
18165,2020-08-01,6484,6033,451,7
18167,2020-08-01,45678,41890,3788,8.3
18169,2020-08-01,14216,13407,809,5.7
18171,2020-08-01,3960,3760,200,5.1
18173,2020-08-01,31720,30041,1679,5.3
18175,2020-08-01,13424,12563,861,6.4
18177,2020-08-01,29997,27806,2191,7.3
18179,2020-08-01,14078,13370,708,5
18181,2020-08-01,13374,12720,654,4.9
18183,2020-08-01,17222,16353,869,5
19001,2020-08-01,4058,3926,132,3.3
19003,2020-08-01,1951,1882,69,3.5
19005,2020-08-01,6662,6422,240,3.6
19007,2020-08-01,5739,5465,274,4.8
19009,2020-08-01,2920,2840,80,2.7
19011,2020-08-01,12481,11861,620,5
19013,2020-08-01,66113,62355,3758,5.7
19015,2020-08-01,14108,13592,516,3.7
19017,2020-08-01,13129,12711,418,3.2
19019,2020-08-01,10731,10312,419,3.9
19021,2020-08-01,11039,10629,410,3.7
19023,2020-08-01,7400,7138,262,3.5
19025,2020-08-01,3896,3755,141,3.6
19027,2020-08-01,10366,10006,360,3.5
19029,2020-08-01,6551,6338,213,3.3
19031,2020-08-01,9992,9602,390,3.9
19033,2020-08-01,22837,21770,1067,4.7
19035,2020-08-01,6049,5860,189,3.1
19037,2020-08-01,6007,5772,235,3.9
19039,2020-08-01,4670,4460,210,4.5
19041,2020-08-01,8125,7814,311,3.8
19043,2020-08-01,9479,9112,367,3.9
19045,2020-08-01,21321,19938,1383,6.5
19047,2020-08-01,7595,7272,323,4.3
19049,2020-08-01,48762,47138,1624,3.3
19051,2020-08-01,3988,3841,147,3.7
19053,2020-08-01,4073,3937,136,3.3
19055,2020-08-01,10108,9786,322,3.2
19057,2020-08-01,18501,17334,1167,6.3
19059,2020-08-01,10166,9837,329,3.2
19061,2020-08-01,53731,51007,2724,5.1
19063,2020-08-01,4796,4602,194,4
19065,2020-08-01,9694,9260,434,4.5
19067,2020-08-01,8020,7568,452,5.6
19069,2020-08-01,5426,5258,168,3.1
19071,2020-08-01,3591,3489,102,2.8
19073,2020-08-01,5146,4962,184,3.6
19075,2020-08-01,6055,5826,229,3.8
19077,2020-08-01,5235,5007,228,4.4
19079,2020-08-01,6651,6392,259,3.9
19081,2020-08-01,5557,5340,217,3.9
19083,2020-08-01,7511,7205,306,4.1
19085,2020-08-01,6888,6660,228,3.3
19087,2020-08-01,9125,8708,417,4.6
19089,2020-08-01,4963,4803,160,3.2
19091,2020-08-01,4745,4588,157,3.3
19093,2020-08-01,3813,3685,128,3.4
19095,2020-08-01,9611,9249,362,3.8
19097,2020-08-01,10346,9771,575,5.6
19099,2020-08-01,18560,17679,881,4.7
19101,2020-08-01,9071,8547,524,5.8
19103,2020-08-01,83486,79197,4289,5.1
19105,2020-08-01,9794,9311,483,4.9
19107,2020-08-01,4952,4749,203,4.1
19109,2020-08-01,7725,7475,250,3.2
19111,2020-08-01,15291,14385,906,5.9
19113,2020-08-01,116555,108371,8184,7
19115,2020-08-01,5795,5567,228,3.9
19117,2020-08-01,4561,4408,153,3.4
19119,2020-08-01,6665,6530,135,2
19121,2020-08-01,8141,7752,389,4.8
19123,2020-08-01,11519,11056,463,4
19125,2020-08-01,17605,17018,587,3.3
19127,2020-08-01,17004,16048,956,5.6
19129,2020-08-01,7030,6781,249,3.5
19131,2020-08-01,6044,5890,154,2.5
19133,2020-08-01,4211,4047,164,3.9
19135,2020-08-01,3841,3655,186,4.8
19137,2020-08-01,4757,4546,211,4.4
19139,2020-08-01,20536,19471,1065,5.2
19141,2020-08-01,7881,7636,245,3.1
19143,2020-08-01,3360,3276,84,2.5
19145,2020-08-01,6053,5795,258,4.3
19147,2020-08-01,4264,4091,173,4.1
19149,2020-08-01,13926,13472,454,3.3
19151,2020-08-01,4098,3961,137,3.3
19153,2020-08-01,261964,246985,14979,5.7
19155,2020-08-01,46748,44480,2268,4.9
19157,2020-08-01,9333,8943,390,4.2
19159,2020-08-01,2315,2239,76,3.3
19161,2020-08-01,5036,4902,134,2.7
19163,2020-08-01,85101,79665,5436,6.4
19165,2020-08-01,6179,5991,188,3
19167,2020-08-01,19703,19279,424,2.2
19169,2020-08-01,54861,52925,1936,3.5
19171,2020-08-01,8866,8448,418,4.7
19173,2020-08-01,2948,2861,87,3
19175,2020-08-01,5986,5666,320,5.3
19177,2020-08-01,3626,3478,148,4.1
19179,2020-08-01,17099,16099,1000,5.8
19181,2020-08-01,27157,26088,1069,3.9
19183,2020-08-01,11152,10783,369,3.3
19185,2020-08-01,2685,2577,108,4
19187,2020-08-01,18169,17273,896,4.9
19189,2020-08-01,4945,4707,238,4.8
19191,2020-08-01,10534,10157,377,3.6
19193,2020-08-01,53653,51040,2613,4.9
19195,2020-08-01,3951,3807,144,3.6
19197,2020-08-01,6790,6545,245,3.6
20001,2020-08-01,6290,5883,407,6.5
20003,2020-08-01,4334,4128,206,4.8
20005,2020-08-01,6924,6422,502,7.3
20007,2020-08-01,2341,2252,89,3.8
20009,2020-08-01,13653,12985,668,4.9
20011,2020-08-01,6800,6344,456,6.7
20013,2020-08-01,5156,4933,223,4.3
20015,2020-08-01,32583,30324,2259,6.9
20017,2020-08-01,1500,1387,113,7.5
20019,2020-08-01,1510,1391,119,7.9
20021,2020-08-01,9972,9415,557,5.6
20023,2020-08-01,1315,1287,28,2.1
20025,2020-08-01,1180,1154,26,2.2
20027,2020-08-01,3857,3672,185,4.8
20029,2020-08-01,3878,3701,177,4.6
20031,2020-08-01,3768,3552,216,5.7
20033,2020-08-01,872,837,35,4
20035,2020-08-01,17066,15832,1234,7.2
20037,2020-08-01,19010,17859,1151,6.1
20039,2020-08-01,1307,1256,51,3.9
20041,2020-08-01,8857,8432,425,4.8
20043,2020-08-01,4208,4016,192,4.6
20045,2020-08-01,64205,59956,4249,6.6
20047,2020-08-01,1488,1435,53,3.6
20049,2020-08-01,1140,1069,71,6.2
20051,2020-08-01,16770,16177,593,3.5
20053,2020-08-01,2797,2699,98,3.5
20055,2020-08-01,20576,19793,783,3.8
20057,2020-08-01,17676,16991,685,3.9
20059,2020-08-01,14227,13314,913,6.4
20061,2020-08-01,11563,10600,963,8.3
20063,2020-08-01,1476,1437,39,2.6
20065,2020-08-01,1139,1068,71,6.2
20067,2020-08-01,3184,3007,177,5.6
20069,2020-08-01,3163,3089,74,2.3
20071,2020-08-01,825,809,16,1.9
20073,2020-08-01,3016,2843,173,5.7
20075,2020-08-01,1735,1705,30,1.7
20077,2020-08-01,2796,2641,155,5.5
20079,2020-08-01,16952,16006,946,5.6
20081,2020-08-01,2259,2203,56,2.5
20083,2020-08-01,1046,1020,26,2.5
20085,2020-08-01,7248,6908,340,4.7
20087,2020-08-01,10327,9840,487,4.7
20089,2020-08-01,1286,1243,43,3.3
20091,2020-08-01,345615,326912,18703,5.4
20093,2020-08-01,2039,1978,61,3
20095,2020-08-01,3400,3207,193,5.7
20097,2020-08-01,1244,1197,47,3.8
20099,2020-08-01,9733,9100,633,6.5
20101,2020-08-01,756,732,24,3.2
20103,2020-08-01,37094,34897,2197,5.9
20105,2020-08-01,1671,1612,59,3.5
20107,2020-08-01,4460,4125,335,7.5
20109,2020-08-01,1506,1468,38,2.5
20111,2020-08-01,16689,15860,829,5
20113,2020-08-01,17266,16644,622,3.6
20115,2020-08-01,5875,5614,261,4.4
20117,2020-08-01,5608,5433,175,3.1
20119,2020-08-01,2191,2124,67,3.1
20121,2020-08-01,17846,16930,916,5.1
20123,2020-08-01,3472,3365,107,3.1
20125,2020-08-01,14909,13677,1232,8.3
20127,2020-08-01,3120,2976,144,4.6
20129,2020-08-01,1134,1090,44,3.9
20131,2020-08-01,5761,5613,148,2.6
20133,2020-08-01,6375,5895,480,7.5
20135,2020-08-01,1360,1306,54,4
20137,2020-08-01,2700,2624,76,2.8
20139,2020-08-01,8125,7701,424,5.2
20141,2020-08-01,2001,1945,56,2.8
20143,2020-08-01,3042,2899,143,4.7
20145,2020-08-01,2936,2824,112,3.8
20147,2020-08-01,2587,2498,89,3.4
20149,2020-08-01,11909,11383,526,4.4
20151,2020-08-01,4923,4722,201,4.1
20153,2020-08-01,1595,1549,46,2.9
20155,2020-08-01,29371,27594,1777,6.1
20157,2020-08-01,2390,2301,89,3.7
20159,2020-08-01,5070,4838,232,4.6
20161,2020-08-01,33918,32029,1889,5.6
20163,2020-08-01,2560,2446,114,4.5
20165,2020-08-01,1579,1501,78,4.9
20167,2020-08-01,3358,3205,153,4.6
20169,2020-08-01,30195,28416,1779,5.9
20171,2020-08-01,2850,2777,73,2.6
20173,2020-08-01,259152,233674,25478,9.8
20175,2020-08-01,10000,9510,490,4.9
20177,2020-08-01,92453,86744,5709,6.2
20179,2020-08-01,1515,1474,41,2.7
20181,2020-08-01,2965,2858,107,3.6
20183,2020-08-01,2004,1946,58,2.9
20185,2020-08-01,2054,1967,87,4.2
20187,2020-08-01,1090,1065,25,2.3
20189,2020-08-01,2831,2732,99,3.5
20191,2020-08-01,11165,10150,1015,9.1
20193,2020-08-01,4285,4155,130,3
20195,2020-08-01,1500,1451,49,3.3
20197,2020-08-01,3739,3602,137,3.7
20199,2020-08-01,857,842,15,1.8
20201,2020-08-01,3113,3037,76,2.4
20203,2020-08-01,1246,1221,25,2
20205,2020-08-01,3913,3587,326,8.3
20207,2020-08-01,1567,1457,110,7
20209,2020-08-01,79585,72876,6709,8.4
21001,2020-08-01,6604,6243,361,5.5
21003,2020-08-01,8597,8236,361,4.2
21005,2020-08-01,11426,10868,558,4.9
21007,2020-08-01,3332,3169,163,4.9
21009,2020-08-01,17577,16559,1018,5.8
21011,2020-08-01,4464,4207,257,5.8
21013,2020-08-01,7939,7432,507,6.4
21015,2020-08-01,69009,65975,3034,4.4
21017,2020-08-01,9415,9028,387,4.1
21019,2020-08-01,17015,15848,1167,6.9
21021,2020-08-01,12112,11376,736,6.1
21023,2020-08-01,3650,3483,167,4.6
21025,2020-08-01,3136,2872,264,8.4
21027,2020-08-01,7637,7242,395,5.2
21029,2020-08-01,41126,39309,1817,4.4
21031,2020-08-01,4788,4556,232,4.8
21033,2020-08-01,5474,5212,262,4.8
21035,2020-08-01,17475,16614,861,4.9
21037,2020-08-01,48857,46603,2254,4.6
21039,2020-08-01,2141,2065,76,3.5
21041,2020-08-01,5218,4958,260,5
21043,2020-08-01,9233,8560,673,7.3
21045,2020-08-01,6504,6205,299,4.6
21047,2020-08-01,23934,22457,1477,6.2
21049,2020-08-01,16646,15763,883,5.3
21051,2020-08-01,5119,4756,363,7.1
21053,2020-08-01,3872,3707,165,4.3
21055,2020-08-01,3596,3450,146,4.1
21057,2020-08-01,3165,3052,113,3.6
21059,2020-08-01,45081,42944,2137,4.7
21061,2020-08-01,4460,4228,232,5.2
21063,2020-08-01,1856,1718,138,7.4
21065,2020-08-01,4995,4707,288,5.8
21067,2020-08-01,169554,161396,8158,4.8
21069,2020-08-01,6011,5721,290,4.8
21071,2020-08-01,10256,9447,809,7.9
21073,2020-08-01,24108,22751,1357,5.6
21075,2020-08-01,1964,1843,121,6.2
21077,2020-08-01,3944,3756,188,4.8
21079,2020-08-01,7322,6966,356,4.9
21081,2020-08-01,11265,10642,623,5.5
21083,2020-08-01,15336,14612,724,4.7
21085,2020-08-01,10319,9687,632,6.1
21087,2020-08-01,4840,4654,186,3.8
21089,2020-08-01,12783,11899,884,6.9
21091,2020-08-01,3736,3581,155,4.1
21093,2020-08-01,46295,43812,2483,5.4
21095,2020-08-01,6144,5471,673,11
21097,2020-08-01,8457,8104,353,4.2
21099,2020-08-01,7321,7006,315,4.3
21101,2020-08-01,20415,19517,898,4.4
21103,2020-08-01,7915,7600,315,4
21105,2020-08-01,1676,1599,77,4.6
21107,2020-08-01,17794,16815,979,5.5
21109,2020-08-01,3837,3577,260,6.8
21111,2020-08-01,384411,362792,21619,5.6
21113,2020-08-01,25627,24462,1165,4.5
21115,2020-08-01,6437,5971,466,7.2
21117,2020-08-01,84733,80688,4045,4.8
21119,2020-08-01,4157,3842,315,7.6
21121,2020-08-01,9737,9073,664,6.8
21123,2020-08-01,5595,5331,264,4.7
21125,2020-08-01,24235,22948,1287,5.3
21127,2020-08-01,5049,4716,333,6.6
21129,2020-08-01,1984,1879,105,5.3
21131,2020-08-01,2477,2259,218,8.8
21133,2020-08-01,5930,5390,540,9.1
21135,2020-08-01,4436,4152,284,6.4
21137,2020-08-01,8985,8413,572,6.4
21139,2020-08-01,3513,3320,193,5.5
21141,2020-08-01,11842,11370,472,4
21143,2020-08-01,3178,3052,126,4
21145,2020-08-01,28292,26760,1532,5.4
21147,2020-08-01,4632,4377,255,5.5
21149,2020-08-01,3987,3806,181,4.5
21151,2020-08-01,44352,42260,2092,4.7
21153,2020-08-01,3067,2665,402,13.1
21155,2020-08-01,9161,8727,434,4.7
21157,2020-08-01,14604,13957,647,4.4
21159,2020-08-01,2380,2126,254,10.7
21161,2020-08-01,6727,6329,398,5.9
21163,2020-08-01,11438,10832,606,5.3
21165,2020-08-01,2221,2079,142,6.4
21167,2020-08-01,9590,9029,561,5.8
21169,2020-08-01,3860,3641,219,5.7
21171,2020-08-01,4408,4222,186,4.2
21173,2020-08-01,11186,10543,643,5.7
21175,2020-08-01,4242,4028,214,5
21177,2020-08-01,9600,8897,703,7.3
21179,2020-08-01,22326,21334,992,4.4
21181,2020-08-01,3183,3020,163,5.1
21183,2020-08-01,9049,8536,513,5.7
21185,2020-08-01,31906,30782,1124,3.5
21187,2020-08-01,4937,4695,242,4.9
21189,2020-08-01,1033,972,61,5.9
21191,2020-08-01,6651,6389,262,3.9
21193,2020-08-01,7783,7176,607,7.8
21195,2020-08-01,18452,17163,1289,7
21197,2020-08-01,5008,4732,276,5.5
21199,2020-08-01,25124,23743,1381,5.5
21201,2020-08-01,774,741,33,4.3
21203,2020-08-01,6174,5857,317,5.1
21205,2020-08-01,9651,9127,524,5.4
21207,2020-08-01,5944,5619,325,5.5
21209,2020-08-01,28525,27366,1159,4.1
21211,2020-08-01,24771,23782,989,4
21213,2020-08-01,8472,8040,432,5.1
21215,2020-08-01,10013,9629,384,3.8
21217,2020-08-01,12424,11907,517,4.2
21219,2020-08-01,5340,5145,195,3.7
21221,2020-08-01,5877,5581,296,5
21223,2020-08-01,3692,3528,164,4.4
21225,2020-08-01,5919,5681,238,4
21227,2020-08-01,61963,58937,3026,4.9
21229,2020-08-01,5991,5755,236,3.9
21231,2020-08-01,7295,6930,365,5
21233,2020-08-01,5273,5023,250,4.7
21235,2020-08-01,13533,12736,797,5.9
21237,2020-08-01,1952,1835,117,6
21239,2020-08-01,14747,14154,593,4
22001,2020-08-01,23831,22063,1768,7.4
22003,2020-08-01,8217,7468,749,9.1
22005,2020-08-01,64798,60660,4138,6.4
22007,2020-08-01,8938,8031,907,10.1
22009,2020-08-01,15392,14198,1194,7.8
22011,2020-08-01,14633,13720,913,6.2
22013,2020-08-01,5564,5118,446,8
22015,2020-08-01,57504,53995,3509,6.1
22017,2020-08-01,104639,94902,9737,9.3
22019,2020-08-01,97430,88981,8449,8.7
22021,2020-08-01,3740,3484,256,6.8
22023,2020-08-01,3491,3309,182,5.2
22025,2020-08-01,3658,3394,264,7.2
22027,2020-08-01,5525,5156,369,6.7
22029,2020-08-01,7127,6542,585,8.2
22031,2020-08-01,10789,10010,779,7.2
22033,2020-08-01,232565,214216,18349,7.9
22035,2020-08-01,1868,1645,223,11.9
22037,2020-08-01,7891,7358,533,6.8
22039,2020-08-01,11960,10970,990,8.3
22041,2020-08-01,7584,6977,607,8
22043,2020-08-01,8314,7805,509,6.1
22045,2020-08-01,28541,25678,2863,10
22047,2020-08-01,14242,12778,1464,10.3
22049,2020-08-01,6778,6433,345,5.1
22051,2020-08-01,212295,192545,19750,9.3
22053,2020-08-01,13004,12073,931,7.2
22055,2020-08-01,115327,107215,8112,7
22057,2020-08-01,41907,39286,2621,6.3
22059,2020-08-01,7079,6754,325,4.6
22061,2020-08-01,20934,19606,1328,6.3
22063,2020-08-01,68991,64838,4153,6
22065,2020-08-01,3613,3319,294,8.1
22067,2020-08-01,10369,9367,1002,9.7
22069,2020-08-01,16361,15177,1184,7.2
22071,2020-08-01,184053,160355,23698,12.9
22073,2020-08-01,71272,66053,5219,7.3
22075,2020-08-01,9659,9013,646,6.7
22077,2020-08-01,9804,9037,767,7.8
22079,2020-08-01,56247,52796,3451,6.1
22081,2020-08-01,3712,3477,235,6.3
22083,2020-08-01,8392,7758,634,7.6
22085,2020-08-01,9384,8858,526,5.6
22087,2020-08-01,20180,18081,2099,10.4
22089,2020-08-01,24645,22783,1862,7.6
22091,2020-08-01,4433,3865,568,12.8
22093,2020-08-01,9110,8189,921,10.1
22095,2020-08-01,19634,17330,2304,11.7
22097,2020-08-01,33106,30156,2950,8.9
22099,2020-08-01,22390,20514,1876,8.4
22101,2020-08-01,19872,17996,1876,9.4
22103,2020-08-01,116341,109080,7261,6.2
22105,2020-08-01,57528,51971,5557,9.7
22107,2020-08-01,1403,1297,106,7.6
22109,2020-08-01,46835,43189,3646,7.8
22111,2020-08-01,9176,8517,659,7.2
22113,2020-08-01,24145,22353,1792,7.4
22115,2020-08-01,16340,15269,1071,6.6
22117,2020-08-01,16840,15411,1429,8.5
22119,2020-08-01,14313,13185,1128,7.9
22121,2020-08-01,13703,12707,996,7.3
22123,2020-08-01,3698,3388,310,8.4
22125,2020-08-01,5329,5066,263,4.9
22127,2020-08-01,4812,4459,353,7.3
23001,2020-08-01,54264,51680,2584,4.8
23003,2020-08-01,29640,28417,1223,4.1
23005,2020-08-01,161686,154632,7054,4.4
23007,2020-08-01,13815,13139,676,4.9
23009,2020-08-01,30008,28917,1091,3.6
23011,2020-08-01,61840,59402,2438,3.9
23013,2020-08-01,20334,19538,796,3.9
23015,2020-08-01,17377,16689,688,4
23017,2020-08-01,26065,24582,1483,5.7
23019,2020-08-01,73679,70558,3121,4.2
23021,2020-08-01,7314,7025,289,4
23023,2020-08-01,19523,18765,758,3.9
23025,2020-08-01,22571,21488,1083,4.8
23027,2020-08-01,20471,19649,822,4
23029,2020-08-01,13689,13103,586,4.3
23031,2020-08-01,112285,107436,4849,4.3
24001,2020-08-01,30726,28160,2566,8.4
24003,2020-08-01,308147,286269,21878,7.1
24005,2020-08-01,444636,406757,37879,8.5
24009,2020-08-01,48007,44976,3031,6.3
24011,2020-08-01,17778,16653,1125,6.3
24013,2020-08-01,91723,86189,5534,6
24015,2020-08-01,51985,48322,3663,7
24017,2020-08-01,85969,78469,7500,8.7
24019,2020-08-01,16194,14966,1228,7.6
24021,2020-08-01,132485,122942,9543,7.2
24023,2020-08-01,15458,14472,986,6.4
24025,2020-08-01,137049,127500,9549,7
24027,2020-08-01,183221,171381,11840,6.5
24029,2020-08-01,9379,8693,686,7.3
24031,2020-08-01,552801,507357,45444,8.2
24033,2020-08-01,507619,452433,55186,10.9
24035,2020-08-01,26640,24960,1680,6.3
24037,2020-08-01,57047,53618,3429,6
24039,2020-08-01,9015,8186,829,9.2
24041,2020-08-01,17741,16606,1135,6.4
24043,2020-08-01,72439,66688,5751,7.9
24045,2020-08-01,51723,47769,3954,7.6
24047,2020-08-01,25517,23190,2327,9.1
24510,2020-08-01,283348,251240,32108,11.3
25001,2020-08-01,115499,105922,9577,8.3
25003,2020-08-01,62491,56867,5624,9
25005,2020-08-01,292514,263452,29062,9.9
25007,2020-08-01,11781,11126,655,5.6
25009,2020-08-01,414708,372357,42351,10.2
25011,2020-08-01,38951,36046,2905,7.5
25013,2020-08-01,218779,194844,23935,10.9
25015,2020-08-01,84534,78465,6069,7.2
25017,2020-08-01,879840,812904,66936,7.6
25019,2020-08-01,9813,9337,476,4.9
25021,2020-08-01,378807,345973,32834,8.7
25023,2020-08-01,276226,250370,25856,9.4
25025,2020-08-01,450331,400527,49804,11.1
25027,2020-08-01,430252,391347,38905,9
26001,2020-08-01,4018,3743,275,6.8
26003,2020-08-01,3346,3131,215,6.4
26005,2020-08-01,62867,59645,3222,5.1
26007,2020-08-01,13181,12408,773,5.9
26009,2020-08-01,10739,10068,671,6.2
26011,2020-08-01,5999,5567,432,7.2
26013,2020-08-01,3140,2862,278,8.9
26015,2020-08-01,31396,29661,1735,5.5
26017,2020-08-01,49669,46356,3313,6.7
26019,2020-08-01,9002,8470,532,5.9
26021,2020-08-01,73661,68405,5256,7.1
26023,2020-08-01,19932,18734,1198,6
26025,2020-08-01,61313,56536,4777,7.8
26027,2020-08-01,24394,22774,1620,6.6
26029,2020-08-01,13403,12642,761,5.7
26031,2020-08-01,10870,10189,681,6.3
26033,2020-08-01,16257,15227,1030,6.3
26035,2020-08-01,11778,10799,979,8.3
26037,2020-08-01,39348,37421,1927,4.9
26039,2020-08-01,5826,5395,431,7.4
26041,2020-08-01,17041,16026,1015,6
26043,2020-08-01,12421,11776,645,5.2
26045,2020-08-01,54555,51374,3181,5.8
26047,2020-08-01,18301,17241,1060,5.8
26049,2020-08-01,179730,164152,15578,8.7
26051,2020-08-01,10071,9382,689,6.8
26053,2020-08-01,5780,5421,359,6.2
26055,2020-08-01,51269,48380,2889,5.6
26057,2020-08-01,17853,16826,1027,5.8
26059,2020-08-01,20414,19140,1274,6.2
26061,2020-08-01,15866,14943,923,5.8
26063,2020-08-01,15967,15120,847,5.3
26065,2020-08-01,144183,134792,9391,6.5
26067,2020-08-01,30652,29008,1644,5.4
26069,2020-08-01,10432,9699,733,7
26071,2020-08-01,5117,4833,284,5.6
26073,2020-08-01,33173,31127,2046,6.2
26075,2020-08-01,72878,67692,5186,7.1
26077,2020-08-01,130862,122578,8284,6.3
26079,2020-08-01,8188,7576,612,7.5
26081,2020-08-01,357234,335090,22144,6.2
26083,2020-08-01,881,821,60,6.8
26085,2020-08-01,4112,3765,347,8.4
26087,2020-08-01,39977,36479,3498,8.8
26089,2020-08-01,10809,10255,554,5.1
26091,2020-08-01,45153,42295,2858,6.3
26093,2020-08-01,101242,94105,7137,7
26095,2020-08-01,2372,2233,139,5.9
26097,2020-08-01,6216,5984,232,3.7
26099,2020-08-01,444900,399562,45338,10.2
26101,2020-08-01,10623,9844,779,7.3
26103,2020-08-01,31844,30061,1783,5.6
26105,2020-08-01,13835,12945,890,6.4
26107,2020-08-01,17975,16794,1181,6.6
26109,2020-08-01,10809,10284,525,4.9
26111,2020-08-01,39928,37698,2230,5.6
26113,2020-08-01,7197,6784,413,5.7
26115,2020-08-01,73011,68324,4687,6.4
26117,2020-08-01,27924,26097,1827,6.5
26119,2020-08-01,3107,2833,274,8.8
26121,2020-08-01,77902,70746,7156,9.2
26123,2020-08-01,23313,21824,1489,6.4
26125,2020-08-01,664580,608736,55844,8.4
26127,2020-08-01,12777,11866,911,7.1
26129,2020-08-01,8303,7688,615,7.4
26131,2020-08-01,2068,1906,162,7.8
26133,2020-08-01,11740,11066,674,5.7
26135,2020-08-01,3024,2772,252,8.3
26137,2020-08-01,11870,11067,803,6.8
26139,2020-08-01,158912,150828,8084,5.1
26141,2020-08-01,5136,4777,359,7
26143,2020-08-01,8294,7644,650,7.8
26145,2020-08-01,84581,77936,6645,7.9
26147,2020-08-01,74174,67406,6768,9.1
26149,2020-08-01,29231,27310,1921,6.6
26151,2020-08-01,19859,18653,1206,6.1
26153,2020-08-01,3259,3054,205,6.3
26155,2020-08-01,32373,30304,2069,6.4
26157,2020-08-01,23485,21898,1587,6.8
26159,2020-08-01,34722,32515,2207,6.4
26161,2020-08-01,191852,180751,11101,5.8
26163,2020-08-01,812499,704274,108225,13.3
26165,2020-08-01,15262,14198,1064,7
27001,2020-08-01,7644,7173,471,6.2
27003,2020-08-01,200112,186827,13285,6.6
27005,2020-08-01,19002,18064,938,4.9
27007,2020-08-01,25399,24041,1358,5.3
27009,2020-08-01,21861,20664,1197,5.5
27011,2020-08-01,2530,2455,75,3
27013,2020-08-01,39581,37344,2237,5.7
27015,2020-08-01,14359,13762,597,4.2
27017,2020-08-01,17568,16390,1178,6.7
27019,2020-08-01,59230,56041,3189,5.4
27021,2020-08-01,15017,13873,1144,7.6
27023,2020-08-01,6684,6403,281,4.2
27025,2020-08-01,30134,28377,1757,5.8
27027,2020-08-01,36032,34674,1358,3.8
27029,2020-08-01,4490,4237,253,5.6
27031,2020-08-01,3218,3047,171,5.3
27033,2020-08-01,6212,5965,247,4
27035,2020-08-01,33085,31193,1892,5.7
27037,2020-08-01,244927,228651,16276,6.6
27039,2020-08-01,12136,11617,519,4.3
27041,2020-08-01,21950,21113,837,3.8
27043,2020-08-01,7289,6923,366,5
27045,2020-08-01,11784,11304,480,4.1
27047,2020-08-01,15916,15050,866,5.4
27049,2020-08-01,27047,25645,1402,5.2
27051,2020-08-01,3334,3201,133,4
27053,2020-08-01,724540,669362,55178,7.6
27055,2020-08-01,10220,9861,359,3.5
27057,2020-08-01,10443,9925,518,5
27059,2020-08-01,21368,20111,1257,5.9
27061,2020-08-01,22640,21016,1624,7.2
27063,2020-08-01,5877,5656,221,3.8
27065,2020-08-01,8955,8466,489,5.5
27067,2020-08-01,24822,23810,1012,4.1
27069,2020-08-01,2402,2307,95,4
27071,2020-08-01,5898,5544,354,6
27073,2020-08-01,3403,3270,133,3.9
27075,2020-08-01,5559,5242,317,5.7
27077,2020-08-01,2456,2325,131,5.3
27079,2020-08-01,16091,15236,855,5.3
27081,2020-08-01,3107,3017,90,2.9
27083,2020-08-01,14256,13660,596,4.2
27085,2020-08-01,19353,18343,1010,5.2
27087,2020-08-01,2152,1851,301,14
27089,2020-08-01,5299,5101,198,3.7
27091,2020-08-01,10238,9780,458,4.5
27093,2020-08-01,13280,12747,533,4
27095,2020-08-01,12807,11951,856,6.7
27097,2020-08-01,17856,17096,760,4.3
27099,2020-08-01,20811,19827,984,4.7
27101,2020-08-01,4775,4602,173,3.6
27103,2020-08-01,20453,19405,1048,5.1
27105,2020-08-01,11551,11078,473,4.1
27107,2020-08-01,3271,3103,168,5.1
27109,2020-08-01,92748,87817,4931,5.3
27111,2020-08-01,32363,31083,1280,4
27113,2020-08-01,8533,8213,320,3.8
27115,2020-08-01,14570,13578,992,6.8
27117,2020-08-01,4724,4584,140,3
27119,2020-08-01,16045,15251,794,4.9
27121,2020-08-01,6669,6403,266,4
27123,2020-08-01,295757,272145,23612,8
27125,2020-08-01,2177,2095,82,3.8
27127,2020-08-01,7823,7457,366,4.7
27129,2020-08-01,8722,8356,366,4.2
27131,2020-08-01,37521,35592,1929,5.1
27133,2020-08-01,5962,5791,171,2.9
27135,2020-08-01,7724,7381,343,4.4
27137,2020-08-01,100216,93377,6839,6.8
27139,2020-08-01,84579,79437,5142,6.1
27141,2020-08-01,52374,49519,2855,5.5
27143,2020-08-01,8371,7972,399,4.8
27145,2020-08-01,90587,85782,4805,5.3
27147,2020-08-01,20335,19262,1073,5.3
27149,2020-08-01,5488,5333,155,2.8
27151,2020-08-01,5022,4713,309,6.2
27153,2020-08-01,13689,13128,561,4.1
27155,2020-08-01,1727,1677,50,2.9
27157,2020-08-01,12574,12042,532,4.2
27159,2020-08-01,5967,5642,325,5.4
27161,2020-08-01,9247,8723,524,5.7
27163,2020-08-01,144566,136208,8358,5.8
27165,2020-08-01,6609,6338,271,4.1
27167,2020-08-01,3425,3319,106,3.1
27169,2020-08-01,28368,27013,1355,4.8
27171,2020-08-01,75928,72129,3799,5
27173,2020-08-01,5249,5056,193,3.7
28001,2020-08-01,10690,9483,1207,11.3
28003,2020-08-01,15181,14312,869,5.7
28005,2020-08-01,4490,4084,406,9
28007,2020-08-01,6924,6330,594,8.6
28009,2020-08-01,2975,2718,257,8.6
28011,2020-08-01,11377,10373,1004,8.8
28013,2020-08-01,5522,5134,388,7
28015,2020-08-01,3415,3156,259,7.6
28017,2020-08-01,6898,6266,632,9.2
28019,2020-08-01,3581,3363,218,6.1
28021,2020-08-01,3100,2632,468,15.1
28023,2020-08-01,5869,5363,506,8.6
28025,2020-08-01,7985,7123,862,10.8
28027,2020-08-01,8191,7153,1038,12.7
28029,2020-08-01,10748,9879,869,8.1
28031,2020-08-01,8446,7842,604,7.2
28033,2020-08-01,90060,84261,5799,6.4
28035,2020-08-01,32998,30293,2705,8.2
28037,2020-08-01,2757,2516,241,8.7
28039,2020-08-01,9114,8218,896,9.8
28041,2020-08-01,4362,3900,462,10.6
28043,2020-08-01,9205,8554,651,7.1
28045,2020-08-01,18797,17347,1450,7.7
28047,2020-08-01,87345,80370,6975,8
28049,2020-08-01,104419,95055,9364,9
28051,2020-08-01,5245,4404,841,16
28053,2020-08-01,2177,1836,341,15.7
28055,2020-08-01,325,296,29,8.9
28057,2020-08-01,10301,9719,582,5.6
28059,2020-08-01,58742,53712,5030,8.6
28061,2020-08-01,6042,5500,542,9
28063,2020-08-01,2022,1624,398,19.7
28065,2020-08-01,4005,3608,397,9.9
28067,2020-08-01,25496,23649,1847,7.2
28069,2020-08-01,3399,3082,317,9.3
28071,2020-08-01,26182,24677,1505,5.7
28073,2020-08-01,30459,28697,1762,5.8
28075,2020-08-01,29585,27541,2044,6.9
28077,2020-08-01,4686,4250,436,9.3
28079,2020-08-01,7922,7342,580,7.3
28081,2020-08-01,41292,38481,2811,6.8
28083,2020-08-01,9792,8726,1066,10.9
28085,2020-08-01,14545,13486,1059,7.3
28087,2020-08-01,24910,22899,2011,8.1
28089,2020-08-01,52027,49135,2892,5.6
28091,2020-08-01,10264,9510,754,7.3
28093,2020-08-01,14099,12924,1175,8.3
28095,2020-08-01,15691,14454,1237,7.9
28097,2020-08-01,3907,3598,309,7.9
28099,2020-08-01,10280,9457,823,8
28101,2020-08-01,7872,7258,614,7.8
28103,2020-08-01,3865,3410,455,11.8
28105,2020-08-01,22270,20663,1607,7.2
28107,2020-08-01,12762,11487,1275,10
28109,2020-08-01,23183,21413,1770,7.6
28111,2020-08-01,4252,3864,388,9.1
28113,2020-08-01,14812,13437,1375,9.3
28115,2020-08-01,14831,13907,924,6.2
28117,2020-08-01,11031,10359,672,6.1
28119,2020-08-01,2342,2069,273,11.7
28121,2020-08-01,74133,70735,3398,4.6
28123,2020-08-01,12725,12045,680,5.3
28125,2020-08-01,1407,1263,144,10.2
28127,2020-08-01,10462,9742,720,6.9
28129,2020-08-01,6595,6216,379,5.7
28131,2020-08-01,7037,6531,506,7.2
28133,2020-08-01,7408,6531,877,11.8
28135,2020-08-01,5111,4723,388,7.6
28137,2020-08-01,11920,10937,983,8.2
28139,2020-08-01,9212,8639,573,6.2
28141,2020-08-01,8343,7820,523,6.3
28143,2020-08-01,4514,3846,668,14.8
28145,2020-08-01,13951,13123,828,5.9
28147,2020-08-01,5002,4557,445,8.9
28149,2020-08-01,20027,18302,1725,8.6
28151,2020-08-01,16282,14411,1871,11.5
28153,2020-08-01,7526,6780,746,9.9
28155,2020-08-01,3884,3627,257,6.6
28157,2020-08-01,2836,2413,423,14.9
28159,2020-08-01,7429,6800,629,8.5
28161,2020-08-01,4879,4533,346,7.1
28163,2020-08-01,9785,8889,896,9.2
29001,2020-08-01,10007,9506,501,5
29003,2020-08-01,9931,9513,418,4.2
29005,2020-08-01,2692,2576,116,4.3
29007,2020-08-01,10196,9700,496,4.9
29009,2020-08-01,15379,14414,965,6.3
29011,2020-08-01,5180,4934,246,4.7
29013,2020-08-01,7802,7356,446,5.7
29015,2020-08-01,7145,6647,498,7
29017,2020-08-01,5455,5177,278,5.1
29019,2020-08-01,96859,92600,4259,4.4
29021,2020-08-01,44541,42397,2144,4.8
29023,2020-08-01,18187,17132,1055,5.8
29025,2020-08-01,4314,4104,210,4.9
29027,2020-08-01,21842,20816,1026,4.7
29029,2020-08-01,20292,19278,1014,5
29031,2020-08-01,40799,38871,1928,4.7
29033,2020-08-01,4578,4363,215,4.7
29035,2020-08-01,2647,2482,165,6.2
29037,2020-08-01,55002,52058,2944,5.4
29039,2020-08-01,5744,5459,285,5
29041,2020-08-01,3666,3518,148,4
29043,2020-08-01,45591,43472,2119,4.6
29045,2020-08-01,3215,3043,172,5.3
29047,2020-08-01,137983,130356,7627,5.5
29049,2020-08-01,10664,10082,582,5.5
29051,2020-08-01,40261,38216,2045,5.1
29053,2020-08-01,7142,6764,378,5.3
29055,2020-08-01,11111,10417,694,6.2
29057,2020-08-01,3464,3300,164,4.7
29059,2020-08-01,7061,6673,388,5.5
29061,2020-08-01,4075,3866,209,5.1
29063,2020-08-01,4859,4647,212,4.4
29065,2020-08-01,6373,6077,296,4.6
29067,2020-08-01,5085,4822,263,5.2
29069,2020-08-01,11462,10594,868,7.6
29071,2020-08-01,53193,50150,3043,5.7
29073,2020-08-01,7656,7301,355,4.6
29075,2020-08-01,3400,3280,120,3.5
29077,2020-08-01,151809,144125,7684,5.1
29079,2020-08-01,4156,3936,220,5.3
29081,2020-08-01,3773,3595,178,4.7
29083,2020-08-01,9667,9144,523,5.4
29085,2020-08-01,4013,3840,173,4.3
29087,2020-08-01,2598,2507,91,3.5
29089,2020-08-01,4766,4559,207,4.3
29091,2020-08-01,16327,15201,1126,6.9
29093,2020-08-01,3532,3277,255,7.2
29095,2020-08-01,367946,340281,27665,7.5
29097,2020-08-01,56679,53614,3065,5.4
29099,2020-08-01,118363,111434,6929,5.9
29101,2020-08-01,22903,21685,1218,5.3
29103,2020-08-01,1712,1633,79,4.6
29105,2020-08-01,16363,15216,1147,7
29107,2020-08-01,16767,15934,833,5
29109,2020-08-01,17474,16359,1115,6.4
29111,2020-08-01,4919,4675,244,5
29113,2020-08-01,28856,27322,1534,5.3
29115,2020-08-01,5084,4740,344,6.8
29117,2020-08-01,7504,7189,315,4.2
29119,2020-08-01,10689,10108,581,5.4
29121,2020-08-01,7386,6973,413,5.6
29123,2020-08-01,5568,5200,368,6.6
29125,2020-08-01,3912,3695,217,5.5
29127,2020-08-01,14535,13719,816,5.6
29129,2020-08-01,1782,1710,72,4
29131,2020-08-01,12554,11957,597,4.8
29133,2020-08-01,5726,5374,352,6.1
29135,2020-08-01,7502,7166,336,4.5
29137,2020-08-01,3732,3489,243,6.5
29139,2020-08-01,5863,5600,263,4.5
29141,2020-08-01,8450,8056,394,4.7
29143,2020-08-01,8556,8032,524,6.1
29145,2020-08-01,26992,25461,1531,5.7
29147,2020-08-01,10757,10319,438,4.1
29149,2020-08-01,4012,3740,272,6.8
29151,2020-08-01,7281,6946,335,4.6
29153,2020-08-01,3313,3090,223,6.7
29155,2020-08-01,6426,5856,570,8.9
29157,2020-08-01,9926,9541,385,3.9
29159,2020-08-01,20525,19214,1311,6.4
29161,2020-08-01,20412,19475,937,4.6
29163,2020-08-01,7505,7073,432,5.8
29165,2020-08-01,59329,56197,3132,5.3
29167,2020-08-01,14488,13802,686,4.7
29169,2020-08-01,14823,14022,801,5.4
29171,2020-08-01,2292,2192,100,4.4
29173,2020-08-01,5683,5412,271,4.8
29175,2020-08-01,10112,9502,610,6
29177,2020-08-01,10985,10377,608,5.5
29179,2020-08-01,2883,2709,174,6
29181,2020-08-01,4914,4499,415,8.4
29183,2020-08-01,226858,215995,10863,4.8
29185,2020-08-01,3751,3521,230,6.1
29186,2020-08-01,9434,9005,429,4.5
29187,2020-08-01,27072,25082,1990,7.4
29189,2020-08-01,535448,499693,35755,6.7
29195,2020-08-01,10249,9755,494,4.8
29197,2020-08-01,1951,1835,116,5.9
29199,2020-08-01,2452,2369,83,3.4
29201,2020-08-01,20042,18962,1080,5.4
29203,2020-08-01,3422,3179,243,7.1
29205,2020-08-01,2957,2808,149,5
29207,2020-08-01,13183,12517,666,5.1
29209,2020-08-01,13651,12687,964,7.1
29211,2020-08-01,2715,2605,110,4.1
29213,2020-08-01,27045,24553,2492,9.2
29215,2020-08-01,8931,8389,542,6.1
29217,2020-08-01,9342,8881,461,4.9
29219,2020-08-01,18426,17405,1021,5.5
29221,2020-08-01,10138,9474,664,6.5
29223,2020-08-01,5232,4916,316,6
29225,2020-08-01,17401,16540,861,4.9
29227,2020-08-01,1155,1100,55,4.8
29229,2020-08-01,7256,6790,466,6.4
29510,2020-08-01,156684,141521,15163,9.7
30001,2020-08-01,5084,4912,172,3.4
30003,2020-08-01,4830,4504,326,6.7
30005,2020-08-01,2269,2169,100,4.4
30007,2020-08-01,2675,2529,146,5.5
30009,2020-08-01,5615,5324,291,5.2
30011,2020-08-01,632,612,20,3.2
30013,2020-08-01,37707,35618,2089,5.5
30015,2020-08-01,2402,2316,86,3.6
30017,2020-08-01,6213,5944,269,4.3
30019,2020-08-01,892,873,19,2.1
30021,2020-08-01,4801,4496,305,6.4
30023,2020-08-01,5137,4919,218,4.2
30025,2020-08-01,1709,1633,76,4.4
30027,2020-08-01,5896,5703,193,3.3
30029,2020-08-01,50872,47753,3119,6.1
30031,2020-08-01,72577,69560,3017,4.2
30033,2020-08-01,711,699,12,1.7
30035,2020-08-01,5681,5067,614,10.8
30037,2020-08-01,359,347,12,3.3
30039,2020-08-01,1620,1521,99,6.1
30041,2020-08-01,7635,7251,384,5
30043,2020-08-01,5900,5638,262,4.4
30045,2020-08-01,894,847,47,5.3
30047,2020-08-01,13801,12998,803,5.8
30049,2020-08-01,37422,35727,1695,4.5
30051,2020-08-01,947,927,20,2.1
30053,2020-08-01,8267,7624,643,7.8
30055,2020-08-01,940,904,36,3.8
30057,2020-08-01,4448,4279,169,3.8
30059,2020-08-01,929,891,38,4.1
30061,2020-08-01,1884,1752,132,7
30063,2020-08-01,64170,60529,3641,5.7
30065,2020-08-01,2294,2167,127,5.5
30067,2020-08-01,9392,8853,539,5.7
30069,2020-08-01,255,248,7,2.7
30071,2020-08-01,1848,1767,81,4.4
30073,2020-08-01,2673,2528,145,5.4
30075,2020-08-01,976,959,17,1.7
30077,2020-08-01,3067,2967,100,3.3
30079,2020-08-01,475,438,37,7.8
30081,2020-08-01,20879,19862,1017,4.9
30083,2020-08-01,5973,5522,451,7.6
30085,2020-08-01,4389,4118,271,6.2
30087,2020-08-01,3673,3491,182,5
30089,2020-08-01,5195,4871,324,6.2
30091,2020-08-01,1759,1679,80,4.5
30093,2020-08-01,17756,16640,1116,6.3
30095,2020-08-01,5324,5055,269,5.1
30097,2020-08-01,1887,1833,54,2.9
30099,2020-08-01,2778,2681,97,3.5
30101,2020-08-01,2188,2075,113,5.2
30103,2020-08-01,335,322,13,3.9
30105,2020-08-01,4107,3948,159,3.9
30107,2020-08-01,735,689,46,6.3
30109,2020-08-01,468,447,21,4.5
30111,2020-08-01,84648,80433,4215,5
31001,2020-08-01,16841,16315,526,3.1
31003,2020-08-01,3774,3702,72,1.9
31005,2020-08-01,211,199,12,5.7
31007,2020-08-01,346,339,7,2
31009,2020-08-01,229,224,5,2.2
31011,2020-08-01,2834,2777,57,2
31013,2020-08-01,5351,5097,254,4.7
31015,2020-08-01,984,961,23,2.3
31017,2020-08-01,1385,1358,27,1.9
31019,2020-08-01,27078,26266,812,3
31021,2020-08-01,3493,3374,119,3.4
31023,2020-08-01,4468,4322,146,3.3
31025,2020-08-01,13372,12880,492,3.7
31027,2020-08-01,4400,4303,97,2.2
31029,2020-08-01,2195,2161,34,1.5
31031,2020-08-01,3288,3228,60,1.8
31033,2020-08-01,4162,3989,173,4.2
31035,2020-08-01,3201,3118,83,2.6
31037,2020-08-01,5608,5460,148,2.6
31039,2020-08-01,4731,4630,101,2.1
31041,2020-08-01,6251,6080,171,2.7
31043,2020-08-01,10534,10079,455,4.3
31045,2020-08-01,4830,4710,120,2.5
31047,2020-08-01,13102,12689,413,3.2
31049,2020-08-01,947,925,22,2.3
31051,2020-08-01,2854,2780,74,2.6
31053,2020-08-01,19954,19310,644,3.2
31055,2020-08-01,301555,286889,14666,4.9
31057,2020-08-01,1097,1073,24,2.2
31059,2020-08-01,3069,2998,71,2.3
31061,2020-08-01,1403,1357,46,3.3
31063,2020-08-01,1430,1398,32,2.2
31065,2020-08-01,2541,2480,61,2.4
31067,2020-08-01,10775,10426,349,3.2
31069,2020-08-01,1062,1035,27,2.5
31071,2020-08-01,1141,1123,18,1.6
31073,2020-08-01,1134,1109,25,2.2
31075,2020-08-01,372,365,7,1.9
31077,2020-08-01,1153,1122,31,2.7
31079,2020-08-01,32080,30392,1688,5.3
31081,2020-08-01,4686,4542,144,3.1
31083,2020-08-01,1707,1666,41,2.4
31085,2020-08-01,590,579,11,1.9
31087,2020-08-01,1293,1252,41,3.2
31089,2020-08-01,5544,5434,110,2
31091,2020-08-01,448,440,8,1.8
31093,2020-08-01,3287,3167,120,3.7
31095,2020-08-01,4175,4072,103,2.5
31097,2020-08-01,2024,1951,73,3.6
31099,2020-08-01,3673,3569,104,2.8
31101,2020-08-01,4605,4481,124,2.7
31103,2020-08-01,548,538,10,1.8
31105,2020-08-01,1967,1896,71,3.6
31107,2020-08-01,4562,4457,105,2.3
31109,2020-08-01,177086,170163,6923,3.9
31111,2020-08-01,18660,18026,634,3.4
31113,2020-08-01,452,441,11,2.4
31115,2020-08-01,381,372,9,2.4
31117,2020-08-01,436,429,7,1.6
31119,2020-08-01,19744,18975,769,3.9
31121,2020-08-01,3960,3807,153,3.9
31123,2020-08-01,2527,2453,74,2.9
31125,2020-08-01,1896,1839,57,3
31127,2020-08-01,3453,3350,103,3
31129,2020-08-01,2360,2309,51,2.2
31131,2020-08-01,8281,8036,245,3
31133,2020-08-01,1441,1407,34,2.4
31135,2020-08-01,1769,1743,26,1.5
31137,2020-08-01,4849,4720,129,2.7
31139,2020-08-01,4151,4011,140,3.4
31141,2020-08-01,17707,17182,525,3
31143,2020-08-01,2800,2734,66,2.4
31145,2020-08-01,5839,5675,164,2.8
31147,2020-08-01,4111,4002,109,2.7
31149,2020-08-01,831,818,13,1.6
31151,2020-08-01,7104,6896,208,2.9
31153,2020-08-01,96994,93482,3512,3.6
31155,2020-08-01,11100,10744,356,3.2
31157,2020-08-01,18027,17349,678,3.8
31159,2020-08-01,8709,8415,294,3.4
31161,2020-08-01,2590,2535,55,2.1
31163,2020-08-01,1648,1602,46,2.8
31165,2020-08-01,717,702,15,2.1
31167,2020-08-01,3526,3410,116,3.3
31169,2020-08-01,2677,2612,65,2.4
31171,2020-08-01,382,367,15,3.9
31173,2020-08-01,3078,2939,139,4.5
31175,2020-08-01,2093,2046,47,2.2
31177,2020-08-01,11085,10729,356,3.2
31179,2020-08-01,5346,5216,130,2.4
31181,2020-08-01,1603,1553,50,3.1
31183,2020-08-01,466,457,9,1.9
31185,2020-08-01,7248,7053,195,2.7
32001,2020-08-01,10863,10248,615,5.7
32003,2020-08-01,NA,930546,188707,16.9
32005,2020-08-01,22463,20597,1866,8.3
32007,2020-08-01,26697,25390,1307,4.9
32009,2020-08-01,383,365,18,4.7
32011,2020-08-01,942,904,38,4
32013,2020-08-01,7716,7316,400,5.2
32015,2020-08-01,3104,2961,143,4.6
32017,2020-08-01,1946,1843,103,5.3
32019,2020-08-01,22901,20941,1960,8.6
32021,2020-08-01,2089,1961,128,6.1
32023,2020-08-01,17438,15592,1846,10.6
32027,2020-08-01,2427,2306,121,5
32029,2020-08-01,2038,1870,168,8.2
32031,2020-08-01,252412,232793,19619,7.8
32033,2020-08-01,4571,4370,201,4.4
32510,2020-08-01,26076,24020,2056,7.9
33001,2020-08-01,32044,30031,2013,6.3
33003,2020-08-01,24421,22780,1641,6.7
33005,2020-08-01,39779,37431,2348,5.9
33007,2020-08-01,14729,13743,986,6.7
33009,2020-08-01,48885,46382,2503,5.1
33011,2020-08-01,239746,223365,16381,6.8
33013,2020-08-01,83028,78483,4545,5.5
33015,2020-08-01,188924,176282,12642,6.7
33017,2020-08-01,73655,69296,4359,5.9
33019,2020-08-01,23655,22438,1217,5.1
34001,2020-08-01,123046,101680,21366,17.4
34003,2020-08-01,480043,426826,53217,11.1
34005,2020-08-01,233077,211905,21172,9.1
34007,2020-08-01,258789,230205,28584,11
34009,2020-08-01,52870,47628,5242,9.9
34011,2020-08-01,66405,58896,7509,11.3
34013,2020-08-01,380101,328469,51632,13.6
34015,2020-08-01,152209,137031,15178,10
34017,2020-08-01,363661,318038,45623,12.5
34019,2020-08-01,63591,58591,5000,7.9
34021,2020-08-01,207771,190288,17483,8.4
34023,2020-08-01,443862,400068,43794,9.9
34025,2020-08-01,332501,300577,31924,9.6
34027,2020-08-01,253860,231758,22102,8.7
34029,2020-08-01,281374,253498,27876,9.9
34031,2020-08-01,246891,211508,35383,14.3
34033,2020-08-01,30241,27163,3078,10.2
34035,2020-08-01,168756,154040,14716,8.7
34037,2020-08-01,74095,66675,7420,10
34039,2020-08-01,278571,247385,31186,11.2
34041,2020-08-01,56310,51190,5120,9.1
35001,2020-08-01,323468,294686,28782,8.9
35003,2020-08-01,1171,1091,80,6.8
35005,2020-08-01,27216,24713,2503,9.2
35006,2020-08-01,8869,8014,855,9.6
35007,2020-08-01,4955,4581,374,7.5
35009,2020-08-01,21399,20110,1289,6
35011,2020-08-01,679,648,31,4.6
35013,2020-08-01,94640,86649,7991,8.4
35015,2020-08-01,31322,28555,2767,8.8
35017,2020-08-01,11171,9923,1248,11.2
35019,2020-08-01,1499,1382,117,7.8
35021,2020-08-01,269,257,12,4.5
35023,2020-08-01,1887,1761,126,6.7
35025,2020-08-01,27556,23485,4071,14.8
35027,2020-08-01,8873,7993,880,9.9
35028,2020-08-01,9696,9329,367,3.8
35029,2020-08-01,10373,8903,1470,14.2
35031,2020-08-01,22933,20156,2777,12.1
35033,2020-08-01,2037,1870,167,8.2
35035,2020-08-01,24334,21871,2463,10.1
35037,2020-08-01,2968,2717,251,8.5
35039,2020-08-01,16352,14861,1491,9.1
35041,2020-08-01,7552,7023,529,7
35043,2020-08-01,65050,58841,6209,9.5
35045,2020-08-01,48949,43481,5468,11.2
35047,2020-08-01,10025,9139,886,8.8
35049,2020-08-01,69483,62966,6517,9.4
35051,2020-08-01,4071,3675,396,9.7
35053,2020-08-01,6073,5622,451,7.4
35055,2020-08-01,14300,12463,1837,12.8
35057,2020-08-01,5244,4709,535,10.2
35059,2020-08-01,1662,1580,82,4.9
35061,2020-08-01,29544,26893,2651,9
36001,2020-08-01,161698,148385,13313,8.2
36003,2020-08-01,18351,16827,1524,8.3
36005,2020-08-01,609105,489583,119522,19.6
36007,2020-08-01,83086,75485,7601,9.1
36009,2020-08-01,32710,29665,3045,9.3
36011,2020-08-01,35994,32933,3061,8.5
36013,2020-08-01,53329,48601,4728,8.9
36015,2020-08-01,36006,32723,3283,9.1
36017,2020-08-01,21579,20052,1527,7.1
36019,2020-08-01,35117,32406,2711,7.7
36021,2020-08-01,30578,28495,2083,6.8
36023,2020-08-01,21916,20214,1702,7.8
36025,2020-08-01,18494,17119,1375,7.4
36027,2020-08-01,144336,131960,12376,8.6
36029,2020-08-01,447369,402286,45083,10.1
36031,2020-08-01,16930,15712,1218,7.2
36033,2020-08-01,19139,17555,1584,8.3
36035,2020-08-01,22448,20354,2094,9.3
36037,2020-08-01,29017,26841,2176,7.5
36039,2020-08-01,20503,18643,1860,9.1
36041,2020-08-01,2315,2183,132,5.7
36043,2020-08-01,27979,25693,2286,8.2
36045,2020-08-01,44272,40734,3538,8
36047,2020-08-01,NA,996787,178323,15.2
36049,2020-08-01,11164,10425,739,6.6
36051,2020-08-01,29910,27849,2061,6.9
36053,2020-08-01,32946,30502,2444,7.4
36055,2020-08-01,364508,329280,35228,9.7
36057,2020-08-01,22158,20082,2076,9.4
36059,2020-08-01,721565,650799,70766,9.8
36061,2020-08-01,871376,769871,101505,11.6
36063,2020-08-01,99102,88982,10120,10.2
36065,2020-08-01,102946,94131,8815,8.6
36067,2020-08-01,226189,205846,20343,9
36069,2020-08-01,54722,50620,4102,7.5
36071,2020-08-01,186761,168965,17796,9.5
36073,2020-08-01,17330,15789,1541,8.9
36075,2020-08-01,53139,48459,4680,8.8
36077,2020-08-01,26274,24300,1974,7.5
36079,2020-08-01,50869,46556,4313,8.5
36081,2020-08-01,NA,951535,166755,14.9
36083,2020-08-01,82674,76380,6294,7.6
36085,2020-08-01,213134,186569,26565,12.5
36087,2020-08-01,156389,141392,14997,9.6
36089,2020-08-01,42024,38497,3527,8.4
36091,2020-08-01,121385,112857,8528,7
36093,2020-08-01,79308,71868,7440,9.4
36095,2020-08-01,14674,13650,1024,7
36097,2020-08-01,8276,7657,619,7.5
36099,2020-08-01,15256,13936,1320,8.7
36101,2020-08-01,41781,38282,3499,8.4
36103,2020-08-01,786165,711404,74761,9.5
36105,2020-08-01,36851,32850,4001,10.9
36107,2020-08-01,22391,20603,1788,8
36109,2020-08-01,48021,44718,3303,6.9
36111,2020-08-01,88039,80292,7747,8.8
36113,2020-08-01,32303,29871,2432,7.5
36115,2020-08-01,28733,26742,1991,6.9
36117,2020-08-01,43260,39909,3351,7.7
36119,2020-08-01,490498,440489,50009,10.2
36121,2020-08-01,18001,16776,1225,6.8
36123,2020-08-01,11596,10880,716,6.2
37001,2020-08-01,80077,74650,5427,6.8
37003,2020-08-01,17388,16305,1083,6.2
37005,2020-08-01,4171,3894,277,6.6
37007,2020-08-01,10243,9389,854,8.3
37009,2020-08-01,12734,12060,674,5.3
37011,2020-08-01,7463,7056,407,5.5
37013,2020-08-01,19189,18067,1122,5.8
37015,2020-08-01,7360,6913,447,6.1
37017,2020-08-01,14393,13395,998,6.9
37019,2020-08-01,53130,49165,3965,7.5
37021,2020-08-01,134962,124675,10287,7.6
37023,2020-08-01,39411,36952,2459,6.2
37025,2020-08-01,107742,100629,7113,6.6
37027,2020-08-01,35409,32896,2513,7.1
37029,2020-08-01,4469,4256,213,4.8
37031,2020-08-01,31547,29951,1596,5.1
37033,2020-08-01,9403,8741,662,7
37035,2020-08-01,76844,71602,5242,6.8
37037,2020-08-01,34843,33106,1737,5
37039,2020-08-01,10740,9981,759,7.1
37041,2020-08-01,5349,5028,321,6
37043,2020-08-01,4047,3767,280,6.9
37045,2020-08-01,47539,44089,3450,7.3
37047,2020-08-01,22368,20621,1747,7.8
37049,2020-08-01,40662,38217,2445,6
37051,2020-08-01,124680,113236,11444,9.2
37053,2020-08-01,13675,12991,684,5
37055,2020-08-01,21397,20123,1274,6
37057,2020-08-01,78082,73145,4937,6.3
37059,2020-08-01,19840,18635,1205,6.1
37061,2020-08-01,24136,22904,1232,5.1
37063,2020-08-01,169533,158603,10930,6.4
37065,2020-08-01,20382,18123,2259,11.1
37067,2020-08-01,183204,170195,13009,7.1
37069,2020-08-01,30858,28871,1987,6.4
37071,2020-08-01,108806,100579,8227,7.6
37073,2020-08-01,5024,4757,267,5.3
37075,2020-08-01,3057,2806,251,8.2
37077,2020-08-01,29170,27547,1623,5.6
37079,2020-08-01,9265,8767,498,5.4
37081,2020-08-01,254955,233702,21253,8.3
37083,2020-08-01,19801,17992,1809,9.1
37085,2020-08-01,52375,48775,3600,6.9
37087,2020-08-01,28325,26390,1935,6.8
37089,2020-08-01,51702,48563,3139,6.1
37091,2020-08-01,8769,8179,590,6.7
37093,2020-08-01,19428,17832,1596,8.2
37095,2020-08-01,1790,1659,131,7.3
37097,2020-08-01,87918,82118,5800,6.6
37099,2020-08-01,19795,18533,1262,6.4
37101,2020-08-01,97607,91779,5828,6
37103,2020-08-01,4124,3903,221,5.4
37105,2020-08-01,25544,23670,1874,7.3
37107,2020-08-01,27158,25467,1691,6.2
37109,2020-08-01,42784,40298,2486,5.8
37111,2020-08-01,20293,19059,1234,6.1
37113,2020-08-01,15492,14564,928,6
37115,2020-08-01,9474,8879,595,6.3
37117,2020-08-01,8724,8155,569,6.5
37119,2020-08-01,616025,568917,47108,7.6
37121,2020-08-01,5909,5516,393,6.7
37123,2020-08-01,11281,10570,711,6.3
37125,2020-08-01,40386,37802,2584,6.4
37127,2020-08-01,41310,37865,3445,8.3
37129,2020-08-01,121147,113332,7815,6.5
37131,2020-08-01,7361,6859,502,6.8
37133,2020-08-01,63969,59864,4105,6.4
37135,2020-08-01,77138,73322,3816,4.9
37137,2020-08-01,5201,4934,267,5.1
37139,2020-08-01,16228,15149,1079,6.6
37141,2020-08-01,27945,26314,1631,5.8
37143,2020-08-01,4719,4437,282,6
37145,2020-08-01,17816,16642,1174,6.6
37147,2020-08-01,86165,80528,5637,6.5
37149,2020-08-01,8956,8477,479,5.3
37151,2020-08-01,62934,58814,4120,6.5
37153,2020-08-01,16371,14856,1515,9.3
37155,2020-08-01,49677,45095,4582,9.2
37157,2020-08-01,38384,35474,2910,7.6
37159,2020-08-01,64345,59735,4610,7.2
37161,2020-08-01,24304,22250,2054,8.5
37163,2020-08-01,27510,25959,1551,5.6
37165,2020-08-01,11139,9734,1405,12.6
37167,2020-08-01,29277,27600,1677,5.7
37169,2020-08-01,20777,19586,1191,5.7
37171,2020-08-01,31995,30040,1955,6.1
37173,2020-08-01,6952,6496,456,6.6
37175,2020-08-01,14209,13450,759,5.3
37177,2020-08-01,1458,1362,96,6.6
37179,2020-08-01,120173,113562,6611,5.5
37181,2020-08-01,16920,15189,1731,10.2
37183,2020-08-01,581649,546554,35095,6
37185,2020-08-01,6555,5928,627,9.6
37187,2020-08-01,4389,4056,333,7.6
37189,2020-08-01,28494,27081,1413,5
37191,2020-08-01,49721,46673,3048,6.1
37193,2020-08-01,27927,26258,1669,6
37195,2020-08-01,33248,30335,2913,8.8
37197,2020-08-01,16967,15964,1003,5.9
37199,2020-08-01,8232,7761,471,5.7
38001,2020-08-01,1034,989,45,4.4
38003,2020-08-01,5287,5093,194,3.7
38005,2020-08-01,2464,2300,164,6.7
38007,2020-08-01,547,530,17,3.1
38009,2020-08-01,3037,2868,169,5.6
38011,2020-08-01,1695,1633,62,3.7
38013,2020-08-01,1013,947,66,6.5
38015,2020-08-01,51964,49679,2285,4.4
38017,2020-08-01,107191,102222,4969,4.6
38019,2020-08-01,1975,1908,67,3.4
38021,2020-08-01,2371,2309,62,2.6
38023,2020-08-01,1474,1414,60,4.1
38025,2020-08-01,3134,2937,197,6.3
38027,2020-08-01,1187,1133,54,4.5
38029,2020-08-01,1532,1461,71,4.6
38031,2020-08-01,1605,1551,54,3.4
38033,2020-08-01,887,853,34,3.8
38035,2020-08-01,36861,34999,1862,5.1
38037,2020-08-01,1232,1201,31,2.5
38039,2020-08-01,1024,991,33,3.2
38041,2020-08-01,1430,1366,64,4.5
38043,2020-08-01,1347,1288,59,4.4
38045,2020-08-01,2118,2069,49,2.3
38047,2020-08-01,891,863,28,3.1
38049,2020-08-01,3112,2957,155,5
38051,2020-08-01,1137,1092,45,4
38053,2020-08-01,9328,8366,962,10.3
38055,2020-08-01,4941,4712,229,4.6
38057,2020-08-01,3790,3559,231,6.1
38059,2020-08-01,17242,16347,895,5.2
38061,2020-08-01,6970,6487,483,6.9
38063,2020-08-01,1455,1394,61,4.2
38065,2020-08-01,914,866,48,5.3
38067,2020-08-01,3526,3354,172,4.9
38069,2020-08-01,1778,1711,67,3.8
38071,2020-08-01,5900,5647,253,4.3
38073,2020-08-01,2919,2827,92,3.2
38075,2020-08-01,1263,1197,66,5.2
38077,2020-08-01,8848,8518,330,3.7
38079,2020-08-01,4960,3865,1095,22.1
38081,2020-08-01,2905,2834,71,2.4
38083,2020-08-01,734,698,36,4.9
38085,2020-08-01,1264,1195,69,5.5
38087,2020-08-01,406,393,13,3.2
38089,2020-08-01,18591,16824,1767,9.5
38091,2020-08-01,972,936,36,3.7
38093,2020-08-01,10791,10394,397,3.7
38095,2020-08-01,1216,1185,31,2.5
38097,2020-08-01,4551,4392,159,3.5
38099,2020-08-01,5278,5016,262,5
38101,2020-08-01,32749,30523,2226,6.8
38103,2020-08-01,1991,1913,78,3.9
38105,2020-08-01,23165,19981,3184,13.7
39001,2020-08-01,11249,10205,1044,9.3
39003,2020-08-01,48890,44658,4232,8.7
39005,2020-08-01,26723,24904,1819,6.8
39007,2020-08-01,45179,41149,4030,8.9
39009,2020-08-01,24775,22394,2381,9.6
39011,2020-08-01,24902,23234,1668,6.7
39013,2020-08-01,29149,25947,3202,11
39015,2020-08-01,19841,18079,1762,8.9
39017,2020-08-01,199203,182321,16882,8.5
39019,2020-08-01,13088,11863,1225,9.4
39021,2020-08-01,20099,18621,1478,7.4
39023,2020-08-01,64058,58412,5646,8.8
39025,2020-08-01,108946,100398,8548,7.8
39027,2020-08-01,18050,16433,1617,9
39029,2020-08-01,48550,43605,4945,10.2
39031,2020-08-01,14417,13068,1349,9.4
39033,2020-08-01,18985,17248,1737,9.1
39035,2020-08-01,587844,534342,53502,9.1
39037,2020-08-01,26082,24434,1648,6.3
39039,2020-08-01,18183,16810,1373,7.6
39041,2020-08-01,113913,106929,6984,6.1
39043,2020-08-01,38482,34922,3560,9.3
39045,2020-08-01,80198,74240,5958,7.4
39047,2020-08-01,14176,12980,1196,8.4
39049,2020-08-01,729146,661573,67573,9.3
39051,2020-08-01,21947,20416,1531,7
39053,2020-08-01,12057,11028,1029,8.5
39055,2020-08-01,45949,43657,2292,5
39057,2020-08-01,84384,78232,6152,7.3
39059,2020-08-01,18761,17104,1657,8.8
39061,2020-08-01,430637,389210,41427,9.6
39063,2020-08-01,42239,39370,2869,6.8
39065,2020-08-01,14066,12949,1117,7.9
39067,2020-08-01,6907,6215,692,10
39069,2020-08-01,13184,12274,910,6.9
39071,2020-08-01,18016,16439,1577,8.8
39073,2020-08-01,13152,12194,958,7.3
39075,2020-08-01,21365,20471,894,4.2
39077,2020-08-01,28180,25870,2310,8.2
39079,2020-08-01,13388,12185,1203,9
39081,2020-08-01,28293,24987,3306,11.7
39083,2020-08-01,31475,29365,2110,6.7
39085,2020-08-01,118993,111264,7729,6.5
39087,2020-08-01,24400,21994,2406,9.9
39089,2020-08-01,92766,85880,6886,7.4
39091,2020-08-01,22818,21159,1659,7.3
39093,2020-08-01,145790,134817,10973,7.5
39095,2020-08-01,213949,190390,23559,11
39097,2020-08-01,21070,19703,1367,6.5
39099,2020-08-01,103708,91775,11933,11.5
39101,2020-08-01,28785,26369,2416,8.4
39103,2020-08-01,91913,86646,5267,5.7
39105,2020-08-01,9038,8071,967,10.7
39107,2020-08-01,23799,22540,1259,5.3
39109,2020-08-01,54970,50863,4107,7.5
39111,2020-08-01,5887,5229,658,11.2
39113,2020-08-01,260763,234708,26055,10
39115,2020-08-01,6791,6208,583,8.6
39117,2020-08-01,17129,15900,1229,7.2
39119,2020-08-01,40981,37712,3269,8
39121,2020-08-01,4753,4307,446,9.4
39123,2020-08-01,22069,20341,1728,7.8
39125,2020-08-01,8779,8184,595,6.8
39127,2020-08-01,16180,14767,1413,8.7
39129,2020-08-01,26946,24976,1970,7.3
39131,2020-08-01,11160,10069,1091,9.8
39133,2020-08-01,87030,79959,7071,8.1
39135,2020-08-01,21487,20045,1442,6.7
39137,2020-08-01,18851,17934,917,4.9
39139,2020-08-01,52828,48043,4785,9.1
39141,2020-08-01,35752,32816,2936,8.2
39143,2020-08-01,30522,28245,2277,7.5
39145,2020-08-01,29983,27194,2789,9.3
39147,2020-08-01,27665,25496,2169,7.8
39149,2020-08-01,24620,22758,1862,7.6
39151,2020-08-01,187856,171274,16582,8.8
39153,2020-08-01,275777,249335,26442,9.6
39155,2020-08-01,87053,77103,9950,11.4
39157,2020-08-01,45810,42251,3559,7.8
39159,2020-08-01,29788,27985,1803,6.1
39161,2020-08-01,14962,14013,949,6.3
39163,2020-08-01,5778,5234,544,9.4
39165,2020-08-01,121588,112791,8797,7.2
39167,2020-08-01,27549,25093,2456,8.9
39169,2020-08-01,60871,56938,3933,6.5
39171,2020-08-01,19173,17753,1420,7.4
39173,2020-08-01,70490,65371,5119,7.3
39175,2020-08-01,13102,12313,789,6
40001,2020-08-01,8571,8095,476,5.6
40003,2020-08-01,2714,2613,101,3.7
40005,2020-08-01,5252,4873,379,7.2
40007,2020-08-01,2532,2471,61,2.4
40009,2020-08-01,10194,9359,835,8.2
40011,2020-08-01,4390,4088,302,6.9
40013,2020-08-01,22645,21572,1073,4.7
40015,2020-08-01,12177,11461,716,5.9
40017,2020-08-01,75973,71490,4483,5.9
40019,2020-08-01,21369,19993,1376,6.4
40021,2020-08-01,20010,19006,1004,5
40023,2020-08-01,5638,5193,445,7.9
40025,2020-08-01,1493,1465,28,1.9
40027,2020-08-01,142392,134573,7819,5.5
40029,2020-08-01,2375,2216,159,6.7
40031,2020-08-01,47990,45073,2917,6.1
40033,2020-08-01,2746,2562,184,6.7
40035,2020-08-01,5904,5610,294,5
40037,2020-08-01,31427,29350,2077,6.6
40039,2020-08-01,15228,14331,897,5.9
40041,2020-08-01,18687,17827,860,4.6
40043,2020-08-01,2831,2676,155,5.5
40045,2020-08-01,2190,2076,114,5.2
40047,2020-08-01,27491,25982,1509,5.5
40049,2020-08-01,12896,12053,843,6.5
40051,2020-08-01,26758,25073,1685,6.3
40053,2020-08-01,2798,2711,87,3.1
40055,2020-08-01,1965,1819,146,7.4
40057,2020-08-01,1237,1190,47,3.8
40059,2020-08-01,1873,1817,56,3
40061,2020-08-01,4418,4083,335,7.6
40063,2020-08-01,5326,4903,423,7.9
40065,2020-08-01,10969,10554,415,3.8
40067,2020-08-01,2588,2405,183,7.1
40069,2020-08-01,3742,3468,274,7.3
40071,2020-08-01,18433,17241,1192,6.5
40073,2020-08-01,8730,8331,399,4.6
40075,2020-08-01,3683,3504,179,4.9
40077,2020-08-01,3155,2827,328,10.4
40079,2020-08-01,19363,18008,1355,7
40081,2020-08-01,15631,14781,850,5.4
40083,2020-08-01,22221,21097,1124,5.1
40085,2020-08-01,6580,6325,255,3.9
40087,2020-08-01,19971,18850,1121,5.6
40089,2020-08-01,15495,14475,1020,6.6
40091,2020-08-01,7241,6652,589,8.1
40093,2020-08-01,3753,3560,193,5.1
40095,2020-08-01,6872,6473,399,5.8
40097,2020-08-01,19291,18297,994,5.2
40099,2020-08-01,6177,5783,394,6.4
40101,2020-08-01,29655,27935,1720,5.8
40103,2020-08-01,5465,5263,202,3.7
40105,2020-08-01,4716,4471,245,5.2
40107,2020-08-01,4433,4144,289,6.5
40109,2020-08-01,385682,360895,24787,6.4
40111,2020-08-01,15653,14527,1126,7.2
40113,2020-08-01,20578,19255,1323,6.4
40115,2020-08-01,14270,13602,668,4.7
40117,2020-08-01,7356,6872,484,6.6
40119,2020-08-01,38009,36200,1809,4.8
40121,2020-08-01,16431,15135,1296,7.9
40123,2020-08-01,19492,18576,916,4.7
40125,2020-08-01,32272,30330,1942,6
40127,2020-08-01,4553,4259,294,6.5
40129,2020-08-01,1921,1817,104,5.4
40131,2020-08-01,44937,42319,2618,5.8
40133,2020-08-01,9228,8535,693,7.5
40135,2020-08-01,16635,15573,1062,6.4
40137,2020-08-01,18323,16770,1553,8.5
40139,2020-08-01,11397,11158,239,2.1
40141,2020-08-01,3059,2927,132,4.3
40143,2020-08-01,324659,303051,21608,6.7
40145,2020-08-01,38154,35972,2182,5.7
40147,2020-08-01,22657,21356,1301,5.7
40149,2020-08-01,5237,4842,395,7.5
40151,2020-08-01,4625,4460,165,3.6
40153,2020-08-01,8951,8266,685,7.7
41001,2020-08-01,7342,6835,507,6.9
41003,2020-08-01,44441,41495,2946,6.6
41005,2020-08-01,217770,200043,17727,8.1
41007,2020-08-01,19646,17935,1711,8.7
41009,2020-08-01,23859,21847,2012,8.4
41011,2020-08-01,26618,24293,2325,8.7
41013,2020-08-01,10520,9645,875,8.3
41015,2020-08-01,9116,8352,764,8.4
41017,2020-08-01,98894,91239,7655,7.7
41019,2020-08-01,47371,43846,3525,7.4
41021,2020-08-01,1032,969,63,6.1
41023,2020-08-01,3290,3075,215,6.5
41025,2020-08-01,3756,3558,198,5.3
41027,2020-08-01,15610,14686,924,5.9
41029,2020-08-01,105940,97053,8887,8.4
41031,2020-08-01,10361,9482,879,8.5
41033,2020-08-01,36197,33158,3039,8.4
41035,2020-08-01,29565,27156,2409,8.1
41037,2020-08-01,3783,3586,197,5.2
41039,2020-08-01,176184,160795,15389,8.7
41041,2020-08-01,21321,19109,2212,10.4
41043,2020-08-01,58864,54025,4839,8.2
41045,2020-08-01,12754,12081,673,5.3
41047,2020-08-01,165082,153126,11956,7.2
41049,2020-08-01,5788,5478,310,5.4
41051,2020-08-01,460267,412726,47541,10.3
41053,2020-08-01,40495,37684,2811,6.9
41055,2020-08-01,1014,951,63,6.2
41057,2020-08-01,11949,11018,931,7.8
41059,2020-08-01,37078,34480,2598,7
41061,2020-08-01,12030,11196,834,6.9
41063,2020-08-01,3684,3492,192,5.2
41065,2020-08-01,13446,12484,962,7.2
41067,2020-08-01,320861,296808,24053,7.5
41069,2020-08-01,673,645,28,4.2
41071,2020-08-01,54019,50109,3910,7.2
42001,2020-08-01,53206,49454,3752,7.1
42003,2020-08-01,629982,563614,66368,10.5
42005,2020-08-01,30986,27728,3258,10.5
42007,2020-08-01,82105,72545,9560,11.6
42009,2020-08-01,22885,20838,2047,8.9
42011,2020-08-01,209144,187075,22069,10.6
42013,2020-08-01,58707,53507,5200,8.9
42015,2020-08-01,27790,25598,2192,7.9
42017,2020-08-01,334817,303641,31176,9.3
42019,2020-08-01,95237,87345,7892,8.3
42021,2020-08-01,55007,49435,5572,10.1
42023,2020-08-01,2060,1816,244,11.8
42025,2020-08-01,30794,27571,3223,10.5
42027,2020-08-01,73402,68992,4410,6
42029,2020-08-01,277249,257212,20037,7.2
42031,2020-08-01,16352,15076,1276,7.8
42033,2020-08-01,34891,31615,3276,9.4
42035,2020-08-01,17279,15794,1485,8.6
42037,2020-08-01,32700,30090,2610,8
42039,2020-08-01,37814,34307,3507,9.3
42041,2020-08-01,129417,120110,9307,7.2
42043,2020-08-01,143894,129456,14438,10
42045,2020-08-01,289698,257899,31799,11
42047,2020-08-01,15143,13236,1907,12.6
42049,2020-08-01,125742,112485,13257,10.5
42051,2020-08-01,55602,48539,7063,12.7
42053,2020-08-01,1801,1608,193,10.7
42055,2020-08-01,76473,70044,6429,8.4
42057,2020-08-01,7378,6307,1071,14.5
42059,2020-08-01,15453,13748,1705,11
42061,2020-08-01,19514,17456,2058,10.5
42063,2020-08-01,36736,33085,3651,9.9
42065,2020-08-01,19863,18012,1851,9.3
42067,2020-08-01,12480,11669,811,6.5
42069,2020-08-01,101846,91164,10682,10.5
42071,2020-08-01,280200,257592,22608,8.1
42073,2020-08-01,39804,35529,4275,10.7
42075,2020-08-01,71079,64892,6187,8.7
42077,2020-08-01,188149,167365,20784,11
42079,2020-08-01,154441,136172,18269,11.8
42081,2020-08-01,54785,49742,5043,9.2
42083,2020-08-01,16828,15202,1626,9.7
42085,2020-08-01,47575,42658,4917,10.3
42087,2020-08-01,21001,19202,1799,8.6
42089,2020-08-01,81008,71079,9929,12.3
42091,2020-08-01,441664,403244,38420,8.7
42093,2020-08-01,8894,8339,555,6.2
42095,2020-08-01,155472,139903,15569,10
42097,2020-08-01,42358,38262,4096,9.7
42099,2020-08-01,23927,22256,1671,7
42101,2020-08-01,717290,605623,111667,15.6
42103,2020-08-01,24282,21491,2791,11.5
42105,2020-08-01,7099,6466,633,8.9
42107,2020-08-01,65240,58718,6522,10
42109,2020-08-01,19112,17822,1290,6.7
42111,2020-08-01,32127,29008,3119,9.7
42113,2020-08-01,2639,2421,218,8.3
42115,2020-08-01,19499,18055,1444,7.4
42117,2020-08-01,18460,16671,1789,9.7
42119,2020-08-01,18873,17599,1274,6.8
42121,2020-08-01,21822,19752,2070,9.5
42123,2020-08-01,18350,16762,1588,8.7
42125,2020-08-01,103576,92871,10705,10.3
42127,2020-08-01,22304,20339,1965,8.8
42129,2020-08-01,173731,156747,16984,9.8
42131,2020-08-01,12952,11860,1092,8.4
42133,2020-08-01,229856,209731,20125,8.8
44001,2020-08-01,24297,21911,2386,9.8
44003,2020-08-01,86561,76745,9816,11.3
44005,2020-08-01,41451,37188,4263,10.3
44007,2020-08-01,318232,274022,44210,13.9
44009,2020-08-01,64682,58274,6408,9.9
45001,2020-08-01,10119,9606,513,5.1
45003,2020-08-01,75752,72777,2975,3.9
45005,2020-08-01,2625,2384,241,9.2
45007,2020-08-01,91879,87343,4536,4.9
45009,2020-08-01,4785,4374,411,8.6
45011,2020-08-01,8034,7514,520,6.5
45013,2020-08-01,78671,75271,3400,4.3
45015,2020-08-01,105980,100631,5349,5
45017,2020-08-01,6654,6279,375,5.6
45019,2020-08-01,214677,201834,12843,6
45021,2020-08-01,25489,23693,1796,7
45023,2020-08-01,13772,12615,1157,8.4
45025,2020-08-01,22061,20862,1199,5.4
45027,2020-08-01,12908,12150,758,5.9
45029,2020-08-01,17034,16029,1005,5.9
45031,2020-08-01,31042,29092,1950,6.3
45033,2020-08-01,13551,12821,730,5.4
45035,2020-08-01,78521,74361,4160,5.3
45037,2020-08-01,10846,10416,430,4
45039,2020-08-01,9737,9023,714,7.3
45041,2020-08-01,68197,64569,3628,5.3
45043,2020-08-01,26973,25219,1754,6.5
45045,2020-08-01,258956,246612,12344,4.8
45047,2020-08-01,31940,30108,1832,5.7
45049,2020-08-01,8411,8003,408,4.9
45051,2020-08-01,151884,141785,10099,6.6
45053,2020-08-01,13133,12536,597,4.5
45055,2020-08-01,29737,28379,1358,4.6
45057,2020-08-01,42897,40207,2690,6.3
45059,2020-08-01,30516,28751,1765,5.8
45061,2020-08-01,6873,6393,480,7
45063,2020-08-01,151902,146146,5756,3.8
45065,2020-08-01,3370,3188,182,5.4
45067,2020-08-01,13747,12743,1004,7.3
45069,2020-08-01,9516,8669,847,8.9
45071,2020-08-01,19738,18920,818,4.1
45073,2020-08-01,35410,33941,1469,4.1
45075,2020-08-01,35400,32331,3069,8.7
45077,2020-08-01,57605,55249,2356,4.1
45079,2020-08-01,202175,190846,11329,5.6
45081,2020-08-01,8807,8512,295,3.3
45083,2020-08-01,159746,150764,8982,5.6
45085,2020-08-01,43603,40795,2808,6.4
45087,2020-08-01,12079,11117,962,8
45089,2020-08-01,12259,11286,973,7.9
45091,2020-08-01,145166,137112,8054,5.5
46003,2020-08-01,1448,1400,48,3.3
46005,2020-08-01,9287,8899,388,4.2
46007,2020-08-01,1089,1032,57,5.2
46009,2020-08-01,2868,2752,116,4
46011,2020-08-01,17460,16677,783,4.5
46013,2020-08-01,20029,19167,862,4.3
46015,2020-08-01,2446,2347,99,4
46017,2020-08-01,763,689,74,9.7
46019,2020-08-01,4961,4679,282,5.7
46021,2020-08-01,780,747,33,4.2
46023,2020-08-01,3908,3551,357,9.1
46025,2020-08-01,2275,2203,72,3.2
46027,2020-08-01,6408,6094,314,4.9
46029,2020-08-01,15074,14367,707,4.7
46031,2020-08-01,1330,1233,97,7.3
46033,2020-08-01,4154,3912,242,5.8
46035,2020-08-01,10742,10327,415,3.9
46037,2020-08-01,2702,2573,129,4.8
46039,2020-08-01,2426,2315,111,4.6
46041,2020-08-01,2305,2049,256,11.1
46043,2020-08-01,1539,1491,48,3.1
46045,2020-08-01,1950,1896,54,2.8
46047,2020-08-01,3031,2832,199,6.6
46049,2020-08-01,1037,999,38,3.7
46051,2020-08-01,4319,4177,142,3.3
46053,2020-08-01,1983,1906,77,3.9
46055,2020-08-01,1051,1022,29,2.8
46057,2020-08-01,3345,3239,106,3.2
46059,2020-08-01,1713,1666,47,2.7
46061,2020-08-01,1719,1638,81,4.7
46063,2020-08-01,707,677,30,4.2
46065,2020-08-01,10013,9706,307,3.1
46067,2020-08-01,3523,3401,122,3.5
46069,2020-08-01,671,647,24,3.6
46071,2020-08-01,1305,1253,52,4
46073,2020-08-01,1211,1176,35,2.9
46075,2020-08-01,534,510,24,4.5
46077,2020-08-01,2631,2538,93,3.5
46079,2020-08-01,6287,6020,267,4.2
46081,2020-08-01,13595,12927,668,4.9
46083,2020-08-01,35147,33884,1263,3.6
46085,2020-08-01,1722,1604,118,6.9
46087,2020-08-01,3034,2924,110,3.6
46089,2020-08-01,1008,947,61,6.1
46091,2020-08-01,2412,2314,98,4.1
46093,2020-08-01,14189,13546,643,4.5
46095,2020-08-01,722,675,47,6.5
46097,2020-08-01,1133,1064,69,6.1
46099,2020-08-01,111182,106345,4837,4.4
46101,2020-08-01,3977,3747,230,5.8
46102,2020-08-01,3963,3402,561,14.2
46103,2020-08-01,58342,55421,2921,5
46105,2020-08-01,1399,1332,67,4.8
46107,2020-08-01,1041,1004,37,3.6
46109,2020-08-01,4756,4469,287,6
46111,2020-08-01,1140,1096,44,3.9
46115,2020-08-01,3087,2964,123,4
46117,2020-08-01,1909,1841,68,3.6
46119,2020-08-01,799,777,22,2.8
46121,2020-08-01,3088,2854,234,7.6
46123,2020-08-01,3010,2919,91,3
46125,2020-08-01,4578,4407,171,3.7
46127,2020-08-01,8290,7863,427,5.2
46129,2020-08-01,2139,2007,132,6.2
46135,2020-08-01,11495,10975,520,4.5
46137,2020-08-01,953,888,65,6.8
47001,2020-08-01,34925,32726,2199,6.3
47003,2020-08-01,21270,19785,1485,7
47005,2020-08-01,6807,6228,579,8.5
47007,2020-08-01,4254,3943,311,7.3
47009,2020-08-01,64503,60691,3812,5.9
47011,2020-08-01,53707,50193,3514,6.5
47013,2020-08-01,14836,13894,942,6.3
47015,2020-08-01,6548,6192,356,5.4
47017,2020-08-01,12165,11362,803,6.6
47019,2020-08-01,24084,22407,1677,7
47021,2020-08-01,21845,20582,1263,5.8
47023,2020-08-01,8519,8080,439,5.2
47025,2020-08-01,12984,12256,728,5.6
47027,2020-08-01,2777,2608,169,6.1
47029,2020-08-01,15126,13813,1313,8.7
47031,2020-08-01,26216,24558,1658,6.3
47033,2020-08-01,6948,6564,384,5.5
47035,2020-08-01,23382,21855,1527,6.5
47037,2020-08-01,417140,377079,40061,9.6
47039,2020-08-01,4486,4144,342,7.6
47041,2020-08-01,7919,7329,590,7.5
47043,2020-08-01,26749,25260,1489,5.6
47045,2020-08-01,16225,15005,1220,7.5
47047,2020-08-01,19266,17955,1311,6.8
47049,2020-08-01,7643,7190,453,5.9
47051,2020-08-01,19943,18741,1202,6
47053,2020-08-01,22345,20850,1495,6.7
47055,2020-08-01,14985,13918,1067,7.1
47057,2020-08-01,9629,8989,640,6.6
47059,2020-08-01,29192,26929,2263,7.8
47061,2020-08-01,5101,4682,419,8.2
47063,2020-08-01,28325,26449,1876,6.6
47065,2020-08-01,186017,172486,13531,7.3
47067,2020-08-01,2191,2023,168,7.7
47069,2020-08-01,9516,8657,859,9
47071,2020-08-01,10728,10016,712,6.6
47073,2020-08-01,23692,22061,1631,6.9
47075,2020-08-01,8084,7242,842,10.4
47077,2020-08-01,12304,11434,870,7.1
47079,2020-08-01,14043,13126,917,6.5
47081,2020-08-01,11292,10686,606,5.4
47083,2020-08-01,3294,3038,256,7.8
47085,2020-08-01,8942,8419,523,5.8
47087,2020-08-01,4926,4592,334,6.8
47089,2020-08-01,24832,23230,1602,6.5
47091,2020-08-01,7965,7536,429,5.4
47093,2020-08-01,247495,232984,14511,5.9
47095,2020-08-01,1732,1585,147,8.5
47097,2020-08-01,9901,8974,927,9.4
47099,2020-08-01,19656,18323,1333,6.8
47101,2020-08-01,5458,5114,344,6.3
47103,2020-08-01,16476,15302,1174,7.1
47105,2020-08-01,23836,22485,1351,5.7
47107,2020-08-01,23681,22015,1666,7
47109,2020-08-01,8643,7896,747,8.6
47111,2020-08-01,11299,10591,708,6.3
47113,2020-08-01,50580,46423,4157,8.2
47115,2020-08-01,12558,11633,925,7.4
47117,2020-08-01,15749,14595,1154,7.3
47119,2020-08-01,50331,46716,3615,7.2
47121,2020-08-01,5342,4912,430,8
47123,2020-08-01,20404,19063,1341,6.6
47125,2020-08-01,88327,81534,6793,7.7
47127,2020-08-01,3592,3433,159,4.4
47129,2020-08-01,7767,7274,493,6.3
47131,2020-08-01,12429,11590,839,6.8
47133,2020-08-01,9874,9375,499,5.1
47135,2020-08-01,3068,2847,221,7.2
47137,2020-08-01,2371,2266,105,4.4
47139,2020-08-01,7556,7093,463,6.1
47141,2020-08-01,35836,33680,2156,6
47143,2020-08-01,13061,11986,1075,8.2
47145,2020-08-01,23365,21921,1444,6.2
47147,2020-08-01,37970,35610,2360,6.2
47149,2020-08-01,187408,174803,12605,6.7
47151,2020-08-01,8285,7621,664,8
47153,2020-08-01,6247,5790,457,7.3
47155,2020-08-01,56007,51839,4168,7.4
47157,2020-08-01,466475,408905,57570,12.3
47159,2020-08-01,9350,8867,483,5.2
47161,2020-08-01,5543,5214,329,5.9
47163,2020-08-01,70617,65648,4969,7
47165,2020-08-01,104382,97374,7008,6.7
47167,2020-08-01,27871,25860,2011,7.2
47169,2020-08-01,5489,5147,342,6.2
47171,2020-08-01,7141,6578,563,7.9
47173,2020-08-01,7791,7267,524,6.7
47175,2020-08-01,2050,1905,145,7.1
47177,2020-08-01,17407,16175,1232,7.1
47179,2020-08-01,60491,56753,3738,6.2
47181,2020-08-01,6522,6109,413,6.3
47183,2020-08-01,15813,14928,885,5.6
47185,2020-08-01,12284,11507,777,6.3
47187,2020-08-01,129475,123467,6008,4.6
47189,2020-08-01,78329,73193,5136,6.6
48001,2020-08-01,23853,22637,1216,5.1
48003,2020-08-01,9071,8298,773,8.5
48005,2020-08-01,35924,33496,2428,6.8
48007,2020-08-01,9140,8470,670,7.3
48009,2020-08-01,3978,3796,182,4.6
48011,2020-08-01,936,905,31,3.3
48013,2020-08-01,22175,20433,1742,7.9
48015,2020-08-01,13693,12881,812,5.9
48017,2020-08-01,2510,2417,93,3.7
48019,2020-08-01,9992,9490,502,5
48021,2020-08-01,43080,40795,2285,5.3
48023,2020-08-01,1812,1764,48,2.6
48025,2020-08-01,9953,9018,935,9.4
48027,2020-08-01,146608,137670,8938,6.1
48029,2020-08-01,952559,887208,65351,6.9
48031,2020-08-01,6724,6511,213,3.2
48033,2020-08-01,428,416,12,2.8
48035,2020-08-01,8532,8149,383,4.5
48037,2020-08-01,39187,36730,2457,6.3
48039,2020-08-01,177300,163352,13948,7.9
48041,2020-08-01,115130,109711,5419,4.7
48043,2020-08-01,4141,3897,244,5.9
48045,2020-08-01,586,565,21,3.6
48047,2020-08-01,2558,2300,258,10.1
48049,2020-08-01,15489,14623,866,5.6
48051,2020-08-01,8125,7659,466,5.7
48053,2020-08-01,24249,23307,942,3.9
48055,2020-08-01,19562,18442,1120,5.7
48057,2020-08-01,12224,11587,637,5.2
48059,2020-08-01,6087,5804,283,4.6
48061,2020-08-01,171497,156128,15369,9
48063,2020-08-01,5148,4791,357,6.9
48065,2020-08-01,3002,2902,100,3.3
48067,2020-08-01,12594,11705,889,7.1
48069,2020-08-01,3394,3291,103,3
48071,2020-08-01,19807,18047,1760,8.9
48073,2020-08-01,21569,20003,1566,7.3
48075,2020-08-01,3238,3144,94,2.9
48077,2020-08-01,4872,4643,229,4.7
48079,2020-08-01,1152,1075,77,6.7
48081,2020-08-01,1399,1329,70,5
48083,2020-08-01,2991,2803,188,6.3
48085,2020-08-01,576523,545454,31069,5.4
48087,2020-08-01,1108,1072,36,3.2
48089,2020-08-01,9966,9475,491,4.9
48091,2020-08-01,75785,71801,3984,5.3
48093,2020-08-01,5800,5537,263,4.5
48095,2020-08-01,1379,1330,49,3.6
48097,2020-08-01,19429,18244,1185,6.1
48099,2020-08-01,24286,22945,1341,5.5
48101,2020-08-01,591,569,22,3.7
48103,2020-08-01,1619,1409,210,13
48105,2020-08-01,1580,1447,133,8.4
48107,2020-08-01,2459,2359,100,4.1
48109,2020-08-01,1198,1121,77,6.4
48111,2020-08-01,3870,3782,88,2.3
48113,2020-08-01,NA,NA,95271,6.9
48115,2020-08-01,4635,4260,375,8.1
48117,2020-08-01,8873,8610,263,3
48119,2020-08-01,2433,2319,114,4.7
48121,2020-08-01,508874,480615,28259,5.6
48123,2020-08-01,9354,8797,557,6
48125,2020-08-01,683,649,34,5
48127,2020-08-01,6241,5847,394,6.3
48129,2020-08-01,1446,1387,59,4.1
48131,2020-08-01,4916,4334,582,11.8
48133,2020-08-01,7331,6895,436,5.9
48135,2020-08-01,80897,71417,9480,11.7
48137,2020-08-01,1355,1316,39,2.9
48139,2020-08-01,94719,89804,4915,5.2
48141,2020-08-01,367401,341232,26169,7.1
48143,2020-08-01,19992,19035,957,4.8
48145,2020-08-01,6725,6371,354,5.3
48147,2020-08-01,17134,16459,675,3.9
48149,2020-08-01,12006,11518,488,4.1
48151,2020-08-01,1643,1576,67,4.1
48153,2020-08-01,2600,2472,128,4.9
48155,2020-08-01,596,578,18,3
48157,2020-08-01,394949,366776,28173,7.1
48159,2020-08-01,5002,4779,223,4.5
48161,2020-08-01,6508,6030,478,7.3
48163,2020-08-01,9600,9097,503,5.2
48165,2020-08-01,9931,9426,505,5.1
48167,2020-08-01,164128,151241,12887,7.9
48169,2020-08-01,2084,1945,139,6.7
48171,2020-08-01,13538,13011,527,3.9
48173,2020-08-01,799,772,27,3.4
48175,2020-08-01,3207,2961,246,7.7
48177,2020-08-01,9830,9360,470,4.8
48179,2020-08-01,7904,7291,613,7.8
48181,2020-08-01,65501,62284,3217,4.9
48183,2020-08-01,56791,52487,4304,7.6
48185,2020-08-01,11104,10285,819,7.4
48187,2020-08-01,81272,77052,4220,5.2
48189,2020-08-01,12086,11409,677,5.6
48191,2020-08-01,1113,1057,56,5
48193,2020-08-01,3873,3730,143,3.7
48195,2020-08-01,2594,2513,81,3.1
48197,2020-08-01,1750,1692,58,3.3
48199,2020-08-01,24891,22919,1972,7.9
48201,2020-08-01,NA,NA,195235,8.5
48203,2020-08-01,29267,27210,2057,7
48205,2020-08-01,2724,2683,41,1.5
48207,2020-08-01,2774,2672,102,3.7
48209,2020-08-01,122474,115678,6796,5.5
48211,2020-08-01,1771,1704,67,3.8
48213,2020-08-01,37793,35642,2151,5.7
48215,2020-08-01,360352,322251,38101,10.6
48217,2020-08-01,16557,15641,916,5.5
48219,2020-08-01,10539,9715,824,7.8
48221,2020-08-01,27868,26254,1614,5.8
48223,2020-08-01,17770,17002,768,4.3
48225,2020-08-01,10342,9893,449,4.3
48227,2020-08-01,13445,12362,1083,8.1
48229,2020-08-01,1896,1762,134,7.1
48231,2020-08-01,44034,41551,2483,5.6
48233,2020-08-01,8656,8144,512,5.9
48235,2020-08-01,775,732,43,5.5
48237,2020-08-01,3451,3236,215,6.2
48239,2020-08-01,7415,7016,399,5.4
48241,2020-08-01,13045,11745,1300,10
48243,2020-08-01,1012,971,41,4.1
48245,2020-08-01,105107,93699,11408,10.9
48247,2020-08-01,1938,1755,183,9.4
48249,2020-08-01,15861,13789,2072,13.1
48251,2020-08-01,83463,78759,4704,5.6
48253,2020-08-01,5836,5476,360,6.2
48255,2020-08-01,6846,6401,445,6.5
48257,2020-08-01,68034,64130,3904,5.7
48259,2020-08-01,22473,21541,932,4.1
48261,2020-08-01,172,163,9,5.2
48263,2020-08-01,498,481,17,3.4
48265,2020-08-01,22056,21039,1017,4.6
48267,2020-08-01,1896,1807,89,4.7
48269,2020-08-01,268,265,3,1.1
48271,2020-08-01,1337,1280,57,4.3
48273,2020-08-01,13453,12383,1070,8
48275,2020-08-01,1488,1416,72,4.8
48277,2020-08-01,24031,22694,1337,5.6
48279,2020-08-01,5392,5162,230,4.3
48281,2020-08-01,9190,8794,396,4.3
48283,2020-08-01,3612,3365,247,6.8
48285,2020-08-01,8545,8130,415,4.9
48287,2020-08-01,9178,8781,397,4.3
48289,2020-08-01,6164,5753,411,6.7
48291,2020-08-01,33580,30257,3323,9.9
48293,2020-08-01,8455,7895,560,6.6
48295,2020-08-01,1520,1463,57,3.8
48297,2020-08-01,5137,4761,376,7.3
48299,2020-08-01,8810,8400,410,4.7
48301,2020-08-01,286,283,3,1
48303,2020-08-01,159632,151550,8082,5.1
48305,2020-08-01,2810,2691,119,4.2
48307,2020-08-01,3333,3118,215,6.5
48309,2020-08-01,123388,116882,6506,5.3
48311,2020-08-01,703,681,22,3.1
48313,2020-08-01,4565,4265,300,6.6
48315,2020-08-01,4326,4009,317,7.3
48317,2020-08-01,2506,2352,154,6.1
48319,2020-08-01,1794,1708,86,4.8
48321,2020-08-01,16536,14913,1623,9.8
48323,2020-08-01,24349,21070,3279,13.5
48325,2020-08-01,21715,20553,1162,5.4
48327,2020-08-01,881,842,39,4.4
48329,2020-08-01,95779,87572,8207,8.6
48331,2020-08-01,9914,9297,617,6.2
48333,2020-08-01,1978,1915,63,3.2
48335,2020-08-01,2429,2231,198,8.2
48337,2020-08-01,9131,8586,545,6
48339,2020-08-01,284915,265638,19277,6.8
48341,2020-08-01,10803,10445,358,3.3
48343,2020-08-01,4767,4227,540,11.3
48345,2020-08-01,452,434,18,4
48347,2020-08-01,28481,26830,1651,5.8
48349,2020-08-01,23636,22399,1237,5.2
48351,2020-08-01,5024,4533,491,9.8
48353,2020-08-01,7251,6905,346,4.8
48355,2020-08-01,165211,151698,13513,8.2
48357,2020-08-01,4066,3851,215,5.3
48359,2020-08-01,911,885,26,2.9
48361,2020-08-01,35825,32476,3349,9.3
48363,2020-08-01,13482,12609,873,6.5
48365,2020-08-01,9443,8699,744,7.9
48367,2020-08-01,68734,65236,3498,5.1
48369,2020-08-01,5087,4990,97,1.9
48371,2020-08-01,6783,6261,522,7.7
48373,2020-08-01,18628,17180,1448,7.8
48375,2020-08-01,55149,52578,2571,4.7
48377,2020-08-01,3230,2777,453,14
48379,2020-08-01,6073,5829,244,4
48381,2020-08-01,73524,70923,2601,3.5
48383,2020-08-01,1803,1623,180,10
48385,2020-08-01,1153,1089,64,5.6
48387,2020-08-01,5277,5015,262,5
48389,2020-08-01,8205,7561,644,7.8
48391,2020-08-01,3123,2881,242,7.7
48393,2020-08-01,430,412,18,4.2
48395,2020-08-01,7280,6880,400,5.5
48397,2020-08-01,53764,51063,2701,5
48399,2020-08-01,4598,4413,185,4
48401,2020-08-01,22304,20802,1502,6.7
48403,2020-08-01,3983,3604,379,9.5
48405,2020-08-01,3066,2803,263,8.6
48407,2020-08-01,11741,10876,865,7.4
48409,2020-08-01,29343,26650,2693,9.2
48411,2020-08-01,2168,2073,95,4.4
48413,2020-08-01,1206,1123,83,6.9
48415,2020-08-01,6303,5811,492,7.8
48417,2020-08-01,1792,1703,89,5
48419,2020-08-01,11641,10926,715,6.1
48421,2020-08-01,1326,1296,30,2.3
48423,2020-08-01,110047,103607,6440,5.9
48425,2020-08-01,4363,4117,246,5.6
48427,2020-08-01,26116,22183,3933,15.1
48429,2020-08-01,4053,3809,244,6
48431,2020-08-01,578,544,34,5.9
48433,2020-08-01,620,593,27,4.4
48435,2020-08-01,1246,1138,108,8.7
48437,2020-08-01,2595,2483,112,4.3
48439,2020-08-01,NA,NA,71371,6.5
48441,2020-08-01,67062,63879,3183,4.7
48443,2020-08-01,412,395,17,4.1
48445,2020-08-01,4949,4620,329,6.6
48447,2020-08-01,672,642,30,4.5
48449,2020-08-01,13519,12719,800,5.9
48451,2020-08-01,54206,51146,3060,5.6
48453,2020-08-01,749725,707275,42450,5.7
48455,2020-08-01,5427,5035,392,7.2
48457,2020-08-01,7488,6834,654,8.7
48459,2020-08-01,17525,16333,1192,6.8
48461,2020-08-01,1864,1767,97,5.2
48463,2020-08-01,11578,10928,650,5.6
48465,2020-08-01,23041,21507,1534,6.7
48467,2020-08-01,26875,25482,1393,5.2
48469,2020-08-01,41243,38160,3083,7.5
48471,2020-08-01,24282,22705,1577,6.5
48473,2020-08-01,23878,22153,1725,7.2
48475,2020-08-01,5888,5285,603,10.2
48477,2020-08-01,15651,14857,794,5.1
48479,2020-08-01,116853,107758,9095,7.8
48481,2020-08-01,21419,20087,1332,6.2
48483,2020-08-01,2301,2180,121,5.3
48485,2020-08-01,56036,52710,3326,5.9
48487,2020-08-01,5088,4845,243,4.8
48489,2020-08-01,6602,5908,694,10.5
48491,2020-08-01,320914,304808,16106,5
48493,2020-08-01,24813,23555,1258,5.1
48495,2020-08-01,3852,3461,391,10.2
48497,2020-08-01,32396,30587,1809,5.6
48499,2020-08-01,18315,17305,1010,5.5
48501,2020-08-01,3536,3119,417,11.8
48503,2020-08-01,8058,7695,363,4.5
48505,2020-08-01,4511,3974,537,11.9
48507,2020-08-01,3336,2895,441,13.2
49001,2020-08-01,2776,2653,123,4.4
49003,2020-08-01,26405,25481,924,3.5
49005,2020-08-01,63817,61881,1936,3
49007,2020-08-01,8651,8199,452,5.2
49009,2020-08-01,458,445,13,2.8
49011,2020-08-01,178469,171155,7314,4.1
49013,2020-08-01,7802,7116,686,8.8
49015,2020-08-01,4485,4296,189,4.2
49017,2020-08-01,2960,2787,173,5.8
49019,2020-08-01,6749,6332,417,6.2
49021,2020-08-01,24666,23530,1136,4.6
49023,2020-08-01,5918,5747,171,2.9
49025,2020-08-01,4156,3982,174,4.2
49027,2020-08-01,5865,5660,205,3.5
49029,2020-08-01,5616,5446,170,3
49031,2020-08-01,472,444,28,5.9
49033,2020-08-01,1519,1472,47,3.1
49035,2020-08-01,647583,612929,34654,5.4
49037,2020-08-01,5505,4916,589,10.7
49039,2020-08-01,12400,11912,488,3.9
49041,2020-08-01,9859,9454,405,4.1
49043,2020-08-01,23818,22179,1639,6.9
49045,2020-08-01,35159,33515,1644,4.7
49047,2020-08-01,13436,12103,1333,9.9
49049,2020-08-01,317106,304847,12259,3.9
49051,2020-08-01,16816,15851,965,5.7
49053,2020-08-01,81058,76712,4346,5.4
49055,2020-08-01,1513,1446,67,4.4
49057,2020-08-01,131293,125204,6089,4.6
50001,2020-08-01,19555,18701,854,4.4
50003,2020-08-01,16850,15866,984,5.8
50005,2020-08-01,13974,13291,683,4.9
50007,2020-08-01,92376,88064,4312,4.7
50009,2020-08-01,2552,2426,126,4.9
50011,2020-08-01,26013,24754,1259,4.8
50013,2020-08-01,3954,3741,213,5.4
50015,2020-08-01,13152,12339,813,6.2
50017,2020-08-01,15202,14603,599,3.9
50019,2020-08-01,12219,11450,769,6.3
50021,2020-08-01,29182,27376,1806,6.2
50023,2020-08-01,32361,31013,1348,4.2
50025,2020-08-01,20616,19316,1300,6.3
50027,2020-08-01,27514,26152,1362,5
51001,2020-08-01,16332,15223,1109,6.8
51003,2020-08-01,55512,52124,3388,6.1
51005,2020-08-01,6738,6304,434,6.4
51007,2020-08-01,6294,5889,405,6.4
51009,2020-08-01,14865,13958,907,6.1
51011,2020-08-01,7115,6676,439,6.2
51013,2020-08-01,152663,144727,7936,5.2
51015,2020-08-01,37123,35325,1798,4.8
51017,2020-08-01,2229,2024,205,9.2
51019,2020-08-01,38083,36087,1996,5.2
51021,2020-08-01,2819,2645,174,6.2
51023,2020-08-01,17220,16449,771,4.5
51025,2020-08-01,6014,5443,571,9.5
51027,2020-08-01,6252,5608,644,10.3
51029,2020-08-01,6274,5778,496,7.9
51031,2020-08-01,25802,24162,1640,6.4
51033,2020-08-01,15228,14082,1146,7.5
51035,2020-08-01,13243,12113,1130,8.5
51036,2020-08-01,3650,3390,260,7.1
51037,2020-08-01,5079,4771,308,6.1
51041,2020-08-01,188492,176148,12344,6.5
51043,2020-08-01,7549,7194,355,4.7
51045,2020-08-01,2312,2187,125,5.4
51047,2020-08-01,24745,23458,1287,5.2
51049,2020-08-01,4622,4297,325,7
51051,2020-08-01,4766,4360,406,8.5
51053,2020-08-01,13686,12688,998,7.3
51057,2020-08-01,5543,5122,421,7.6
51059,2020-08-01,637041,594341,42700,6.7
51061,2020-08-01,37042,35240,1802,4.9
51063,2020-08-01,8129,7697,432,5.3
51065,2020-08-01,13630,12831,799,5.9
51067,2020-08-01,26288,24737,1551,5.9
51069,2020-08-01,49138,46837,2301,4.7
51071,2020-08-01,7799,7287,512,6.6
51073,2020-08-01,19491,18333,1158,5.9
51075,2020-08-01,11268,10702,566,5
51077,2020-08-01,8143,7671,472,5.8
51079,2020-08-01,10114,9551,563,5.6
51081,2020-08-01,4308,3940,368,8.5
51083,2020-08-01,15340,14170,1170,7.6
51085,2020-08-01,58455,55463,2992,5.1
51087,2020-08-01,183459,169544,13915,7.6
51089,2020-08-01,24173,22088,2085,8.6
51091,2020-08-01,1245,1201,44,3.5
51093,2020-08-01,19382,18255,1127,5.8
51095,2020-08-01,37098,34285,2813,7.6
51097,2020-08-01,3944,3713,231,5.9
51099,2020-08-01,14007,13349,658,4.7
51101,2020-08-01,9198,8657,541,5.9
51103,2020-08-01,5478,5101,377,6.9
51105,2020-08-01,8300,7752,548,6.6
51107,2020-08-01,225265,211774,13491,6
51109,2020-08-01,20088,18967,1121,5.6
51111,2020-08-01,5276,4948,328,6.2
51113,2020-08-01,7304,7015,289,4
51115,2020-08-01,4094,3882,212,5.2
51117,2020-08-01,12671,11749,922,7.3
51119,2020-08-01,5235,4947,288,5.5
51121,2020-08-01,48844,46445,2399,4.9
51125,2020-08-01,7317,6861,456,6.2
51127,2020-08-01,12643,12013,630,5
51131,2020-08-01,5638,5155,483,8.6
51133,2020-08-01,5830,5491,339,5.8
51135,2020-08-01,7196,6765,431,6
51137,2020-08-01,17288,16271,1017,5.9
51139,2020-08-01,12176,11396,780,6.4
51141,2020-08-01,7301,6749,552,7.6
51143,2020-08-01,30001,27980,2021,6.7
51145,2020-08-01,14093,13405,688,4.9
51147,2020-08-01,10205,9444,761,7.5
51149,2020-08-01,15113,13999,1114,7.4
51153,2020-08-01,249240,230480,18760,7.5
51155,2020-08-01,16450,14879,1571,9.6
51157,2020-08-01,3745,3565,180,4.8
51159,2020-08-01,4063,3848,215,5.3
51161,2020-08-01,49083,46491,2592,5.3
51163,2020-08-01,10311,9758,553,5.4
51165,2020-08-01,40892,39020,1872,4.6
51167,2020-08-01,11057,10299,758,6.9
51169,2020-08-01,8998,8509,489,5.4
51171,2020-08-01,22315,21095,1220,5.5
51173,2020-08-01,13405,12497,908,6.8
51175,2020-08-01,9208,8648,560,6.1
51177,2020-08-01,67800,63354,4446,6.6
51179,2020-08-01,72945,68334,4611,6.3
51181,2020-08-01,3590,3362,228,6.4
51183,2020-08-01,3864,3465,399,10.3
51185,2020-08-01,15324,14035,1289,8.4
51187,2020-08-01,20450,19176,1274,6.2
51191,2020-08-01,26056,24521,1535,5.9
51193,2020-08-01,9608,9012,596,6.2
51195,2020-08-01,13104,12010,1094,8.3
51197,2020-08-01,13886,12748,1138,8.2
51199,2020-08-01,32782,30762,2020,6.2
51510,2020-08-01,101556,94450,7106,7
51520,2020-08-01,7408,6790,618,8.3
51530,2020-08-01,3076,2896,180,5.9
51540,2020-08-01,25382,23413,1969,7.8
51550,2020-08-01,124098,115150,8948,7.2
51570,2020-08-01,8653,7925,728,8.4
51580,2020-08-01,2373,2156,217,9.1
51590,2020-08-01,19405,17296,2109,10.9
51595,2020-08-01,2432,2072,360,14.8
51600,2020-08-01,13206,12360,846,6.4
51610,2020-08-01,8344,8006,338,4.1
51620,2020-08-01,3806,3373,433,11.4
51630,2020-08-01,14202,13041,1161,8.2
51640,2020-08-01,2911,2676,235,8.1
51650,2020-08-01,66212,59395,6817,10.3
51660,2020-08-01,24034,22341,1693,7
51670,2020-08-01,10141,8794,1347,13.3
51678,2020-08-01,2010,1853,157,7.8
51680,2020-08-01,36628,33583,3045,8.3
51683,2020-08-01,21998,20347,1651,7.5
51685,2020-08-01,9644,8880,764,7.9
51690,2020-08-01,5826,5065,761,13.1
51700,2020-08-01,91947,82331,9616,10.5
51710,2020-08-01,114894,102578,12316,10.7
51720,2020-08-01,1663,1526,137,8.2
51730,2020-08-01,14124,11642,2482,17.6
51735,2020-08-01,6301,6028,273,4.3
51740,2020-08-01,46311,40645,5666,12.2
51750,2020-08-01,8518,7927,591,6.9
51760,2020-08-01,123187,110060,13127,10.7
51770,2020-08-01,50278,45646,4632,9.2
51775,2020-08-01,12772,11990,782,6.1
51790,2020-08-01,12330,11465,865,7
51800,2020-08-01,45422,41840,3582,7.9
51810,2020-08-01,233187,217338,15849,6.8
51820,2020-08-01,10782,9984,798,7.4
51830,2020-08-01,6816,6194,622,9.1
51840,2020-08-01,15129,14181,948,6.3
53001,2020-08-01,9780,9177,603,6.2
53003,2020-08-01,10263,9717,546,5.3
53005,2020-08-01,102434,93706,8728,8.5
53007,2020-08-01,45791,42312,3479,7.6
53009,2020-08-01,28963,26142,2821,9.7
53011,2020-08-01,237346,214802,22544,9.5
53013,2020-08-01,1740,1629,111,6.4
53015,2020-08-01,48270,43669,4601,9.5
53017,2020-08-01,21608,19817,1791,8.3
53019,2020-08-01,2402,2150,252,10.5
53021,2020-08-01,43105,39205,3900,9
53023,2020-08-01,865,800,65,7.5
53025,2020-08-01,47960,43942,4018,8.4
53027,2020-08-01,28581,25259,3322,11.6
53029,2020-08-01,35589,32615,2974,8.4
53031,2020-08-01,13206,11997,1209,9.2
53033,2020-08-01,NA,NA,100462,7.8
53035,2020-08-01,126397,116426,9971,7.9
53037,2020-08-01,20672,18724,1948,9.4
53039,2020-08-01,9830,9011,819,8.3
53041,2020-08-01,34657,31537,3120,9
53043,2020-08-01,4749,4458,291,6.1
53045,2020-08-01,24955,22486,2469,9.9
53047,2020-08-01,20403,18779,1624,8
53049,2020-08-01,8567,7658,909,10.6
53051,2020-08-01,4817,4272,545,11.3
53053,2020-08-01,439311,394642,44669,10.2
53055,2020-08-01,8476,7882,594,7
53057,2020-08-01,61803,55822,5981,9.7
53059,2020-08-01,5394,4842,552,10.2
53061,2020-08-01,441049,404335,36714,8.3
53063,2020-08-01,249525,226963,22562,9
53065,2020-08-01,17865,16260,1605,9
53067,2020-08-01,140305,128628,11677,8.3
53069,2020-08-01,1472,1356,116,7.9
53071,2020-08-01,30142,28114,2028,6.7
53073,2020-08-01,111079,100265,10814,9.7
53075,2020-08-01,21448,20039,1409,6.6
53077,2020-08-01,134343,121116,13227,9.8
54001,2020-08-01,7300,6704,596,8.2
54003,2020-08-01,58403,54620,3783,6.5
54005,2020-08-01,7521,6660,861,11.4
54007,2020-08-01,5249,4754,495,9.4
54009,2020-08-01,9969,9063,906,9.1
54011,2020-08-01,42164,38714,3450,8.2
54013,2020-08-01,2529,2178,351,13.9
54015,2020-08-01,3133,2758,375,12
54017,2020-08-01,3891,3644,247,6.3
54019,2020-08-01,16424,14869,1555,9.5
54021,2020-08-01,2241,2029,212,9.5
54023,2020-08-01,6022,5661,361,6
54025,2020-08-01,16198,15096,1102,6.8
54027,2020-08-01,11017,10431,586,5.3
54029,2020-08-01,13178,11859,1319,10
54031,2020-08-01,5817,5443,374,6.4
54033,2020-08-01,34178,31485,2693,7.9
54035,2020-08-01,13262,12131,1131,8.5
54037,2020-08-01,30399,28507,1892,6.2
54039,2020-08-01,82882,75150,7732,9.3
54041,2020-08-01,6559,5878,681,10.4
54043,2020-08-01,7317,6583,734,10
54045,2020-08-01,11149,9672,1477,13.2
54047,2020-08-01,4362,3747,615,14.1
54049,2020-08-01,25141,22962,2179,8.7
54051,2020-08-01,13443,12212,1231,9.2
54053,2020-08-01,10356,9534,822,7.9
54055,2020-08-01,20468,18377,2091,10.2
54057,2020-08-01,12216,11377,839,6.9
54059,2020-08-01,6993,5952,1041,14.9
54061,2020-08-01,54296,50804,3492,6.4
54063,2020-08-01,6191,5791,400,6.5
54065,2020-08-01,8575,8082,493,5.7
54067,2020-08-01,9801,8850,951,9.7
54069,2020-08-01,20336,18636,1700,8.4
54071,2020-08-01,3731,3574,157,4.2
54073,2020-08-01,2706,2404,302,11.2
54075,2020-08-01,3648,3342,306,8.4
54077,2020-08-01,15429,14401,1028,6.7
54079,2020-08-01,27057,25153,1904,7
54081,2020-08-01,30955,28209,2746,8.9
54083,2020-08-01,12165,11132,1033,8.5
54085,2020-08-01,4443,4061,382,8.6
54087,2020-08-01,5082,4497,585,11.5
54089,2020-08-01,4483,4182,301,6.7
54091,2020-08-01,7762,7216,546,7
54093,2020-08-01,3296,3048,248,7.5
54095,2020-08-01,3189,2870,319,10
54097,2020-08-01,9599,8644,955,9.9
54099,2020-08-01,15864,14548,1316,8.3
54101,2020-08-01,3413,3111,302,8.8
54103,2020-08-01,6880,6248,632,9.2
54105,2020-08-01,2272,2058,214,9.4
54107,2020-08-01,36448,33403,3045,8.4
54109,2020-08-01,6359,5662,697,11
55001,2020-08-01,8065,7449,616,7.6
55003,2020-08-01,7985,7422,563,7.1
55005,2020-08-01,23708,22632,1076,4.5
55007,2020-08-01,7563,7075,488,6.5
55009,2020-08-01,141989,134047,7942,5.6
55011,2020-08-01,6178,5803,375,6.1
55013,2020-08-01,7205,6694,511,7.1
55015,2020-08-01,27187,26082,1105,4.1
55017,2020-08-01,32934,31153,1781,5.4
55019,2020-08-01,16953,16346,607,3.6
55021,2020-08-01,30965,29399,1566,5.1
55023,2020-08-01,7349,6980,369,5
55025,2020-08-01,320793,305659,15134,4.7
55027,2020-08-01,47553,45354,2199,4.6
55029,2020-08-01,16453,15704,749,4.6
55031,2020-08-01,22587,20701,1886,8.3
55033,2020-08-01,22465,21398,1067,4.7
55035,2020-08-01,58883,55759,3124,5.3
55037,2020-08-01,2214,2075,139,6.3
55039,2020-08-01,56047,53470,2577,4.6
55041,2020-08-01,3975,3369,606,15.2
55043,2020-08-01,26044,24885,1159,4.5
55045,2020-08-01,20254,19441,813,4
55047,2020-08-01,9295,8869,426,4.6
55049,2020-08-01,13157,12533,624,4.7
55051,2020-08-01,2554,2282,272,10.6
55053,2020-08-01,9806,8928,878,9
55055,2020-08-01,45194,43010,2184,4.8
55057,2020-08-01,13138,12339,799,6.1
55059,2020-08-01,88920,82976,5944,6.7
55061,2020-08-01,10527,10144,383,3.6
55063,2020-08-01,64267,61031,3236,5
55065,2020-08-01,9368,9041,327,3.5
55067,2020-08-01,9255,8656,599,6.5
55069,2020-08-01,14765,14017,748,5.1
55071,2020-08-01,40085,37905,2180,5.4
55073,2020-08-01,72205,69047,3158,4.4
55075,2020-08-01,19638,18317,1321,6.7
55077,2020-08-01,7590,7197,393,5.2
55078,2020-08-01,1704,1389,315,18.5
55079,2020-08-01,471205,430792,40413,8.6
55081,2020-08-01,23384,22188,1196,5.1
55083,2020-08-01,20136,19138,998,5
55085,2020-08-01,18429,17377,1052,5.7
55087,2020-08-01,103910,98721,5189,5
55089,2020-08-01,48473,45937,2536,5.2
55091,2020-08-01,4047,3884,163,4
55093,2020-08-01,24442,23032,1410,5.8
55095,2020-08-01,24206,22883,1323,5.5
55097,2020-08-01,36616,34779,1837,5
55099,2020-08-01,6212,5884,328,5.3
55101,2020-08-01,98079,91389,6690,6.8
55103,2020-08-01,8918,8560,358,4
55105,2020-08-01,85597,80150,5447,6.4
55107,2020-08-01,6472,6159,313,4.8
55109,2020-08-01,49415,46390,3025,6.1
55111,2020-08-01,34913,32834,2079,6
55113,2020-08-01,8209,7674,535,6.5
55115,2020-08-01,20639,19510,1129,5.5
55117,2020-08-01,62001,59041,2960,4.8
55119,2020-08-01,10712,10346,366,3.4
55121,2020-08-01,15250,14326,924,6.1
55123,2020-08-01,14664,14043,621,4.2
55125,2020-08-01,10841,10291,550,5.1
55127,2020-08-01,56340,53324,3016,5.4
55129,2020-08-01,7944,7530,414,5.2
55131,2020-08-01,76153,72160,3993,5.2
55133,2020-08-01,222761,210990,11771,5.3
55135,2020-08-01,25328,24057,1271,5
55137,2020-08-01,10911,10357,554,5.1
55139,2020-08-01,91881,87427,4454,4.8
55141,2020-08-01,34573,32427,2146,6.2
56001,2020-08-01,19215,18518,697,3.6
56003,2020-08-01,5499,5252,247,4.5
56005,2020-08-01,23143,21190,1953,8.4
56007,2020-08-01,8644,8319,325,3.8
56009,2020-08-01,7770,7188,582,7.5
56011,2020-08-01,4045,3894,151,3.7
56013,2020-08-01,19367,18183,1184,6.1
56015,2020-08-01,6721,6436,285,4.2
56017,2020-08-01,2291,2174,117,5.1
56019,2020-08-01,4337,4104,233,5.4
56021,2020-08-01,51100,48618,2482,4.9
56023,2020-08-01,9463,8956,507,5.4
56025,2020-08-01,40891,37208,3683,9
56027,2020-08-01,1266,1220,46,3.6
56029,2020-08-01,16534,15831,703,4.3
56031,2020-08-01,4700,4471,229,4.9
56033,2020-08-01,16426,15761,665,4
56035,2020-08-01,4183,3898,285,6.8
56037,2020-08-01,20612,18973,1639,8
56039,2020-08-01,16461,15816,645,3.9
56041,2020-08-01,9527,8869,658,6.9
56043,2020-08-01,3983,3785,198,5
56045,2020-08-01,3777,3631,146,3.9
72001,2020-08-01,4089,3676,413,10.1
72003,2020-08-01,11688,10676,1012,8.7
72005,2020-08-01,14233,12917,1316,9.2
72007,2020-08-01,6354,5748,606,9.5
72009,2020-08-01,6218,5698,520,8.4
72011,2020-08-01,8730,8067,663,7.6
72013,2020-08-01,23465,21447,2018,8.6
72015,2020-08-01,4577,4221,356,7.8
72017,2020-08-01,5720,5129,591,10.3
72019,2020-08-01,7158,6470,688,9.6
72021,2020-08-01,64808,59001,5807,9
72023,2020-08-01,13438,12321,1117,8.3
72025,2020-08-01,46889,43214,3675,7.8
72027,2020-08-01,9326,8605,721,7.7
72029,2020-08-01,16031,14643,1388,8.7
72031,2020-08-01,61151,55798,5353,8.8
72033,2020-08-01,7809,7032,777,10
72035,2020-08-01,15658,14581,1077,6.9
72037,2020-08-01,3560,3220,340,9.6
72039,2020-08-01,3664,3207,457,12.5
72041,2020-08-01,14909,14032,877,5.9
72043,2020-08-01,9790,8917,873,8.9
72045,2020-08-01,4796,4332,464,9.7
72047,2020-08-01,8860,7809,1051,11.9
72049,2020-08-01,875,800,75,8.6
72051,2020-08-01,13140,12200,940,7.2
72053,2020-08-01,10572,9460,1112,10.5
72054,2020-08-01,3226,2853,373,11.6
72055,2020-08-01,3804,3378,426,11.2
72057,2020-08-01,10865,10087,778,7.2
72059,2020-08-01,4952,4480,472,9.5
72061,2020-08-01,37258,35145,2113,5.7
72063,2020-08-01,17868,16842,1026,5.7
72065,2020-08-01,12885,11932,953,7.4
72067,2020-08-01,5339,4895,444,8.3
72069,2020-08-01,16479,15214,1265,7.7
72071,2020-08-01,11548,10615,933,8.1
72073,2020-08-01,4207,3904,303,7.2
72075,2020-08-01,14838,13772,1066,7.2
72077,2020-08-01,12045,11003,1042,8.7
72079,2020-08-01,5017,4468,549,10.9
72081,2020-08-01,6796,6073,723,10.6
72083,2020-08-01,2714,2452,262,9.7
72085,2020-08-01,11001,10115,886,8.1
72087,2020-08-01,8276,7479,797,9.6
72089,2020-08-01,6117,5472,645,10.5
72091,2020-08-01,11161,10230,931,8.3
72093,2020-08-01,1918,1782,136,7.1
72095,2020-08-01,2649,2410,239,9
72097,2020-08-01,21083,19346,1737,8.2
72099,2020-08-01,10237,9288,949,9.3
72101,2020-08-01,7903,7058,845,10.7
72103,2020-08-01,7952,7341,611,7.7
72105,2020-08-01,7138,6241,897,12.6
72107,2020-08-01,4817,4242,575,11.9
72109,2020-08-01,4108,3751,357,8.7
72111,2020-08-01,5409,4859,550,10.2
72113,2020-08-01,43184,39574,3610,8.4
72115,2020-08-01,5922,5348,574,9.7
72117,2020-08-01,4515,4090,425,9.4
72119,2020-08-01,16834,15209,1625,9.7
72121,2020-08-01,5730,5214,516,9
72123,2020-08-01,6823,6162,661,9.7
72125,2020-08-01,9281,8510,771,8.3
72127,2020-08-01,133663,122753,10910,8.2
72129,2020-08-01,11246,10330,916,8.1
72131,2020-08-01,9871,8859,1012,10.3
72133,2020-08-01,7698,7116,582,7.6
72135,2020-08-01,26984,25048,1936,7.2
72137,2020-08-01,28740,26479,2261,7.9
72139,2020-08-01,26612,24937,1675,6.3
72141,2020-08-01,6384,5843,541,8.5
72143,2020-08-01,9674,8678,996,10.3
72145,2020-08-01,13030,11523,1507,11.6
72147,2020-08-01,2440,2177,263,10.8
72149,2020-08-01,6715,6079,636,9.5
72151,2020-08-01,8245,7465,780,9.5
72153,2020-08-01,9111,8147,964,10.6
01001,2020-09-01,25525,24133,1392,5.5
01003,2020-09-01,95737,90075,5662,5.9
01005,2020-09-01,8577,7710,867,10.1
01007,2020-09-01,8500,7901,599,7
01009,2020-09-01,24237,23194,1043,4.3
01011,2020-09-01,4915,4571,344,7
01013,2020-09-01,9060,8112,948,10.5
01015,2020-09-01,45929,42388,3541,7.7
01017,2020-09-01,15840,14660,1180,7.4
01019,2020-09-01,11381,10875,506,4.4
01021,2020-09-01,19318,18278,1040,5.4
01023,2020-09-01,4599,4250,349,7.6
01025,2020-09-01,7922,6986,936,11.8
01027,2020-09-01,5984,5708,276,4.6
01029,2020-09-01,5600,5351,249,4.4
01031,2020-09-01,21134,20060,1074,5.1
01033,2020-09-01,23394,21768,1626,7
01035,2020-09-01,4529,4112,417,9.2
01037,2020-09-01,4315,4053,262,6.1
01039,2020-09-01,15153,14366,787,5.2
01041,2020-09-01,6236,5867,369,5.9
01043,2020-09-01,38035,36417,1618,4.3
01045,2020-09-01,20628,19393,1235,6
01047,2020-09-01,14674,12727,1947,13.3
01049,2020-09-01,30177,28769,1408,4.7
01051,2020-09-01,36164,34184,1980,5.5
01053,2020-09-01,14274,13227,1047,7.3
01055,2020-09-01,40096,36756,3340,8.3
01057,2020-09-01,6476,6147,329,5.1
01059,2020-09-01,14196,13569,627,4.4
01061,2020-09-01,10776,10287,489,4.5
01063,2020-09-01,3010,2607,403,13.4
01065,2020-09-01,6185,5491,694,11.2
01067,2020-09-01,6762,6392,370,5.5
01069,2020-09-01,46147,43116,3031,6.6
01071,2020-09-01,22676,21474,1202,5.3
01073,2020-09-01,314095,289723,24372,7.8
01075,2020-09-01,5680,5376,304,5.4
01077,2020-09-01,41496,39154,2342,5.6
01079,2020-09-01,14237,13480,757,5.3
01081,2020-09-01,75691,71351,4340,5.7
01083,2020-09-01,44100,42118,1982,4.5
01085,2020-09-01,3764,3126,638,17
01087,2020-09-01,8111,7155,956,11.8
01089,2020-09-01,185886,175828,10058,5.4
01091,2020-09-01,7708,7109,599,7.8
01093,2020-09-01,12915,12199,716,5.5
01095,2020-09-01,43770,41841,1929,4.4
01097,2020-09-01,190086,171531,18555,9.8
01099,2020-09-01,7445,6717,728,9.8
01101,2020-09-01,107825,96886,10939,10.1
01103,2020-09-01,58323,55431,2892,5
01105,2020-09-01,3488,3020,468,13.4
01107,2020-09-01,7663,7099,564,7.4
01109,2020-09-01,15461,14533,928,6
01111,2020-09-01,9177,8763,414,4.5
01113,2020-09-01,23115,21804,1311,5.7
01115,2020-09-01,39437,37321,2116,5.4
01117,2020-09-01,112035,107218,4817,4.3
01119,2020-09-01,4839,4454,385,8
01121,2020-09-01,35470,32780,2690,7.6
01123,2020-09-01,17861,16460,1401,7.8
01125,2020-09-01,101797,94195,7602,7.5
01127,2020-09-01,24478,22924,1554,6.3
01129,2020-09-01,6745,6078,667,9.9
01131,2020-09-01,2981,2413,568,19.1
01133,2020-09-01,9804,9292,512,5.2
02013,2020-09-01,2445,2385,60,2.5
02016,2020-09-01,3787,3703,84,2.2
02020,2020-09-01,142512,133160,9352,6.6
02050,2020-09-01,6638,5960,678,10.2
02060,2020-09-01,324,298,26,8
02068,2020-09-01,693,620,73,10.5
02070,2020-09-01,1571,1451,120,7.6
02090,2020-09-01,43479,41244,2235,5.1
02100,2020-09-01,1029,914,115,11.2
02105,2020-09-01,1088,979,109,10
02110,2020-09-01,15815,14907,908,5.7
02122,2020-09-01,26051,24158,1893,7.3
02130,2020-09-01,6288,5794,494,7.9
02150,2020-09-01,5909,5658,251,4.2
02158,2020-09-01,2274,1932,342,15
02164,2020-09-01,761,715,46,6
02170,2020-09-01,45650,42547,3103,6.8
02180,2020-09-01,3752,3408,344,9.2
02185,2020-09-01,2712,2557,155,5.7
02188,2020-09-01,2846,2564,282,9.9
02195,2020-09-01,1419,1344,75,5.3
02198,2020-09-01,2789,2583,206,7.4
02220,2020-09-01,4295,4089,206,4.8
02230,2020-09-01,635,528,107,16.9
02240,2020-09-01,2857,2712,145,5.1
02261,2020-09-01,4580,4324,256,5.6
02275,2020-09-01,893,830,63,7.1
02282,2020-09-01,265,251,14,5.3
02290,2020-09-01,2333,2134,199,8.5
04001,2020-09-01,20246,17926,2320,11.5
04003,2020-09-01,52513,49495,3018,5.7
04005,2020-09-01,75315,69310,6005,8
04007,2020-09-01,21261,19860,1401,6.6
04009,2020-09-01,16307,15414,893,5.5
04011,2020-09-01,4387,4153,234,5.3
04012,2020-09-01,9009,8395,614,6.8
04013,2020-09-01,NA,NA,152518,6.6
04015,2020-09-01,88226,80973,7253,8.2
04017,2020-09-01,41500,37895,3605,8.7
04019,2020-09-01,491929,458821,33108,6.7
04021,2020-09-01,190517,177879,12638,6.6
04023,2020-09-01,18953,16714,2239,11.8
04025,2020-09-01,107243,100782,6461,6
04027,2020-09-01,98890,81794,17096,17.3
05001,2020-09-01,9329,8956,373,4
05003,2020-09-01,7174,6540,634,8.8
05005,2020-09-01,16445,15612,833,5.1
05007,2020-09-01,138585,132580,6005,4.3
05009,2020-09-01,15679,14967,712,4.5
05011,2020-09-01,4303,4086,217,5
05013,2020-09-01,2393,2289,104,4.3
05015,2020-09-01,12848,12216,632,4.9
05017,2020-09-01,3247,2922,325,10
05019,2020-09-01,9375,8876,499,5.3
05021,2020-09-01,5486,5221,265,4.8
05023,2020-09-01,9174,8595,579,6.3
05025,2020-09-01,3183,2991,192,6
05027,2020-09-01,8996,8375,621,6.9
05029,2020-09-01,8351,7919,432,5.2
05031,2020-09-01,55320,52433,2887,5.2
05033,2020-09-01,26135,24803,1332,5.1
05035,2020-09-01,20950,19152,1798,8.6
05037,2020-09-01,7201,6798,403,5.6
05039,2020-09-01,2853,2723,130,4.6
05041,2020-09-01,5173,4805,368,7.1
05043,2020-09-01,7670,7195,475,6.2
05045,2020-09-01,60353,57441,2912,4.8
05047,2020-09-01,7407,7028,379,5.1
05049,2020-09-01,4904,4685,219,4.5
05051,2020-09-01,40873,37552,3321,8.1
05053,2020-09-01,8054,7666,388,4.8
05055,2020-09-01,19238,18235,1003,5.2
05057,2020-09-01,9469,9013,456,4.8
05059,2020-09-01,13960,13176,784,5.6
05061,2020-09-01,5534,5269,265,4.8
05063,2020-09-01,16405,15624,781,4.8
05065,2020-09-01,4622,4296,326,7.1
05067,2020-09-01,5758,5398,360,6.3
05069,2020-09-01,27288,25005,2283,8.4
05071,2020-09-01,10036,9497,539,5.4
05073,2020-09-01,2405,2209,196,8.1
05075,2020-09-01,6807,6411,396,5.8
05077,2020-09-01,2776,2572,204,7.3
05079,2020-09-01,3793,3588,205,5.4
05081,2020-09-01,5290,4970,320,6
05083,2020-09-01,8644,8156,488,5.6
05085,2020-09-01,32908,31205,1703,5.2
05087,2020-09-01,7357,7073,284,3.9
05089,2020-09-01,6128,5767,361,5.9
05091,2020-09-01,18991,17840,1151,6.1
05093,2020-09-01,16972,15479,1493,8.8
05095,2020-09-01,2682,2504,178,6.6
05097,2020-09-01,3034,2854,180,5.9
05099,2020-09-01,3516,3314,202,5.7
05101,2020-09-01,3218,3095,123,3.8
05103,2020-09-01,9688,9181,507,5.2
05105,2020-09-01,4108,3904,204,5
05107,2020-09-01,6315,5795,520,8.2
05109,2020-09-01,4322,4088,234,5.4
05111,2020-09-01,9832,9309,523,5.3
05113,2020-09-01,7964,7501,463,5.8
05115,2020-09-01,27548,26102,1446,5.2
05117,2020-09-01,3606,3439,167,4.6
05119,2020-09-01,187037,172146,14891,8
05121,2020-09-01,7465,7062,403,5.4
05123,2020-09-01,7873,7253,620,7.9
05125,2020-09-01,57107,54388,2719,4.8
05127,2020-09-01,4320,4146,174,4
05129,2020-09-01,2960,2807,153,5.2
05131,2020-09-01,55473,52403,3070,5.5
05133,2020-09-01,5458,5164,294,5.4
05135,2020-09-01,5682,5339,343,6
05137,2020-09-01,4620,4339,281,6.1
05139,2020-09-01,15420,14190,1230,8
05141,2020-09-01,5782,5424,358,6.2
05143,2020-09-01,125023,119313,5710,4.6
05145,2020-09-01,33570,31772,1798,5.4
05147,2020-09-01,2769,2629,140,5.1
05149,2020-09-01,7958,7579,379,4.8
06001,2020-09-01,799246,721820,77426,9.7
06003,2020-09-01,455,405,50,11
06005,2020-09-01,14281,13010,1271,8.9
06007,2020-09-01,90474,82305,8169,9
06009,2020-09-01,21160,19613,1547,7.3
06011,2020-09-01,10317,9289,1028,10
06013,2020-09-01,531215,479958,51257,9.6
06015,2020-09-01,9320,8495,825,8.9
06017,2020-09-01,88988,82165,6823,7.7
06019,2020-09-01,438826,392532,46294,10.5
06021,2020-09-01,12369,11435,934,7.6
06023,2020-09-01,58683,53940,4743,8.1
06025,2020-09-01,67343,52415,14928,22.2
06027,2020-09-01,8164,7549,615,7.5
06029,2020-09-01,382804,337263,45541,11.9
06031,2020-09-01,54769,49097,5672,10.4
06033,2020-09-01,28411,25887,2524,8.9
06035,2020-09-01,9367,8781,586,6.3
06037,2020-09-01,NA,NA,631853,13.2
06039,2020-09-01,60757,54897,5860,9.6
06041,2020-09-01,127528,118548,8980,7
06043,2020-09-01,7068,6395,673,9.5
06045,2020-09-01,36801,33622,3179,8.6
06047,2020-09-01,114259,102153,12106,10.6
06049,2020-09-01,3210,3013,197,6.1
06051,2020-09-01,7729,6956,773,10
06053,2020-09-01,213344,196047,17297,8.1
06055,2020-09-01,67911,62276,5635,8.3
06057,2020-09-01,45830,42293,3537,7.7
06059,2020-09-01,NA,NA,146059,9.6
06061,2020-09-01,182109,168909,13200,7.2
06063,2020-09-01,7709,7110,599,7.8
06065,2020-09-01,NA,979520,116633,10.6
06067,2020-09-01,702830,632402,70428,10
06069,2020-09-01,30544,27833,2711,8.9
06071,2020-09-01,959915,859402,100513,10.5
06073,2020-09-01,NA,NA,145203,9.6
06075,2020-09-01,541684,493193,48491,9
06077,2020-09-01,330993,293613,37380,11.3
06079,2020-09-01,130677,120845,9832,7.5
06081,2020-09-01,421235,389143,32092,7.6
06083,2020-09-01,215658,199548,16110,7.5
06085,2020-09-01,NA,926058,74134,7.4
06087,2020-09-01,131149,120278,10871,8.3
06089,2020-09-01,72772,66969,5803,8
06091,2020-09-01,1309,1224,85,6.5
06093,2020-09-01,16960,15600,1360,8
06095,2020-09-01,199338,179130,20208,10.1
06097,2020-09-01,241905,223033,18872,7.8
06099,2020-09-01,239788,215130,24658,10.3
06101,2020-09-01,44920,40690,4230,9.4
06103,2020-09-01,25563,23494,2069,8.1
06105,2020-09-01,4638,4338,300,6.5
06107,2020-09-01,194135,170727,23408,12.1
06109,2020-09-01,19848,17937,1911,9.6
06111,2020-09-01,399863,364738,35125,8.8
06113,2020-09-01,103524,96016,7508,7.3
06115,2020-09-01,29765,26744,3021,10.1
08001,2020-09-01,276729,255197,21532,7.8
08003,2020-09-01,8467,7964,503,5.9
08005,2020-09-01,371107,342220,28887,7.8
08007,2020-09-01,7424,6984,440,5.9
08009,2020-09-01,2126,2085,41,1.9
08011,2020-09-01,1799,1722,77,4.3
08013,2020-09-01,194964,183699,11265,5.8
08014,2020-09-01,40418,37954,2464,6.1
08015,2020-09-01,10146,9625,521,5.1
08017,2020-09-01,1092,1063,29,2.7
08019,2020-09-01,6170,5705,465,7.5
08021,2020-09-01,4055,3871,184,4.5
08023,2020-09-01,1865,1729,136,7.3
08025,2020-09-01,1540,1467,73,4.7
08027,2020-09-01,2157,2069,88,4.1
08029,2020-09-01,14652,13794,858,5.9
08031,2020-09-01,428695,393765,34930,8.1
08033,2020-09-01,1168,1110,58,5
08035,2020-09-01,195812,185601,10211,5.2
08037,2020-09-01,35061,32464,2597,7.4
08039,2020-09-01,15022,14415,607,4
08041,2020-09-01,350164,327378,22786,6.5
08043,2020-09-01,15842,14792,1050,6.6
08045,2020-09-01,31790,30007,1783,5.6
08047,2020-09-01,3955,3614,341,8.6
08049,2020-09-01,9141,8585,556,6.1
08051,2020-09-01,11595,11114,481,4.1
08053,2020-09-01,469,455,14,3
08055,2020-09-01,2686,2460,226,8.4
08057,2020-09-01,984,955,29,2.9
08059,2020-09-01,336402,314133,22269,6.6
08061,2020-09-01,961,942,19,2
08063,2020-09-01,4170,4067,103,2.5
08065,2020-09-01,4724,4413,311,6.6
08067,2020-09-01,32071,30339,1732,5.4
08069,2020-09-01,206002,194333,11669,5.7
08071,2020-09-01,6679,6210,469,7
08073,2020-09-01,2365,2264,101,4.3
08075,2020-09-01,11071,10582,489,4.4
08077,2020-09-01,76958,72003,4955,6.4
08079,2020-09-01,437,416,21,4.8
08081,2020-09-01,7400,7030,370,5
08083,2020-09-01,13030,12303,727,5.6
08085,2020-09-01,21963,20706,1257,5.7
08087,2020-09-01,16162,15272,890,5.5
08089,2020-09-01,8311,7831,480,5.8
08091,2020-09-01,2662,2509,153,5.7
08093,2020-09-01,11244,10678,566,5
08095,2020-09-01,2384,2329,55,2.3
08097,2020-09-01,11084,10265,819,7.4
08099,2020-09-01,6186,5912,274,4.4
08101,2020-09-01,78153,71822,6331,8.1
08103,2020-09-01,3006,2858,148,4.9
08105,2020-09-01,5470,5129,341,6.2
08107,2020-09-01,15890,14931,959,6
08109,2020-09-01,3449,3187,262,7.6
08111,2020-09-01,613,593,20,3.3
08113,2020-09-01,5333,4952,381,7.1
08115,2020-09-01,1171,1136,35,3
08117,2020-09-01,21188,19535,1653,7.8
08119,2020-09-01,13169,12390,779,5.9
08121,2020-09-01,2910,2815,95,3.3
08123,2020-09-01,167019,155312,11707,7
08125,2020-09-01,5515,5360,155,2.8
09001,2020-09-01,457973,419522,38451,8.4
09003,2020-09-01,468839,428845,39994,8.5
09005,2020-09-01,100512,93901,6611,6.6
09007,2020-09-01,90588,84802,5786,6.4
09009,2020-09-01,452298,414595,37703,8.3
09011,2020-09-01,130395,117951,12444,9.5
09013,2020-09-01,82719,77841,4878,5.9
09015,2020-09-01,60563,55954,4609,7.6
10001,2020-09-01,79657,73295,6362,8
10003,2020-09-01,297508,274935,22573,7.6
10005,2020-09-01,108305,101652,6653,6.1
11001,2020-09-01,404522,368874,35648,8.8
12001,2020-09-01,136377,130174,6203,4.5
12003,2020-09-01,11920,11394,526,4.4
12005,2020-09-01,83940,79994,3946,4.7
12007,2020-09-01,10985,10421,564,5.1
12009,2020-09-01,282272,266805,15467,5.5
12011,2020-09-01,NA,929959,78058,7.7
12013,2020-09-01,4868,4650,218,4.5
12015,2020-09-01,70748,66479,4269,6
12017,2020-09-01,46628,43394,3234,6.9
12019,2020-09-01,106445,101925,4520,4.2
12021,2020-09-01,171558,161466,10092,5.9
12023,2020-09-01,29992,28403,1589,5.3
12027,2020-09-01,14021,13381,640,4.6
12029,2020-09-01,6194,5905,289,4.7
12031,2020-09-01,489484,460970,28514,5.8
12033,2020-09-01,145215,136933,8282,5.7
12035,2020-09-01,46329,43433,2896,6.3
12037,2020-09-01,4780,4587,193,4
12039,2020-09-01,18813,17538,1275,6.8
12041,2020-09-01,7111,6815,296,4.2
12043,2020-09-01,5086,4836,250,4.9
12045,2020-09-01,5110,4851,259,5.1
12047,2020-09-01,4317,3983,334,7.7
12049,2020-09-01,8579,8056,523,6.1
12051,2020-09-01,15559,14291,1268,8.1
12053,2020-09-01,71122,66412,4710,6.6
12055,2020-09-01,34277,31844,2433,7.1
12057,2020-09-01,752404,706177,46227,6.1
12059,2020-09-01,6921,6607,314,4.5
12061,2020-09-01,63003,59019,3984,6.3
12063,2020-09-01,17582,16744,838,4.8
12065,2020-09-01,5411,5144,267,4.9
12067,2020-09-01,2845,2728,117,4.1
12069,2020-09-01,149969,139092,10877,7.3
12071,2020-09-01,340022,319239,20783,6.1
12073,2020-09-01,152392,144533,7859,5.2
12075,2020-09-01,16882,16036,846,5
12077,2020-09-01,2639,2518,121,4.6
12079,2020-09-01,7822,7340,482,6.2
12081,2020-09-01,173924,164210,9714,5.6
12083,2020-09-01,138920,130506,8414,6.1
12085,2020-09-01,72023,68546,3477,4.8
12086,2020-09-01,NA,NA,170076,12.6
12087,2020-09-01,43335,40867,2468,5.7
12089,2020-09-01,41527,39716,1811,4.4
12091,2020-09-01,96514,92551,3963,4.1
12093,2020-09-01,17263,16436,827,4.8
12095,2020-09-01,719486,653205,66281,9.2
12097,2020-09-01,180021,159366,20655,11.5
12099,2020-09-01,708512,661893,46619,6.6
12101,2020-09-01,237255,223298,13957,5.9
12103,2020-09-01,482237,454645,27592,5.7
12105,2020-09-01,318019,293055,24964,7.8
12107,2020-09-01,26917,24956,1961,7.3
12109,2020-09-01,134190,128830,5360,4
12111,2020-09-01,145138,135508,9630,6.6
12113,2020-09-01,82718,79391,3327,4
12115,2020-09-01,181663,171752,9911,5.5
12117,2020-09-01,232939,218674,14265,6.1
12119,2020-09-01,31875,29737,2138,6.7
12121,2020-09-01,17901,16984,917,5.1
12123,2020-09-01,8264,7712,552,6.7
12125,2020-09-01,4613,4426,187,4.1
12127,2020-09-01,247939,232359,15580,6.3
12129,2020-09-01,15055,14499,556,3.7
12131,2020-09-01,31989,30613,1376,4.3
12133,2020-09-01,9485,9030,455,4.8
13001,2020-09-01,8675,8285,390,4.5
13003,2020-09-01,4290,4143,147,3.4
13005,2020-09-01,4375,4182,193,4.4
13007,2020-09-01,1063,1001,62,5.8
13009,2020-09-01,17158,15995,1163,6.8
13011,2020-09-01,9460,9106,354,3.7
13013,2020-09-01,38726,36969,1757,4.5
13015,2020-09-01,47798,45255,2543,5.3
13017,2020-09-01,5283,4933,350,6.6
13019,2020-09-01,7178,6821,357,5
13021,2020-09-01,65821,60642,5179,7.9
13023,2020-09-01,4332,4064,268,6.2
13025,2020-09-01,6837,6507,330,4.8
13027,2020-09-01,6587,6229,358,5.4
13029,2020-09-01,18159,17280,879,4.8
13031,2020-09-01,36377,34150,2227,6.1
13033,2020-09-01,8740,8140,600,6.9
13035,2020-09-01,10406,9775,631,6.1
13037,2020-09-01,2078,1971,107,5.1
13039,2020-09-01,20597,19761,836,4.1
13043,2020-09-01,5452,5211,241,4.4
13045,2020-09-01,52673,49615,3058,5.8
13047,2020-09-01,31878,30707,1171,3.7
13049,2020-09-01,4682,4528,154,3.3
13051,2020-09-01,136864,126594,10270,7.5
13053,2020-09-01,1904,1795,109,5.7
13055,2020-09-01,9454,8740,714,7.6
13057,2020-09-01,128740,123310,5430,4.2
13059,2020-09-01,56458,53027,3431,6.1
13061,2020-09-01,861,748,113,13.1
13063,2020-09-01,137756,121762,15994,11.6
13065,2020-09-01,2795,2690,105,3.8
13067,2020-09-01,402694,379659,23035,5.7
13069,2020-09-01,18550,17500,1050,5.7
13071,2020-09-01,20870,19940,930,4.5
13073,2020-09-01,72505,69954,2551,3.5
13075,2020-09-01,7847,7461,386,4.9
13077,2020-09-01,71543,67444,4099,5.7
13079,2020-09-01,5275,5037,238,4.5
13081,2020-09-01,9274,8464,810,8.7
13083,2020-09-01,7736,7479,257,3.3
13085,2020-09-01,11898,11441,457,3.8
13087,2020-09-01,10805,10298,507,4.7
13089,2020-09-01,387430,354425,33005,8.5
13091,2020-09-01,6833,6477,356,5.2
13093,2020-09-01,4674,4295,379,8.1
13095,2020-09-01,36917,33420,3497,9.5
13097,2020-09-01,70525,65144,5381,7.6
13099,2020-09-01,4270,3993,277,6.5
13101,2020-09-01,1787,1720,67,3.7
13103,2020-09-01,30378,29010,1368,4.5
13105,2020-09-01,7734,7215,519,6.7
13107,2020-09-01,8299,7667,632,7.6
13109,2020-09-01,4917,4665,252,5.1
13111,2020-09-01,10898,10493,405,3.7
13113,2020-09-01,54573,51905,2668,4.9
13115,2020-09-01,41809,39610,2199,5.3
13117,2020-09-01,116704,112215,4489,3.8
13119,2020-09-01,9527,9042,485,5.1
13121,2020-09-01,544883,498648,46235,8.5
13123,2020-09-01,11656,11245,411,3.5
13125,2020-09-01,1194,1158,36,3
13127,2020-09-01,37318,35082,2236,6
13129,2020-09-01,27330,26112,1218,4.5
13131,2020-09-01,10227,9827,400,3.9
13133,2020-09-01,6779,6412,367,5.4
13135,2020-09-01,468380,439316,29064,6.2
13137,2020-09-01,17884,17068,816,4.6
13139,2020-09-01,98625,94705,3920,4
13141,2020-09-01,2433,2207,226,9.3
13143,2020-09-01,11863,11235,628,5.3
13145,2020-09-01,15887,15297,590,3.7
13147,2020-09-01,10987,10470,517,4.7
13149,2020-09-01,4929,4656,273,5.5
13151,2020-09-01,112078,103658,8420,7.5
13153,2020-09-01,68555,65315,3240,4.7
13155,2020-09-01,3329,3163,166,5
13157,2020-09-01,39039,37590,1449,3.7
13159,2020-09-01,6539,6233,306,4.7
13161,2020-09-01,5829,5563,266,4.6
13163,2020-09-01,6379,5937,442,6.9
13165,2020-09-01,3133,2945,188,6
13167,2020-09-01,3935,3755,180,4.6
13169,2020-09-01,12889,12359,530,4.1
13171,2020-09-01,7742,7293,449,5.8
13173,2020-09-01,3612,3442,170,4.7
13175,2020-09-01,19084,17930,1154,6
13177,2020-09-01,14249,13650,599,4.2
13179,2020-09-01,24981,23424,1557,6.2
13181,2020-09-01,3384,3206,178,5.3
13183,2020-09-01,7830,7512,318,4.1
13185,2020-09-01,50256,47271,2985,5.9
13187,2020-09-01,15934,15344,590,3.7
13189,2020-09-01,8469,7846,623,7.4
13191,2020-09-01,5785,5461,324,5.6
13193,2020-09-01,4397,4098,299,6.8
13195,2020-09-01,12565,12008,557,4.4
13197,2020-09-01,3083,2940,143,4.6
13199,2020-09-01,8560,7830,730,8.5
13201,2020-09-01,2631,2528,103,3.9
13205,2020-09-01,7897,7340,557,7.1
13207,2020-09-01,12296,11711,585,4.8
13209,2020-09-01,3790,3604,186,4.9
13211,2020-09-01,8816,8387,429,4.9
13213,2020-09-01,14819,13997,822,5.5
13215,2020-09-01,75144,69255,5889,7.8
13217,2020-09-01,50459,46824,3635,7.2
13219,2020-09-01,18563,18044,519,2.8
13221,2020-09-01,6526,6251,275,4.2
13223,2020-09-01,82548,78401,4147,5
13225,2020-09-01,11466,10795,671,5.9
13227,2020-09-01,14413,13822,591,4.1
13229,2020-09-01,8260,7913,347,4.2
13231,2020-09-01,8413,8049,364,4.3
13233,2020-09-01,17764,16864,900,5.1
13235,2020-09-01,3845,3695,150,3.9
13237,2020-09-01,7873,7402,471,6
13239,2020-09-01,767,720,47,6.1
13241,2020-09-01,7141,6837,304,4.3
13243,2020-09-01,2333,2186,147,6.3
13245,2020-09-01,83516,77032,6484,7.8
13247,2020-09-01,42917,39561,3356,7.8
13249,2020-09-01,2066,1990,76,3.7
13251,2020-09-01,4911,4518,393,8
13253,2020-09-01,2967,2823,144,4.9
13255,2020-09-01,27567,25421,2146,7.8
13257,2020-09-01,10158,9579,579,5.7
13259,2020-09-01,2397,2258,139,5.8
13261,2020-09-01,12126,11190,936,7.7
13263,2020-09-01,2672,2497,175,6.5
13265,2020-09-01,506,472,34,6.7
13267,2020-09-01,9171,8808,363,4
13269,2020-09-01,2682,2507,175,6.5
13271,2020-09-01,3617,3281,336,9.3
13273,2020-09-01,3411,3129,282,8.3
13275,2020-09-01,16549,15454,1095,6.6
13277,2020-09-01,19953,18940,1013,5.1
13279,2020-09-01,11827,11081,746,6.3
13281,2020-09-01,3881,3692,189,4.9
13283,2020-09-01,2653,2515,138,5.2
13285,2020-09-01,36297,33955,2342,6.5
13287,2020-09-01,3163,2908,255,8.1
13289,2020-09-01,2673,2492,181,6.8
13291,2020-09-01,10147,9795,352,3.5
13293,2020-09-01,11054,10323,731,6.6
13295,2020-09-01,29811,28601,1210,4.1
13297,2020-09-01,43423,41263,2160,5
13299,2020-09-01,14850,14071,779,5.2
13301,2020-09-01,2559,2404,155,6.1
13303,2020-09-01,6700,6251,449,6.7
13305,2020-09-01,11244,10657,587,5.2
13307,2020-09-01,959,903,56,5.8
13309,2020-09-01,1512,1418,94,6.2
13311,2020-09-01,15866,15340,526,3.3
13313,2020-09-01,41765,39684,2081,5
13315,2020-09-01,2638,2476,162,6.1
13317,2020-09-01,3533,3303,230,6.5
13319,2020-09-01,3690,3512,178,4.8
13321,2020-09-01,8484,8053,431,5.1
15001,2020-09-01,84811,73322,11489,13.5
15003,2020-09-01,414141,357658,56483,13.6
15007,2020-09-01,33246,26461,6785,20.4
15009,2020-09-01,76367,58056,18311,24
16001,2020-09-01,260140,244914,15226,5.9
16003,2020-09-01,1834,1682,152,8.3
16005,2020-09-01,43689,41349,2340,5.4
16007,2020-09-01,3193,3058,135,4.2
16009,2020-09-01,4187,3910,277,6.6
16011,2020-09-01,25050,24059,991,4
16013,2020-09-01,12758,11861,897,7
16015,2020-09-01,3657,3340,317,8.7
16017,2020-09-01,21467,19912,1555,7.2
16019,2020-09-01,59212,56638,2574,4.3
16021,2020-09-01,5589,5277,312,5.6
16023,2020-09-01,1421,1371,50,3.5
16025,2020-09-01,715,687,28,3.9
16027,2020-09-01,108153,101476,6677,6.2
16029,2020-09-01,4142,3992,150,3.6
16031,2020-09-01,12825,12336,489,3.8
16033,2020-09-01,388,374,14,3.6
16035,2020-09-01,3072,2842,230,7.5
16037,2020-09-01,2457,2346,111,4.5
16039,2020-09-01,12343,11720,623,5
16041,2020-09-01,7190,6920,270,3.8
16043,2020-09-01,7708,7441,267,3.5
16045,2020-09-01,8594,8044,550,6.4
16047,2020-09-01,8430,8110,320,3.8
16049,2020-09-01,6982,6525,457,6.5
16051,2020-09-01,14466,13919,547,3.8
16053,2020-09-01,12389,11874,515,4.2
16055,2020-09-01,82621,76990,5631,6.8
16057,2020-09-01,19967,18941,1026,5.1
16059,2020-09-01,3804,3572,232,6.1
16061,2020-09-01,1730,1611,119,6.9
16063,2020-09-01,2765,2626,139,5
16065,2020-09-01,21869,21136,733,3.4
16067,2020-09-01,12166,11703,463,3.8
16069,2020-09-01,20947,19972,975,4.7
16071,2020-09-01,2371,2261,110,4.6
16073,2020-09-01,5648,5309,339,6
16075,2020-09-01,12294,11643,651,5.3
16077,2020-09-01,4583,4415,168,3.7
16079,2020-09-01,5503,5015,488,8.9
16081,2020-09-01,7041,6716,325,4.6
16083,2020-09-01,41833,39582,2251,5.4
16085,2020-09-01,5864,5480,384,6.5
16087,2020-09-01,4886,4610,276,5.6
17001,2020-09-01,31720,30136,1584,5
17003,2020-09-01,1952,1778,174,8.9
17005,2020-09-01,7575,7139,436,5.8
17007,2020-09-01,25364,23415,1949,7.7
17009,2020-09-01,3005,2915,90,3
17011,2020-09-01,16569,15553,1016,6.1
17013,2020-09-01,2225,2105,120,5.4
17015,2020-09-01,7584,7200,384,5.1
17017,2020-09-01,5853,5539,314,5.4
17019,2020-09-01,112460,106057,6403,5.7
17021,2020-09-01,13786,12830,956,6.9
17023,2020-09-01,7376,6960,416,5.6
17025,2020-09-01,6117,5704,413,6.8
17027,2020-09-01,19941,19064,877,4.4
17029,2020-09-01,23908,22279,1629,6.8
17031,2020-09-01,NA,NA,350437,13.5
17033,2020-09-01,8575,8081,494,5.8
17035,2020-09-01,6065,5795,270,4.5
17037,2020-09-01,53547,49683,3864,7.2
17039,2020-09-01,7262,6853,409,5.6
17041,2020-09-01,10220,9728,492,4.8
17043,2020-09-01,488356,445076,43280,8.9
17045,2020-09-01,8875,8426,449,5.1
17047,2020-09-01,2693,2536,157,5.8
17049,2020-09-01,19546,18570,976,5
17051,2020-09-01,10004,9383,621,6.2
17053,2020-09-01,6410,6085,325,5.1
17055,2020-09-01,16027,14739,1288,8
17057,2020-09-01,14750,13743,1007,6.8
17059,2020-09-01,2057,1888,169,8.2
17061,2020-09-01,5990,5645,345,5.8
17063,2020-09-01,24256,22119,2137,8.8
17065,2020-09-01,4310,4106,204,4.7
17067,2020-09-01,8181,7748,433,5.3
17069,2020-09-01,1316,1210,106,8.1
17071,2020-09-01,3561,3394,167,4.7
17073,2020-09-01,24144,22607,1537,6.4
17075,2020-09-01,13663,12949,714,5.2
17077,2020-09-01,27848,25928,1920,6.9
17079,2020-09-01,4704,4477,227,4.8
17081,2020-09-01,17086,15800,1286,7.5
17083,2020-09-01,10748,10090,658,6.1
17085,2020-09-01,10736,10089,647,6
17087,2020-09-01,4157,3867,290,7
17089,2020-09-01,263418,242626,20792,7.9
17091,2020-09-01,54077,49852,4225,7.8
17093,2020-09-01,66665,60832,5833,8.7
17095,2020-09-01,21641,19946,1695,7.8
17097,2020-09-01,370344,344156,26188,7.1
17099,2020-09-01,53163,49089,4074,7.7
17101,2020-09-01,5863,5478,385,6.6
17103,2020-09-01,17481,16508,973,5.6
17105,2020-09-01,16157,15256,901,5.6
17107,2020-09-01,12453,11729,724,5.8
17109,2020-09-01,13290,12526,764,5.7
17111,2020-09-01,158606,145040,13566,8.6
17113,2020-09-01,86683,81661,5022,5.8
17115,2020-09-01,48024,43528,4496,9.4
17117,2020-09-01,22305,21050,1255,5.6
17119,2020-09-01,132954,123863,9091,6.8
17121,2020-09-01,17113,15900,1213,7.1
17123,2020-09-01,5157,4845,312,6.1
17125,2020-09-01,6067,5661,406,6.7
17127,2020-09-01,5525,5119,406,7.3
17129,2020-09-01,6192,5876,316,5.1
17131,2020-09-01,7747,7252,495,6.4
17133,2020-09-01,18589,17744,845,4.5
17135,2020-09-01,11596,10794,802,6.9
17137,2020-09-01,16186,15226,960,5.9
17139,2020-09-01,7399,7066,333,4.5
17141,2020-09-01,24535,22978,1557,6.3
17143,2020-09-01,84970,77182,7788,9.2
17145,2020-09-01,8093,7516,577,7.1
17147,2020-09-01,8725,8352,373,4.3
17149,2020-09-01,6838,6522,316,4.6
17151,2020-09-01,1689,1585,104,6.2
17153,2020-09-01,1805,1624,181,10
17155,2020-09-01,3015,2815,200,6.6
17157,2020-09-01,13890,13122,768,5.5
17159,2020-09-01,7432,7009,423,5.7
17161,2020-09-01,69544,63897,5647,8.1
17163,2020-09-01,127196,116239,10957,8.6
17165,2020-09-01,9625,8809,816,8.5
17167,2020-09-01,98783,91462,7321,7.4
17169,2020-09-01,3178,3036,142,4.5
17171,2020-09-01,2364,2256,108,4.6
17173,2020-09-01,10326,9784,542,5.2
17175,2020-09-01,2409,2269,140,5.8
17177,2020-09-01,21505,20126,1379,6.4
17179,2020-09-01,62689,58619,4070,6.5
17181,2020-09-01,7203,6763,440,6.1
17183,2020-09-01,32973,30401,2572,7.8
17185,2020-09-01,5727,5408,319,5.6
17187,2020-09-01,8135,7703,432,5.3
17189,2020-09-01,9849,9520,329,3.3
17191,2020-09-01,6814,6399,415,6.1
17193,2020-09-01,6183,5824,359,5.8
17195,2020-09-01,27918,26107,1811,6.5
17197,2020-09-01,347802,311613,36189,10.4
17199,2020-09-01,31847,29689,2158,6.8
17201,2020-09-01,136982,123866,13116,9.6
17203,2020-09-01,18311,17413,898,4.9
18001,2020-09-01,16907,16298,609,3.6
18003,2020-09-01,185456,173935,11521,6.2
18005,2020-09-01,43491,41321,2170,5
18007,2020-09-01,4265,4093,172,4
18009,2020-09-01,4838,4583,255,5.3
18011,2020-09-01,35691,34374,1317,3.7
18013,2020-09-01,7548,7156,392,5.2
18015,2020-09-01,9648,9225,423,4.4
18017,2020-09-01,17644,16768,876,5
18019,2020-09-01,61146,57389,3757,6.1
18021,2020-09-01,11425,10777,648,5.7
18023,2020-09-01,16771,16053,718,4.3
18025,2020-09-01,4866,4610,256,5.3
18027,2020-09-01,16516,16000,516,3.1
18029,2020-09-01,25031,23688,1343,5.4
18031,2020-09-01,14756,14070,686,4.6
18033,2020-09-01,21929,20892,1037,4.7
18035,2020-09-01,52889,49639,3250,6.1
18037,2020-09-01,22277,21424,853,3.8
18039,2020-09-01,111640,105825,5815,5.2
18041,2020-09-01,8498,7838,660,7.8
18043,2020-09-01,41091,38860,2231,5.4
18045,2020-09-01,7719,7393,326,4.2
18047,2020-09-01,11338,10872,466,4.1
18049,2020-09-01,9684,9182,502,5.2
18051,2020-09-01,19431,18637,794,4.1
18053,2020-09-01,30863,29232,1631,5.3
18055,2020-09-01,13378,12688,690,5.2
18057,2020-09-01,183469,175901,7568,4.1
18059,2020-09-01,40305,38402,1903,4.7
18061,2020-09-01,19810,18848,962,4.9
18063,2020-09-01,89559,85540,4019,4.5
18065,2020-09-01,21716,20632,1084,5
18067,2020-09-01,36121,33275,2846,7.9
18069,2020-09-01,18127,17320,807,4.5
18071,2020-09-01,23202,22099,1103,4.8
18073,2020-09-01,15413,14580,833,5.4
18075,2020-09-01,8727,8367,360,4.1
18077,2020-09-01,14943,14179,764,5.1
18079,2020-09-01,13487,12786,701,5.2
18081,2020-09-01,82195,78322,3873,4.7
18083,2020-09-01,18222,17429,793,4.4
18085,2020-09-01,41142,39085,2057,5
18087,2020-09-01,19644,18995,649,3.3
18089,2020-09-01,224590,203913,20677,9.2
18091,2020-09-01,47011,43264,3747,8
18093,2020-09-01,20710,19529,1181,5.7
18095,2020-09-01,58477,54569,3908,6.7
18097,2020-09-01,500311,460061,40250,8
18099,2020-09-01,22520,21445,1075,4.8
18101,2020-09-01,5414,5208,206,3.8
18103,2020-09-01,15008,14054,954,6.4
18105,2020-09-01,68306,65044,3262,4.8
18107,2020-09-01,18378,17609,769,4.2
18109,2020-09-01,35647,34012,1635,4.6
18111,2020-09-01,6522,6191,331,5.1
18113,2020-09-01,22341,21213,1128,5
18115,2020-09-01,3128,2952,176,5.6
18117,2020-09-01,8408,7749,659,7.8
18119,2020-09-01,9020,8534,486,5.4
18121,2020-09-01,6921,6620,301,4.3
18123,2020-09-01,9102,8631,471,5.2
18125,2020-09-01,6208,5923,285,4.6
18127,2020-09-01,83434,77973,5461,6.5
18129,2020-09-01,12847,12342,505,3.9
18131,2020-09-01,6380,6076,304,4.8
18133,2020-09-01,16294,15443,851,5.2
18135,2020-09-01,11214,10641,573,5.1
18137,2020-09-01,13722,13107,615,4.5
18139,2020-09-01,8625,8241,384,4.5
18141,2020-09-01,132134,122361,9773,7.4
18143,2020-09-01,10379,9711,668,6.4
18145,2020-09-01,22794,21619,1175,5.2
18147,2020-09-01,10562,10106,456,4.3
18149,2020-09-01,9828,9214,614,6.2
18151,2020-09-01,20085,19218,867,4.3
18153,2020-09-01,7832,7391,441,5.6
18155,2020-09-01,4709,4421,288,6.1
18157,2020-09-01,95050,89868,5182,5.5
18159,2020-09-01,8992,8611,381,4.2
18161,2020-09-01,3411,3275,136,4
18163,2020-09-01,91798,86025,5773,6.3
18165,2020-09-01,6509,6138,371,5.7
18167,2020-09-01,45686,42573,3113,6.8
18169,2020-09-01,14527,13835,692,4.8
18171,2020-09-01,3997,3824,173,4.3
18173,2020-09-01,31679,30325,1354,4.3
18175,2020-09-01,13355,12662,693,5.2
18177,2020-09-01,30029,28089,1940,6.5
18179,2020-09-01,13986,13428,558,4
18181,2020-09-01,13321,12784,537,4
18183,2020-09-01,17132,16410,722,4.2
19001,2020-09-01,4090,3975,115,2.8
19003,2020-09-01,1947,1879,68,3.5
19005,2020-09-01,6796,6582,214,3.1
19007,2020-09-01,5827,5587,240,4.1
19009,2020-09-01,2928,2849,79,2.7
19011,2020-09-01,12514,12009,505,4
19013,2020-09-01,66697,63296,3401,5.1
19015,2020-09-01,14301,13870,431,3
19017,2020-09-01,13280,12910,370,2.8
19019,2020-09-01,10849,10471,378,3.5
19021,2020-09-01,11292,10945,347,3.1
19023,2020-09-01,7552,7320,232,3.1
19025,2020-09-01,3994,3866,128,3.2
19027,2020-09-01,10259,9954,305,3
19029,2020-09-01,6657,6464,193,2.9
19031,2020-09-01,10121,9793,328,3.2
19033,2020-09-01,22739,21797,942,4.1
19035,2020-09-01,6099,5943,156,2.6
19037,2020-09-01,6098,5913,185,3
19039,2020-09-01,4634,4443,191,4.1
19041,2020-09-01,8156,7887,269,3.3
19043,2020-09-01,9396,9046,350,3.7
19045,2020-09-01,21546,20307,1239,5.8
19047,2020-09-01,7653,7367,286,3.7
19049,2020-09-01,48684,47264,1420,2.9
19051,2020-09-01,4023,3884,139,3.5
19053,2020-09-01,4309,4200,109,2.5
19055,2020-09-01,10145,9859,286,2.8
19057,2020-09-01,18349,17292,1057,5.8
19059,2020-09-01,9743,9443,300,3.1
19061,2020-09-01,53520,51060,2460,4.6
19063,2020-09-01,4868,4702,166,3.4
19065,2020-09-01,10121,9732,389,3.8
19067,2020-09-01,8021,7655,366,4.6
19069,2020-09-01,5488,5333,155,2.8
19071,2020-09-01,3643,3552,91,2.5
19073,2020-09-01,5202,5045,157,3
19075,2020-09-01,6128,5927,201,3.3
19077,2020-09-01,5242,5044,198,3.8
19079,2020-09-01,6641,6413,228,3.4
19081,2020-09-01,5568,5371,197,3.5
19083,2020-09-01,7511,7243,268,3.6
19085,2020-09-01,6864,6656,208,3
19087,2020-09-01,9340,8979,361,3.9
19089,2020-09-01,4888,4745,143,2.9
19091,2020-09-01,4844,4699,145,3
19093,2020-09-01,3840,3723,117,3
19095,2020-09-01,9682,9394,288,3
19097,2020-09-01,10317,9848,469,4.5
19099,2020-09-01,18755,17991,764,4.1
19101,2020-09-01,9431,8947,484,5.1
19103,2020-09-01,82990,79428,3562,4.3
19105,2020-09-01,9872,9442,430,4.4
19107,2020-09-01,5017,4830,187,3.7
19109,2020-09-01,7775,7567,208,2.7
19111,2020-09-01,15309,14516,793,5.2
19113,2020-09-01,116354,109674,6680,5.7
19115,2020-09-01,5852,5636,216,3.7
19117,2020-09-01,4592,4453,139,3
19119,2020-09-01,6672,6557,115,1.7
19121,2020-09-01,8134,7784,350,4.3
19123,2020-09-01,11704,11301,403,3.4
19125,2020-09-01,17748,17202,546,3.1
19127,2020-09-01,17002,16165,837,4.9
19129,2020-09-01,6976,6765,211,3
19131,2020-09-01,5884,5742,142,2.4
19133,2020-09-01,4251,4111,140,3.3
19135,2020-09-01,3859,3695,164,4.2
19137,2020-09-01,4723,4543,180,3.8
19139,2020-09-01,20403,19461,942,4.6
19141,2020-09-01,7885,7678,207,2.6
19143,2020-09-01,3378,3311,67,2
19145,2020-09-01,6001,5786,215,3.6
19147,2020-09-01,4340,4195,145,3.3
19149,2020-09-01,14039,13648,391,2.8
19151,2020-09-01,4158,4039,119,2.9
19153,2020-09-01,260620,247513,13107,5
19155,2020-09-01,46217,44325,1892,4.1
19157,2020-09-01,9410,9082,328,3.5
19159,2020-09-01,2328,2260,68,2.9
19161,2020-09-01,5034,4907,127,2.5
19163,2020-09-01,85231,80317,4914,5.8
19165,2020-09-01,6130,5963,167,2.7
19167,2020-09-01,20468,20130,338,1.7
19169,2020-09-01,56713,55107,1606,2.8
19171,2020-09-01,8952,8582,370,4.1
19173,2020-09-01,2979,2905,74,2.5
19175,2020-09-01,5983,5691,292,4.9
19177,2020-09-01,3638,3517,121,3.3
19179,2020-09-01,17145,16255,890,5.2
19181,2020-09-01,27105,26169,936,3.5
19183,2020-09-01,11185,10852,333,3
19185,2020-09-01,2730,2631,99,3.6
19187,2020-09-01,18244,17467,777,4.3
19189,2020-09-01,4868,4644,224,4.6
19191,2020-09-01,10878,10553,325,3
19193,2020-09-01,53797,51570,2227,4.1
19195,2020-09-01,3917,3781,136,3.5
19197,2020-09-01,6648,6437,211,3.2
20001,2020-09-01,6322,5988,334,5.3
20003,2020-09-01,4235,4054,181,4.3
20005,2020-09-01,6795,6348,447,6.6
20007,2020-09-01,2307,2230,77,3.3
20009,2020-09-01,13237,12598,639,4.8
20011,2020-09-01,6615,6216,399,6
20013,2020-09-01,5116,4907,209,4.1
20015,2020-09-01,31858,29836,2022,6.3
20017,2020-09-01,1459,1358,101,6.9
20019,2020-09-01,1485,1383,102,6.9
20021,2020-09-01,9861,9354,507,5.1
20023,2020-09-01,1317,1291,26,2
20025,2020-09-01,1133,1113,20,1.8
20027,2020-09-01,3888,3717,171,4.4
20029,2020-09-01,3858,3692,166,4.3
20031,2020-09-01,3850,3660,190,4.9
20033,2020-09-01,850,813,37,4.4
20035,2020-09-01,16497,15424,1073,6.5
20037,2020-09-01,18628,17556,1072,5.8
20039,2020-09-01,1231,1191,40,3.2
20041,2020-09-01,8695,8315,380,4.4
20043,2020-09-01,4061,3895,166,4.1
20045,2020-09-01,63665,59872,3793,6
20047,2020-09-01,1462,1416,46,3.1
20049,2020-09-01,1166,1110,56,4.8
20051,2020-09-01,16472,15939,533,3.2
20053,2020-09-01,2726,2641,85,3.1
20055,2020-09-01,20382,19694,688,3.4
20057,2020-09-01,17082,16456,626,3.7
20059,2020-09-01,14060,13275,785,5.6
20061,2020-09-01,11471,10629,842,7.3
20063,2020-09-01,1464,1429,35,2.4
20065,2020-09-01,1078,1017,61,5.7
20067,2020-09-01,3084,2934,150,4.9
20069,2020-09-01,3335,3265,70,2.1
20071,2020-09-01,833,820,13,1.6
20073,2020-09-01,3052,2895,157,5.1
20075,2020-09-01,1660,1634,26,1.6
20077,2020-09-01,2752,2615,137,5
20079,2020-09-01,16525,15737,788,4.8
20081,2020-09-01,2262,2210,52,2.3
20083,2020-09-01,1005,982,23,2.3
20085,2020-09-01,7010,6702,308,4.4
20087,2020-09-01,9974,9534,440,4.4
20089,2020-09-01,1258,1222,36,2.9
20091,2020-09-01,334140,317567,16573,5
20093,2020-09-01,2048,1995,53,2.6
20095,2020-09-01,3300,3140,160,4.8
20097,2020-09-01,1289,1248,41,3.2
20099,2020-09-01,9516,8945,571,6
20101,2020-09-01,761,737,24,3.2
20103,2020-09-01,35903,33928,1975,5.5
20105,2020-09-01,1716,1666,50,2.9
20107,2020-09-01,4307,3995,312,7.2
20109,2020-09-01,1626,1592,34,2.1
20111,2020-09-01,16287,15531,756,4.6
20113,2020-09-01,16894,16322,572,3.4
20115,2020-09-01,5719,5491,228,4
20117,2020-09-01,5444,5288,156,2.9
20119,2020-09-01,2199,2137,62,2.8
20121,2020-09-01,17288,16451,837,4.8
20123,2020-09-01,3398,3304,94,2.8
20125,2020-09-01,14542,13350,1192,8.2
20127,2020-09-01,3120,2983,137,4.4
20129,2020-09-01,1145,1102,43,3.8
20131,2020-09-01,5577,5436,141,2.5
20133,2020-09-01,6163,5750,413,6.7
20135,2020-09-01,1327,1279,48,3.6
20137,2020-09-01,2589,2511,78,3
20139,2020-09-01,7849,7450,399,5.1
20141,2020-09-01,1933,1878,55,2.8
20143,2020-09-01,2959,2841,118,4
20145,2020-09-01,2835,2733,102,3.6
20147,2020-09-01,2658,2575,83,3.1
20149,2020-09-01,11801,11342,459,3.9
20151,2020-09-01,4861,4689,172,3.5
20153,2020-09-01,1582,1541,41,2.6
20155,2020-09-01,29365,27701,1664,5.7
20157,2020-09-01,2302,2220,82,3.6
20159,2020-09-01,5067,4865,202,4
20161,2020-09-01,33649,32019,1630,4.8
20163,2020-09-01,2501,2396,105,4.2
20165,2020-09-01,1535,1459,76,5
20167,2020-09-01,3196,3072,124,3.9
20169,2020-09-01,29023,27448,1575,5.4
20171,2020-09-01,2830,2763,67,2.4
20173,2020-09-01,252811,230008,22803,9
20175,2020-09-01,9760,9326,434,4.4
20177,2020-09-01,89342,84170,5172,5.8
20179,2020-09-01,1464,1432,32,2.2
20181,2020-09-01,2869,2773,96,3.3
20183,2020-09-01,1988,1941,47,2.4
20185,2020-09-01,2029,1941,88,4.3
20187,2020-09-01,1091,1069,22,2
20189,2020-09-01,2842,2755,87,3.1
20191,2020-09-01,10881,9983,898,8.3
20193,2020-09-01,4187,4074,113,2.7
20195,2020-09-01,1458,1412,46,3.2
20197,2020-09-01,3627,3494,133,3.7
20199,2020-09-01,841,825,16,1.9
20201,2020-09-01,3081,3019,62,2
20203,2020-09-01,1239,1214,25,2
20205,2020-09-01,3906,3598,308,7.9
20207,2020-09-01,1495,1395,100,6.7
20209,2020-09-01,76966,70876,6090,7.9
21001,2020-09-01,6756,6391,365,5.4
21003,2020-09-01,8574,8233,341,4
21005,2020-09-01,11474,10913,561,4.9
21007,2020-09-01,3317,3160,157,4.7
21009,2020-09-01,17699,16660,1039,5.9
21011,2020-09-01,4412,4158,254,5.8
21013,2020-09-01,8066,7561,505,6.3
21015,2020-09-01,68562,65635,2927,4.3
21017,2020-09-01,9202,8819,383,4.2
21019,2020-09-01,17088,15935,1153,6.7
21021,2020-09-01,12166,11472,694,5.7
21023,2020-09-01,3632,3465,167,4.6
21025,2020-09-01,3140,2882,258,8.2
21027,2020-09-01,7564,7162,402,5.3
21029,2020-09-01,40873,39097,1776,4.3
21031,2020-09-01,4856,4616,240,4.9
21033,2020-09-01,5480,5213,267,4.9
21035,2020-09-01,17558,16715,843,4.8
21037,2020-09-01,48664,46423,2241,4.6
21039,2020-09-01,2140,2059,81,3.8
21041,2020-09-01,5107,4855,252,4.9
21043,2020-09-01,9344,8659,685,7.3
21045,2020-09-01,6452,6157,295,4.6
21047,2020-09-01,24058,22599,1459,6.1
21049,2020-09-01,16566,15669,897,5.4
21051,2020-09-01,5093,4726,367,7.2
21053,2020-09-01,3906,3745,161,4.1
21055,2020-09-01,3560,3412,148,4.2
21057,2020-09-01,3231,3112,119,3.7
21059,2020-09-01,44697,42563,2134,4.8
21061,2020-09-01,4481,4261,220,4.9
21063,2020-09-01,1860,1730,130,7
21065,2020-09-01,5018,4739,279,5.6
21067,2020-09-01,168346,160263,8083,4.8
21069,2020-09-01,5921,5623,298,5
21071,2020-09-01,10323,9477,846,8.2
21073,2020-09-01,24197,22861,1336,5.5
21075,2020-09-01,1957,1830,127,6.5
21077,2020-09-01,3907,3723,184,4.7
21079,2020-09-01,7350,6988,362,4.9
21081,2020-09-01,11199,10588,611,5.5
21083,2020-09-01,15235,14514,721,4.7
21085,2020-09-01,10268,9647,621,6
21087,2020-09-01,4946,4751,195,3.9
21089,2020-09-01,12826,11944,882,6.9
21091,2020-09-01,3706,3546,160,4.3
21093,2020-09-01,45998,43631,2367,5.1
21095,2020-09-01,6142,5488,654,10.6
21097,2020-09-01,8448,8098,350,4.1
21099,2020-09-01,7356,7042,314,4.3
21101,2020-09-01,20376,19478,898,4.4
21103,2020-09-01,7838,7527,311,4
21105,2020-09-01,1697,1617,80,4.7
21107,2020-09-01,17633,16694,939,5.3
21109,2020-09-01,3925,3654,271,6.9
21111,2020-09-01,383112,361312,21800,5.7
21113,2020-09-01,25542,24351,1191,4.7
21115,2020-09-01,6375,5892,483,7.6
21117,2020-09-01,84315,80297,4018,4.8
21119,2020-09-01,4237,3915,322,7.6
21121,2020-09-01,9746,9090,656,6.7
21123,2020-09-01,5596,5326,270,4.8
21125,2020-09-01,24264,22999,1265,5.2
21127,2020-09-01,5006,4666,340,6.8
21129,2020-09-01,1959,1862,97,5
21131,2020-09-01,2516,2306,210,8.3
21133,2020-09-01,5907,5378,529,9
21135,2020-09-01,4406,4121,285,6.5
21137,2020-09-01,9037,8470,567,6.3
21139,2020-09-01,3509,3308,201,5.7
21141,2020-09-01,11732,11274,458,3.9
21143,2020-09-01,3071,2934,137,4.5
21145,2020-09-01,28264,26759,1505,5.3
21147,2020-09-01,4697,4449,248,5.3
21149,2020-09-01,3933,3750,183,4.7
21151,2020-09-01,44672,42596,2076,4.6
21153,2020-09-01,3052,2648,404,13.2
21155,2020-09-01,8955,8521,434,4.8
21157,2020-09-01,14603,13943,660,4.5
21159,2020-09-01,2405,2137,268,11.1
21161,2020-09-01,6688,6316,372,5.6
21163,2020-09-01,11365,10766,599,5.3
21165,2020-09-01,2199,2057,142,6.5
21167,2020-09-01,9605,9085,520,5.4
21169,2020-09-01,3876,3648,228,5.9
21171,2020-09-01,4468,4223,245,5.5
21173,2020-09-01,11081,10455,626,5.6
21175,2020-09-01,4204,3983,221,5.3
21177,2020-09-01,9613,8917,696,7.2
21179,2020-09-01,22143,21175,968,4.4
21181,2020-09-01,3170,3021,149,4.7
21183,2020-09-01,8880,8375,505,5.7
21185,2020-09-01,31732,30627,1105,3.5
21187,2020-09-01,4981,4742,239,4.8
21189,2020-09-01,1020,955,65,6.4
21191,2020-09-01,6625,6368,257,3.9
21193,2020-09-01,7944,7337,607,7.6
21195,2020-09-01,18558,17238,1320,7.1
21197,2020-09-01,4976,4693,283,5.7
21199,2020-09-01,24874,23551,1323,5.3
21201,2020-09-01,760,726,34,4.5
21203,2020-09-01,6239,5901,338,5.4
21205,2020-09-01,9753,9241,512,5.2
21207,2020-09-01,5901,5583,318,5.4
21209,2020-09-01,28313,27155,1158,4.1
21211,2020-09-01,24553,23590,963,3.9
21213,2020-09-01,8515,8090,425,5
21215,2020-09-01,9963,9587,376,3.8
21217,2020-09-01,12602,12087,515,4.1
21219,2020-09-01,5198,5002,196,3.8
21221,2020-09-01,5905,5581,324,5.5
21223,2020-09-01,3680,3499,181,4.9
21225,2020-09-01,5808,5579,229,3.9
21227,2020-09-01,62201,59420,2781,4.5
21229,2020-09-01,5936,5702,234,3.9
21231,2020-09-01,7199,6841,358,5
21233,2020-09-01,5238,4996,242,4.6
21235,2020-09-01,13515,12742,773,5.7
21237,2020-09-01,1992,1887,105,5.3
21239,2020-09-01,14469,13884,585,4
22001,2020-09-01,23735,22035,1700,7.2
22003,2020-09-01,8378,7586,792,9.5
22005,2020-09-01,65119,61121,3998,6.1
22007,2020-09-01,8961,8096,865,9.7
22009,2020-09-01,15222,14120,1102,7.2
22011,2020-09-01,14206,13100,1106,7.8
22013,2020-09-01,5572,5125,447,8
22015,2020-09-01,57283,53957,3326,5.8
22017,2020-09-01,103981,94795,9186,8.8
22019,2020-09-01,92843,81009,11834,12.7
22021,2020-09-01,3743,3496,247,6.6
22023,2020-09-01,3252,3016,236,7.3
22025,2020-09-01,3683,3423,260,7.1
22027,2020-09-01,5537,5168,369,6.7
22029,2020-09-01,7173,6616,557,7.8
22031,2020-09-01,10760,10016,744,6.9
22033,2020-09-01,233230,215808,17422,7.5
22035,2020-09-01,1912,1694,218,11.4
22037,2020-09-01,7919,7417,502,6.3
22039,2020-09-01,12139,11202,937,7.7
22041,2020-09-01,7627,7038,589,7.7
22043,2020-09-01,8322,7812,510,6.1
22045,2020-09-01,28392,25599,2793,9.8
22047,2020-09-01,14320,12907,1413,9.9
22049,2020-09-01,6849,6515,334,4.9
22051,2020-09-01,210491,191676,18815,8.9
22053,2020-09-01,12757,11686,1071,8.4
22055,2020-09-01,114375,106590,7785,6.8
22057,2020-09-01,41881,39307,2574,6.1
22059,2020-09-01,7052,6736,316,4.5
22061,2020-09-01,21181,19938,1243,5.9
22063,2020-09-01,69255,65342,3913,5.7
22065,2020-09-01,3723,3441,282,7.6
22067,2020-09-01,10335,9353,982,9.5
22069,2020-09-01,16633,15486,1147,6.9
22071,2020-09-01,182332,159591,22741,12.5
22073,2020-09-01,70913,65963,4950,7
22075,2020-09-01,9621,9018,603,6.3
22077,2020-09-01,9894,9140,754,7.6
22079,2020-09-01,56176,52856,3320,5.9
22081,2020-09-01,3674,3446,228,6.2
22083,2020-09-01,8312,7705,607,7.3
22085,2020-09-01,9517,9011,506,5.3
22087,2020-09-01,20018,18017,2001,10
22089,2020-09-01,24464,22684,1780,7.3
22091,2020-09-01,4428,3898,530,12
22093,2020-09-01,9077,8168,909,10
22095,2020-09-01,19508,17253,2255,11.6
22097,2020-09-01,32941,30067,2874,8.7
22099,2020-09-01,22279,20449,1830,8.2
22101,2020-09-01,19762,17937,1825,9.2
22103,2020-09-01,115383,108565,6818,5.9
22105,2020-09-01,57951,52701,5250,9.1
22107,2020-09-01,1422,1319,103,7.2
22109,2020-09-01,46803,43273,3530,7.5
22111,2020-09-01,9195,8547,648,7
22113,2020-09-01,23977,22262,1715,7.2
22115,2020-09-01,16016,14928,1088,6.8
22117,2020-09-01,16887,15476,1411,8.4
22119,2020-09-01,14271,13180,1091,7.6
22121,2020-09-01,13759,12799,960,7
22123,2020-09-01,3683,3382,301,8.2
22125,2020-09-01,5375,5115,260,4.8
22127,2020-09-01,4788,4449,339,7.1
23001,2020-09-01,53647,51309,2338,4.4
23003,2020-09-01,27939,26794,1145,4.1
23005,2020-09-01,158835,152469,6366,4
23007,2020-09-01,13318,12723,595,4.5
23009,2020-09-01,27915,26953,962,3.4
23011,2020-09-01,60030,57842,2188,3.6
23013,2020-09-01,18906,18204,702,3.7
23015,2020-09-01,16207,15609,598,3.7
23017,2020-09-01,24899,23577,1322,5.3
23019,2020-09-01,73287,70456,2831,3.9
23021,2020-09-01,7034,6768,266,3.8
23023,2020-09-01,18910,18272,638,3.4
23025,2020-09-01,21423,20414,1009,4.7
23027,2020-09-01,19541,18809,732,3.7
23029,2020-09-01,12521,11942,579,4.6
23031,2020-09-01,109793,105389,4404,4
24001,2020-09-01,29252,27263,1989,6.8
24003,2020-09-01,293081,276447,16634,5.7
24005,2020-09-01,421912,392836,29076,6.9
24009,2020-09-01,45709,43442,2267,5
24011,2020-09-01,16046,15159,887,5.5
24013,2020-09-01,87149,83110,4039,4.6
24015,2020-09-01,49290,46539,2751,5.6
24017,2020-09-01,81388,75814,5574,6.8
24019,2020-09-01,15245,14283,962,6.3
24021,2020-09-01,124797,117626,7171,5.7
24023,2020-09-01,14290,13545,745,5.2
24025,2020-09-01,130123,123113,7010,5.4
24027,2020-09-01,174409,165520,8889,5.1
24029,2020-09-01,8755,8173,582,6.6
24031,2020-09-01,520463,485826,34637,6.7
24033,2020-09-01,480502,437050,43452,9
24035,2020-09-01,25255,24014,1241,4.9
24037,2020-09-01,54069,51637,2432,4.5
24039,2020-09-01,8351,7693,658,7.9
24041,2020-09-01,16525,15694,831,5
24043,2020-09-01,68688,64315,4373,6.4
24045,2020-09-01,48181,45140,3041,6.3
24047,2020-09-01,23688,21900,1788,7.5
24510,2020-09-01,267685,242708,24977,9.3
25001,2020-09-01,110964,101756,9208,8.3
25003,2020-09-01,61698,56347,5351,8.7
25005,2020-09-01,292700,264927,27773,9.5
25007,2020-09-01,10080,9464,616,6.1
25009,2020-09-01,413588,372315,41273,10
25011,2020-09-01,39031,36288,2743,7
25013,2020-09-01,218833,195428,23405,10.7
25015,2020-09-01,84571,78699,5872,6.9
25017,2020-09-01,874586,809302,65284,7.5
25019,2020-09-01,8354,7890,464,5.6
25021,2020-09-01,376918,344621,32297,8.6
25023,2020-09-01,274316,249349,24967,9.1
25025,2020-09-01,446931,398713,48218,10.8
25027,2020-09-01,428972,391406,37566,8.8
26001,2020-09-01,3946,3680,266,6.7
26003,2020-09-01,3215,3016,199,6.2
26005,2020-09-01,61690,58719,2971,4.8
26007,2020-09-01,13236,12526,710,5.4
26009,2020-09-01,10403,9774,629,6
26011,2020-09-01,5856,5460,396,6.8
26013,2020-09-01,3128,2878,250,8
26015,2020-09-01,31049,29504,1545,5
26017,2020-09-01,48844,45833,3011,6.2
26019,2020-09-01,8671,8197,474,5.5
26021,2020-09-01,72346,67619,4727,6.5
26023,2020-09-01,19716,18574,1142,5.8
26025,2020-09-01,60797,56389,4408,7.3
26027,2020-09-01,23829,22326,1503,6.3
26029,2020-09-01,12709,12038,671,5.3
26031,2020-09-01,10232,9628,604,5.9
26033,2020-09-01,16150,15218,932,5.8
26035,2020-09-01,11675,10743,932,8
26037,2020-09-01,39343,37562,1781,4.5
26039,2020-09-01,5678,5295,383,6.7
26041,2020-09-01,16892,15952,940,5.6
26043,2020-09-01,12165,11551,614,5
26045,2020-09-01,54686,51686,3000,5.5
26047,2020-09-01,17379,16433,946,5.4
26049,2020-09-01,177827,163515,14312,8
26051,2020-09-01,9898,9263,635,6.4
26053,2020-09-01,5699,5378,321,5.6
26055,2020-09-01,49462,46851,2611,5.3
26057,2020-09-01,17747,16803,944,5.3
26059,2020-09-01,20002,18845,1157,5.8
26061,2020-09-01,16100,15306,794,4.9
26063,2020-09-01,15631,14890,741,4.7
26065,2020-09-01,144394,135666,8728,6
26067,2020-09-01,30213,28699,1514,5
26069,2020-09-01,10102,9435,667,6.6
26071,2020-09-01,4960,4697,263,5.3
26073,2020-09-01,32802,30942,1860,5.7
26075,2020-09-01,72753,68025,4728,6.5
26077,2020-09-01,130734,123118,7616,5.8
26079,2020-09-01,7917,7340,577,7.3
26081,2020-09-01,354134,334104,20030,5.7
26083,2020-09-01,886,838,48,5.4
26085,2020-09-01,4016,3688,328,8.2
26087,2020-09-01,39779,36504,3275,8.2
26089,2020-09-01,10432,9912,520,5
26091,2020-09-01,44978,42382,2596,5.8
26093,2020-09-01,100900,94208,6692,6.6
26095,2020-09-01,2284,2157,127,5.6
26097,2020-09-01,5908,5698,210,3.6
26099,2020-09-01,443109,400590,42519,9.6
26101,2020-09-01,10219,9512,707,6.9
26103,2020-09-01,31413,29821,1592,5.1
26105,2020-09-01,13354,12537,817,6.1
26107,2020-09-01,18524,17395,1129,6.1
26109,2020-09-01,10749,10252,497,4.6
26111,2020-09-01,39453,37367,2086,5.3
26113,2020-09-01,7030,6650,380,5.4
26115,2020-09-01,72948,68769,4179,5.7
26117,2020-09-01,27639,25986,1653,6
26119,2020-09-01,3021,2762,259,8.6
26121,2020-09-01,76467,69875,6592,8.6
26123,2020-09-01,23270,21933,1337,5.7
26125,2020-09-01,662527,609742,52785,8
26127,2020-09-01,12387,11552,835,6.7
26129,2020-09-01,8059,7503,556,6.9
26131,2020-09-01,2041,1896,145,7.1
26133,2020-09-01,11681,11078,603,5.2
26135,2020-09-01,2977,2757,220,7.4
26137,2020-09-01,11540,10803,737,6.4
26139,2020-09-01,157509,150275,7234,4.6
26141,2020-09-01,4935,4609,326,6.6
26143,2020-09-01,8061,7442,619,7.7
26145,2020-09-01,84150,78009,6141,7.3
26147,2020-09-01,73784,67480,6304,8.5
26149,2020-09-01,28653,26886,1767,6.2
26151,2020-09-01,19436,18360,1076,5.5
26153,2020-09-01,3189,3011,178,5.6
26155,2020-09-01,32081,30203,1878,5.9
26157,2020-09-01,23188,21775,1413,6.1
26159,2020-09-01,34550,32538,2012,5.8
26161,2020-09-01,192293,182144,10149,5.3
26163,2020-09-01,813177,708674,104503,12.9
26165,2020-09-01,14898,13977,921,6.2
27001,2020-09-01,7491,7087,404,5.4
27003,2020-09-01,197147,185601,11546,5.9
27005,2020-09-01,18656,17845,811,4.3
27007,2020-09-01,24872,23728,1144,4.6
27009,2020-09-01,21821,20754,1067,4.9
27011,2020-09-01,2511,2446,65,2.6
27013,2020-09-01,40096,38251,1845,4.6
27015,2020-09-01,14166,13645,521,3.7
27017,2020-09-01,17617,16608,1009,5.7
27019,2020-09-01,58298,55593,2705,4.6
27021,2020-09-01,14550,13570,980,6.7
27023,2020-09-01,6709,6475,234,3.5
27025,2020-09-01,29663,28116,1547,5.2
27027,2020-09-01,36396,35215,1181,3.2
27029,2020-09-01,4441,4221,220,5
27031,2020-09-01,3141,2989,152,4.8
27033,2020-09-01,6334,6099,235,3.7
27035,2020-09-01,32776,31122,1654,5
27037,2020-09-01,241332,227210,14122,5.9
27039,2020-09-01,11912,11475,437,3.7
27041,2020-09-01,21351,20642,709,3.3
27043,2020-09-01,7097,6765,332,4.7
27045,2020-09-01,11538,11130,408,3.5
27047,2020-09-01,16174,15441,733,4.5
27049,2020-09-01,26551,25359,1192,4.5
27051,2020-09-01,3322,3195,127,3.8
27053,2020-09-01,712193,664037,48156,6.8
27055,2020-09-01,10255,9958,297,2.9
27057,2020-09-01,10053,9599,454,4.5
27059,2020-09-01,21081,19962,1119,5.3
27061,2020-09-01,21878,20518,1360,6.2
27063,2020-09-01,5699,5510,189,3.3
27065,2020-09-01,8984,8544,440,4.9
27067,2020-09-01,24607,23706,901,3.7
27069,2020-09-01,2381,2307,74,3.1
27071,2020-09-01,5743,5434,309,5.4
27073,2020-09-01,3463,3349,114,3.3
27075,2020-09-01,5379,5129,250,4.6
27077,2020-09-01,2381,2275,106,4.5
27079,2020-09-01,15808,15080,728,4.6
27081,2020-09-01,3066,2991,75,2.4
27083,2020-09-01,14157,13649,508,3.6
27085,2020-09-01,19018,18168,850,4.5
27087,2020-09-01,2179,1914,265,12.2
27089,2020-09-01,5357,5200,157,2.9
27091,2020-09-01,9778,9383,395,4
27093,2020-09-01,13063,12586,477,3.7
27095,2020-09-01,12640,11845,795,6.3
27097,2020-09-01,17606,16922,684,3.9
27099,2020-09-01,20890,19987,903,4.3
27101,2020-09-01,4799,4636,163,3.4
27103,2020-09-01,20676,19804,872,4.2
27105,2020-09-01,11599,11179,420,3.6
27107,2020-09-01,3222,3069,153,4.7
27109,2020-09-01,91002,86932,4070,4.5
27111,2020-09-01,31604,30480,1124,3.6
27113,2020-09-01,8572,8286,286,3.3
27115,2020-09-01,14392,13513,879,6.1
27117,2020-09-01,4633,4521,112,2.4
27119,2020-09-01,16350,15684,666,4.1
27121,2020-09-01,6474,6234,240,3.7
27123,2020-09-01,290809,270122,20687,7.1
27125,2020-09-01,2208,2135,73,3.3
27127,2020-09-01,7679,7345,334,4.3
27129,2020-09-01,8664,8346,318,3.7
27131,2020-09-01,36834,35230,1604,4.4
27133,2020-09-01,5901,5760,141,2.4
27135,2020-09-01,7750,7471,279,3.6
27137,2020-09-01,100637,94790,5847,5.8
27139,2020-09-01,83314,78899,4415,5.3
27141,2020-09-01,51623,49197,2426,4.7
27143,2020-09-01,8226,7872,354,4.3
27145,2020-09-01,90446,86211,4235,4.7
27147,2020-09-01,20242,19312,930,4.6
27149,2020-09-01,5440,5315,125,2.3
27151,2020-09-01,4773,4593,180,3.8
27153,2020-09-01,13570,13078,492,3.6
27155,2020-09-01,1711,1665,46,2.7
27157,2020-09-01,12295,11857,438,3.6
27159,2020-09-01,5921,5634,287,4.8
27161,2020-09-01,9109,8650,459,5
27163,2020-09-01,142589,135371,7218,5.1
27165,2020-09-01,6510,6285,225,3.5
27167,2020-09-01,3423,3324,99,2.9
27169,2020-09-01,28196,27081,1115,4
27171,2020-09-01,74837,71518,3319,4.4
27173,2020-09-01,5213,5054,159,3.1
28001,2020-09-01,10679,9537,1142,10.7
28003,2020-09-01,15396,14607,789,5.1
28005,2020-09-01,4407,4071,336,7.6
28007,2020-09-01,6920,6373,547,7.9
28009,2020-09-01,2989,2760,229,7.7
28011,2020-09-01,11443,10526,917,8
28013,2020-09-01,5381,5038,343,6.4
28015,2020-09-01,3411,3177,234,6.9
28017,2020-09-01,6970,6376,594,8.5
28019,2020-09-01,3612,3417,195,5.4
28021,2020-09-01,3082,2651,431,14
28023,2020-09-01,5868,5414,454,7.7
28025,2020-09-01,8002,7160,842,10.5
28027,2020-09-01,8304,7274,1030,12.4
28029,2020-09-01,10762,9967,795,7.4
28031,2020-09-01,8498,7928,570,6.7
28033,2020-09-01,90784,85678,5106,5.6
28035,2020-09-01,33526,30998,2528,7.5
28037,2020-09-01,2778,2556,222,8
28039,2020-09-01,8976,8248,728,8.1
28041,2020-09-01,4283,3900,383,8.9
28043,2020-09-01,9284,8664,620,6.7
28045,2020-09-01,18833,17516,1317,7
28047,2020-09-01,87238,80780,6458,7.4
28049,2020-09-01,105259,96330,8929,8.5
28051,2020-09-01,5342,4539,803,15
28053,2020-09-01,2135,1824,311,14.6
28055,2020-09-01,319,292,27,8.5
28057,2020-09-01,10337,9823,514,5
28059,2020-09-01,58371,53894,4477,7.7
28061,2020-09-01,5990,5493,497,8.3
28063,2020-09-01,1966,1603,363,18.5
28065,2020-09-01,4037,3650,387,9.6
28067,2020-09-01,25392,23705,1687,6.6
28069,2020-09-01,3375,3080,295,8.7
28071,2020-09-01,27414,26123,1291,4.7
28073,2020-09-01,30941,29382,1559,5
28075,2020-09-01,29721,27790,1931,6.5
28077,2020-09-01,4674,4298,376,8
28079,2020-09-01,7925,7374,551,7
28081,2020-09-01,41690,39018,2672,6.4
28083,2020-09-01,9776,8777,999,10.2
28085,2020-09-01,14559,13637,922,6.3
28087,2020-09-01,25228,23403,1825,7.2
28089,2020-09-01,52438,49828,2610,5
28091,2020-09-01,10410,9724,686,6.6
28093,2020-09-01,14234,13146,1088,7.6
28095,2020-09-01,15880,14693,1187,7.5
28097,2020-09-01,3897,3603,294,7.5
28099,2020-09-01,10071,9365,706,7
28101,2020-09-01,7949,7390,559,7
28103,2020-09-01,3841,3420,421,11
28105,2020-09-01,22804,21359,1445,6.3
28107,2020-09-01,12759,11563,1196,9.4
28109,2020-09-01,23275,21710,1565,6.7
28111,2020-09-01,4281,3945,336,7.8
28113,2020-09-01,14737,13488,1249,8.5
28115,2020-09-01,14928,14116,812,5.4
28117,2020-09-01,11192,10573,619,5.5
28119,2020-09-01,2311,2067,244,10.6
28121,2020-09-01,74705,71665,3040,4.1
28123,2020-09-01,12739,12095,644,5.1
28125,2020-09-01,1438,1288,150,10.4
28127,2020-09-01,10516,9842,674,6.4
28129,2020-09-01,6642,6299,343,5.2
28131,2020-09-01,7131,6683,448,6.3
28133,2020-09-01,7349,6493,856,11.6
28135,2020-09-01,5114,4746,368,7.2
28137,2020-09-01,11978,11085,893,7.5
28139,2020-09-01,9368,8871,497,5.3
28141,2020-09-01,8386,7972,414,4.9
28143,2020-09-01,4520,3866,654,14.5
28145,2020-09-01,14039,13305,734,5.2
28147,2020-09-01,5008,4609,399,8
28149,2020-09-01,20021,18448,1573,7.9
28151,2020-09-01,16156,14380,1776,11
28153,2020-09-01,7420,6747,673,9.1
28155,2020-09-01,3959,3709,250,6.3
28157,2020-09-01,2820,2428,392,13.9
28159,2020-09-01,7220,6638,582,8.1
28161,2020-09-01,4984,4661,323,6.5
28163,2020-09-01,9801,8951,850,8.7
29001,2020-09-01,10080,9732,348,3.5
29003,2020-09-01,9719,9414,305,3.1
29005,2020-09-01,2685,2612,73,2.7
29007,2020-09-01,10265,9899,366,3.6
29009,2020-09-01,15588,14865,723,4.6
29011,2020-09-01,5264,5080,184,3.5
29013,2020-09-01,7622,7300,322,4.2
29015,2020-09-01,7436,6964,472,6.3
29017,2020-09-01,5427,5185,242,4.5
29019,2020-09-01,97794,94556,3238,3.3
29021,2020-09-01,43768,42041,1727,3.9
29023,2020-09-01,18452,17600,852,4.6
29025,2020-09-01,4215,4070,145,3.4
29027,2020-09-01,21360,20688,672,3.1
29029,2020-09-01,19514,18687,827,4.2
29031,2020-09-01,40613,39092,1521,3.7
29033,2020-09-01,4604,4444,160,3.5
29035,2020-09-01,2572,2463,109,4.2
29037,2020-09-01,54192,51843,2349,4.3
29039,2020-09-01,5889,5704,185,3.1
29041,2020-09-01,3800,3695,105,2.8
29043,2020-09-01,45529,43943,1586,3.5
29045,2020-09-01,3143,3020,123,3.9
29047,2020-09-01,135890,129947,5943,4.4
29049,2020-09-01,10470,10034,436,4.2
29051,2020-09-01,39292,37994,1298,3.3
29053,2020-09-01,7283,7015,268,3.7
29055,2020-09-01,10958,10432,526,4.8
29057,2020-09-01,3580,3469,111,3.1
29059,2020-09-01,7023,6725,298,4.2
29061,2020-09-01,4103,3982,121,2.9
29063,2020-09-01,4741,4597,144,3
29065,2020-09-01,6412,6176,236,3.7
29067,2020-09-01,5108,4897,211,4.1
29069,2020-09-01,11633,10944,689,5.9
29071,2020-09-01,52435,50122,2313,4.4
29073,2020-09-01,7597,7312,285,3.8
29075,2020-09-01,3400,3315,85,2.5
29077,2020-09-01,151940,145881,6059,4
29079,2020-09-01,4335,4212,123,2.8
29081,2020-09-01,3755,3640,115,3.1
29083,2020-09-01,9782,9375,407,4.2
29085,2020-09-01,3983,3842,141,3.5
29087,2020-09-01,2539,2478,61,2.4
29089,2020-09-01,4857,4709,148,3
29091,2020-09-01,16213,15334,879,5.4
29093,2020-09-01,3506,3313,193,5.5
29095,2020-09-01,361879,339138,22741,6.3
29097,2020-09-01,56398,53861,2537,4.5
29099,2020-09-01,116924,111396,5528,4.7
29101,2020-09-01,23169,22209,960,4.1
29103,2020-09-01,1741,1693,48,2.8
29105,2020-09-01,16657,15738,919,5.5
29107,2020-09-01,16535,15857,678,4.1
29109,2020-09-01,17694,16943,751,4.2
29111,2020-09-01,4946,4784,162,3.3
29113,2020-09-01,28515,27302,1213,4.3
29115,2020-09-01,5110,4871,239,4.7
29117,2020-09-01,7353,7151,202,2.7
29119,2020-09-01,10665,10197,468,4.4
29121,2020-09-01,7392,7147,245,3.3
29123,2020-09-01,5525,5235,290,5.2
29125,2020-09-01,3926,3789,137,3.5
29127,2020-09-01,14465,13926,539,3.7
29129,2020-09-01,1862,1821,41,2.2
29131,2020-09-01,12613,12155,458,3.6
29133,2020-09-01,5674,5430,244,4.3
29135,2020-09-01,7329,7108,221,3
29137,2020-09-01,3822,3664,158,4.1
29139,2020-09-01,5752,5562,190,3.3
29141,2020-09-01,8365,8027,338,4
29143,2020-09-01,8532,8132,400,4.7
29145,2020-09-01,26734,25550,1184,4.4
29147,2020-09-01,10786,10481,305,2.8
29149,2020-09-01,3949,3749,200,5.1
29151,2020-09-01,7046,6889,157,2.2
29153,2020-09-01,3559,3383,176,4.9
29155,2020-09-01,6388,5928,460,7.2
29157,2020-09-01,9798,9494,304,3.1
29159,2020-09-01,20735,19674,1061,5.1
29161,2020-09-01,20118,19379,739,3.7
29163,2020-09-01,7552,7265,287,3.8
29165,2020-09-01,58502,56021,2481,4.2
29167,2020-09-01,14415,13884,531,3.7
29169,2020-09-01,14567,13930,637,4.4
29171,2020-09-01,2251,2177,74,3.3
29173,2020-09-01,5645,5483,162,2.9
29175,2020-09-01,10292,9812,480,4.7
29177,2020-09-01,10788,10336,452,4.2
29179,2020-09-01,2985,2842,143,4.8
29181,2020-09-01,5040,4720,320,6.3
29183,2020-09-01,224734,216092,8642,3.8
29185,2020-09-01,3797,3625,172,4.5
29186,2020-09-01,9435,9105,330,3.5
29187,2020-09-01,26639,25095,1544,5.8
29189,2020-09-01,528736,499667,29069,5.5
29195,2020-09-01,10646,10293,353,3.3
29197,2020-09-01,1934,1857,77,4
29199,2020-09-01,2392,2340,52,2.2
29201,2020-09-01,19992,19165,827,4.1
29203,2020-09-01,3427,3262,165,4.8
29205,2020-09-01,3037,2954,83,2.7
29207,2020-09-01,13207,12695,512,3.9
29209,2020-09-01,13450,12670,780,5.8
29211,2020-09-01,2770,2686,84,3
29213,2020-09-01,26551,24575,1976,7.4
29215,2020-09-01,9106,8716,390,4.3
29217,2020-09-01,9546,9206,340,3.6
29219,2020-09-01,18159,17390,769,4.2
29221,2020-09-01,10268,9704,564,5.5
29223,2020-09-01,5098,4857,241,4.7
29225,2020-09-01,17337,16680,657,3.8
29227,2020-09-01,1176,1136,40,3.4
29229,2020-09-01,7317,6968,349,4.8
29510,2020-09-01,153929,141555,12374,8
30001,2020-09-01,5034,4882,152,3
30003,2020-09-01,4866,4567,299,6.1
30005,2020-09-01,2223,2133,90,4
30007,2020-09-01,2603,2473,130,5
30009,2020-09-01,5534,5288,246,4.4
30011,2020-09-01,638,618,20,3.1
30013,2020-09-01,37645,35823,1822,4.8
30015,2020-09-01,2416,2337,79,3.3
30017,2020-09-01,6178,5948,230,3.7
30019,2020-09-01,885,863,22,2.5
30021,2020-09-01,4629,4371,258,5.6
30023,2020-09-01,5054,4855,199,3.9
30025,2020-09-01,1623,1558,65,4
30027,2020-09-01,5825,5655,170,2.9
30029,2020-09-01,49519,46856,2663,5.4
30031,2020-09-01,71325,68736,2589,3.6
30033,2020-09-01,735,723,12,1.6
30035,2020-09-01,5565,5079,486,8.7
30037,2020-09-01,362,349,13,3.6
30039,2020-09-01,1573,1495,78,5
30041,2020-09-01,7597,7276,321,4.2
30043,2020-09-01,5770,5550,220,3.8
30045,2020-09-01,967,925,42,4.3
30047,2020-09-01,13805,13093,712,5.2
30049,2020-09-01,36464,35100,1364,3.7
30051,2020-09-01,947,927,20,2.1
30053,2020-09-01,8058,7479,579,7.2
30055,2020-09-01,968,939,29,3
30057,2020-09-01,4302,4146,156,3.6
30059,2020-09-01,956,917,39,4.1
30061,2020-09-01,1824,1706,118,6.5
30063,2020-09-01,63831,60765,3066,4.8
30065,2020-09-01,2309,2194,115,5
30067,2020-09-01,9055,8610,445,4.9
30069,2020-09-01,258,252,6,2.3
30071,2020-09-01,1863,1799,64,3.4
30073,2020-09-01,2651,2535,116,4.4
30075,2020-09-01,984,963,21,2.1
30077,2020-09-01,3033,2937,96,3.2
30079,2020-09-01,476,442,34,7.1
30081,2020-09-01,20826,19920,906,4.4
30083,2020-09-01,5835,5450,385,6.6
30085,2020-09-01,4442,4217,225,5.1
30087,2020-09-01,3689,3514,175,4.7
30089,2020-09-01,5130,4837,293,5.7
30091,2020-09-01,1769,1698,71,4
30093,2020-09-01,17328,16393,935,5.4
30095,2020-09-01,5341,5105,236,4.4
30097,2020-09-01,1861,1810,51,2.7
30099,2020-09-01,2720,2634,86,3.2
30101,2020-09-01,2154,2059,95,4.4
30103,2020-09-01,341,328,13,3.8
30105,2020-09-01,4024,3888,136,3.4
30107,2020-09-01,742,694,48,6.5
30109,2020-09-01,456,438,18,3.9
30111,2020-09-01,83266,79635,3631,4.4
31001,2020-09-01,16846,16344,502,3
31003,2020-09-01,3751,3673,78,2.1
31005,2020-09-01,222,209,13,5.9
31007,2020-09-01,376,367,9,2.4
31009,2020-09-01,242,234,8,3.3
31011,2020-09-01,2821,2761,60,2.1
31013,2020-09-01,5330,5098,232,4.4
31015,2020-09-01,1025,998,27,2.6
31017,2020-09-01,1347,1314,33,2.4
31019,2020-09-01,27174,26399,775,2.9
31021,2020-09-01,3524,3408,116,3.3
31023,2020-09-01,4547,4403,144,3.2
31025,2020-09-01,13203,12722,481,3.6
31027,2020-09-01,4372,4270,102,2.3
31029,2020-09-01,2199,2165,34,1.5
31031,2020-09-01,3258,3194,64,2
31033,2020-09-01,4108,3943,165,4
31035,2020-09-01,3161,3083,78,2.5
31037,2020-09-01,5602,5464,138,2.5
31039,2020-09-01,4732,4625,107,2.3
31041,2020-09-01,6182,6064,118,1.9
31043,2020-09-01,10511,10108,403,3.8
31045,2020-09-01,5044,4930,114,2.3
31047,2020-09-01,13075,12701,374,2.9
31049,2020-09-01,939,911,28,3
31051,2020-09-01,2870,2796,74,2.6
31053,2020-09-01,19998,19364,634,3.2
31055,2020-09-01,297259,283276,13983,4.7
31057,2020-09-01,1113,1090,23,2.1
31059,2020-09-01,3020,2951,69,2.3
31061,2020-09-01,1425,1378,47,3.3
31063,2020-09-01,1461,1428,33,2.3
31065,2020-09-01,2511,2454,57,2.3
31067,2020-09-01,10698,10349,349,3.3
31069,2020-09-01,1025,995,30,2.9
31071,2020-09-01,1116,1100,16,1.4
31073,2020-09-01,1088,1066,22,2
31075,2020-09-01,395,390,5,1.3
31077,2020-09-01,1170,1140,30,2.6
31079,2020-09-01,32037,30444,1593,5
31081,2020-09-01,4703,4558,145,3.1
31083,2020-09-01,1677,1641,36,2.1
31085,2020-09-01,610,598,12,2
31087,2020-09-01,1283,1236,47,3.7
31089,2020-09-01,5503,5395,108,2
31091,2020-09-01,439,429,10,2.3
31093,2020-09-01,3301,3182,119,3.6
31095,2020-09-01,4123,4019,104,2.5
31097,2020-09-01,2016,1949,67,3.3
31099,2020-09-01,3692,3600,92,2.5
31101,2020-09-01,4495,4381,114,2.5
31103,2020-09-01,553,542,11,2
31105,2020-09-01,1938,1866,72,3.7
31107,2020-09-01,4548,4437,111,2.4
31109,2020-09-01,176034,169566,6468,3.7
31111,2020-09-01,18167,17630,537,3
31113,2020-09-01,451,442,9,2
31115,2020-09-01,392,383,9,2.3
31117,2020-09-01,422,415,7,1.7
31119,2020-09-01,19672,18909,763,3.9
31121,2020-09-01,3951,3824,127,3.2
31123,2020-09-01,2523,2448,75,3
31125,2020-09-01,1864,1811,53,2.8
31127,2020-09-01,3527,3431,96,2.7
31129,2020-09-01,2374,2325,49,2.1
31131,2020-09-01,8247,8004,243,2.9
31133,2020-09-01,1443,1407,36,2.5
31135,2020-09-01,1761,1733,28,1.6
31137,2020-09-01,4791,4667,124,2.6
31139,2020-09-01,4109,3964,145,3.5
31141,2020-09-01,17539,17057,482,2.7
31143,2020-09-01,2809,2747,62,2.2
31145,2020-09-01,5795,5631,164,2.8
31147,2020-09-01,4114,4001,113,2.7
31149,2020-09-01,843,830,13,1.5
31151,2020-09-01,7149,6950,199,2.8
31153,2020-09-01,95678,92354,3324,3.5
31155,2020-09-01,10936,10590,346,3.2
31157,2020-09-01,18150,17474,676,3.7
31159,2020-09-01,8690,8383,307,3.5
31161,2020-09-01,2625,2572,53,2
31163,2020-09-01,1631,1590,41,2.5
31165,2020-09-01,728,713,15,2.1
31167,2020-09-01,3508,3393,115,3.3
31169,2020-09-01,2711,2648,63,2.3
31171,2020-09-01,385,371,14,3.6
31173,2020-09-01,3120,2989,131,4.2
31175,2020-09-01,2025,1984,41,2
31177,2020-09-01,10967,10616,351,3.2
31179,2020-09-01,5500,5372,128,2.3
31181,2020-09-01,1607,1558,49,3
31183,2020-09-01,514,505,9,1.8
31185,2020-09-01,7224,7039,185,2.6
32001,2020-09-01,11120,10578,542,4.9
32003,2020-09-01,NA,954619,173161,15.4
32005,2020-09-01,22711,20999,1712,7.5
32007,2020-09-01,26917,25733,1184,4.4
32009,2020-09-01,401,381,20,5
32011,2020-09-01,1024,993,31,3
32013,2020-09-01,8051,7685,366,4.5
32015,2020-09-01,3169,3033,136,4.3
32017,2020-09-01,2018,1924,94,4.7
32019,2020-09-01,23106,21338,1768,7.7
32021,2020-09-01,2097,1983,114,5.4
32023,2020-09-01,17707,16032,1675,9.5
32027,2020-09-01,2511,2402,109,4.3
32029,2020-09-01,2082,1928,154,7.4
32031,2020-09-01,257324,239742,17582,6.8
32033,2020-09-01,4651,4470,181,3.9
32510,2020-09-01,26421,24538,1883,7.1
33001,2020-09-01,31285,29643,1642,5.2
33003,2020-09-01,23334,21987,1347,5.8
33005,2020-09-01,39554,37529,2025,5.1
33007,2020-09-01,14351,13536,815,5.7
33009,2020-09-01,47873,45755,2118,4.4
33011,2020-09-01,238193,224364,13829,5.8
33013,2020-09-01,82183,78438,3745,4.6
33015,2020-09-01,185613,174955,10658,5.7
33017,2020-09-01,73128,69509,3619,4.9
33019,2020-09-01,23047,21995,1052,4.6
34001,2020-09-01,116607,103021,13586,11.7
34003,2020-09-01,459677,423643,36034,7.8
34005,2020-09-01,224099,210136,13963,6.2
34007,2020-09-01,247491,228344,19147,7.7
34009,2020-09-01,46891,43408,3483,7.4
34011,2020-09-01,64258,59173,5085,7.9
34013,2020-09-01,361201,325477,35724,9.9
34015,2020-09-01,145789,135906,9883,6.8
34017,2020-09-01,347306,315670,31636,9.1
34019,2020-09-01,61280,58008,3272,5.3
34021,2020-09-01,199975,188064,11911,6
34023,2020-09-01,425495,395799,29696,7
34025,2020-09-01,318640,297381,21259,6.7
34027,2020-09-01,244181,229632,14549,6
34029,2020-09-01,268967,250836,18131,6.7
34031,2020-09-01,234043,209906,24137,10.3
34033,2020-09-01,28554,26518,2036,7.1
34035,2020-09-01,162520,152611,9909,6.1
34037,2020-09-01,70779,66035,4744,6.7
34039,2020-09-01,266607,245121,21486,8.1
34041,2020-09-01,53927,50577,3350,6.2
35001,2020-09-01,339538,311733,27805,8.2
35003,2020-09-01,1209,1133,76,6.3
35005,2020-09-01,28573,26153,2420,8.5
35006,2020-09-01,9304,8448,856,9.2
35007,2020-09-01,5293,4931,362,6.8
35009,2020-09-01,22585,21355,1230,5.4
35011,2020-09-01,718,685,33,4.6
35013,2020-09-01,99715,92046,7669,7.7
35015,2020-09-01,32706,29998,2708,8.3
35017,2020-09-01,11748,10517,1231,10.5
35019,2020-09-01,1556,1443,113,7.3
35021,2020-09-01,288,275,13,4.5
35023,2020-09-01,1977,1863,114,5.8
35025,2020-09-01,28875,24847,4028,13.9
35027,2020-09-01,9104,8325,779,8.6
35028,2020-09-01,10129,9781,348,3.4
35029,2020-09-01,10620,9139,1481,13.9
35031,2020-09-01,24321,21605,2716,11.2
35033,2020-09-01,2093,1926,167,8
35035,2020-09-01,25649,23457,2192,8.5
35037,2020-09-01,3124,2874,250,8
35039,2020-09-01,17098,15719,1379,8.1
35041,2020-09-01,7986,7482,504,6.3
35043,2020-09-01,68173,62199,5974,8.8
35045,2020-09-01,51781,46355,5426,10.5
35047,2020-09-01,10488,9627,861,8.2
35049,2020-09-01,73093,66946,6147,8.4
35051,2020-09-01,4215,3826,389,9.2
35053,2020-09-01,6292,5877,415,6.6
35055,2020-09-01,14963,13149,1814,12.1
35057,2020-09-01,5566,5010,556,10
35059,2020-09-01,1667,1579,88,5.3
35061,2020-09-01,31016,28436,2580,8.3
36001,2020-09-01,156918,147839,9079,5.8
36003,2020-09-01,18957,17939,1018,5.4
36005,2020-09-01,609182,488369,120813,19.8
36007,2020-09-01,81071,76019,5052,6.2
36009,2020-09-01,33100,31115,1985,6
36011,2020-09-01,35759,33817,1942,5.4
36013,2020-09-01,52830,49501,3329,6.3
36015,2020-09-01,35101,32918,2183,6.2
36017,2020-09-01,21786,20763,1023,4.7
36019,2020-09-01,35428,33607,1821,5.1
36021,2020-09-01,30573,29168,1405,4.6
36023,2020-09-01,22428,21278,1150,5.1
36025,2020-09-01,18798,17864,934,5
36027,2020-09-01,140625,132308,8317,5.9
36029,2020-09-01,435391,405191,30200,6.9
36031,2020-09-01,16647,15854,793,4.8
36033,2020-09-01,19451,18433,1018,5.2
36035,2020-09-01,22410,21012,1398,6.2
36037,2020-09-01,29152,27726,1426,4.9
36039,2020-09-01,20164,18912,1252,6.2
36041,2020-09-01,2224,2129,95,4.3
36043,2020-09-01,27088,25642,1446,5.3
36045,2020-09-01,43756,41425,2331,5.3
36047,2020-09-01,NA,993433,173917,14.9
36049,2020-09-01,11545,11038,507,4.4
36051,2020-09-01,29527,28144,1383,4.7
36053,2020-09-01,32133,30539,1594,5
36055,2020-09-01,355179,331015,24164,6.8
36057,2020-09-01,21943,20479,1464,6.7
36059,2020-09-01,694804,647779,47025,6.8
36061,2020-09-01,866242,767128,99114,11.4
36063,2020-09-01,96301,89714,6587,6.8
36065,2020-09-01,99768,93787,5981,6
36067,2020-09-01,219005,205152,13853,6.3
36069,2020-09-01,53669,50988,2681,5
36071,2020-09-01,180691,168900,11791,6.5
36073,2020-09-01,16977,16020,957,5.6
36075,2020-09-01,51426,48343,3083,6
36077,2020-09-01,26401,25057,1344,5.1
36079,2020-09-01,49453,46621,2832,5.7
36081,2020-09-01,NA,948628,161825,14.6
36083,2020-09-01,80345,76106,4239,5.3
36085,2020-09-01,211805,186167,25638,12.1
36087,2020-09-01,150916,140903,10013,6.6
36089,2020-09-01,43115,40881,2234,5.2
36091,2020-09-01,118095,112445,5650,4.8
36093,2020-09-01,76640,71598,5042,6.6
36095,2020-09-01,14357,13671,686,4.8
36097,2020-09-01,8127,7718,409,5
36099,2020-09-01,15106,14249,857,5.7
36101,2020-09-01,42006,39748,2258,5.4
36103,2020-09-01,756818,708729,48089,6.4
36105,2020-09-01,35872,33354,2518,7
36107,2020-09-01,21957,20793,1164,5.3
36109,2020-09-01,47489,45262,2227,4.7
36111,2020-09-01,86021,80886,5135,6
36113,2020-09-01,30899,29268,1631,5.3
36115,2020-09-01,27690,26376,1314,4.7
36117,2020-09-01,42554,40371,2183,5.1
36119,2020-09-01,472695,438639,34056,7.2
36121,2020-09-01,17978,17187,791,4.4
36123,2020-09-01,11554,11072,482,4.2
37001,2020-09-01,81613,75868,5745,7
37003,2020-09-01,17777,16655,1122,6.3
37005,2020-09-01,4360,4061,299,6.9
37007,2020-09-01,10638,9692,946,8.9
37009,2020-09-01,13050,12338,712,5.5
37011,2020-09-01,7643,7217,426,5.6
37013,2020-09-01,19837,18584,1253,6.3
37015,2020-09-01,7698,7194,504,6.5
37017,2020-09-01,15101,14035,1066,7.1
37019,2020-09-01,53335,49126,4209,7.9
37021,2020-09-01,138179,127751,10428,7.5
37023,2020-09-01,40291,37649,2642,6.6
37025,2020-09-01,109284,101854,7430,6.8
37027,2020-09-01,36209,33486,2723,7.5
37029,2020-09-01,4655,4426,229,4.9
37031,2020-09-01,31950,30230,1720,5.4
37033,2020-09-01,9652,8944,708,7.3
37035,2020-09-01,78299,72740,5559,7.1
37037,2020-09-01,35568,33729,1839,5.2
37039,2020-09-01,11000,10190,810,7.4
37041,2020-09-01,5510,5172,338,6.1
37043,2020-09-01,4137,3847,290,7
37045,2020-09-01,48897,45024,3873,7.9
37047,2020-09-01,22918,20992,1926,8.4
37049,2020-09-01,41460,38767,2693,6.5
37051,2020-09-01,127881,115684,12197,9.5
37053,2020-09-01,13926,13185,741,5.3
37055,2020-09-01,21124,19829,1295,6.1
37057,2020-09-01,79805,74339,5466,6.8
37059,2020-09-01,20208,18974,1234,6.1
37061,2020-09-01,25283,23926,1357,5.4
37063,2020-09-01,171755,160316,11439,6.7
37065,2020-09-01,21057,18601,2456,11.7
37067,2020-09-01,186548,172692,13856,7.4
37069,2020-09-01,31420,29305,2115,6.7
37071,2020-09-01,110383,101692,8691,7.9
37073,2020-09-01,5139,4858,281,5.5
37075,2020-09-01,3132,2862,270,8.6
37077,2020-09-01,29801,28081,1720,5.8
37079,2020-09-01,9806,9231,575,5.9
37081,2020-09-01,260949,238622,22327,8.6
37083,2020-09-01,20404,18391,2013,9.9
37085,2020-09-01,53693,49869,3824,7.1
37087,2020-09-01,29069,27054,2015,6.9
37089,2020-09-01,53156,49887,3269,6.1
37091,2020-09-01,9087,8437,650,7.2
37093,2020-09-01,20011,18282,1729,8.6
37095,2020-09-01,1907,1764,143,7.5
37097,2020-09-01,89340,83172,6168,6.9
37099,2020-09-01,20643,19359,1284,6.2
37101,2020-09-01,99531,93401,6130,6.2
37103,2020-09-01,4287,4046,241,5.6
37105,2020-09-01,26181,24199,1982,7.6
37107,2020-09-01,28135,26305,1830,6.5
37109,2020-09-01,43490,40873,2617,6
37111,2020-09-01,20788,19484,1304,6.3
37113,2020-09-01,15998,15028,970,6.1
37115,2020-09-01,9727,9115,612,6.3
37117,2020-09-01,9124,8471,653,7.2
37119,2020-09-01,624670,575161,49509,7.9
37121,2020-09-01,5976,5555,421,7
37123,2020-09-01,11600,10842,758,6.5
37125,2020-09-01,41511,38759,2752,6.6
37127,2020-09-01,42480,38770,3710,8.7
37129,2020-09-01,123151,115085,8066,6.5
37131,2020-09-01,7624,7052,572,7.5
37133,2020-09-01,65321,60911,4410,6.8
37135,2020-09-01,78231,74245,3986,5.1
37137,2020-09-01,5329,5036,293,5.5
37139,2020-09-01,16795,15648,1147,6.8
37141,2020-09-01,28613,26896,1717,6
37143,2020-09-01,4957,4646,311,6.3
37145,2020-09-01,18161,16891,1270,7
37147,2020-09-01,89243,82968,6275,7
37149,2020-09-01,9174,8651,523,5.7
37151,2020-09-01,64696,60259,4437,6.9
37153,2020-09-01,17001,15378,1623,9.5
37155,2020-09-01,50677,45809,4868,9.6
37157,2020-09-01,39434,36327,3107,7.9
37159,2020-09-01,65464,60565,4899,7.5
37161,2020-09-01,25126,22924,2202,8.8
37163,2020-09-01,29028,27341,1687,5.8
37165,2020-09-01,11643,10102,1541,13.2
37167,2020-09-01,30008,28210,1798,6
37169,2020-09-01,21220,19936,1284,6.1
37171,2020-09-01,32891,30838,2053,6.2
37173,2020-09-01,7109,6640,469,6.6
37175,2020-09-01,14498,13687,811,5.6
37177,2020-09-01,1497,1386,111,7.4
37179,2020-09-01,122290,115214,7076,5.8
37181,2020-09-01,17324,15442,1882,10.9
37183,2020-09-01,590518,553731,36787,6.2
37185,2020-09-01,6773,6099,674,10
37187,2020-09-01,4557,4176,381,8.4
37189,2020-09-01,28660,27206,1454,5.1
37191,2020-09-01,51526,48237,3289,6.4
37193,2020-09-01,28723,26933,1790,6.2
37195,2020-09-01,34952,31888,3064,8.8
37197,2020-09-01,17381,16318,1063,6.1
37199,2020-09-01,8354,7866,488,5.8
38001,2020-09-01,990,957,33,3.3
38003,2020-09-01,5224,5090,134,2.6
38005,2020-09-01,2392,2273,119,5
38007,2020-09-01,496,483,13,2.6
38009,2020-09-01,2985,2862,123,4.1
38011,2020-09-01,1656,1612,44,2.7
38013,2020-09-01,1037,995,42,4.1
38015,2020-09-01,50780,49218,1562,3.1
38017,2020-09-01,105472,102067,3405,3.2
38019,2020-09-01,1940,1888,52,2.7
38021,2020-09-01,2312,2266,46,2
38023,2020-09-01,1417,1379,38,2.7
38025,2020-09-01,3021,2873,148,4.9
38027,2020-09-01,1208,1173,35,2.9
38029,2020-09-01,1514,1460,54,3.6
38031,2020-09-01,1558,1523,35,2.2
38033,2020-09-01,842,821,21,2.5
38035,2020-09-01,36942,35737,1205,3.3
38037,2020-09-01,1198,1175,23,1.9
38039,2020-09-01,1026,1002,24,2.3
38041,2020-09-01,1411,1365,46,3.3
38043,2020-09-01,1282,1247,35,2.7
38045,2020-09-01,2083,2049,34,1.6
38047,2020-09-01,854,834,20,2.3
38049,2020-09-01,3086,2988,98,3.2
38051,2020-09-01,1115,1083,32,2.9
38053,2020-09-01,8962,8279,683,7.6
38055,2020-09-01,4798,4638,160,3.3
38057,2020-09-01,3671,3512,159,4.3
38059,2020-09-01,16756,16144,612,3.7
38061,2020-09-01,6653,6296,357,5.4
38063,2020-09-01,1415,1381,34,2.4
38065,2020-09-01,886,849,37,4.2
38067,2020-09-01,3376,3272,104,3.1
38069,2020-09-01,1710,1663,47,2.7
38071,2020-09-01,5722,5551,171,3
38073,2020-09-01,2877,2819,58,2
38075,2020-09-01,1235,1189,46,3.7
38077,2020-09-01,8694,8492,202,2.3
38079,2020-09-01,4720,4144,576,12.2
38081,2020-09-01,2828,2780,48,1.7
38083,2020-09-01,661,636,25,3.8
38085,2020-09-01,1227,1179,48,3.9
38087,2020-09-01,393,382,11,2.8
38089,2020-09-01,17921,16685,1236,6.9
38091,2020-09-01,956,935,21,2.2
38093,2020-09-01,10499,10221,278,2.6
38095,2020-09-01,1173,1148,25,2.1
38097,2020-09-01,4564,4460,104,2.3
38099,2020-09-01,5128,4977,151,2.9
38101,2020-09-01,31720,30151,1569,4.9
38103,2020-09-01,1958,1905,53,2.7
38105,2020-09-01,22024,19733,2291,10.4
39001,2020-09-01,10991,10151,840,7.6
39003,2020-09-01,47915,44653,3262,6.8
39005,2020-09-01,26696,25320,1376,5.2
39007,2020-09-01,44057,40888,3169,7.2
39009,2020-09-01,26125,24319,1806,6.9
39011,2020-09-01,24431,23163,1268,5.2
39013,2020-09-01,29107,26564,2543,8.7
39015,2020-09-01,19442,18062,1380,7.1
39017,2020-09-01,194901,181701,13200,6.8
39019,2020-09-01,12802,11849,953,7.4
39021,2020-09-01,19762,18641,1121,5.7
39023,2020-09-01,62630,58235,4395,7
39025,2020-09-01,106458,100029,6429,6
39027,2020-09-01,17827,16539,1288,7.2
39029,2020-09-01,47473,43613,3860,8.1
39031,2020-09-01,14199,13164,1035,7.3
39033,2020-09-01,18652,17297,1355,7.3
39035,2020-09-01,537280,483588,53692,10
39037,2020-09-01,25839,24546,1293,5
39039,2020-09-01,17912,16880,1032,5.8
39041,2020-09-01,111590,106263,5327,4.8
39043,2020-09-01,37110,34194,2916,7.9
39045,2020-09-01,78632,73959,4673,5.9
39047,2020-09-01,13937,13011,926,6.6
39049,2020-09-01,710683,657087,53596,7.5
39051,2020-09-01,21939,20739,1200,5.5
39053,2020-09-01,11813,10969,844,7.1
39055,2020-09-01,41842,39589,2253,5.4
39057,2020-09-01,83005,78284,4721,5.7
39059,2020-09-01,18276,16985,1291,7.1
39061,2020-09-01,420087,387473,32614,7.8
39063,2020-09-01,41767,39566,2201,5.3
39065,2020-09-01,13992,13132,860,6.1
39067,2020-09-01,6701,6152,549,8.2
39069,2020-09-01,13102,12391,711,5.4
39071,2020-09-01,17607,16412,1195,6.8
39073,2020-09-01,12875,12107,768,6
39075,2020-09-01,21290,20618,672,3.2
39077,2020-09-01,27562,25788,1774,6.4
39079,2020-09-01,13231,12207,1024,7.7
39081,2020-09-01,27581,24962,2619,9.5
39083,2020-09-01,31354,29765,1589,5.1
39085,2020-09-01,108414,100819,7595,7
39087,2020-09-01,23868,22087,1781,7.5
39089,2020-09-01,90751,85510,5241,5.8
39091,2020-09-01,22495,21208,1287,5.7
39093,2020-09-01,133271,122289,10982,8.2
39095,2020-09-01,210514,191891,18623,8.8
39097,2020-09-01,20841,19763,1078,5.2
39099,2020-09-01,101661,92195,9466,9.3
39101,2020-09-01,28174,26289,1885,6.7
39103,2020-09-01,83771,78594,5177,6.2
39105,2020-09-01,8998,8213,785,8.7
39107,2020-09-01,23328,22389,939,4
39109,2020-09-01,54166,50942,3224,6
39111,2020-09-01,5676,5168,508,8.9
39113,2020-09-01,255118,234374,20744,8.1
39115,2020-09-01,6696,6224,472,7
39117,2020-09-01,16798,15841,957,5.7
39119,2020-09-01,40357,37711,2646,6.6
39121,2020-09-01,4649,4274,375,8.1
39123,2020-09-01,21407,20031,1376,6.4
39125,2020-09-01,8733,8277,456,5.2
39127,2020-09-01,15882,14732,1150,7.2
39129,2020-09-01,26493,24937,1556,5.9
39131,2020-09-01,11024,10177,847,7.7
39133,2020-09-01,85609,80149,5460,6.4
39135,2020-09-01,21245,20064,1181,5.6
39137,2020-09-01,18673,17989,684,3.7
39139,2020-09-01,51847,48051,3796,7.3
39141,2020-09-01,35263,32988,2275,6.5
39143,2020-09-01,30254,28464,1790,5.9
39145,2020-09-01,29392,27182,2210,7.5
39147,2020-09-01,27226,25586,1640,6
39149,2020-09-01,24037,22613,1424,5.9
39151,2020-09-01,183315,170321,12994,7.1
39153,2020-09-01,270620,249781,20839,7.7
39155,2020-09-01,85252,77405,7847,9.2
39157,2020-09-01,44643,41872,2771,6.2
39159,2020-09-01,29370,28003,1367,4.7
39161,2020-09-01,14609,13911,698,4.8
39163,2020-09-01,5634,5213,421,7.5
39165,2020-09-01,119205,112393,6812,5.7
39167,2020-09-01,26910,24917,1993,7.4
39169,2020-09-01,60725,57668,3057,5
39171,2020-09-01,18835,17736,1099,5.8
39173,2020-09-01,69908,65992,3916,5.6
39175,2020-09-01,13015,12398,617,4.7
40001,2020-09-01,8537,8103,434,5.1
40003,2020-09-01,2789,2692,97,3.5
40005,2020-09-01,5286,4938,348,6.6
40007,2020-09-01,2579,2522,57,2.2
40009,2020-09-01,10235,9457,778,7.6
40011,2020-09-01,4449,4175,274,6.2
40013,2020-09-01,22647,21628,1019,4.5
40015,2020-09-01,12100,11434,666,5.5
40017,2020-09-01,76567,72558,4009,5.2
40019,2020-09-01,22109,20843,1266,5.7
40021,2020-09-01,20147,19203,944,4.7
40023,2020-09-01,5666,5257,409,7.2
40025,2020-09-01,1421,1398,23,1.6
40027,2020-09-01,143787,136831,6956,4.8
40029,2020-09-01,2379,2227,152,6.4
40031,2020-09-01,48237,45556,2681,5.6
40033,2020-09-01,2727,2563,164,6
40035,2020-09-01,5896,5619,277,4.7
40037,2020-09-01,31549,29623,1926,6.1
40039,2020-09-01,15457,14639,818,5.3
40041,2020-09-01,18721,17921,800,4.3
40043,2020-09-01,2766,2625,141,5.1
40045,2020-09-01,2176,2069,107,4.9
40047,2020-09-01,27326,25931,1395,5.1
40049,2020-09-01,12954,12185,769,5.9
40051,2020-09-01,26883,25365,1518,5.6
40053,2020-09-01,2791,2707,84,3
40055,2020-09-01,1927,1795,132,6.9
40057,2020-09-01,1211,1165,46,3.8
40059,2020-09-01,1810,1754,56,3.1
40061,2020-09-01,4396,4088,308,7
40063,2020-09-01,5474,5085,389,7.1
40065,2020-09-01,10969,10582,387,3.5
40067,2020-09-01,2631,2475,156,5.9
40069,2020-09-01,3768,3519,249,6.6
40071,2020-09-01,18388,17294,1094,5.9
40073,2020-09-01,8724,8351,373,4.3
40075,2020-09-01,3632,3472,160,4.4
40077,2020-09-01,3233,2917,316,9.8
40079,2020-09-01,19498,18232,1266,6.5
40081,2020-09-01,15742,14954,788,5
40083,2020-09-01,22399,21376,1023,4.6
40085,2020-09-01,6626,6398,228,3.4
40087,2020-09-01,20050,19042,1008,5
40089,2020-09-01,15376,14410,966,6.3
40091,2020-09-01,7131,6586,545,7.6
40093,2020-09-01,3751,3561,190,5.1
40095,2020-09-01,7006,6641,365,5.2
40097,2020-09-01,19856,18925,931,4.7
40099,2020-09-01,6243,5879,364,5.8
40101,2020-09-01,29972,28342,1630,5.4
40103,2020-09-01,5603,5410,193,3.4
40105,2020-09-01,4725,4492,233,4.9
40107,2020-09-01,4520,4244,276,6.1
40109,2020-09-01,389342,366795,22547,5.8
40111,2020-09-01,15706,14632,1074,6.8
40113,2020-09-01,20651,19405,1246,6
40115,2020-09-01,14260,13623,637,4.5
40117,2020-09-01,7346,6912,434,5.9
40119,2020-09-01,38031,36375,1656,4.4
40121,2020-09-01,16874,15667,1207,7.2
40123,2020-09-01,19664,18799,865,4.4
40125,2020-09-01,33027,31227,1800,5.5
40127,2020-09-01,4518,4256,262,5.8
40129,2020-09-01,1880,1789,91,4.8
40131,2020-09-01,45089,42751,2338,5.2
40133,2020-09-01,9483,8809,674,7.1
40135,2020-09-01,16756,15765,991,5.9
40137,2020-09-01,18690,17242,1448,7.7
40139,2020-09-01,11397,11166,231,2
40141,2020-09-01,3081,2967,114,3.7
40143,2020-09-01,325737,306175,19562,6
40145,2020-09-01,38331,36328,2003,5.2
40147,2020-09-01,22587,21416,1171,5.2
40149,2020-09-01,5235,4886,349,6.7
40151,2020-09-01,4734,4598,136,2.9
40153,2020-09-01,8978,8350,628,7
41001,2020-09-01,7360,6905,455,6.2
41003,2020-09-01,45527,42948,2579,5.7
41005,2020-09-01,218197,202117,16080,7.4
41007,2020-09-01,19618,18112,1506,7.7
41009,2020-09-01,23934,22109,1825,7.6
41011,2020-09-01,26920,24757,2163,8
41013,2020-09-01,10627,9823,804,7.6
41015,2020-09-01,9295,8602,693,7.5
41017,2020-09-01,99183,92573,6610,6.7
41019,2020-09-01,47968,44528,3440,7.2
41021,2020-09-01,1013,953,60,5.9
41023,2020-09-01,3284,3099,185,5.6
41025,2020-09-01,3782,3603,179,4.7
41027,2020-09-01,15221,14465,756,5
41029,2020-09-01,106692,98920,7772,7.3
41031,2020-09-01,10453,9707,746,7.1
41033,2020-09-01,36667,34071,2596,7.1
41035,2020-09-01,29891,27705,2186,7.3
41037,2020-09-01,3779,3602,177,4.7
41039,2020-09-01,177449,163507,13942,7.9
41041,2020-09-01,21228,19184,2044,9.6
41043,2020-09-01,59041,54461,4580,7.8
41045,2020-09-01,12919,12331,588,4.6
41047,2020-09-01,166115,155161,10954,6.6
41049,2020-09-01,5867,5607,260,4.4
41051,2020-09-01,458343,417787,40556,8.8
41053,2020-09-01,40867,38266,2601,6.4
41055,2020-09-01,1001,945,56,5.6
41057,2020-09-01,11931,11034,897,7.5
41059,2020-09-01,37724,35667,2057,5.5
41061,2020-09-01,12065,11347,718,6
41063,2020-09-01,3650,3471,179,4.9
41065,2020-09-01,12814,11988,826,6.4
41067,2020-09-01,320939,300144,20795,6.5
41069,2020-09-01,705,680,25,3.5
41071,2020-09-01,54230,50747,3483,6.4
42001,2020-09-01,53990,51521,2469,4.6
42003,2020-09-01,630755,585666,45089,7.1
42005,2020-09-01,30927,28751,2176,7
42007,2020-09-01,81724,75368,6356,7.8
42009,2020-09-01,23436,21883,1553,6.6
42011,2020-09-01,209273,193997,15276,7.3
42013,2020-09-01,58947,55480,3467,5.9
42015,2020-09-01,27926,26451,1475,5.3
42017,2020-09-01,336335,314913,21422,6.4
42019,2020-09-01,95935,90654,5281,5.5
42021,2020-09-01,55716,52056,3660,6.6
42023,2020-09-01,2072,1870,202,9.7
42025,2020-09-01,31006,28861,2145,6.9
42027,2020-09-01,75792,72713,3079,4.1
42029,2020-09-01,279729,266059,13670,4.9
42031,2020-09-01,16956,16098,858,5.1
42033,2020-09-01,35038,32840,2198,6.3
42035,2020-09-01,17508,16473,1035,5.9
42037,2020-09-01,33119,31304,1815,5.5
42039,2020-09-01,37587,35205,2382,6.3
42041,2020-09-01,130421,124055,6366,4.9
42043,2020-09-01,143849,133875,9974,6.9
42045,2020-09-01,292257,270141,22116,7.6
42047,2020-09-01,14799,13537,1262,8.5
42049,2020-09-01,125951,116790,9161,7.3
42051,2020-09-01,55269,50377,4892,8.9
42053,2020-09-01,1776,1654,122,6.9
42055,2020-09-01,76620,72192,4428,5.8
42057,2020-09-01,7813,7067,746,9.5
42059,2020-09-01,15858,14726,1132,7.1
42061,2020-09-01,19682,18222,1460,7.4
42063,2020-09-01,37378,35001,2377,6.4
42065,2020-09-01,19787,18596,1191,6
42067,2020-09-01,12637,12095,542,4.3
42069,2020-09-01,102241,94866,7375,7.2
42071,2020-09-01,281541,266193,15348,5.5
42073,2020-09-01,39805,36797,3008,7.6
42075,2020-09-01,71596,67339,4257,5.9
42077,2020-09-01,189339,175219,14120,7.5
42079,2020-09-01,154788,141675,13113,8.5
42081,2020-09-01,55484,51964,3520,6.3
42083,2020-09-01,16675,15588,1087,6.5
42085,2020-09-01,47648,44150,3498,7.3
42087,2020-09-01,21132,19742,1390,6.6
42089,2020-09-01,80723,73745,6978,8.6
42091,2020-09-01,444841,418473,26368,5.9
42093,2020-09-01,9060,8678,382,4.2
42095,2020-09-01,156923,146476,10447,6.7
42097,2020-09-01,42184,39395,2789,6.6
42099,2020-09-01,24030,22920,1110,4.6
42101,2020-09-01,713065,634584,78481,11
42103,2020-09-01,24347,22409,1938,8
42105,2020-09-01,7167,6711,456,6.4
42107,2020-09-01,65235,60795,4440,6.8
42109,2020-09-01,19346,18473,873,4.5
42111,2020-09-01,32119,30080,2039,6.3
42113,2020-09-01,2617,2466,151,5.8
42115,2020-09-01,19742,18732,1010,5.1
42117,2020-09-01,18652,17424,1228,6.6
42119,2020-09-01,19235,18365,870,4.5
42121,2020-09-01,21782,20381,1401,6.4
42123,2020-09-01,18753,17656,1097,5.8
42125,2020-09-01,103724,96416,7308,7
42127,2020-09-01,21966,20617,1349,6.1
42129,2020-09-01,173887,162672,11215,6.4
42131,2020-09-01,13034,12291,743,5.7
42133,2020-09-01,230767,217311,13456,5.8
44001,2020-09-01,25433,23428,2005,7.9
44003,2020-09-01,90532,82062,8470,9.4
44005,2020-09-01,43284,39765,3519,8.1
44007,2020-09-01,331233,293002,38231,11.5
44009,2020-09-01,67370,61997,5373,8
45001,2020-09-01,10115,9616,499,4.9
45003,2020-09-01,76254,73476,2778,3.6
45005,2020-09-01,2647,2423,224,8.5
45007,2020-09-01,92178,87987,4191,4.5
45009,2020-09-01,4772,4375,397,8.3
45011,2020-09-01,8032,7525,507,6.3
45013,2020-09-01,77400,74313,3087,4
45015,2020-09-01,105773,100883,4890,4.6
45017,2020-09-01,6634,6269,365,5.5
45019,2020-09-01,213832,202131,11701,5.5
45021,2020-09-01,25855,24040,1815,7
45023,2020-09-01,13839,12671,1168,8.4
45025,2020-09-01,21998,20838,1160,5.3
45027,2020-09-01,12773,12032,741,5.8
45029,2020-09-01,16933,15981,952,5.6
45031,2020-09-01,30905,29088,1817,5.9
45033,2020-09-01,13347,12628,719,5.4
45035,2020-09-01,78400,74514,3886,5
45037,2020-09-01,10854,10451,403,3.7
45039,2020-09-01,9720,9030,690,7.1
45041,2020-09-01,68243,64767,3476,5.1
45043,2020-09-01,26633,24973,1660,6.2
45045,2020-09-01,259987,248556,11431,4.4
45047,2020-09-01,31856,30086,1770,5.6
45049,2020-09-01,8256,7886,370,4.5
45051,2020-09-01,149555,140248,9307,6.2
45053,2020-09-01,12911,12350,561,4.3
45055,2020-09-01,29676,28411,1265,4.3
45057,2020-09-01,42886,40408,2478,5.8
45059,2020-09-01,30567,28913,1654,5.4
45061,2020-09-01,6907,6440,467,6.8
45063,2020-09-01,151934,146561,5373,3.5
45065,2020-09-01,3386,3189,197,5.8
45067,2020-09-01,13647,12672,975,7.1
45069,2020-09-01,9515,8674,841,8.8
45071,2020-09-01,19414,18651,763,3.9
45073,2020-09-01,35338,34047,1291,3.7
45075,2020-09-01,35088,32097,2991,8.5
45077,2020-09-01,57893,55675,2218,3.8
45079,2020-09-01,202716,191869,10847,5.4
45081,2020-09-01,8649,8376,273,3.2
45083,2020-09-01,160878,152471,8407,5.2
45085,2020-09-01,43875,41205,2670,6.1
45087,2020-09-01,12215,11238,977,8
45089,2020-09-01,12143,11258,885,7.3
45091,2020-09-01,145479,138008,7471,5.1
46003,2020-09-01,1536,1483,53,3.5
46005,2020-09-01,9518,9201,317,3.3
46007,2020-09-01,1096,1046,50,4.6
46009,2020-09-01,2938,2830,108,3.7
46011,2020-09-01,18749,18128,621,3.3
46013,2020-09-01,21030,20309,721,3.4
46015,2020-09-01,2499,2410,89,3.6
46017,2020-09-01,742,708,34,4.6
46019,2020-09-01,5145,4921,224,4.4
46021,2020-09-01,825,799,26,3.2
46023,2020-09-01,3937,3710,227,5.8
46025,2020-09-01,2364,2296,68,2.9
46027,2020-09-01,7333,7090,243,3.3
46029,2020-09-01,15673,15063,610,3.9
46031,2020-09-01,1388,1326,62,4.5
46033,2020-09-01,4217,4031,186,4.4
46035,2020-09-01,11357,10841,516,4.5
46037,2020-09-01,2784,2679,105,3.8
46039,2020-09-01,2565,2466,99,3.9
46041,2020-09-01,2367,2187,180,7.6
46043,2020-09-01,1602,1556,46,2.9
46045,2020-09-01,2057,2010,47,2.3
46047,2020-09-01,3085,2930,155,5
46049,2020-09-01,1079,1043,36,3.3
46051,2020-09-01,4467,4347,120,2.7
46053,2020-09-01,2078,2015,63,3
46055,2020-09-01,1095,1069,26,2.4
46057,2020-09-01,3471,3382,89,2.6
46059,2020-09-01,1831,1790,41,2.2
46061,2020-09-01,1800,1724,76,4.2
46063,2020-09-01,752,728,24,3.2
46065,2020-09-01,10242,9984,258,2.5
46067,2020-09-01,3630,3527,103,2.8
46069,2020-09-01,701,679,22,3.1
46071,2020-09-01,1323,1273,50,3.8
46073,2020-09-01,1258,1228,30,2.4
46075,2020-09-01,533,514,19,3.6
46077,2020-09-01,2745,2661,84,3.1
46079,2020-09-01,6608,6407,201,3
46081,2020-09-01,14120,13580,540,3.8
46083,2020-09-01,36459,35440,1019,2.8
46085,2020-09-01,1731,1643,88,5.1
46087,2020-09-01,3155,3066,89,2.8
46089,2020-09-01,1042,995,47,4.5
46091,2020-09-01,2522,2440,82,3.3
46093,2020-09-01,14396,13879,517,3.6
46095,2020-09-01,744,703,41,5.5
46097,2020-09-01,1150,1085,65,5.7
46099,2020-09-01,115174,111206,3968,3.4
46101,2020-09-01,4182,3977,205,4.9
46102,2020-09-01,3836,3471,365,9.5
46103,2020-09-01,59118,56705,2413,4.1
46105,2020-09-01,1441,1380,61,4.2
46107,2020-09-01,1048,1018,30,2.9
46109,2020-09-01,4990,4796,194,3.9
46111,2020-09-01,1223,1168,55,4.5
46115,2020-09-01,3205,3100,105,3.3
46117,2020-09-01,1955,1902,53,2.7
46119,2020-09-01,826,807,19,2.3
46121,2020-09-01,3070,2901,169,5.5
46123,2020-09-01,3088,3015,73,2.4
46125,2020-09-01,4753,4622,131,2.8
46127,2020-09-01,8662,8304,358,4.1
46129,2020-09-01,2181,2076,105,4.8
46135,2020-09-01,11836,11404,432,3.6
46137,2020-09-01,990,947,43,4.3
47001,2020-09-01,35078,32917,2161,6.2
47003,2020-09-01,21274,19822,1452,6.8
47005,2020-09-01,6849,6327,522,7.6
47007,2020-09-01,4305,3988,317,7.4
47009,2020-09-01,64728,61012,3716,5.7
47011,2020-09-01,53490,50025,3465,6.5
47013,2020-09-01,14900,13961,939,6.3
47015,2020-09-01,6569,6219,350,5.3
47017,2020-09-01,12191,11431,760,6.2
47019,2020-09-01,24328,22737,1591,6.5
47021,2020-09-01,21843,20633,1210,5.5
47023,2020-09-01,8585,8113,472,5.5
47025,2020-09-01,12997,12288,709,5.5
47027,2020-09-01,2842,2664,178,6.3
47029,2020-09-01,14989,13685,1304,8.7
47031,2020-09-01,26083,24412,1671,6.4
47033,2020-09-01,6951,6575,376,5.4
47035,2020-09-01,23219,21615,1604,6.9
47037,2020-09-01,417676,378955,38721,9.3
47039,2020-09-01,4461,4127,334,7.5
47041,2020-09-01,7904,7334,570,7.2
47043,2020-09-01,26837,25388,1449,5.4
47045,2020-09-01,16242,15027,1215,7.5
47047,2020-09-01,19321,18022,1299,6.7
47049,2020-09-01,7682,7213,469,6.1
47051,2020-09-01,19845,18670,1175,5.9
47053,2020-09-01,22342,20835,1507,6.7
47055,2020-09-01,14844,13822,1022,6.9
47057,2020-09-01,9642,9018,624,6.5
47059,2020-09-01,29315,27070,2245,7.7
47061,2020-09-01,5157,4767,390,7.6
47063,2020-09-01,28371,26531,1840,6.5
47065,2020-09-01,186725,173656,13069,7
47067,2020-09-01,2211,2038,173,7.8
47069,2020-09-01,9469,8613,856,9
47071,2020-09-01,10654,9949,705,6.6
47073,2020-09-01,23741,22123,1618,6.8
47075,2020-09-01,8102,7239,863,10.7
47077,2020-09-01,12293,11432,861,7
47079,2020-09-01,13806,12898,908,6.6
47081,2020-09-01,11308,10715,593,5.2
47083,2020-09-01,3289,3036,253,7.7
47085,2020-09-01,8824,8311,513,5.8
47087,2020-09-01,4956,4620,336,6.8
47089,2020-09-01,24863,23299,1564,6.3
47091,2020-09-01,7950,7524,426,5.4
47093,2020-09-01,248327,234377,13950,5.6
47095,2020-09-01,1734,1584,150,8.7
47097,2020-09-01,10046,9109,937,9.3
47099,2020-09-01,19517,18244,1273,6.5
47101,2020-09-01,5409,5068,341,6.3
47103,2020-09-01,16532,15337,1195,7.2
47105,2020-09-01,23904,22600,1304,5.5
47107,2020-09-01,23764,22107,1657,7
47109,2020-09-01,8553,7809,744,8.7
47111,2020-09-01,11295,10616,679,6
47113,2020-09-01,50816,46622,4194,8.3
47115,2020-09-01,12586,11704,882,7
47117,2020-09-01,15699,14545,1154,7.4
47119,2020-09-01,50455,46946,3509,7
47121,2020-09-01,5376,4946,430,8
47123,2020-09-01,20595,19271,1324,6.4
47125,2020-09-01,89189,82532,6657,7.5
47127,2020-09-01,3657,3514,143,3.9
47129,2020-09-01,7796,7323,473,6.1
47131,2020-09-01,12419,11594,825,6.6
47133,2020-09-01,9941,9424,517,5.2
47135,2020-09-01,3063,2841,222,7.2
47137,2020-09-01,2305,2200,105,4.6
47139,2020-09-01,7534,7065,469,6.2
47141,2020-09-01,36090,33952,2138,5.9
47143,2020-09-01,13243,12159,1084,8.2
47145,2020-09-01,23462,22058,1404,6
47147,2020-09-01,38068,35778,2290,6
47149,2020-09-01,188002,175821,12181,6.5
47151,2020-09-01,8266,7632,634,7.7
47153,2020-09-01,6261,5814,447,7.1
47155,2020-09-01,55331,51345,3986,7.2
47157,2020-09-01,468298,411300,56998,12.2
47159,2020-09-01,9392,8901,491,5.2
47161,2020-09-01,5535,5221,314,5.7
47163,2020-09-01,70616,65800,4816,6.8
47165,2020-09-01,104595,97800,6795,6.5
47167,2020-09-01,27973,26003,1970,7
47169,2020-09-01,5512,5171,341,6.2
47171,2020-09-01,7217,6676,541,7.5
47173,2020-09-01,7800,7289,511,6.6
47175,2020-09-01,2082,1923,159,7.6
47177,2020-09-01,17432,16211,1221,7
47179,2020-09-01,61308,57723,3585,5.8
47181,2020-09-01,6607,6219,388,5.9
47183,2020-09-01,15881,15006,875,5.5
47185,2020-09-01,12380,11617,763,6.2
47187,2020-09-01,129692,123919,5773,4.5
47189,2020-09-01,78501,73570,4931,6.3
48001,2020-09-01,23376,21932,1444,6.2
48003,2020-09-01,9153,8280,873,9.5
48005,2020-09-01,35699,32817,2882,8.1
48007,2020-09-01,9052,8251,801,8.8
48009,2020-09-01,3893,3677,216,5.5
48011,2020-09-01,914,877,37,4
48013,2020-09-01,22067,20032,2035,9.2
48015,2020-09-01,13541,12594,947,7
48017,2020-09-01,2425,2316,109,4.5
48019,2020-09-01,9890,9292,598,6
48021,2020-09-01,42684,40094,2590,6.1
48023,2020-09-01,1786,1720,66,3.7
48025,2020-09-01,9914,8801,1113,11.2
48027,2020-09-01,145167,134741,10426,7.2
48029,2020-09-01,947504,873829,73675,7.8
48031,2020-09-01,6591,6333,258,3.9
48033,2020-09-01,440,425,15,3.4
48035,2020-09-01,8380,7924,456,5.4
48037,2020-09-01,38893,36052,2841,7.3
48039,2020-09-01,176679,160505,16174,9.2
48041,2020-09-01,116456,110258,6198,5.3
48043,2020-09-01,4061,3795,266,6.6
48045,2020-09-01,558,536,22,3.9
48047,2020-09-01,2509,2213,296,11.8
48049,2020-09-01,15419,14407,1012,6.6
48051,2020-09-01,8214,7654,560,6.8
48053,2020-09-01,23833,22705,1128,4.7
48055,2020-09-01,19384,18131,1253,6.5
48057,2020-09-01,12238,11499,739,6
48059,2020-09-01,6024,5683,341,5.7
48061,2020-09-01,168933,151527,17406,10.3
48063,2020-09-01,5096,4700,396,7.8
48065,2020-09-01,2937,2819,118,4
48067,2020-09-01,12395,11359,1036,8.4
48069,2020-09-01,3314,3191,123,3.7
48071,2020-09-01,19812,17735,2077,10.5
48073,2020-09-01,21367,19474,1893,8.9
48075,2020-09-01,3126,3012,114,3.6
48077,2020-09-01,4767,4490,277,5.8
48079,2020-09-01,1110,1021,89,8
48081,2020-09-01,1382,1296,86,6.2
48083,2020-09-01,2936,2711,225,7.7
48085,2020-09-01,571633,536215,35418,6.2
48087,2020-09-01,1073,1026,47,4.4
48089,2020-09-01,9674,9093,581,6
48091,2020-09-01,75151,70588,4563,6.1
48093,2020-09-01,5698,5378,320,5.6
48095,2020-09-01,1295,1239,56,4.3
48097,2020-09-01,19161,17772,1389,7.2
48099,2020-09-01,24056,22447,1609,6.7
48101,2020-09-01,570,544,26,4.6
48103,2020-09-01,1632,1383,249,15.3
48105,2020-09-01,1560,1407,153,9.8
48107,2020-09-01,2380,2259,121,5.1
48109,2020-09-01,1151,1070,81,7
48111,2020-09-01,3740,3634,106,2.8
48113,2020-09-01,NA,NA,109068,8
48115,2020-09-01,4570,4124,446,9.8
48117,2020-09-01,8497,8192,305,3.6
48119,2020-09-01,2416,2283,133,5.5
48121,2020-09-01,504459,472617,31842,6.3
48123,2020-09-01,9273,8614,659,7.1
48125,2020-09-01,667,623,44,6.6
48127,2020-09-01,6121,5674,447,7.3
48129,2020-09-01,1398,1339,59,4.2
48131,2020-09-01,4861,4173,688,14.2
48133,2020-09-01,7330,6805,525,7.2
48135,2020-09-01,81172,70176,10996,13.5
48137,2020-09-01,1334,1282,52,3.9
48139,2020-09-01,93901,88205,5696,6.1
48141,2020-09-01,365158,335199,29959,8.2
48143,2020-09-01,19751,18606,1145,5.8
48145,2020-09-01,6593,6188,405,6.1
48147,2020-09-01,16911,16112,799,4.7
48149,2020-09-01,11782,11174,608,5.2
48151,2020-09-01,1599,1515,84,5.3
48153,2020-09-01,2476,2336,140,5.7
48155,2020-09-01,569,547,22,3.9
48157,2020-09-01,392798,360286,32512,8.3
48159,2020-09-01,4859,4598,261,5.4
48161,2020-09-01,6356,5789,567,8.9
48163,2020-09-01,9436,8834,602,6.4
48165,2020-09-01,9635,9024,611,6.3
48167,2020-09-01,163430,148500,14930,9.1
48169,2020-09-01,2025,1869,156,7.7
48171,2020-09-01,13257,12658,599,4.5
48173,2020-09-01,765,730,35,4.6
48175,2020-09-01,3181,2912,269,8.5
48177,2020-09-01,9637,9073,564,5.9
48179,2020-09-01,7731,7032,699,9
48181,2020-09-01,64661,60892,3769,5.8
48183,2020-09-01,56433,51387,5046,8.9
48185,2020-09-01,11046,10083,963,8.7
48187,2020-09-01,80763,75886,4877,6
48189,2020-09-01,11766,11011,755,6.4
48191,2020-09-01,1081,1015,66,6.1
48193,2020-09-01,3791,3613,178,4.7
48195,2020-09-01,2529,2433,96,3.8
48197,2020-09-01,1722,1646,76,4.4
48199,2020-09-01,24777,22469,2308,9.3
48201,2020-09-01,NA,NA,224050,9.8
48203,2020-09-01,29203,26773,2430,8.3
48205,2020-09-01,2629,2580,49,1.9
48207,2020-09-01,2654,2528,126,4.7
48209,2020-09-01,121415,113888,7527,6.2
48211,2020-09-01,1736,1659,77,4.4
48213,2020-09-01,37462,34976,2486,6.6
48215,2020-09-01,360711,317147,43564,12.1
48217,2020-09-01,16368,15332,1036,6.3
48219,2020-09-01,10472,9555,917,8.8
48221,2020-09-01,27633,25708,1925,7
48223,2020-09-01,17608,16681,927,5.3
48225,2020-09-01,10081,9533,548,5.4
48227,2020-09-01,13341,12078,1263,9.5
48229,2020-09-01,1847,1702,145,7.9
48231,2020-09-01,43622,40782,2840,6.5
48233,2020-09-01,8591,7981,610,7.1
48235,2020-09-01,758,703,55,7.3
48237,2020-09-01,3353,3099,254,7.6
48239,2020-09-01,7213,6766,447,6.2
48241,2020-09-01,12922,11373,1549,12
48243,2020-09-01,968,920,48,5
48245,2020-09-01,105247,91819,13428,12.8
48247,2020-09-01,1907,1691,216,11.3
48249,2020-09-01,15877,13446,2431,15.3
48251,2020-09-01,82788,77361,5427,6.6
48253,2020-09-01,5774,5346,428,7.4
48255,2020-09-01,6739,6220,519,7.7
48257,2020-09-01,67543,63054,4489,6.6
48259,2020-09-01,22162,21076,1086,4.9
48261,2020-09-01,165,155,10,6.1
48263,2020-09-01,468,449,19,4.1
48265,2020-09-01,21359,20170,1189,5.6
48267,2020-09-01,1814,1707,107,5.9
48269,2020-09-01,253,250,3,1.2
48271,2020-09-01,1311,1232,79,6
48273,2020-09-01,13334,12129,1205,9
48275,2020-09-01,1448,1362,86,5.9
48277,2020-09-01,23904,22346,1558,6.5
48279,2020-09-01,5206,4939,267,5.1
48281,2020-09-01,9061,8575,486,5.4
48283,2020-09-01,3563,3278,285,8
48285,2020-09-01,8447,7936,511,6
48287,2020-09-01,9129,8658,471,5.2
48289,2020-09-01,6163,5667,496,8
48291,2020-09-01,33544,29666,3878,11.6
48293,2020-09-01,8296,7623,673,8.1
48295,2020-09-01,1533,1461,72,4.7
48297,2020-09-01,5067,4618,449,8.9
48299,2020-09-01,8664,8166,498,5.7
48301,2020-09-01,314,310,4,1.3
48303,2020-09-01,157507,148369,9138,5.8
48305,2020-09-01,2733,2587,146,5.3
48307,2020-09-01,3270,3005,265,8.1
48309,2020-09-01,121584,114132,7452,6.1
48311,2020-09-01,675,650,25,3.7
48313,2020-09-01,4490,4132,358,8
48315,2020-09-01,4305,3936,369,8.6
48317,2020-09-01,2439,2272,167,6.8
48319,2020-09-01,1702,1599,103,6.1
48321,2020-09-01,16453,14580,1873,11.4
48323,2020-09-01,24629,20756,3873,15.7
48325,2020-09-01,21522,20152,1370,6.4
48327,2020-09-01,869,824,45,5.2
48329,2020-09-01,95108,85680,9428,9.9
48331,2020-09-01,9831,9125,706,7.2
48333,2020-09-01,1914,1831,83,4.3
48335,2020-09-01,2415,2185,230,9.5
48337,2020-09-01,9033,8399,634,7
48339,2020-09-01,283138,260677,22461,7.9
48341,2020-09-01,10787,10369,418,3.9
48343,2020-09-01,4761,4104,657,13.8
48345,2020-09-01,430,408,22,5.1
48347,2020-09-01,28279,26377,1902,6.7
48349,2020-09-01,23387,21971,1416,6.1
48351,2020-09-01,5024,4435,589,11.7
48353,2020-09-01,7268,6863,405,5.6
48355,2020-09-01,163780,148366,15414,9.4
48357,2020-09-01,4003,3753,250,6.2
48359,2020-09-01,889,857,32,3.6
48361,2020-09-01,35906,31835,4071,11.3
48363,2020-09-01,13233,12199,1034,7.8
48365,2020-09-01,9352,8487,865,9.2
48367,2020-09-01,68071,63993,4078,6
48369,2020-09-01,5008,4879,129,2.6
48371,2020-09-01,6753,6151,602,8.9
48373,2020-09-01,18585,16887,1698,9.1
48375,2020-09-01,54539,51578,2961,5.4
48377,2020-09-01,3216,2674,542,16.9
48379,2020-09-01,6048,5751,297,4.9
48381,2020-09-01,72645,69588,3057,4.2
48383,2020-09-01,1780,1558,222,12.5
48385,2020-09-01,1079,999,80,7.4
48387,2020-09-01,5236,4906,330,6.3
48389,2020-09-01,8083,7315,768,9.5
48391,2020-09-01,3066,2785,281,9.2
48393,2020-09-01,416,392,24,5.8
48395,2020-09-01,7358,6860,498,6.8
48397,2020-09-01,53283,50172,3111,5.8
48399,2020-09-01,4494,4277,217,4.8
48401,2020-09-01,22079,20318,1761,8
48403,2020-09-01,3986,3544,442,11.1
48405,2020-09-01,2985,2663,322,10.8
48407,2020-09-01,11727,10711,1016,8.7
48409,2020-09-01,29167,26042,3125,10.7
48411,2020-09-01,2123,2016,107,5
48413,2020-09-01,1177,1081,96,8.2
48415,2020-09-01,6202,5655,547,8.8
48417,2020-09-01,1756,1656,100,5.7
48419,2020-09-01,11383,10546,837,7.4
48421,2020-09-01,1305,1266,39,3
48423,2020-09-01,108873,101450,7423,6.8
48425,2020-09-01,4328,4042,286,6.6
48427,2020-09-01,25935,21404,4531,17.5
48429,2020-09-01,4048,3760,288,7.1
48431,2020-09-01,555,515,40,7.2
48433,2020-09-01,592,560,32,5.4
48435,2020-09-01,1223,1087,136,11.1
48437,2020-09-01,2547,2414,133,5.2
48439,2020-09-01,NA,NA,80625,7.5
48441,2020-09-01,66477,62804,3673,5.5
48443,2020-09-01,393,374,19,4.8
48445,2020-09-01,4803,4411,392,8.2
48447,2020-09-01,637,601,36,5.7
48449,2020-09-01,13517,12605,912,6.7
48451,2020-09-01,53618,50060,3558,6.6
48453,2020-09-01,743554,696224,47330,6.4
48455,2020-09-01,5412,4951,461,8.5
48457,2020-09-01,7399,6618,781,10.6
48459,2020-09-01,17384,15952,1432,8.2
48461,2020-09-01,1808,1695,113,6.3
48463,2020-09-01,11322,10555,767,6.8
48465,2020-09-01,23170,21381,1789,7.7
48467,2020-09-01,26297,24657,1640,6.2
48469,2020-09-01,41252,37714,3538,8.6
48471,2020-09-01,24245,22396,1849,7.6
48473,2020-09-01,23663,21694,1969,8.3
48475,2020-09-01,5887,5172,715,12.1
48477,2020-09-01,15505,14624,881,5.7
48479,2020-09-01,115778,105322,10456,9
48481,2020-09-01,21254,19635,1619,7.6
48483,2020-09-01,2236,2082,154,6.9
48485,2020-09-01,55215,51320,3895,7.1
48487,2020-09-01,4954,4661,293,5.9
48489,2020-09-01,6521,5739,782,12
48491,2020-09-01,318694,300375,18319,5.7
48493,2020-09-01,24598,23145,1453,5.9
48495,2020-09-01,3860,3402,458,11.9
48497,2020-09-01,32043,29971,2072,6.5
48499,2020-09-01,18119,16924,1195,6.6
48501,2020-09-01,3499,3020,479,13.7
48503,2020-09-01,7856,7431,425,5.4
48505,2020-09-01,4401,3763,638,14.5
48507,2020-09-01,3354,2828,526,15.7
49001,2020-09-01,2761,2662,99,3.6
49003,2020-09-01,26290,25482,808,3.1
49005,2020-09-01,66068,64406,1662,2.5
49007,2020-09-01,8547,8155,392,4.6
49009,2020-09-01,440,427,13,3
49011,2020-09-01,177058,170893,6165,3.5
49013,2020-09-01,7710,7103,607,7.9
49015,2020-09-01,4437,4262,175,3.9
49017,2020-09-01,2885,2728,157,5.4
49019,2020-09-01,6654,6295,359,5.4
49021,2020-09-01,25303,24319,984,3.9
49023,2020-09-01,5969,5823,146,2.4
49025,2020-09-01,4021,3857,164,4.1
49027,2020-09-01,5785,5618,167,2.9
49029,2020-09-01,5591,5440,151,2.7
49031,2020-09-01,481,458,23,4.8
49033,2020-09-01,1330,1301,29,2.2
49035,2020-09-01,642105,613376,28729,4.5
49037,2020-09-01,5543,5028,515,9.3
49039,2020-09-01,12891,12493,398,3.1
49041,2020-09-01,9839,9489,350,3.6
49043,2020-09-01,23243,21927,1316,5.7
49045,2020-09-01,35016,33549,1467,4.2
49047,2020-09-01,13391,12136,1255,9.4
49049,2020-09-01,319118,308734,10384,3.3
49051,2020-09-01,16223,15453,770,4.7
49053,2020-09-01,81268,77647,3621,4.5
49055,2020-09-01,1498,1439,59,3.9
49057,2020-09-01,130308,125055,5253,4
50001,2020-09-01,19084,18340,744,3.9
50003,2020-09-01,16526,15654,872,5.3
50005,2020-09-01,13701,13119,582,4.2
50007,2020-09-01,90948,87311,3637,4
50009,2020-09-01,2500,2398,102,4.1
50011,2020-09-01,25717,24621,1096,4.3
50013,2020-09-01,3889,3709,180,4.6
50015,2020-09-01,12887,12182,705,5.5
50017,2020-09-01,14772,14231,541,3.7
50019,2020-09-01,12202,11532,670,5.5
50021,2020-09-01,28294,26670,1624,5.7
50023,2020-09-01,31824,30653,1171,3.7
50025,2020-09-01,19988,18836,1152,5.8
50027,2020-09-01,26590,25413,1177,4.4
51001,2020-09-01,15673,14698,975,6.2
51003,2020-09-01,54983,52033,2950,5.4
51005,2020-09-01,6621,6223,398,6
51007,2020-09-01,6070,5715,355,5.8
51009,2020-09-01,14485,13667,818,5.6
51011,2020-09-01,6931,6530,401,5.8
51013,2020-09-01,149122,141940,7182,4.8
51015,2020-09-01,36463,34901,1562,4.3
51017,2020-09-01,2251,2074,177,7.9
51019,2020-09-01,37058,35233,1825,4.9
51021,2020-09-01,2770,2636,134,4.8
51023,2020-09-01,16872,16190,682,4
51025,2020-09-01,5803,5300,503,8.7
51027,2020-09-01,6108,5531,577,9.4
51029,2020-09-01,6201,5755,446,7.2
51031,2020-09-01,25189,23653,1536,6.1
51033,2020-09-01,14756,13747,1009,6.8
51035,2020-09-01,12930,12034,896,6.9
51036,2020-09-01,3544,3308,236,6.7
51037,2020-09-01,4960,4683,277,5.6
51041,2020-09-01,183303,172231,11072,6
51043,2020-09-01,7319,6993,326,4.5
51045,2020-09-01,2248,2140,108,4.8
51047,2020-09-01,23906,22785,1121,4.7
51049,2020-09-01,4508,4205,303,6.7
51051,2020-09-01,4622,4267,355,7.7
51053,2020-09-01,13213,12313,900,6.8
51057,2020-09-01,5403,4992,411,7.6
51059,2020-09-01,619346,581524,37822,6.1
51061,2020-09-01,35943,34350,1593,4.4
51063,2020-09-01,7856,7519,337,4.3
51065,2020-09-01,13529,12831,698,5.2
51067,2020-09-01,25603,24235,1368,5.3
51069,2020-09-01,47977,45930,2047,4.3
51071,2020-09-01,7607,7191,416,5.5
51073,2020-09-01,18969,17935,1034,5.5
51075,2020-09-01,10894,10376,518,4.8
51077,2020-09-01,8069,7668,401,5
51079,2020-09-01,10008,9519,489,4.9
51081,2020-09-01,4207,3867,340,8.1
51083,2020-09-01,14931,13866,1065,7.1
51085,2020-09-01,56873,54188,2685,4.7
51087,2020-09-01,178323,165933,12390,6.9
51089,2020-09-01,23534,21677,1857,7.9
51091,2020-09-01,1200,1159,41,3.4
51093,2020-09-01,18860,17834,1026,5.4
51095,2020-09-01,36014,33570,2444,6.8
51097,2020-09-01,3777,3567,210,5.6
51099,2020-09-01,13692,13098,594,4.3
51101,2020-09-01,8882,8394,488,5.5
51103,2020-09-01,5307,4957,350,6.6
51105,2020-09-01,8126,7611,515,6.3
51107,2020-09-01,219658,207774,11884,5.4
51109,2020-09-01,19709,18707,1002,5.1
51111,2020-09-01,5159,4855,304,5.9
51113,2020-09-01,7137,6879,258,3.6
51115,2020-09-01,3981,3796,185,4.6
51117,2020-09-01,12357,11471,886,7.2
51119,2020-09-01,5030,4768,262,5.2
51121,2020-09-01,48178,46128,2050,4.3
51125,2020-09-01,7147,6737,410,5.7
51127,2020-09-01,12252,11711,541,4.4
51131,2020-09-01,5329,4928,401,7.5
51133,2020-09-01,5526,5204,322,5.8
51135,2020-09-01,6973,6578,395,5.7
51137,2020-09-01,16766,15860,906,5.4
51139,2020-09-01,11880,11197,683,5.7
51141,2020-09-01,7081,6620,461,6.5
51143,2020-09-01,29389,27494,1895,6.4
51145,2020-09-01,13660,13051,609,4.5
51147,2020-09-01,9840,9192,648,6.6
51149,2020-09-01,14698,13703,995,6.8
51153,2020-09-01,242742,226183,16559,6.8
51155,2020-09-01,15843,14737,1106,7
51157,2020-09-01,3581,3417,164,4.6
51159,2020-09-01,3975,3785,190,4.8
51161,2020-09-01,48078,45796,2282,4.7
51163,2020-09-01,10160,9655,505,5
51165,2020-09-01,40646,38998,1648,4.1
51167,2020-09-01,10894,10222,672,6.2
51169,2020-09-01,8819,8359,460,5.2
51171,2020-09-01,21689,20580,1109,5.1
51173,2020-09-01,13143,12361,782,5.9
51175,2020-09-01,8910,8420,490,5.5
51177,2020-09-01,66059,62090,3969,6
51179,2020-09-01,71292,67203,4089,5.7
51181,2020-09-01,3531,3330,201,5.7
51183,2020-09-01,3718,3355,363,9.8
51185,2020-09-01,15224,14061,1163,7.6
51187,2020-09-01,19832,18710,1122,5.7
51191,2020-09-01,25484,24125,1359,5.3
51193,2020-09-01,9258,8722,536,5.8
51195,2020-09-01,12476,11465,1011,8.1
51197,2020-09-01,13531,12602,929,6.9
51199,2020-09-01,31944,30233,1711,5.4
51510,2020-09-01,99028,92593,6435,6.5
51520,2020-09-01,7213,6648,565,7.8
51530,2020-09-01,3078,2927,151,4.9
51540,2020-09-01,25211,23528,1683,6.7
51550,2020-09-01,121074,113273,7801,6.4
51570,2020-09-01,8394,7748,646,7.7
51580,2020-09-01,2334,2131,203,8.7
51590,2020-09-01,18996,17052,1944,10.2
51595,2020-09-01,2371,2039,332,14
51600,2020-09-01,12820,12086,734,5.7
51610,2020-09-01,8152,7829,323,4
51620,2020-09-01,3665,3280,385,10.5
51630,2020-09-01,13869,12818,1051,7.6
51640,2020-09-01,2823,2639,184,6.5
51650,2020-09-01,64580,58440,6140,9.5
51660,2020-09-01,23883,22499,1384,5.8
51670,2020-09-01,9842,8627,1215,12.3
51678,2020-09-01,2020,1890,130,6.4
51680,2020-09-01,35655,32984,2671,7.5
51683,2020-09-01,21397,19938,1459,6.8
51685,2020-09-01,9356,8673,683,7.3
51690,2020-09-01,5654,4974,680,12
51700,2020-09-01,89580,81062,8518,9.5
51710,2020-09-01,111951,100995,10956,9.8
51720,2020-09-01,1579,1460,119,7.5
51730,2020-09-01,13670,11398,2272,16.6
51735,2020-09-01,6134,5898,236,3.8
51740,2020-09-01,45086,39983,5103,11.3
51750,2020-09-01,8386,7904,482,5.7
51760,2020-09-01,119259,107541,11718,9.8
51770,2020-09-01,48877,44964,3913,8
51775,2020-09-01,12514,11844,670,5.4
51790,2020-09-01,12116,11376,740,6.1
51800,2020-09-01,44387,41187,3200,7.2
51810,2020-09-01,227547,213406,14141,6.2
51820,2020-09-01,10614,9921,693,6.5
51830,2020-09-01,6614,6081,533,8.1
51840,2020-09-01,14701,13883,818,5.6
53001,2020-09-01,9758,9233,525,5.4
53003,2020-09-01,10269,9804,465,4.5
53005,2020-09-01,101313,94346,6967,6.9
53007,2020-09-01,44487,41672,2815,6.3
53009,2020-09-01,28729,26236,2493,8.7
53011,2020-09-01,234704,215870,18834,8
53013,2020-09-01,1714,1614,100,5.8
53015,2020-09-01,47579,43533,4046,8.5
53017,2020-09-01,21579,20185,1394,6.5
53019,2020-09-01,2391,2161,230,9.6
53021,2020-09-01,42259,39196,3063,7.2
53023,2020-09-01,819,764,55,6.7
53025,2020-09-01,48346,44991,3355,6.9
53027,2020-09-01,28148,25228,2920,10.4
53029,2020-09-01,35134,32553,2581,7.3
53031,2020-09-01,12987,11956,1031,7.9
53033,2020-09-01,NA,NA,93557,7.2
53035,2020-09-01,125221,116556,8665,6.9
53037,2020-09-01,21180,19669,1511,7.1
53039,2020-09-01,9624,8919,705,7.3
53041,2020-09-01,34431,31725,2706,7.9
53043,2020-09-01,4693,4446,247,5.3
53045,2020-09-01,24811,22538,2273,9.2
53047,2020-09-01,20278,18938,1340,6.6
53049,2020-09-01,8412,7633,779,9.3
53051,2020-09-01,4799,4348,451,9.4
53053,2020-09-01,435661,398046,37615,8.6
53055,2020-09-01,8401,7899,502,6
53057,2020-09-01,60863,55848,5015,8.2
53059,2020-09-01,5355,4884,471,8.8
53061,2020-09-01,440665,406275,34390,7.8
53063,2020-09-01,248961,230287,18674,7.5
53065,2020-09-01,17898,16520,1378,7.7
53067,2020-09-01,139884,129874,10010,7.2
53069,2020-09-01,1449,1336,113,7.8
53071,2020-09-01,30137,28420,1717,5.7
53073,2020-09-01,109862,100660,9202,8.4
53075,2020-09-01,21432,20185,1247,5.8
53077,2020-09-01,134624,124740,9884,7.3
54001,2020-09-01,7407,6885,522,7
54003,2020-09-01,58414,55234,3180,5.4
54005,2020-09-01,7410,6682,728,9.8
54007,2020-09-01,5159,4719,440,8.5
54009,2020-09-01,9962,9141,821,8.2
54011,2020-09-01,42086,39175,2911,6.9
54013,2020-09-01,2413,2141,272,11.3
54015,2020-09-01,3092,2769,323,10.4
54017,2020-09-01,3828,3620,208,5.4
54019,2020-09-01,16292,14915,1377,8.5
54021,2020-09-01,2357,2175,182,7.7
54023,2020-09-01,6009,5695,314,5.2
54025,2020-09-01,16160,15183,977,6
54027,2020-09-01,11032,10539,493,4.5
54029,2020-09-01,13091,11956,1135,8.7
54031,2020-09-01,5916,5581,335,5.7
54033,2020-09-01,33851,31473,2378,7
54035,2020-09-01,12956,11968,988,7.6
54037,2020-09-01,30611,28979,1632,5.3
54039,2020-09-01,82225,75370,6855,8.3
54041,2020-09-01,6375,5758,617,9.7
54043,2020-09-01,7293,6656,637,8.7
54045,2020-09-01,10993,9692,1301,11.8
54047,2020-09-01,4445,3898,547,12.3
54049,2020-09-01,25415,23537,1878,7.4
54051,2020-09-01,13650,12585,1065,7.8
54053,2020-09-01,10455,9724,731,7
54055,2020-09-01,21014,19153,1861,8.9
54057,2020-09-01,12350,11575,775,6.3
54059,2020-09-01,6866,5943,923,13.4
54061,2020-09-01,54895,51941,2954,5.4
54063,2020-09-01,6254,5897,357,5.7
54065,2020-09-01,8498,8105,393,4.6
54067,2020-09-01,9770,8942,828,8.5
54069,2020-09-01,20694,19207,1487,7.2
54071,2020-09-01,3869,3723,146,3.8
54073,2020-09-01,2702,2450,252,9.3
54075,2020-09-01,3742,3465,277,7.4
54077,2020-09-01,15621,14729,892,5.7
54079,2020-09-01,27132,25477,1655,6.1
54081,2020-09-01,30752,28301,2451,8
54083,2020-09-01,12327,11412,915,7.4
54085,2020-09-01,4358,4045,313,7.2
54087,2020-09-01,5010,4512,498,9.9
54089,2020-09-01,4418,4133,285,6.5
54091,2020-09-01,7855,7375,480,6.1
54093,2020-09-01,3303,3085,218,6.6
54095,2020-09-01,3195,2909,286,9
54097,2020-09-01,9654,8834,820,8.5
54099,2020-09-01,15859,14725,1134,7.2
54101,2020-09-01,3475,3205,270,7.8
54103,2020-09-01,6844,6292,552,8.1
54105,2020-09-01,2263,2073,190,8.4
54107,2020-09-01,36310,33527,2783,7.7
54109,2020-09-01,6335,5721,614,9.7
55001,2020-09-01,8194,7616,578,7.1
55003,2020-09-01,7884,7436,448,5.7
55005,2020-09-01,24100,23191,909,3.8
55007,2020-09-01,7489,7074,415,5.5
55009,2020-09-01,143630,137090,6540,4.6
55011,2020-09-01,6297,5987,310,4.9
55013,2020-09-01,7310,6884,426,5.8
55015,2020-09-01,27503,26625,878,3.2
55017,2020-09-01,33273,31916,1357,4.1
55019,2020-09-01,17309,16813,496,2.9
55021,2020-09-01,31660,30290,1370,4.3
55023,2020-09-01,7442,7107,335,4.5
55025,2020-09-01,327713,314599,13114,4
55027,2020-09-01,48238,46445,1793,3.7
55029,2020-09-01,16093,15481,612,3.8
55031,2020-09-01,23256,21657,1599,6.9
55033,2020-09-01,23883,23020,863,3.6
55035,2020-09-01,59509,57112,2397,4
55037,2020-09-01,2231,2106,125,5.6
55039,2020-09-01,56982,54855,2127,3.7
55041,2020-09-01,3973,3493,480,12.1
55043,2020-09-01,27608,26601,1007,3.6
55045,2020-09-01,20741,20027,714,3.4
55047,2020-09-01,9509,9137,372,3.9
55049,2020-09-01,13463,12907,556,4.1
55051,2020-09-01,2568,2351,217,8.5
55053,2020-09-01,9961,9171,790,7.9
55055,2020-09-01,46284,44448,1836,4
55057,2020-09-01,13593,12838,755,5.6
55059,2020-09-01,90641,85437,5204,5.7
55061,2020-09-01,10683,10392,291,2.7
55063,2020-09-01,66600,64040,2560,3.8
55065,2020-09-01,9750,9462,288,3
55067,2020-09-01,9393,8927,466,5
55069,2020-09-01,14925,14344,581,3.9
55071,2020-09-01,41166,39456,1710,4.2
55073,2020-09-01,73416,70736,2680,3.7
55075,2020-09-01,19973,18865,1108,5.5
55077,2020-09-01,7820,7465,355,4.5
55078,2020-09-01,1649,1431,218,13.2
55079,2020-09-01,477229,440335,36894,7.7
55081,2020-09-01,23759,22586,1173,4.9
55083,2020-09-01,20386,19559,827,4.1
55085,2020-09-01,18242,17388,854,4.7
55087,2020-09-01,104926,100712,4214,4
55089,2020-09-01,49017,46871,2146,4.4
55091,2020-09-01,4099,3963,136,3.3
55093,2020-09-01,24812,23596,1216,4.9
55095,2020-09-01,24436,23313,1123,4.6
55097,2020-09-01,38229,36667,1562,4.1
55099,2020-09-01,6202,5953,249,4
55101,2020-09-01,98987,92983,6004,6.1
55103,2020-09-01,9057,8738,319,3.5
55105,2020-09-01,86443,81756,4687,5.4
55107,2020-09-01,6492,6208,284,4.4
55109,2020-09-01,50060,47490,2570,5.1
55111,2020-09-01,34795,33044,1751,5
55113,2020-09-01,8140,7695,445,5.5
55115,2020-09-01,20926,20010,916,4.4
55117,2020-09-01,62764,60321,2443,3.9
55119,2020-09-01,10923,10607,316,2.9
55121,2020-09-01,15711,14955,756,4.8
55123,2020-09-01,14963,14416,547,3.7
55125,2020-09-01,10720,10254,466,4.3
55127,2020-09-01,57935,55439,2496,4.3
55129,2020-09-01,7944,7588,356,4.5
55131,2020-09-01,77125,73777,3348,4.3
55133,2020-09-01,225600,215534,10066,4.5
55135,2020-09-01,26012,25005,1007,3.9
55137,2020-09-01,11161,10692,469,4.2
55139,2020-09-01,93239,89770,3469,3.7
55141,2020-09-01,34974,33248,1726,4.9
56001,2020-09-01,19769,19087,682,3.4
56003,2020-09-01,5590,5360,230,4.1
56005,2020-09-01,22947,21231,1716,7.5
56007,2020-09-01,8513,8200,313,3.7
56009,2020-09-01,7827,7298,529,6.8
56011,2020-09-01,4083,3936,147,3.6
56013,2020-09-01,19584,18475,1109,5.7
56015,2020-09-01,6801,6530,271,4
56017,2020-09-01,2282,2172,110,4.8
56019,2020-09-01,4342,4123,219,5
56021,2020-09-01,50409,48009,2400,4.8
56023,2020-09-01,9595,9218,377,3.9
56025,2020-09-01,40201,36797,3404,8.5
56027,2020-09-01,1331,1286,45,3.4
56029,2020-09-01,16353,15672,681,4.2
56031,2020-09-01,4766,4559,207,4.3
56033,2020-09-01,16214,15566,648,4
56035,2020-09-01,4187,3921,266,6.4
56037,2020-09-01,20551,19076,1475,7.2
56039,2020-09-01,16088,15491,597,3.7
56041,2020-09-01,9331,8758,573,6.1
56043,2020-09-01,4064,3881,183,4.5
56045,2020-09-01,3836,3697,139,3.6
72001,2020-09-01,4124,3639,485,11.8
72003,2020-09-01,11671,10559,1112,9.5
72005,2020-09-01,14219,12779,1440,10.1
72007,2020-09-01,6356,5685,671,10.6
72009,2020-09-01,6198,5629,569,9.2
72011,2020-09-01,8690,7974,716,8.2
72013,2020-09-01,23510,21351,2159,9.2
72015,2020-09-01,4523,4135,388,8.6
72017,2020-09-01,5701,5070,631,11.1
72019,2020-09-01,7155,6405,750,10.5
72021,2020-09-01,64800,58268,6532,10.1
72023,2020-09-01,13406,12201,1205,9
72025,2020-09-01,46776,42691,4085,8.7
72027,2020-09-01,9355,8565,790,8.4
72029,2020-09-01,16023,14474,1549,9.7
72031,2020-09-01,61208,55118,6090,9.9
72033,2020-09-01,7809,6943,866,11.1
72035,2020-09-01,15548,14398,1150,7.4
72037,2020-09-01,3566,3179,387,10.9
72039,2020-09-01,3694,3188,506,13.7
72041,2020-09-01,14827,13868,959,6.5
72043,2020-09-01,9725,8757,968,10
72045,2020-09-01,4797,4285,512,10.7
72047,2020-09-01,8923,7732,1191,13.3
72049,2020-09-01,883,793,90,10.2
72051,2020-09-01,13117,12060,1057,8.1
72053,2020-09-01,10593,9343,1250,11.8
72054,2020-09-01,3227,2822,405,12.6
72055,2020-09-01,3844,3378,466,12.1
72057,2020-09-01,10721,9885,836,7.8
72059,2020-09-01,5038,4493,545,10.8
72061,2020-09-01,37008,34691,2317,6.3
72063,2020-09-01,17781,16641,1140,6.4
72065,2020-09-01,12896,11888,1008,7.8
72067,2020-09-01,5338,4856,482,9
72069,2020-09-01,16414,15053,1361,8.3
72071,2020-09-01,11525,10501,1024,8.9
72073,2020-09-01,4235,3868,367,8.7
72075,2020-09-01,14939,13751,1188,8
72077,2020-09-01,12051,10883,1168,9.7
72079,2020-09-01,5046,4449,597,11.8
72081,2020-09-01,6890,6101,789,11.5
72083,2020-09-01,2695,2418,277,10.3
72085,2020-09-01,10994,9997,997,9.1
72087,2020-09-01,8299,7391,908,10.9
72089,2020-09-01,6139,5405,734,12
72091,2020-09-01,11146,10143,1003,9
72093,2020-09-01,1941,1790,151,7.8
72095,2020-09-01,2629,2381,248,9.4
72097,2020-09-01,21129,19238,1891,8.9
72099,2020-09-01,10252,9195,1057,10.3
72101,2020-09-01,7887,6979,908,11.5
72103,2020-09-01,7944,7258,686,8.6
72105,2020-09-01,7162,6173,989,13.8
72107,2020-09-01,4826,4196,630,13.1
72109,2020-09-01,4067,3678,389,9.6
72111,2020-09-01,5452,4834,618,11.3
72113,2020-09-01,43405,39369,4036,9.3
72115,2020-09-01,5954,5317,637,10.7
72117,2020-09-01,4502,4042,460,10.2
72119,2020-09-01,16866,15033,1833,10.9
72121,2020-09-01,5761,5217,544,9.4
72123,2020-09-01,6804,6077,727,10.7
72125,2020-09-01,9260,8437,823,8.9
72127,2020-09-01,133362,121131,12231,9.2
72129,2020-09-01,11219,10211,1008,9
72131,2020-09-01,9995,8860,1135,11.4
72133,2020-09-01,7512,6856,656,8.7
72135,2020-09-01,26935,24750,2185,8.1
72137,2020-09-01,28696,26170,2526,8.8
72139,2020-09-01,26491,24626,1865,7
72141,2020-09-01,6391,5802,589,9.2
72143,2020-09-01,9685,8578,1107,11.4
72145,2020-09-01,13044,11390,1654,12.7
72147,2020-09-01,2460,2162,298,12.1
72149,2020-09-01,6717,6047,670,10
72151,2020-09-01,8235,7379,856,10.4
72153,2020-09-01,9216,8152,1064,11.5
01001,2020-10-01,26159,25261,898,3.4
01003,2020-10-01,96392,92631,3761,3.9
01005,2020-10-01,8689,8090,599,6.9
01007,2020-10-01,8685,8290,395,4.5
01009,2020-10-01,25006,24350,656,2.6
01011,2020-10-01,5023,4771,252,5
01013,2020-10-01,9113,8469,644,7.1
01015,2020-10-01,46515,44179,2336,5
01017,2020-10-01,16182,15383,799,4.9
01019,2020-10-01,11728,11403,325,2.8
01021,2020-10-01,19824,19169,655,3.3
01023,2020-10-01,4683,4467,216,4.6
01025,2020-10-01,7827,7286,541,6.9
01027,2020-10-01,6204,6020,184,3
01029,2020-10-01,5762,5597,165,2.9
01031,2020-10-01,21692,21021,671,3.1
01033,2020-10-01,23991,22969,1022,4.3
01035,2020-10-01,4569,4289,280,6.1
01037,2020-10-01,4466,4283,183,4.1
01039,2020-10-01,15507,14994,513,3.3
01041,2020-10-01,6409,6170,239,3.7
01043,2020-10-01,39172,38146,1026,2.6
01045,2020-10-01,21117,20344,773,3.7
01047,2020-10-01,14667,13360,1307,8.9
01049,2020-10-01,31095,30189,906,2.9
01051,2020-10-01,37087,35791,1296,3.5
01053,2020-10-01,14585,13901,684,4.7
01055,2020-10-01,40730,38591,2139,5.3
01057,2020-10-01,6652,6409,243,3.7
01059,2020-10-01,14616,14218,398,2.7
01061,2020-10-01,11085,10764,321,2.9
01063,2020-10-01,2987,2724,263,8.8
01065,2020-10-01,6190,5716,474,7.7
01067,2020-10-01,6943,6697,246,3.5
01069,2020-10-01,47132,45156,1976,4.2
01071,2020-10-01,23222,22472,750,3.2
01073,2020-10-01,320097,304155,15942,5
01075,2020-10-01,5801,5622,179,3.1
01077,2020-10-01,42811,41346,1465,3.4
01079,2020-10-01,14632,14144,488,3.3
01081,2020-10-01,78080,75304,2776,3.6
01083,2020-10-01,45580,44315,1265,2.8
01085,2020-10-01,3710,3266,444,12
01087,2020-10-01,8201,7540,661,8.1
01089,2020-10-01,191523,185064,6459,3.4
01091,2020-10-01,7832,7426,406,5.2
01093,2020-10-01,13288,12811,477,3.6
01095,2020-10-01,45188,43958,1230,2.7
01097,2020-10-01,194143,182171,11972,6.2
01099,2020-10-01,7468,6999,469,6.3
01101,2020-10-01,108592,101369,7223,6.7
01103,2020-10-01,59987,58160,1827,3
01105,2020-10-01,3466,3148,318,9.2
01107,2020-10-01,7787,7406,381,4.9
01109,2020-10-01,15992,15383,609,3.8
01111,2020-10-01,9474,9208,266,2.8
01113,2020-10-01,23663,22780,883,3.7
01115,2020-10-01,40532,39190,1342,3.3
01117,2020-10-01,115588,112575,3013,2.6
01119,2020-10-01,4894,4634,260,5.3
01121,2020-10-01,36768,35037,1731,4.7
01123,2020-10-01,17984,17057,927,5.2
01125,2020-10-01,103217,98334,4883,4.7
01127,2020-10-01,25109,24085,1024,4.1
01129,2020-10-01,6791,6399,392,5.8
01131,2020-10-01,2884,2514,370,12.8
01133,2020-10-01,10038,9704,334,3.3
02013,2020-10-01,2701,2649,52,1.9
02016,2020-10-01,2963,2878,85,2.9
02020,2020-10-01,152130,143315,8815,5.8
02050,2020-10-01,6773,6137,636,9.4
02060,2020-10-01,283,262,21,7.4
02068,2020-10-01,744,668,76,10.2
02070,2020-10-01,1670,1561,109,6.5
02090,2020-10-01,45640,43495,2145,4.7
02100,2020-10-01,963,863,100,10.4
02105,2020-10-01,994,893,101,10.2
02110,2020-10-01,16924,16089,835,4.9
02122,2020-10-01,26662,24767,1895,7.1
02130,2020-10-01,6628,6176,452,6.8
02150,2020-10-01,6020,5789,231,3.8
02158,2020-10-01,2481,2173,308,12.4
02164,2020-10-01,666,620,46,6.9
02170,2020-10-01,48662,45766,2896,6
02180,2020-10-01,3944,3641,303,7.7
02185,2020-10-01,2906,2732,174,6
02188,2020-10-01,3010,2742,268,8.9
02195,2020-10-01,1311,1232,79,6
02198,2020-10-01,2868,2691,177,6.2
02220,2020-10-01,4081,3884,197,4.8
02230,2020-10-01,616,522,94,15.3
02240,2020-10-01,2872,2718,154,5.4
02261,2020-10-01,4502,4203,299,6.6
02275,2020-10-01,997,943,54,5.4
02282,2020-10-01,237,221,16,6.8
02290,2020-10-01,2276,2101,175,7.7
04001,2020-10-01,19795,17785,2010,10.2
04003,2020-10-01,52518,49824,2694,5.1
04005,2020-10-01,74941,69529,5412,7.2
04007,2020-10-01,20988,19709,1279,6.1
04009,2020-10-01,16270,15481,789,4.8
04011,2020-10-01,4417,4195,222,5
04012,2020-10-01,9253,8737,516,5.6
04013,2020-10-01,NA,NA,141146,6.1
04015,2020-10-01,87610,81297,6313,7.2
04017,2020-10-01,40628,37524,3104,7.6
04019,2020-10-01,489785,458499,31286,6.4
04021,2020-10-01,191578,180024,11554,6
04023,2020-10-01,18911,16933,1978,10.5
04025,2020-10-01,106874,100871,6003,5.6
04027,2020-10-01,96052,83936,12116,12.6
05001,2020-10-01,9331,9018,313,3.4
05003,2020-10-01,7069,6510,559,7.9
05005,2020-10-01,16202,15503,699,4.3
05007,2020-10-01,139413,134507,4906,3.5
05009,2020-10-01,15510,14921,589,3.8
05011,2020-10-01,4267,4081,186,4.4
05013,2020-10-01,2402,2308,94,3.9
05015,2020-10-01,12727,12210,517,4.1
05017,2020-10-01,3220,2924,296,9.2
05019,2020-10-01,9240,8825,415,4.5
05021,2020-10-01,5446,5231,215,3.9
05023,2020-10-01,8942,8442,500,5.6
05025,2020-10-01,3182,3017,165,5.2
05027,2020-10-01,8929,8413,516,5.8
05029,2020-10-01,8234,7878,356,4.3
05031,2020-10-01,54757,52492,2265,4.1
05033,2020-10-01,26002,24905,1097,4.2
05035,2020-10-01,20792,19392,1400,6.7
05037,2020-10-01,7144,6795,349,4.9
05039,2020-10-01,2827,2721,106,3.7
05041,2020-10-01,5223,4922,301,5.8
05043,2020-10-01,7597,7198,399,5.3
05045,2020-10-01,59829,57402,2427,4.1
05047,2020-10-01,7408,7096,312,4.2
05049,2020-10-01,4818,4629,189,3.9
05051,2020-10-01,40302,37705,2597,6.4
05053,2020-10-01,8010,7690,320,4
05055,2020-10-01,18964,18175,789,4.2
05057,2020-10-01,9350,8992,358,3.8
05059,2020-10-01,13813,13185,628,4.5
05061,2020-10-01,5472,5261,211,3.9
05063,2020-10-01,16244,15539,705,4.3
05065,2020-10-01,4494,4219,275,6.1
05067,2020-10-01,5762,5453,309,5.4
05069,2020-10-01,26969,25040,1929,7.2
05071,2020-10-01,9928,9489,439,4.4
05073,2020-10-01,2407,2236,171,7.1
05075,2020-10-01,6757,6441,316,4.7
05077,2020-10-01,2759,2593,166,6
05079,2020-10-01,3796,3622,174,4.6
05081,2020-10-01,5277,5008,269,5.1
05083,2020-10-01,8514,8106,408,4.8
05085,2020-10-01,32734,31286,1448,4.4
05087,2020-10-01,7482,7240,242,3.2
05089,2020-10-01,5979,5672,307,5.1
05091,2020-10-01,18949,17961,988,5.2
05093,2020-10-01,16768,15532,1236,7.4
05095,2020-10-01,2665,2511,154,5.8
05097,2020-10-01,2995,2847,148,4.9
05099,2020-10-01,3445,3290,155,4.5
05101,2020-10-01,3204,3100,104,3.2
05103,2020-10-01,9598,9182,416,4.3
05105,2020-10-01,4077,3913,164,4
05107,2020-10-01,6291,5831,460,7.3
05109,2020-10-01,4247,4048,199,4.7
05111,2020-10-01,9809,9386,423,4.3
05113,2020-10-01,7871,7484,387,4.9
05115,2020-10-01,27442,26291,1151,4.2
05117,2020-10-01,3611,3457,154,4.3
05119,2020-10-01,183821,171896,11925,6.5
05121,2020-10-01,7423,7097,326,4.4
05123,2020-10-01,7787,7265,522,6.7
05125,2020-10-01,56557,54307,2250,4
05127,2020-10-01,4311,4157,154,3.6
05129,2020-10-01,2781,2654,127,4.6
05131,2020-10-01,55058,52522,2536,4.6
05133,2020-10-01,5405,5148,257,4.8
05135,2020-10-01,5605,5298,307,5.5
05137,2020-10-01,4600,4345,255,5.5
05139,2020-10-01,15122,14114,1008,6.7
05141,2020-10-01,5680,5364,316,5.6
05143,2020-10-01,125627,121011,4616,3.7
05145,2020-10-01,33211,31700,1511,4.5
05147,2020-10-01,2795,2663,132,4.7
05149,2020-10-01,7994,7697,297,3.7
06001,2020-10-01,812829,744319,68510,8.4
06003,2020-10-01,458,411,47,10.3
06005,2020-10-01,14541,13377,1164,8
06007,2020-10-01,92161,84827,7334,8
06009,2020-10-01,21365,19946,1419,6.6
06011,2020-10-01,10606,9634,972,9.2
06013,2020-10-01,540515,494942,45573,8.4
06015,2020-10-01,9401,8623,778,8.3
06017,2020-10-01,91083,84953,6130,6.7
06019,2020-10-01,444044,400972,43072,9.7
06021,2020-10-01,12636,11776,860,6.8
06023,2020-10-01,59562,55240,4322,7.3
06025,2020-10-01,67099,53703,13396,20
06027,2020-10-01,8292,7724,568,6.8
06029,2020-10-01,388703,347465,41238,10.6
06031,2020-10-01,55462,50053,5409,9.8
06033,2020-10-01,28593,26222,2371,8.3
06035,2020-10-01,10042,9495,547,5.4
06037,2020-10-01,NA,NA,591383,12
06039,2020-10-01,61003,55589,5414,8.9
06041,2020-10-01,130998,123183,7815,6
06043,2020-10-01,6985,6372,613,8.8
06045,2020-10-01,36997,34114,2883,7.8
06047,2020-10-01,115767,104570,11197,9.7
06049,2020-10-01,3318,3123,195,5.9
06051,2020-10-01,7419,6665,754,10.2
06053,2020-10-01,213602,197747,15855,7.4
06055,2020-10-01,68901,63813,5088,7.4
06057,2020-10-01,46611,43451,3160,6.8
06059,2020-10-01,NA,NA,127455,8.2
06061,2020-10-01,186307,174640,11667,6.3
06063,2020-10-01,7625,7054,571,7.5
06065,2020-10-01,NA,NA,104595,9.3
06067,2020-10-01,716904,653816,63088,8.8
06069,2020-10-01,31198,28733,2465,7.9
06071,2020-10-01,984411,891544,92867,9.4
06073,2020-10-01,NA,NA,129646,8.4
06075,2020-10-01,550262,508664,41598,7.6
06077,2020-10-01,335549,301469,34080,10.2
06079,2020-10-01,133290,124726,8564,6.4
06081,2020-10-01,429581,401409,28172,6.6
06083,2020-10-01,219314,204816,14498,6.6
06085,2020-10-01,NA,953521,65511,6.4
06087,2020-10-01,133075,123212,9863,7.4
06089,2020-10-01,74156,68742,5414,7.3
06091,2020-10-01,1333,1258,75,5.6
06093,2020-10-01,17319,16060,1259,7.3
06095,2020-10-01,204639,186231,18408,9
06097,2020-10-01,244334,227531,16803,6.9
06099,2020-10-01,242064,219402,22662,9.4
06101,2020-10-01,45370,41451,3919,8.6
06103,2020-10-01,26140,24229,1911,7.3
06105,2020-10-01,4594,4308,286,6.2
06107,2020-10-01,195058,173317,21741,11.1
06109,2020-10-01,19956,18224,1732,8.7
06111,2020-10-01,407702,376548,31154,7.6
06113,2020-10-01,106038,99145,6893,6.5
06115,2020-10-01,30135,27331,2804,9.3
08001,2020-10-01,277269,256457,20812,7.5
08003,2020-10-01,8936,8441,495,5.5
08005,2020-10-01,369836,342010,27826,7.5
08007,2020-10-01,7600,7179,421,5.5
08009,2020-10-01,2473,2431,42,1.7
08011,2020-10-01,2079,2000,79,3.8
08013,2020-10-01,193588,182881,10707,5.5
08014,2020-10-01,40430,38039,2391,5.9
08015,2020-10-01,10004,9508,496,5
08017,2020-10-01,1266,1237,29,2.3
08019,2020-10-01,6134,5706,428,7
08021,2020-10-01,4423,4232,191,4.3
08023,2020-10-01,1953,1824,129,6.6
08025,2020-10-01,1624,1536,88,5.4
08027,2020-10-01,2141,2050,91,4.3
08029,2020-10-01,15312,14490,822,5.4
08031,2020-10-01,427352,393691,33661,7.9
08033,2020-10-01,1252,1191,61,4.9
08035,2020-10-01,195629,185746,9883,5.1
08037,2020-10-01,34426,31897,2529,7.3
08039,2020-10-01,15370,14785,585,3.8
08041,2020-10-01,348424,326211,22213,6.4
08043,2020-10-01,15824,14715,1109,7
08045,2020-10-01,31494,29725,1769,5.6
08047,2020-10-01,3897,3607,290,7.4
08049,2020-10-01,8765,8210,555,6.3
08051,2020-10-01,11348,10839,509,4.5
08053,2020-10-01,400,386,14,3.5
08055,2020-10-01,2813,2592,221,7.9
08057,2020-10-01,1084,1053,31,2.9
08059,2020-10-01,335360,313956,21404,6.4
08061,2020-10-01,1110,1089,21,1.9
08063,2020-10-01,4732,4624,108,2.3
08065,2020-10-01,4707,4385,322,6.8
08067,2020-10-01,32433,30599,1834,5.7
08069,2020-10-01,208632,197365,11267,5.4
08071,2020-10-01,6884,6415,469,6.8
08073,2020-10-01,2615,2508,107,4.1
08075,2020-10-01,11793,11293,500,4.2
08077,2020-10-01,77068,72245,4823,6.3
08079,2020-10-01,416,396,20,4.8
08081,2020-10-01,7537,7200,337,4.5
08083,2020-10-01,13310,12565,745,5.6
08085,2020-10-01,22619,21393,1226,5.4
08087,2020-10-01,17471,16604,867,5
08089,2020-10-01,8864,8353,511,5.8
08091,2020-10-01,2626,2482,144,5.5
08093,2020-10-01,11219,10662,557,5
08095,2020-10-01,2826,2773,53,1.9
08097,2020-10-01,10898,10048,850,7.8
08099,2020-10-01,6815,6531,284,4.2
08101,2020-10-01,79040,72553,6487,8.2
08103,2020-10-01,3172,3028,144,4.5
08105,2020-10-01,6066,5752,314,5.2
08107,2020-10-01,15897,14978,919,5.8
08109,2020-10-01,3796,3582,214,5.6
08111,2020-10-01,523,503,20,3.8
08113,2020-10-01,4889,4495,394,8.1
08115,2020-10-01,1298,1256,42,3.2
08117,2020-10-01,20810,19267,1543,7.4
08119,2020-10-01,13012,12232,780,6
08121,2020-10-01,3284,3203,81,2.5
08123,2020-10-01,170319,158847,11472,6.7
08125,2020-10-01,6423,6272,151,2.4
09001,2020-10-01,456078,419821,36257,7.9
09003,2020-10-01,468421,430547,37874,8.1
09005,2020-10-01,99966,93756,6210,6.2
09007,2020-10-01,90802,85355,5447,6
09009,2020-10-01,453712,417919,35793,7.9
09011,2020-10-01,129837,118474,11363,8.8
09013,2020-10-01,82674,78130,4544,5.5
09015,2020-10-01,60390,56056,4334,7.2
10001,2020-10-01,78434,74011,4423,5.6
10003,2020-10-01,295320,279688,15632,5.3
10005,2020-10-01,106252,101702,4550,4.3
11001,2020-10-01,405870,372532,33338,8.2
12001,2020-10-01,136717,131398,5319,3.9
12003,2020-10-01,11943,11472,471,3.9
12005,2020-10-01,83198,79879,3319,4
12007,2020-10-01,10961,10489,472,4.3
12009,2020-10-01,280311,267704,12607,4.5
12011,2020-10-01,NA,943593,60774,6.1
12013,2020-10-01,4813,4615,198,4.1
12015,2020-10-01,70727,67296,3431,4.9
12017,2020-10-01,45950,43265,2685,5.8
12019,2020-10-01,106394,102582,3812,3.6
12021,2020-10-01,175044,167322,7722,4.4
12023,2020-10-01,30224,28809,1415,4.7
12027,2020-10-01,14063,13530,533,3.8
12029,2020-10-01,6085,5850,235,3.9
12031,2020-10-01,487511,464098,23413,4.8
12033,2020-10-01,144936,137935,7001,4.8
12035,2020-10-01,46286,43956,2330,5
12037,2020-10-01,4690,4512,178,3.8
12039,2020-10-01,19034,17940,1094,5.7
12041,2020-10-01,7141,6882,259,3.6
12043,2020-10-01,5357,5160,197,3.7
12045,2020-10-01,5051,4848,203,4
12047,2020-10-01,4363,4096,267,6.1
12049,2020-10-01,8560,8159,401,4.7
12051,2020-10-01,15842,14932,910,5.7
12053,2020-10-01,70995,67101,3894,5.5
12055,2020-10-01,34524,32516,2008,5.8
12057,2020-10-01,750836,714286,36550,4.9
12059,2020-10-01,6909,6640,269,3.9
12061,2020-10-01,63341,60150,3191,5
12063,2020-10-01,17508,16758,750,4.3
12065,2020-10-01,5430,5192,238,4.4
12067,2020-10-01,2815,2711,104,3.7
12069,2020-10-01,149065,140421,8644,5.8
12071,2020-10-01,344738,328105,16633,4.8
12073,2020-10-01,152218,145520,6698,4.4
12075,2020-10-01,16875,16152,723,4.3
12077,2020-10-01,2605,2505,100,3.8
12079,2020-10-01,7806,7403,403,5.2
12081,2020-10-01,175476,167589,7887,4.5
12083,2020-10-01,139687,132621,7066,5.1
12085,2020-10-01,71781,69027,2754,3.8
12086,2020-10-01,NA,NA,110612,8.5
12087,2020-10-01,43474,41598,1876,4.3
12089,2020-10-01,41475,39991,1484,3.6
12091,2020-10-01,96526,93209,3317,3.4
12093,2020-10-01,17345,16636,709,4.1
12095,2020-10-01,709605,658825,50780,7.2
12097,2020-10-01,176122,160624,15498,8.8
12099,2020-10-01,711009,674585,36424,5.1
12101,2020-10-01,237079,225606,11473,4.8
12103,2020-10-01,481495,459378,22117,4.6
12105,2020-10-01,314930,295321,19609,6.2
12107,2020-10-01,26813,25092,1721,6.4
12109,2020-10-01,134141,129748,4393,3.3
12111,2020-10-01,144153,136418,7735,5.4
12113,2020-10-01,82827,79994,2833,3.4
12115,2020-10-01,183358,175364,7994,4.4
12117,2020-10-01,232061,220638,11423,4.9
12119,2020-10-01,31792,30051,1741,5.5
12121,2020-10-01,17911,17121,790,4.4
12123,2020-10-01,8139,7701,438,5.4
12125,2020-10-01,4574,4399,175,3.8
12127,2020-10-01,247865,235157,12708,5.1
12129,2020-10-01,15051,14594,457,3
12131,2020-10-01,32073,30900,1173,3.7
12133,2020-10-01,9408,9003,405,4.3
13001,2020-10-01,8983,8632,351,3.9
13003,2020-10-01,4513,4373,140,3.1
13005,2020-10-01,4606,4414,192,4.2
13007,2020-10-01,1137,1080,57,5
13009,2020-10-01,17748,16644,1104,6.2
13011,2020-10-01,9998,9683,315,3.2
13013,2020-10-01,40323,38726,1597,4
13015,2020-10-01,49762,47433,2329,4.7
13017,2020-10-01,5492,5137,355,6.5
13019,2020-10-01,7580,7266,314,4.1
13021,2020-10-01,68006,63258,4748,7
13023,2020-10-01,4557,4278,279,6.1
13025,2020-10-01,7099,6802,297,4.2
13027,2020-10-01,7002,6688,314,4.5
13029,2020-10-01,18942,18193,749,4
13031,2020-10-01,37955,35898,2057,5.4
13033,2020-10-01,9134,8555,579,6.3
13035,2020-10-01,10817,10248,569,5.3
13037,2020-10-01,2211,2114,97,4.4
13039,2020-10-01,21413,20633,780,3.6
13043,2020-10-01,5700,5463,237,4.2
13045,2020-10-01,54782,51979,2803,5.1
13047,2020-10-01,32968,32013,955,2.9
13049,2020-10-01,4882,4744,138,2.8
13051,2020-10-01,142104,133232,8872,6.2
13053,2020-10-01,1992,1889,103,5.2
13055,2020-10-01,9657,9074,583,6
13057,2020-10-01,133859,129036,4823,3.6
13059,2020-10-01,59075,55924,3151,5.3
13061,2020-10-01,891,796,95,10.7
13063,2020-10-01,141198,127527,13671,9.7
13065,2020-10-01,2977,2877,100,3.4
13067,2020-10-01,417339,397306,20033,4.8
13069,2020-10-01,19231,18271,960,5
13071,2020-10-01,22370,21478,892,4
13073,2020-10-01,75434,73066,2368,3.1
13075,2020-10-01,8214,7875,339,4.1
13077,2020-10-01,74196,70637,3559,4.8
13079,2020-10-01,5529,5278,251,4.5
13081,2020-10-01,9644,8873,771,8
13083,2020-10-01,8023,7788,235,2.9
13085,2020-10-01,12425,11985,440,3.5
13087,2020-10-01,11353,10853,500,4.4
13089,2020-10-01,398899,370910,27989,7
13091,2020-10-01,7044,6693,351,5
13093,2020-10-01,4880,4529,351,7.2
13095,2020-10-01,38049,34887,3162,8.3
13097,2020-10-01,72845,68175,4670,6.4
13099,2020-10-01,4456,4197,259,5.8
13101,2020-10-01,1929,1865,64,3.3
13103,2020-10-01,31783,30556,1227,3.9
13105,2020-10-01,7980,7480,500,6.3
13107,2020-10-01,8603,8012,591,6.9
13109,2020-10-01,5139,4907,232,4.5
13111,2020-10-01,11318,10954,364,3.2
13113,2020-10-01,56741,54342,2399,4.2
13115,2020-10-01,43640,41634,2006,4.6
13117,2020-10-01,121568,117504,4064,3.3
13119,2020-10-01,9941,9486,455,4.6
13121,2020-10-01,561387,522016,39371,7
13123,2020-10-01,12155,11761,394,3.2
13125,2020-10-01,1253,1216,37,3
13127,2020-10-01,38430,36453,1977,5.1
13129,2020-10-01,28425,27283,1142,4
13131,2020-10-01,10708,10316,392,3.7
13133,2020-10-01,7012,6653,359,5.1
13135,2020-10-01,484749,459684,25065,5.2
13137,2020-10-01,18587,17813,774,4.2
13139,2020-10-01,103540,99951,3589,3.5
13141,2020-10-01,2549,2332,217,8.5
13143,2020-10-01,12328,11757,571,4.6
13145,2020-10-01,16575,16030,545,3.3
13147,2020-10-01,11487,10989,498,4.3
13149,2020-10-01,5135,4886,249,4.8
13151,2020-10-01,115846,108577,7269,6.3
13153,2020-10-01,71350,68170,3180,4.5
13155,2020-10-01,3530,3370,160,4.5
13157,2020-10-01,41031,39721,1310,3.2
13159,2020-10-01,6823,6543,280,4.1
13161,2020-10-01,6076,5819,257,4.2
13163,2020-10-01,6647,6250,397,6
13165,2020-10-01,3275,3096,179,5.5
13167,2020-10-01,4094,3927,167,4.1
13169,2020-10-01,13420,12920,500,3.7
13171,2020-10-01,8059,7629,430,5.3
13173,2020-10-01,3814,3654,160,4.2
13175,2020-10-01,19742,18679,1063,5.4
13177,2020-10-01,14806,14255,551,3.7
13179,2020-10-01,25937,24555,1382,5.3
13181,2020-10-01,3535,3379,156,4.4
13183,2020-10-01,8204,7917,287,3.5
13185,2020-10-01,52839,50139,2700,5.1
13187,2020-10-01,16634,16084,550,3.3
13189,2020-10-01,8755,8202,553,6.3
13191,2020-10-01,6005,5724,281,4.7
13193,2020-10-01,4675,4336,339,7.3
13195,2020-10-01,13183,12662,521,4
13197,2020-10-01,3216,3084,132,4.1
13199,2020-10-01,8850,8218,632,7.1
13201,2020-10-01,2766,2674,92,3.3
13205,2020-10-01,8254,7737,517,6.3
13207,2020-10-01,12789,12242,547,4.3
13209,2020-10-01,3953,3775,178,4.5
13211,2020-10-01,9212,8823,389,4.2
13213,2020-10-01,15357,14550,807,5.3
13215,2020-10-01,77648,72406,5242,6.8
13217,2020-10-01,52256,49060,3196,6.1
13219,2020-10-01,19538,19024,514,2.6
13221,2020-10-01,6879,6627,252,3.7
13223,2020-10-01,85765,82126,3639,4.2
13225,2020-10-01,12068,11321,747,6.2
13227,2020-10-01,15010,14470,540,3.6
13229,2020-10-01,8587,8261,326,3.8
13231,2020-10-01,8767,8436,331,3.8
13233,2020-10-01,18501,17658,843,4.6
13235,2020-10-01,4047,3879,168,4.2
13237,2020-10-01,8227,7807,420,5.1
13239,2020-10-01,792,752,40,5.1
13241,2020-10-01,7312,7050,262,3.6
13243,2020-10-01,2507,2380,127,5.1
13245,2020-10-01,86216,80479,5737,6.7
13247,2020-10-01,44340,41409,2931,6.6
13249,2020-10-01,2171,2089,82,3.8
13251,2020-10-01,5142,4780,362,7
13253,2020-10-01,3058,2931,127,4.2
13255,2020-10-01,28546,26631,1915,6.7
13257,2020-10-01,10470,9938,532,5.1
13259,2020-10-01,2519,2384,135,5.4
13261,2020-10-01,12688,11782,906,7.1
13263,2020-10-01,2777,2616,161,5.8
13265,2020-10-01,522,492,30,5.7
13267,2020-10-01,9612,9271,341,3.5
13269,2020-10-01,2797,2607,190,6.8
13271,2020-10-01,3737,3423,314,8.4
13273,2020-10-01,3540,3274,266,7.5
13275,2020-10-01,17076,16138,938,5.5
13277,2020-10-01,20885,19971,914,4.4
13279,2020-10-01,12225,11595,630,5.2
13281,2020-10-01,4007,3822,185,4.6
13283,2020-10-01,2760,2629,131,4.7
13285,2020-10-01,37530,35396,2134,5.7
13287,2020-10-01,3298,3063,235,7.1
13289,2020-10-01,2774,2608,166,6
13291,2020-10-01,10579,10249,330,3.1
13293,2020-10-01,11360,10734,626,5.5
13295,2020-10-01,30923,29855,1068,3.5
13297,2020-10-01,45165,43224,1941,4.3
13299,2020-10-01,15391,14677,714,4.6
13301,2020-10-01,2663,2515,148,5.6
13303,2020-10-01,6954,6528,426,6.1
13305,2020-10-01,11676,11139,537,4.6
13307,2020-10-01,1010,959,51,5
13309,2020-10-01,1595,1507,88,5.5
13311,2020-10-01,16529,16049,480,2.9
13313,2020-10-01,43318,41170,2148,5
13315,2020-10-01,2802,2652,150,5.4
13317,2020-10-01,3676,3455,221,6
13319,2020-10-01,3814,3628,186,4.9
13321,2020-10-01,8900,8458,442,5
15001,2020-10-01,88358,76634,11724,13.3
15003,2020-10-01,434818,381563,53255,12.2
15007,2020-10-01,34612,27919,6693,19.3
15009,2020-10-01,80986,63006,17980,22.2
16001,2020-10-01,257089,245743,11346,4.4
16003,2020-10-01,1752,1630,122,7
16005,2020-10-01,43454,41714,1740,4
16007,2020-10-01,3191,3097,94,2.9
16009,2020-10-01,4104,3889,215,5.2
16011,2020-10-01,25348,24579,769,3
16013,2020-10-01,12242,11597,645,5.3
16015,2020-10-01,3579,3346,233,6.5
16017,2020-10-01,20881,19675,1206,5.8
16019,2020-10-01,59180,57195,1985,3.4
16021,2020-10-01,5563,5303,260,4.7
16023,2020-10-01,1471,1426,45,3.1
16025,2020-10-01,713,691,22,3.1
16027,2020-10-01,106191,101176,5015,4.7
16029,2020-10-01,4371,4243,128,2.9
16031,2020-10-01,13221,12839,382,2.9
16033,2020-10-01,415,404,11,2.7
16035,2020-10-01,3033,2838,195,6.4
16037,2020-10-01,2279,2188,91,4
16039,2020-10-01,12040,11570,470,3.9
16041,2020-10-01,7382,7175,207,2.8
16043,2020-10-01,8880,8663,217,2.4
16045,2020-10-01,8479,8052,427,5
16047,2020-10-01,8444,8174,270,3.2
16049,2020-10-01,6792,6432,360,5.3
16051,2020-10-01,14678,14265,413,2.8
16053,2020-10-01,12433,12026,407,3.3
16055,2020-10-01,81773,77505,4268,5.2
16057,2020-10-01,19992,19204,788,3.9
16059,2020-10-01,3675,3496,179,4.9
16061,2020-10-01,1686,1589,97,5.8
16063,2020-10-01,2739,2627,112,4.1
16065,2020-10-01,24185,23623,562,2.3
16067,2020-10-01,12292,11941,351,2.9
16069,2020-10-01,20584,19809,775,3.8
16071,2020-10-01,2401,2325,76,3.2
16073,2020-10-01,5424,5176,248,4.6
16075,2020-10-01,12166,11662,504,4.1
16077,2020-10-01,4873,4744,129,2.6
16079,2020-10-01,5320,4931,389,7.3
16081,2020-10-01,6974,6702,272,3.9
16083,2020-10-01,41730,40021,1709,4.1
16085,2020-10-01,5485,5186,299,5.5
16087,2020-10-01,4855,4662,193,4
17001,2020-10-01,32899,31472,1427,4.3
17003,2020-10-01,2023,1864,159,7.9
17005,2020-10-01,7955,7585,370,4.7
17007,2020-10-01,26043,24425,1618,6.2
17009,2020-10-01,3224,3144,80,2.5
17011,2020-10-01,17303,16475,828,4.8
17013,2020-10-01,2335,2235,100,4.3
17015,2020-10-01,8004,7612,392,4.9
17017,2020-10-01,6143,5868,275,4.5
17019,2020-10-01,118292,112451,5841,4.9
17021,2020-10-01,14364,13569,795,5.5
17023,2020-10-01,7838,7488,350,4.5
17025,2020-10-01,6497,6174,323,5
17027,2020-10-01,20850,20114,736,3.5
17029,2020-10-01,24661,23278,1383,5.6
17031,2020-10-01,NA,NA,243169,9.7
17033,2020-10-01,8943,8535,408,4.6
17035,2020-10-01,6413,6167,246,3.8
17037,2020-10-01,55285,51945,3340,6
17039,2020-10-01,7656,7297,359,4.7
17041,2020-10-01,10728,10313,415,3.9
17043,2020-10-01,477548,446967,30581,6.4
17045,2020-10-01,9450,9083,367,3.9
17047,2020-10-01,2823,2696,127,4.5
17049,2020-10-01,20211,19379,832,4.1
17051,2020-10-01,10450,9935,515,4.9
17053,2020-10-01,6926,6652,274,4
17055,2020-10-01,16430,15367,1063,6.5
17057,2020-10-01,15312,14460,852,5.6
17059,2020-10-01,2177,2031,146,6.7
17061,2020-10-01,6312,6019,293,4.6
17063,2020-10-01,23753,22299,1454,6.1
17065,2020-10-01,4540,4376,164,3.6
17067,2020-10-01,8740,8373,367,4.2
17069,2020-10-01,1350,1269,81,6
17071,2020-10-01,3760,3619,141,3.8
17073,2020-10-01,25264,24003,1261,5
17075,2020-10-01,14567,13939,628,4.3
17077,2020-10-01,28937,27289,1648,5.7
17079,2020-10-01,5013,4826,187,3.7
17081,2020-10-01,17667,16580,1087,6.2
17083,2020-10-01,11131,10590,541,4.9
17085,2020-10-01,11109,10584,525,4.7
17087,2020-10-01,4300,4054,246,5.7
17089,2020-10-01,270021,252543,17478,6.5
17091,2020-10-01,55710,52107,3603,6.5
17093,2020-10-01,65188,61111,4077,6.3
17095,2020-10-01,22198,20720,1478,6.7
17097,2020-10-01,380222,357762,22460,5.9
17099,2020-10-01,54858,51544,3314,6
17101,2020-10-01,6055,5722,333,5.5
17103,2020-10-01,18173,17344,829,4.6
17105,2020-10-01,16974,16212,762,4.5
17107,2020-10-01,12873,12274,599,4.7
17109,2020-10-01,13872,13164,708,5.1
17111,2020-10-01,155769,145985,9784,6.3
17113,2020-10-01,89968,85582,4386,4.9
17115,2020-10-01,49171,45262,3909,7.9
17117,2020-10-01,23259,22211,1048,4.5
17119,2020-10-01,136631,129174,7457,5.5
17121,2020-10-01,17746,16680,1066,6
17123,2020-10-01,5452,5176,276,5.1
17125,2020-10-01,6331,5992,339,5.4
17127,2020-10-01,5584,5253,331,5.9
17129,2020-10-01,6457,6179,278,4.3
17131,2020-10-01,8157,7764,393,4.8
17133,2020-10-01,19220,18546,674,3.5
17135,2020-10-01,11906,11227,679,5.7
17137,2020-10-01,16805,15986,819,4.9
17139,2020-10-01,7758,7461,297,3.8
17141,2020-10-01,25444,24119,1325,5.2
17143,2020-10-01,87295,80582,6713,7.7
17145,2020-10-01,8431,7940,491,5.8
17147,2020-10-01,9334,8991,343,3.7
17149,2020-10-01,7223,6953,270,3.7
17151,2020-10-01,1762,1674,88,5
17153,2020-10-01,1912,1746,166,8.7
17155,2020-10-01,3088,2939,149,4.8
17157,2020-10-01,14484,13849,635,4.4
17159,2020-10-01,7696,7350,346,4.5
17161,2020-10-01,71647,66988,4659,6.5
17163,2020-10-01,130057,121124,8933,6.9
17165,2020-10-01,9970,9309,661,6.6
17167,2020-10-01,101479,95197,6282,6.2
17169,2020-10-01,3314,3180,134,4
17171,2020-10-01,2497,2392,105,4.2
17173,2020-10-01,10888,10428,460,4.2
17175,2020-10-01,2575,2453,122,4.7
17177,2020-10-01,22446,21227,1219,5.4
17179,2020-10-01,64899,61440,3459,5.3
17181,2020-10-01,7516,7110,406,5.4
17183,2020-10-01,34420,32115,2305,6.7
17185,2020-10-01,5941,5666,275,4.6
17187,2020-10-01,8580,8199,381,4.4
17189,2020-10-01,10384,10108,276,2.7
17191,2020-10-01,7263,6906,357,4.9
17193,2020-10-01,6459,6161,298,4.6
17195,2020-10-01,28994,27472,1522,5.2
17197,2020-10-01,338127,312834,25293,7.5
17199,2020-10-01,32964,31157,1807,5.5
17201,2020-10-01,139461,128644,10817,7.8
17203,2020-10-01,19138,18339,799,4.2
18001,2020-10-01,17050,16518,532,3.1
18003,2020-10-01,186244,176479,9765,5.2
18005,2020-10-01,43850,42046,1804,4.1
18007,2020-10-01,4458,4294,164,3.7
18009,2020-10-01,4880,4656,224,4.6
18011,2020-10-01,36302,35095,1207,3.3
18013,2020-10-01,7604,7263,341,4.5
18015,2020-10-01,9914,9543,371,3.7
18017,2020-10-01,17549,16799,750,4.3
18019,2020-10-01,60986,57828,3158,5.2
18021,2020-10-01,11545,10969,576,5
18023,2020-10-01,17074,16421,653,3.8
18025,2020-10-01,4829,4608,221,4.6
18027,2020-10-01,16687,16223,464,2.8
18029,2020-10-01,25177,24046,1131,4.5
18031,2020-10-01,14867,14288,579,3.9
18033,2020-10-01,21952,21079,873,4
18035,2020-10-01,53372,50525,2847,5.3
18037,2020-10-01,22636,21866,770,3.4
18039,2020-10-01,112905,107994,4911,4.3
18041,2020-10-01,8412,7871,541,6.4
18043,2020-10-01,41066,39191,1875,4.6
18045,2020-10-01,7819,7529,290,3.7
18047,2020-10-01,11445,11020,425,3.7
18049,2020-10-01,9757,9346,411,4.2
18051,2020-10-01,19641,18941,700,3.6
18053,2020-10-01,31928,30485,1443,4.5
18055,2020-10-01,13476,12890,586,4.3
18057,2020-10-01,185773,179241,6532,3.5
18059,2020-10-01,40851,39196,1655,4.1
18061,2020-10-01,19837,19016,821,4.1
18063,2020-10-01,90649,87195,3454,3.8
18065,2020-10-01,21816,20871,945,4.3
18067,2020-10-01,35725,33496,2229,6.2
18069,2020-10-01,18207,17516,691,3.8
18071,2020-10-01,23411,22437,974,4.2
18073,2020-10-01,15644,14961,683,4.4
18075,2020-10-01,8792,8479,313,3.6
18077,2020-10-01,15059,14395,664,4.4
18079,2020-10-01,13596,12958,638,4.7
18081,2020-10-01,83251,79927,3324,4
18083,2020-10-01,18502,17782,720,3.9
18085,2020-10-01,41481,39757,1724,4.2
18087,2020-10-01,19622,19037,585,3
18089,2020-10-01,223702,206336,17366,7.8
18091,2020-10-01,47271,44029,3242,6.9
18093,2020-10-01,20610,19578,1032,5
18095,2020-10-01,59049,55720,3329,5.6
18097,2020-10-01,502776,468262,34514,6.9
18099,2020-10-01,22713,21763,950,4.2
18101,2020-10-01,5507,5318,189,3.4
18103,2020-10-01,14963,14168,795,5.3
18105,2020-10-01,69039,66017,3022,4.4
18107,2020-10-01,18607,17929,678,3.6
18109,2020-10-01,36068,34665,1403,3.9
18111,2020-10-01,6611,6350,261,3.9
18113,2020-10-01,22432,21423,1009,4.5
18115,2020-10-01,3124,2988,136,4.4
18117,2020-10-01,8399,7733,666,7.9
18119,2020-10-01,9127,8703,424,4.6
18121,2020-10-01,7013,6756,257,3.7
18123,2020-10-01,9045,8662,383,4.2
18125,2020-10-01,6283,6050,233,3.7
18127,2020-10-01,83339,78912,4427,5.3
18129,2020-10-01,12966,12524,442,3.4
18131,2020-10-01,6457,6208,249,3.9
18133,2020-10-01,16510,15798,712,4.3
18135,2020-10-01,11484,11002,482,4.2
18137,2020-10-01,13754,13196,558,4.1
18139,2020-10-01,8863,8516,347,3.9
18141,2020-10-01,133003,124477,8526,6.4
18143,2020-10-01,10367,9803,564,5.4
18145,2020-10-01,23061,22084,977,4.2
18147,2020-10-01,10539,10140,399,3.8
18149,2020-10-01,9878,9336,542,5.5
18151,2020-10-01,19986,19233,753,3.8
18153,2020-10-01,7969,7583,386,4.8
18155,2020-10-01,4683,4428,255,5.4
18157,2020-10-01,96240,91592,4648,4.8
18159,2020-10-01,9125,8814,311,3.4
18161,2020-10-01,3464,3354,110,3.2
18163,2020-10-01,91494,86666,4828,5.3
18165,2020-10-01,6596,6277,319,4.8
18167,2020-10-01,45794,43130,2664,5.8
18169,2020-10-01,14769,14165,604,4.1
18171,2020-10-01,4082,3934,148,3.6
18173,2020-10-01,31683,30522,1161,3.7
18175,2020-10-01,13544,12929,615,4.5
18177,2020-10-01,29878,28348,1530,5.1
18179,2020-10-01,14260,13748,512,3.6
18181,2020-10-01,13491,13040,451,3.3
18183,2020-10-01,17358,16730,628,3.6
19001,2020-10-01,4170,4070,100,2.4
19003,2020-10-01,1948,1889,59,3
19005,2020-10-01,6843,6680,163,2.4
19007,2020-10-01,5844,5639,205,3.5
19009,2020-10-01,2975,2908,67,2.3
19011,2020-10-01,12623,12239,384,3
19013,2020-10-01,66002,63396,2606,3.9
19015,2020-10-01,14301,13943,358,2.5
19017,2020-10-01,13294,13014,280,2.1
19019,2020-10-01,10867,10557,310,2.9
19021,2020-10-01,11589,11285,304,2.6
19023,2020-10-01,7573,7388,185,2.4
19025,2020-10-01,4037,3933,104,2.6
19027,2020-10-01,10324,10068,256,2.5
19029,2020-10-01,6698,6534,164,2.4
19031,2020-10-01,10163,9892,271,2.7
19033,2020-10-01,22502,21760,742,3.3
19035,2020-10-01,6140,6010,130,2.1
19037,2020-10-01,6169,6010,159,2.6
19039,2020-10-01,4648,4498,150,3.2
19041,2020-10-01,8101,7891,210,2.6
19043,2020-10-01,9454,9197,257,2.7
19045,2020-10-01,21336,20367,969,4.5
19047,2020-10-01,7718,7481,237,3.1
19049,2020-10-01,49000,47864,1136,2.3
19051,2020-10-01,4051,3932,119,2.9
19053,2020-10-01,4283,4202,81,1.9
19055,2020-10-01,10220,9979,241,2.4
19057,2020-10-01,18072,17173,899,5
19059,2020-10-01,9263,8987,276,3
19061,2020-10-01,53332,51350,1982,3.7
19063,2020-10-01,4907,4729,178,3.6
19065,2020-10-01,10215,9892,323,3.2
19067,2020-10-01,8025,7728,297,3.7
19069,2020-10-01,5506,5374,132,2.4
19071,2020-10-01,3705,3630,75,2
19073,2020-10-01,5288,5144,144,2.7
19075,2020-10-01,6187,6022,165,2.7
19077,2020-10-01,5332,5166,166,3.1
19079,2020-10-01,6668,6489,179,2.7
19081,2020-10-01,5650,5493,157,2.8
19083,2020-10-01,7581,7364,217,2.9
19085,2020-10-01,6937,6752,185,2.7
19087,2020-10-01,9594,9297,297,3.1
19089,2020-10-01,4938,4799,139,2.8
19091,2020-10-01,4861,4742,119,2.4
19093,2020-10-01,3863,3773,90,2.3
19095,2020-10-01,9751,9494,257,2.6
19097,2020-10-01,10291,9889,402,3.9
19099,2020-10-01,18693,18058,635,3.4
19101,2020-10-01,9405,9012,393,4.2
19103,2020-10-01,82619,79838,2781,3.4
19105,2020-10-01,9952,9643,309,3.1
19107,2020-10-01,5058,4917,141,2.8
19109,2020-10-01,7869,7693,176,2.2
19111,2020-10-01,15321,14645,676,4.4
19113,2020-10-01,116110,110925,5185,4.5
19115,2020-10-01,5857,5685,172,2.9
19117,2020-10-01,4636,4530,106,2.3
19119,2020-10-01,6760,6665,95,1.4
19121,2020-10-01,8182,7907,275,3.4
19123,2020-10-01,11631,11291,340,2.9
19125,2020-10-01,17660,17214,446,2.5
19127,2020-10-01,16902,16162,740,4.4
19129,2020-10-01,7015,6843,172,2.5
19131,2020-10-01,6000,5858,142,2.4
19133,2020-10-01,4258,4150,108,2.5
19135,2020-10-01,3799,3675,124,3.3
19137,2020-10-01,4725,4572,153,3.2
19139,2020-10-01,20174,19379,795,3.9
19141,2020-10-01,7904,7735,169,2.1
19143,2020-10-01,3446,3386,60,1.7
19145,2020-10-01,6015,5837,178,3
19147,2020-10-01,4360,4236,124,2.8
19149,2020-10-01,14171,13840,331,2.3
19151,2020-10-01,4221,4126,95,2.3
19153,2020-10-01,260574,250204,10370,4
19155,2020-10-01,46099,44576,1523,3.3
19157,2020-10-01,9460,9179,281,3
19159,2020-10-01,2360,2306,54,2.3
19161,2020-10-01,5065,4956,109,2.2
19163,2020-10-01,84741,80696,4045,4.8
19165,2020-10-01,6136,6004,132,2.2
19167,2020-10-01,20718,20427,291,1.4
19169,2020-10-01,56810,55531,1279,2.3
19171,2020-10-01,8941,8641,300,3.4
19173,2020-10-01,2996,2926,70,2.3
19175,2020-10-01,5956,5732,224,3.8
19177,2020-10-01,3616,3519,97,2.7
19179,2020-10-01,16916,16169,747,4.4
19181,2020-10-01,27206,26453,753,2.8
19183,2020-10-01,11281,10997,284,2.5
19185,2020-10-01,2751,2671,80,2.9
19187,2020-10-01,18151,17520,631,3.5
19189,2020-10-01,4829,4657,172,3.6
19191,2020-10-01,11103,10814,289,2.6
19193,2020-10-01,53689,51882,1807,3.4
19195,2020-10-01,3931,3820,111,2.8
19197,2020-10-01,6658,6473,185,2.8
20001,2020-10-01,6469,6223,246,3.8
20003,2020-10-01,4379,4254,125,2.9
20005,2020-10-01,6864,6540,324,4.7
20007,2020-10-01,2379,2325,54,2.3
20009,2020-10-01,13636,13158,478,3.5
20011,2020-10-01,6867,6579,288,4.2
20013,2020-10-01,5240,5087,153,2.9
20015,2020-10-01,32605,31141,1464,4.5
20017,2020-10-01,1480,1418,62,4.2
20019,2020-10-01,1521,1450,71,4.7
20021,2020-10-01,10071,9729,342,3.4
20023,2020-10-01,1385,1363,22,1.6
20025,2020-10-01,1194,1176,18,1.5
20027,2020-10-01,3965,3838,127,3.2
20029,2020-10-01,3975,3858,117,2.9
20031,2020-10-01,4010,3885,125,3.1
20033,2020-10-01,881,861,20,2.3
20035,2020-10-01,16952,16190,762,4.5
20037,2020-10-01,19103,18337,766,4
20039,2020-10-01,1267,1232,35,2.8
20041,2020-10-01,9058,8765,293,3.2
20043,2020-10-01,4199,4089,110,2.6
20045,2020-10-01,65002,62253,2749,4.2
20047,2020-10-01,1513,1479,34,2.2
20049,2020-10-01,1207,1166,41,3.4
20051,2020-10-01,17047,16642,405,2.4
20053,2020-10-01,2819,2748,71,2.5
20055,2020-10-01,20994,20447,547,2.6
20057,2020-10-01,17455,16988,467,2.7
20059,2020-10-01,14362,13808,554,3.9
20061,2020-10-01,11686,11087,599,5.1
20063,2020-10-01,1535,1507,28,1.8
20065,2020-10-01,1102,1058,44,4
20067,2020-10-01,3165,3052,113,3.6
20069,2020-10-01,3509,3451,58,1.7
20071,2020-10-01,875,862,13,1.5
20073,2020-10-01,3224,3109,115,3.6
20075,2020-10-01,1738,1709,29,1.7
20077,2020-10-01,2830,2722,108,3.8
20079,2020-10-01,17046,16436,610,3.6
20081,2020-10-01,2349,2308,41,1.7
20083,2020-10-01,1048,1028,20,1.9
20085,2020-10-01,7201,6985,216,3
20087,2020-10-01,10294,9952,342,3.3
20089,2020-10-01,1300,1275,25,1.9
20091,2020-10-01,344127,331835,12292,3.6
20093,2020-10-01,2118,2079,39,1.8
20095,2020-10-01,3420,3294,126,3.7
20097,2020-10-01,1314,1285,29,2.2
20099,2020-10-01,9714,9312,402,4.1
20101,2020-10-01,822,806,16,1.9
20103,2020-10-01,36804,35420,1384,3.8
20105,2020-10-01,1841,1801,40,2.2
20107,2020-10-01,4398,4190,208,4.7
20109,2020-10-01,1697,1667,30,1.8
20111,2020-10-01,16727,16162,565,3.4
20113,2020-10-01,17347,16899,448,2.6
20115,2020-10-01,5927,5756,171,2.9
20117,2020-10-01,5577,5465,112,2
20119,2020-10-01,2239,2195,44,2
20121,2020-10-01,17804,17186,618,3.5
20123,2020-10-01,3523,3451,72,2
20125,2020-10-01,14702,13923,779,5.3
20127,2020-10-01,3202,3108,94,2.9
20129,2020-10-01,1195,1168,27,2.3
20131,2020-10-01,5728,5613,115,2
20133,2020-10-01,6312,6004,308,4.9
20135,2020-10-01,1364,1330,34,2.5
20137,2020-10-01,2677,2623,54,2
20139,2020-10-01,8069,7794,275,3.4
20141,2020-10-01,2014,1973,41,2
20143,2020-10-01,3081,2982,99,3.2
20145,2020-10-01,2930,2852,78,2.7
20147,2020-10-01,2749,2684,65,2.4
20149,2020-10-01,12159,11797,362,3
20151,2020-10-01,5008,4878,130,2.6
20153,2020-10-01,1600,1566,34,2.1
20155,2020-10-01,29474,28275,1199,4.1
20157,2020-10-01,2380,2323,57,2.4
20159,2020-10-01,5173,5014,159,3.1
20161,2020-10-01,34410,33215,1195,3.5
20163,2020-10-01,2562,2482,80,3.1
20165,2020-10-01,1599,1544,55,3.4
20167,2020-10-01,3392,3292,100,2.9
20169,2020-10-01,29644,28491,1153,3.9
20171,2020-10-01,2966,2912,54,1.8
20173,2020-10-01,255932,239985,15947,6.2
20175,2020-10-01,9921,9575,346,3.5
20177,2020-10-01,91441,87676,3765,4.1
20179,2020-10-01,1527,1502,25,1.6
20181,2020-10-01,2978,2902,76,2.6
20183,2020-10-01,2116,2075,41,1.9
20185,2020-10-01,2134,2067,67,3.1
20187,2020-10-01,1150,1128,22,1.9
20189,2020-10-01,2917,2855,62,2.1
20191,2020-10-01,11040,10422,618,5.6
20193,2020-10-01,4378,4284,94,2.1
20195,2020-10-01,1496,1463,33,2.2
20197,2020-10-01,3755,3644,111,3
20199,2020-10-01,871,855,16,1.8
20201,2020-10-01,3221,3168,53,1.6
20203,2020-10-01,1326,1302,24,1.8
20205,2020-10-01,3958,3751,207,5.2
20207,2020-10-01,1542,1477,65,4.2
20209,2020-10-01,78092,73961,4131,5.3
21001,2020-10-01,6831,6495,336,4.9
21003,2020-10-01,8751,8417,334,3.8
21005,2020-10-01,11438,10930,508,4.4
21007,2020-10-01,3254,3096,158,4.9
21009,2020-10-01,17698,16656,1042,5.9
21011,2020-10-01,4469,4228,241,5.4
21013,2020-10-01,8095,7644,451,5.6
21015,2020-10-01,68648,65839,2809,4.1
21017,2020-10-01,9598,9229,369,3.8
21019,2020-10-01,16979,15983,996,5.9
21021,2020-10-01,12185,11526,659,5.4
21023,2020-10-01,3667,3508,159,4.3
21025,2020-10-01,3154,2922,232,7.4
21027,2020-10-01,7720,7323,397,5.1
21029,2020-10-01,40730,39028,1702,4.2
21031,2020-10-01,4897,4671,226,4.6
21033,2020-10-01,5500,5259,241,4.4
21035,2020-10-01,17390,16575,815,4.7
21037,2020-10-01,48586,46553,2033,4.2
21039,2020-10-01,2134,2057,77,3.6
21041,2020-10-01,5120,4898,222,4.3
21043,2020-10-01,9261,8693,568,6.1
21045,2020-10-01,6515,6255,260,4
21047,2020-10-01,24172,22881,1291,5.3
21049,2020-10-01,16762,15936,826,4.9
21051,2020-10-01,5026,4670,356,7.1
21053,2020-10-01,3903,3764,139,3.6
21055,2020-10-01,3587,3445,142,4
21057,2020-10-01,3221,3120,101,3.1
21059,2020-10-01,44522,42508,2014,4.5
21061,2020-10-01,4516,4294,222,4.9
21063,2020-10-01,1899,1772,127,6.7
21065,2020-10-01,5032,4765,267,5.3
21067,2020-10-01,170371,162748,7623,4.5
21069,2020-10-01,6024,5749,275,4.6
21071,2020-10-01,10332,9535,797,7.7
21073,2020-10-01,24178,22898,1280,5.3
21075,2020-10-01,1937,1836,101,5.2
21077,2020-10-01,3957,3770,187,4.7
21079,2020-10-01,7342,7009,333,4.5
21081,2020-10-01,11225,10659,566,5
21083,2020-10-01,15283,14583,700,4.6
21085,2020-10-01,10346,9748,598,5.8
21087,2020-10-01,5002,4809,193,3.9
21089,2020-10-01,12788,12005,783,6.1
21091,2020-10-01,3693,3543,150,4.1
21093,2020-10-01,45910,43676,2234,4.9
21095,2020-10-01,6194,5612,582,9.4
21097,2020-10-01,8503,8166,337,4
21099,2020-10-01,7459,7148,311,4.2
21101,2020-10-01,20441,19531,910,4.5
21103,2020-10-01,7897,7613,284,3.6
21105,2020-10-01,1736,1668,68,3.9
21107,2020-10-01,17606,16738,868,4.9
21109,2020-10-01,3887,3638,249,6.4
21111,2020-10-01,381044,360545,20499,5.4
21113,2020-10-01,25851,24725,1126,4.4
21115,2020-10-01,6306,5854,452,7.2
21117,2020-10-01,84265,80511,3754,4.5
21119,2020-10-01,4226,3928,298,7.1
21121,2020-10-01,9708,9108,600,6.2
21123,2020-10-01,5657,5383,274,4.8
21125,2020-10-01,24199,23033,1166,4.8
21127,2020-10-01,4993,4693,300,6
21129,2020-10-01,1967,1871,96,4.9
21131,2020-10-01,2520,2314,206,8.2
21133,2020-10-01,5903,5408,495,8.4
21135,2020-10-01,4395,4144,251,5.7
21137,2020-10-01,9063,8521,542,6
21139,2020-10-01,3406,3214,192,5.6
21141,2020-10-01,11842,11414,428,3.6
21143,2020-10-01,3089,2966,123,4
21145,2020-10-01,27415,25949,1466,5.3
21147,2020-10-01,4757,4514,243,5.1
21149,2020-10-01,3956,3795,161,4.1
21151,2020-10-01,45109,43171,1938,4.3
21153,2020-10-01,3044,2672,372,12.2
21155,2020-10-01,8999,8599,400,4.4
21157,2020-10-01,14343,13706,637,4.4
21159,2020-10-01,2368,2143,225,9.5
21161,2020-10-01,6740,6372,368,5.5
21163,2020-10-01,11388,10810,578,5.1
21165,2020-10-01,2206,2058,148,6.7
21167,2020-10-01,9630,9156,474,4.9
21169,2020-10-01,3915,3703,212,5.4
21171,2020-10-01,4490,4328,162,3.6
21173,2020-10-01,11077,10472,605,5.5
21175,2020-10-01,4201,3993,208,5
21177,2020-10-01,9582,8945,637,6.6
21179,2020-10-01,22176,21274,902,4.1
21181,2020-10-01,3228,3098,130,4
21183,2020-10-01,8878,8412,466,5.2
21185,2020-10-01,31725,30654,1071,3.4
21187,2020-10-01,5016,4776,240,4.8
21189,2020-10-01,1040,980,60,5.8
21191,2020-10-01,6669,6423,246,3.7
21193,2020-10-01,7900,7337,563,7.1
21195,2020-10-01,18609,17334,1275,6.9
21197,2020-10-01,4975,4711,264,5.3
21199,2020-10-01,25175,23879,1296,5.1
21201,2020-10-01,778,745,33,4.2
21203,2020-10-01,6300,5985,315,5
21205,2020-10-01,9777,9280,497,5.1
21207,2020-10-01,5910,5599,311,5.3
21209,2020-10-01,28685,27599,1086,3.8
21211,2020-10-01,24684,23753,931,3.8
21213,2020-10-01,8532,8150,382,4.5
21215,2020-10-01,9950,9591,359,3.6
21217,2020-10-01,12604,12141,463,3.7
21219,2020-10-01,5324,5156,168,3.2
21221,2020-10-01,5977,5696,281,4.7
21223,2020-10-01,3709,3526,183,4.9
21225,2020-10-01,5857,5629,228,3.9
21227,2020-10-01,62576,59632,2944,4.7
21229,2020-10-01,6015,5793,222,3.7
21231,2020-10-01,7255,6911,344,4.7
21233,2020-10-01,5290,5057,233,4.4
21235,2020-10-01,13507,12740,767,5.7
21237,2020-10-01,2012,1906,106,5.3
21239,2020-10-01,15016,14469,547,3.6
22001,2020-10-01,23586,22076,1510,6.4
22003,2020-10-01,8293,7661,632,7.6
22005,2020-10-01,65514,61913,3601,5.5
22007,2020-10-01,9009,8211,798,8.9
22009,2020-10-01,15190,14214,976,6.4
22011,2020-10-01,14328,13531,797,5.6
22013,2020-10-01,5488,5107,381,6.9
22015,2020-10-01,57195,54102,3093,5.4
22017,2020-10-01,103788,95041,8747,8.4
22019,2020-10-01,92827,83533,9294,10
22021,2020-10-01,3696,3486,210,5.7
22023,2020-10-01,3297,3111,186,5.6
22025,2020-10-01,3602,3381,221,6.1
22027,2020-10-01,5640,5313,327,5.8
22029,2020-10-01,7076,6606,470,6.6
22031,2020-10-01,10719,10046,673,6.3
22033,2020-10-01,234560,218607,15953,6.8
22035,2020-10-01,1877,1688,189,10.1
22037,2020-10-01,7975,7510,465,5.8
22039,2020-10-01,11995,11178,817,6.8
22041,2020-10-01,7535,7031,504,6.7
22043,2020-10-01,8313,7885,428,5.1
22045,2020-10-01,28151,25639,2512,8.9
22047,2020-10-01,14394,13081,1313,9.1
22049,2020-10-01,6777,6474,303,4.5
22051,2020-10-01,211582,193617,17965,8.5
22053,2020-10-01,12699,11833,866,6.8
22055,2020-10-01,113624,106709,6915,6.1
22057,2020-10-01,41945,39588,2357,5.6
22059,2020-10-01,7007,6725,282,4
22061,2020-10-01,20981,19873,1108,5.3
22063,2020-10-01,69713,66180,3533,5.1
22065,2020-10-01,3674,3428,246,6.7
22067,2020-10-01,10281,9399,882,8.6
22069,2020-10-01,16169,15210,959,5.9
22071,2020-10-01,183819,161183,22636,12.3
22073,2020-10-01,71012,66463,4549,6.4
22075,2020-10-01,9655,9113,542,5.6
22077,2020-10-01,9915,9259,656,6.6
22079,2020-10-01,56369,53363,3006,5.3
22081,2020-10-01,3684,3481,203,5.5
22083,2020-10-01,8228,7703,525,6.4
22085,2020-10-01,9419,8980,439,4.7
22087,2020-10-01,20146,18194,1952,9.7
22089,2020-10-01,24588,22916,1672,6.8
22091,2020-10-01,4424,3949,475,10.7
22093,2020-10-01,9087,8255,832,9.2
22095,2020-10-01,19583,17432,2151,11
22097,2020-10-01,32779,30204,2575,7.9
22099,2020-10-01,22086,20481,1605,7.3
22101,2020-10-01,19535,17865,1670,8.5
22103,2020-10-01,115837,109635,6202,5.4
22105,2020-10-01,57853,53139,4714,8.1
22107,2020-10-01,1415,1324,91,6.4
22109,2020-10-01,46855,43594,3261,7
22111,2020-10-01,9177,8617,560,6.1
22113,2020-10-01,23847,22289,1558,6.5
22115,2020-10-01,15751,14899,852,5.4
22117,2020-10-01,16988,15743,1245,7.3
22119,2020-10-01,14207,13215,992,7
22121,2020-10-01,13837,12966,871,6.3
22123,2020-10-01,3631,3373,258,7.1
22125,2020-10-01,5439,5182,257,4.7
22127,2020-10-01,4730,4438,292,6.2
23001,2020-10-01,54029,51616,2413,4.5
23003,2020-10-01,28299,27105,1194,4.2
23005,2020-10-01,160247,153687,6560,4.1
23007,2020-10-01,13504,12911,593,4.4
23009,2020-10-01,27650,26626,1024,3.7
23011,2020-10-01,60311,57964,2347,3.9
23013,2020-10-01,18960,18226,734,3.9
23015,2020-10-01,16105,15479,626,3.9
23017,2020-10-01,25146,23771,1375,5.5
23019,2020-10-01,74308,71300,3008,4
23021,2020-10-01,7105,6768,337,4.7
23023,2020-10-01,19043,18361,682,3.6
23025,2020-10-01,21545,20446,1099,5.1
23027,2020-10-01,19688,18907,781,4
23029,2020-10-01,12928,12303,625,4.8
23031,2020-10-01,110518,105798,4720,4.3
24001,2020-10-01,30192,28360,1832,6.1
24003,2020-10-01,304571,288669,15902,5.2
24005,2020-10-01,437909,410143,27766,6.3
24009,2020-10-01,47440,45223,2217,4.7
24011,2020-10-01,16816,15966,850,5.1
24013,2020-10-01,90748,86948,3800,4.2
24015,2020-10-01,51393,48794,2599,5.1
24017,2020-10-01,84251,78840,5411,6.4
24019,2020-10-01,14557,13634,923,6.3
24021,2020-10-01,128814,121916,6898,5.4
24023,2020-10-01,14409,13708,701,4.9
24025,2020-10-01,135032,128507,6525,4.8
24027,2020-10-01,181478,172830,8648,4.8
24029,2020-10-01,9254,8749,505,5.5
24031,2020-10-01,538771,504000,34771,6.5
24033,2020-10-01,498935,454783,44152,8.8
24035,2020-10-01,26380,25204,1176,4.5
24037,2020-10-01,56131,53816,2315,4.1
24039,2020-10-01,8551,7937,614,7.2
24041,2020-10-01,17608,16728,880,5
24043,2020-10-01,71165,67136,4029,5.7
24045,2020-10-01,49296,46249,3047,6.2
24047,2020-10-01,24302,22494,1808,7.4
24510,2020-10-01,277201,253221,23980,8.7
25001,2020-10-01,108086,99608,8478,7.8
25003,2020-10-01,61802,56795,5007,8.1
25005,2020-10-01,294074,269822,24252,8.2
25007,2020-10-01,9175,8580,595,6.5
25009,2020-10-01,417501,380246,37255,8.9
25011,2020-10-01,39903,37298,2605,6.5
25013,2020-10-01,221632,200698,20934,9.4
25015,2020-10-01,86709,80828,5881,6.8
25017,2020-10-01,889965,827323,62642,7
25019,2020-10-01,7649,7179,470,6.1
25021,2020-10-01,381662,351969,29693,7.8
25023,2020-10-01,276715,254039,22676,8.2
25025,2020-10-01,448364,407256,41108,9.2
25027,2020-10-01,432678,397884,34794,8
26001,2020-10-01,3912,3662,250,6.4
26003,2020-10-01,3095,2899,196,6.3
26005,2020-10-01,61583,58871,2712,4.4
26007,2020-10-01,13204,12582,622,4.7
26009,2020-10-01,10231,9663,568,5.6
26011,2020-10-01,5812,5449,363,6.2
26013,2020-10-01,3126,2902,224,7.2
26015,2020-10-01,30989,29630,1359,4.4
26017,2020-10-01,48723,45940,2783,5.7
26019,2020-10-01,8564,8155,409,4.8
26021,2020-10-01,72122,67853,4269,5.9
26023,2020-10-01,19625,18606,1019,5.2
26025,2020-10-01,60875,56812,4063,6.7
26027,2020-10-01,23899,22539,1360,5.7
26029,2020-10-01,12581,11966,615,4.9
26031,2020-10-01,10002,9422,580,5.8
26033,2020-10-01,16127,15301,826,5.1
26035,2020-10-01,11719,10849,870,7.4
26037,2020-10-01,39574,38001,1573,4
26039,2020-10-01,5614,5273,341,6.1
26041,2020-10-01,16827,15940,887,5.3
26043,2020-10-01,12155,11571,584,4.8
26045,2020-10-01,55065,52416,2649,4.8
26047,2020-10-01,16987,16120,867,5.1
26049,2020-10-01,178038,165041,12997,7.3
26051,2020-10-01,9877,9285,592,6
26053,2020-10-01,5800,5453,347,6
26055,2020-10-01,48948,46643,2305,4.7
26057,2020-10-01,17737,16862,875,4.9
26059,2020-10-01,19930,18886,1044,5.2
26061,2020-10-01,16085,15368,717,4.5
26063,2020-10-01,15493,14852,641,4.1
26065,2020-10-01,145621,137599,8022,5.5
26067,2020-10-01,30307,28953,1354,4.5
26069,2020-10-01,10044,9428,616,6.1
26071,2020-10-01,4968,4712,256,5.2
26073,2020-10-01,32692,31027,1665,5.1
26075,2020-10-01,72629,68315,4314,5.9
26077,2020-10-01,131384,124473,6911,5.3
26079,2020-10-01,7801,7308,493,6.3
26081,2020-10-01,354126,336160,17966,5.1
26083,2020-10-01,881,838,43,4.9
26085,2020-10-01,3994,3685,309,7.7
26087,2020-10-01,39775,36756,3019,7.6
26089,2020-10-01,10291,9842,449,4.4
26091,2020-10-01,45087,42663,2424,5.4
26093,2020-10-01,101040,94947,6093,6
26095,2020-10-01,2263,2152,111,4.9
26097,2020-10-01,5338,5128,210,3.9
26099,2020-10-01,443612,404152,39460,8.9
26101,2020-10-01,10284,9679,605,5.9
26103,2020-10-01,31376,29946,1430,4.6
26105,2020-10-01,13334,12570,764,5.7
26107,2020-10-01,18533,17498,1035,5.6
26109,2020-10-01,10762,10226,536,5
26111,2020-10-01,39563,37699,1864,4.7
26113,2020-10-01,6940,6611,329,4.7
26115,2020-10-01,73470,69148,4322,5.9
26117,2020-10-01,27579,26095,1484,5.4
26119,2020-10-01,3003,2781,222,7.4
26121,2020-10-01,75926,69832,6094,8
26123,2020-10-01,23138,21930,1208,5.2
26125,2020-10-01,663580,614939,48641,7.3
26127,2020-10-01,12031,11269,762,6.3
26129,2020-10-01,8004,7505,499,6.2
26131,2020-10-01,2028,1900,128,6.3
26133,2020-10-01,11653,11104,549,4.7
26135,2020-10-01,2954,2752,202,6.8
26137,2020-10-01,11523,10851,672,5.8
26139,2020-10-01,157425,151018,6407,4.1
26141,2020-10-01,4900,4609,291,5.9
26143,2020-10-01,7790,7244,546,7
26145,2020-10-01,84068,78499,5569,6.6
26147,2020-10-01,73857,68004,5853,7.9
26149,2020-10-01,28535,26987,1548,5.4
26151,2020-10-01,19293,18338,955,4.9
26153,2020-10-01,3208,3038,170,5.3
26155,2020-10-01,32183,30514,1669,5.2
26157,2020-10-01,23295,22034,1261,5.4
26159,2020-10-01,34557,32720,1837,5.3
26161,2020-10-01,193087,184050,9037,4.7
26163,2020-10-01,814769,714667,100102,12.3
26165,2020-10-01,14821,13998,823,5.6
27001,2020-10-01,7479,7125,354,4.7
27003,2020-10-01,194726,185443,9283,4.8
27005,2020-10-01,18550,17861,689,3.7
27007,2020-10-01,24708,23671,1037,4.2
27009,2020-10-01,21967,20945,1022,4.7
27011,2020-10-01,2609,2546,63,2.4
27013,2020-10-01,40651,39193,1458,3.6
27015,2020-10-01,14346,13877,469,3.3
27017,2020-10-01,17452,16650,802,4.6
27019,2020-10-01,58132,55787,2345,4
27021,2020-10-01,13846,13073,773,5.6
27023,2020-10-01,6842,6609,233,3.4
27025,2020-10-01,29495,28166,1329,4.5
27027,2020-10-01,36383,35294,1089,3
27029,2020-10-01,4465,4264,201,4.5
27031,2020-10-01,2894,2770,124,4.3
27033,2020-10-01,6620,6318,302,4.6
27035,2020-10-01,31900,30482,1418,4.4
27037,2020-10-01,238024,226992,11032,4.6
27039,2020-10-01,12238,11642,596,4.9
27041,2020-10-01,21146,20535,611,2.9
27043,2020-10-01,7283,6978,305,4.2
27045,2020-10-01,11848,11466,382,3.2
27047,2020-10-01,16394,15767,627,3.8
27049,2020-10-01,26461,25489,972,3.7
27051,2020-10-01,3453,3344,109,3.2
27053,2020-10-01,699714,662523,37191,5.3
27055,2020-10-01,10404,10141,263,2.5
27057,2020-10-01,9766,9365,401,4.1
27059,2020-10-01,20977,20003,974,4.6
27061,2020-10-01,21836,20482,1354,6.2
27063,2020-10-01,6001,5705,296,4.9
27065,2020-10-01,9052,8638,414,4.6
27067,2020-10-01,24846,23997,849,3.4
27069,2020-10-01,2519,2430,89,3.5
27071,2020-10-01,5610,5337,273,4.9
27073,2020-10-01,3696,3578,118,3.2
27075,2020-10-01,5173,4967,206,4
27077,2020-10-01,2385,2295,90,3.8
27079,2020-10-01,15883,15255,628,4
27081,2020-10-01,3256,3172,84,2.6
27083,2020-10-01,14390,13950,440,3.1
27085,2020-10-01,19094,18304,790,4.1
27087,2020-10-01,2115,1937,178,8.4
27089,2020-10-01,5611,5449,162,2.9
27091,2020-10-01,10142,9660,482,4.8
27093,2020-10-01,13230,12802,428,3.2
27095,2020-10-01,12595,11901,694,5.5
27097,2020-10-01,18061,17301,760,4.2
27099,2020-10-01,21037,20168,869,4.1
27101,2020-10-01,4997,4834,163,3.3
27103,2020-10-01,21038,20347,691,3.3
27105,2020-10-01,11977,11512,465,3.9
27107,2020-10-01,3396,3261,135,4
27109,2020-10-01,90368,86628,3740,4.1
27111,2020-10-01,31392,30380,1012,3.2
27113,2020-10-01,8605,8322,283,3.3
27115,2020-10-01,14295,13558,737,5.2
27117,2020-10-01,4758,4643,115,2.4
27119,2020-10-01,16841,16198,643,3.8
27121,2020-10-01,6588,6390,198,3
27123,2020-10-01,285607,269700,15907,5.6
27125,2020-10-01,2264,2185,79,3.5
27127,2020-10-01,7856,7563,293,3.7
27129,2020-10-01,9337,9044,293,3.1
27131,2020-10-01,36681,35333,1348,3.7
27133,2020-10-01,6027,5903,124,2.1
27135,2020-10-01,7813,7552,261,3.3
27137,2020-10-01,99820,94824,4996,5
27139,2020-10-01,82440,78845,3595,4.4
27141,2020-10-01,51367,49255,2112,4.1
27143,2020-10-01,8523,8207,316,3.7
27145,2020-10-01,91071,87290,3781,4.2
27147,2020-10-01,20555,19717,838,4.1
27149,2020-10-01,5668,5546,122,2.2
27151,2020-10-01,4981,4788,193,3.9
27153,2020-10-01,13955,13452,503,3.6
27155,2020-10-01,1820,1776,44,2.4
27157,2020-10-01,12539,12157,382,3
27159,2020-10-01,6013,5711,302,5
27161,2020-10-01,9215,8819,396,4.3
27163,2020-10-01,141089,135389,5700,4
27165,2020-10-01,6922,6701,221,3.2
27167,2020-10-01,3622,3524,98,2.7
27169,2020-10-01,28133,27172,961,3.4
27171,2020-10-01,74473,71677,2796,3.8
27173,2020-10-01,5436,5276,160,2.9
28001,2020-10-01,10634,9599,1035,9.7
28003,2020-10-01,15228,14511,717,4.7
28005,2020-10-01,4385,4049,336,7.7
28007,2020-10-01,6849,6375,474,6.9
28009,2020-10-01,3007,2809,198,6.6
28011,2020-10-01,11246,10421,825,7.3
28013,2020-10-01,5292,4996,296,5.6
28015,2020-10-01,3372,3161,211,6.3
28017,2020-10-01,6894,6392,502,7.3
28019,2020-10-01,3518,3341,177,5
28021,2020-10-01,3023,2658,365,12.1
28023,2020-10-01,5783,5392,391,6.8
28025,2020-10-01,7800,7101,699,9
28027,2020-10-01,8026,7186,840,10.5
28029,2020-10-01,10740,10006,734,6.8
28031,2020-10-01,8434,7905,529,6.3
28033,2020-10-01,91404,87279,4125,4.5
28035,2020-10-01,33520,31351,2169,6.5
28037,2020-10-01,2760,2569,191,6.9
28039,2020-10-01,8846,8243,603,6.8
28041,2020-10-01,4189,3873,316,7.5
28043,2020-10-01,9235,8704,531,5.7
28045,2020-10-01,18971,17756,1215,6.4
28047,2020-10-01,87593,81977,5616,6.4
28049,2020-10-01,104733,97061,7672,7.3
28051,2020-10-01,5274,4587,687,13
28053,2020-10-01,2045,1777,268,13.1
28055,2020-10-01,304,281,23,7.6
28057,2020-10-01,10323,9870,453,4.4
28059,2020-10-01,58624,54718,3906,6.7
28061,2020-10-01,5929,5470,459,7.7
28063,2020-10-01,1876,1587,289,15.4
28065,2020-10-01,4001,3672,329,8.2
28067,2020-10-01,25206,23666,1540,6.1
28069,2020-10-01,3310,3050,260,7.9
28071,2020-10-01,27202,26075,1127,4.1
28073,2020-10-01,31159,29741,1418,4.6
28075,2020-10-01,29522,27756,1766,6
28077,2020-10-01,4636,4298,338,7.3
28079,2020-10-01,7826,7360,466,6
28081,2020-10-01,41590,39313,2277,5.5
28083,2020-10-01,9640,8755,885,9.2
28085,2020-10-01,14547,13718,829,5.7
28087,2020-10-01,25177,23528,1649,6.5
28089,2020-10-01,52555,50197,2358,4.5
28091,2020-10-01,10328,9716,612,5.9
28093,2020-10-01,14247,13372,875,6.1
28095,2020-10-01,15771,14768,1003,6.4
28097,2020-10-01,3839,3586,253,6.6
28099,2020-10-01,9833,9238,595,6.1
28101,2020-10-01,7892,7422,470,6
28103,2020-10-01,3782,3418,364,9.6
28105,2020-10-01,22648,21378,1270,5.6
28107,2020-10-01,12627,11572,1055,8.4
28109,2020-10-01,23317,21876,1441,6.2
28111,2020-10-01,4271,3980,291,6.8
28113,2020-10-01,14647,13489,1158,7.9
28115,2020-10-01,14902,14201,701,4.7
28117,2020-10-01,11134,10593,541,4.9
28119,2020-10-01,2241,2024,217,9.7
28121,2020-10-01,75020,72206,2814,3.8
28123,2020-10-01,12701,12103,598,4.7
28125,2020-10-01,1373,1243,130,9.5
28127,2020-10-01,10491,9885,606,5.8
28129,2020-10-01,6561,6240,321,4.9
28131,2020-10-01,7110,6714,396,5.6
28133,2020-10-01,7163,6417,746,10.4
28135,2020-10-01,4965,4644,321,6.5
28137,2020-10-01,12010,11251,759,6.3
28139,2020-10-01,9460,9011,449,4.7
28141,2020-10-01,8287,7920,367,4.4
28143,2020-10-01,4441,3909,532,12
28145,2020-10-01,14017,13374,643,4.6
28147,2020-10-01,4968,4603,365,7.3
28149,2020-10-01,19896,18540,1356,6.8
28151,2020-10-01,15881,14355,1526,9.6
28153,2020-10-01,7243,6658,585,8.1
28155,2020-10-01,3920,3696,224,5.7
28157,2020-10-01,2808,2425,383,13.6
28159,2020-10-01,7155,6639,516,7.2
28161,2020-10-01,4880,4598,282,5.8
28163,2020-10-01,9699,8951,748,7.7
29001,2020-10-01,10232,9899,333,3.3
29003,2020-10-01,9854,9609,245,2.5
29005,2020-10-01,2819,2758,61,2.2
29007,2020-10-01,10371,10034,337,3.2
29009,2020-10-01,15729,15074,655,4.2
29011,2020-10-01,5341,5181,160,3
29013,2020-10-01,7728,7459,269,3.5
29015,2020-10-01,7333,6997,336,4.6
29017,2020-10-01,5495,5297,198,3.6
29019,2020-10-01,98050,95370,2680,2.7
29021,2020-10-01,44088,42571,1517,3.4
29023,2020-10-01,18289,17560,729,4
29025,2020-10-01,4307,4172,135,3.1
29027,2020-10-01,21536,20942,594,2.8
29029,2020-10-01,18803,18102,701,3.7
29031,2020-10-01,40691,39386,1305,3.2
29033,2020-10-01,4973,4571,402,8.1
29035,2020-10-01,2524,2425,99,3.9
29037,2020-10-01,54065,52137,1928,3.6
29039,2020-10-01,5921,5753,168,2.8
29041,2020-10-01,3914,3817,97,2.5
29043,2020-10-01,45571,44250,1321,2.9
29045,2020-10-01,3206,3080,126,3.9
29047,2020-10-01,135396,130218,5178,3.8
29049,2020-10-01,10528,10143,385,3.7
29051,2020-10-01,39404,38355,1049,2.7
29053,2020-10-01,7298,7068,230,3.2
29055,2020-10-01,10872,10429,443,4.1
29057,2020-10-01,3660,3563,97,2.7
29059,2020-10-01,7096,6851,245,3.5
29061,2020-10-01,4270,4148,122,2.9
29063,2020-10-01,4852,4723,129,2.7
29065,2020-10-01,6492,6270,222,3.4
29067,2020-10-01,5248,5046,202,3.8
29069,2020-10-01,11655,11093,562,4.8
29071,2020-10-01,52377,50381,1996,3.8
29073,2020-10-01,7709,7462,247,3.2
29075,2020-10-01,3494,3416,78,2.2
29077,2020-10-01,151491,146569,4922,3.2
29079,2020-10-01,4501,4341,160,3.6
29081,2020-10-01,3906,3798,108,2.8
29083,2020-10-01,9804,9439,365,3.7
29085,2020-10-01,4057,3929,128,3.2
29087,2020-10-01,2650,2596,54,2
29089,2020-10-01,4927,4799,128,2.6
29091,2020-10-01,16268,15482,786,4.8
29093,2020-10-01,3496,3330,166,4.7
29095,2020-10-01,358575,339826,18749,5.2
29097,2020-10-01,56744,54625,2119,3.7
29099,2020-10-01,116220,111728,4492,3.9
29101,2020-10-01,23339,22404,935,4
29103,2020-10-01,1806,1762,44,2.4
29105,2020-10-01,16573,15856,717,4.3
29107,2020-10-01,16629,16048,581,3.5
29109,2020-10-01,17933,17228,705,3.9
29111,2020-10-01,5044,4907,137,2.7
29113,2020-10-01,28508,27481,1027,3.6
29115,2020-10-01,5246,5049,197,3.8
29117,2020-10-01,7470,7281,189,2.5
29119,2020-10-01,10840,10448,392,3.6
29121,2020-10-01,7527,7315,212,2.8
29123,2020-10-01,5509,5279,230,4.2
29125,2020-10-01,3991,3858,133,3.3
29127,2020-10-01,14404,13974,430,3
29129,2020-10-01,1980,1941,39,2
29131,2020-10-01,12466,12058,408,3.3
29133,2020-10-01,5794,5560,234,4
29135,2020-10-01,7482,7286,196,2.6
29137,2020-10-01,3814,3688,126,3.3
29139,2020-10-01,5809,5647,162,2.8
29141,2020-10-01,8398,8090,308,3.7
29143,2020-10-01,8687,8346,341,3.9
29145,2020-10-01,26993,26027,966,3.6
29147,2020-10-01,10837,10538,299,2.8
29149,2020-10-01,4022,3829,193,4.8
29151,2020-10-01,7191,7045,146,2
29153,2020-10-01,3506,3347,159,4.5
29155,2020-10-01,6291,5904,387,6.2
29157,2020-10-01,9855,9618,237,2.4
29159,2020-10-01,20559,19739,820,4
29161,2020-10-01,20082,19431,651,3.2
29163,2020-10-01,7598,7361,237,3.1
29165,2020-10-01,58148,56154,1994,3.4
29167,2020-10-01,14613,14164,449,3.1
29169,2020-10-01,14545,13983,562,3.9
29171,2020-10-01,2339,2288,51,2.2
29173,2020-10-01,5680,5536,144,2.5
29175,2020-10-01,10274,9867,407,4
29177,2020-10-01,10823,10402,421,3.9
29179,2020-10-01,2921,2814,107,3.7
29181,2020-10-01,5022,4764,258,5.1
29183,2020-10-01,223707,216577,7130,3.2
29185,2020-10-01,3897,3746,151,3.9
29186,2020-10-01,9396,9109,287,3.1
29187,2020-10-01,26310,25098,1212,4.6
29189,2020-10-01,524316,500998,23318,4.4
29195,2020-10-01,10852,10555,297,2.7
29197,2020-10-01,1996,1938,58,2.9
29199,2020-10-01,2484,2441,43,1.7
29201,2020-10-01,20135,19377,758,3.8
29203,2020-10-01,3455,3307,148,4.3
29205,2020-10-01,3118,3036,82,2.6
29207,2020-10-01,13404,12925,479,3.6
29209,2020-10-01,13272,12631,641,4.8
29211,2020-10-01,2850,2754,96,3.4
29213,2020-10-01,25807,24350,1457,5.6
29215,2020-10-01,9221,8863,358,3.9
29217,2020-10-01,9739,9433,306,3.1
29219,2020-10-01,18136,17505,631,3.5
29221,2020-10-01,10179,9704,475,4.7
29223,2020-10-01,5102,4898,204,4
29225,2020-10-01,17481,16946,535,3.1
29227,2020-10-01,1216,1183,33,2.7
29229,2020-10-01,7523,7209,314,4.2
29510,2020-10-01,151526,141833,9693,6.4
30001,2020-10-01,5112,4966,146,2.9
30003,2020-10-01,4850,4590,260,5.4
30005,2020-10-01,2322,2238,84,3.6
30007,2020-10-01,2599,2474,125,4.8
30009,2020-10-01,5550,5307,243,4.4
30011,2020-10-01,698,680,18,2.6
30013,2020-10-01,37354,35743,1611,4.3
30015,2020-10-01,2523,2447,76,3
30017,2020-10-01,6186,5979,207,3.3
30019,2020-10-01,914,894,20,2.2
30021,2020-10-01,4676,4454,222,4.7
30023,2020-10-01,4954,4782,172,3.5
30025,2020-10-01,1663,1609,54,3.2
30027,2020-10-01,5890,5727,163,2.8
30029,2020-10-01,48270,45914,2356,4.9
30031,2020-10-01,70121,67680,2441,3.5
30033,2020-10-01,785,770,15,1.9
30035,2020-10-01,5189,4743,446,8.6
30037,2020-10-01,371,358,13,3.5
30039,2020-10-01,1561,1492,69,4.4
30041,2020-10-01,7598,7294,304,4
30043,2020-10-01,5768,5551,217,3.8
30045,2020-10-01,1038,999,39,3.8
30047,2020-10-01,13596,12994,602,4.4
30049,2020-10-01,36090,34867,1223,3.4
30051,2020-10-01,1029,1004,25,2.4
30053,2020-10-01,8001,7497,504,6.3
30055,2020-10-01,1015,991,24,2.4
30057,2020-10-01,4160,3996,164,3.9
30059,2020-10-01,972,936,36,3.7
30061,2020-10-01,1753,1645,108,6.2
30063,2020-10-01,63259,60589,2670,4.2
30065,2020-10-01,2329,2224,105,4.5
30067,2020-10-01,8908,8507,401,4.5
30069,2020-10-01,279,271,8,2.9
30071,2020-10-01,1944,1884,60,3.1
30073,2020-10-01,2752,2645,107,3.9
30075,2020-10-01,1047,1021,26,2.5
30077,2020-10-01,3022,2935,87,2.9
30079,2020-10-01,485,456,29,6
30081,2020-10-01,20862,20025,837,4
30083,2020-10-01,5955,5646,309,5.2
30085,2020-10-01,4477,4272,205,4.6
30087,2020-10-01,3749,3578,171,4.6
30089,2020-10-01,5119,4857,262,5.1
30091,2020-10-01,1818,1745,73,4
30093,2020-10-01,17061,16275,786,4.6
30095,2020-10-01,5374,5170,204,3.8
30097,2020-10-01,1926,1877,49,2.5
30099,2020-10-01,2805,2721,84,3
30101,2020-10-01,2187,2099,88,4
30103,2020-10-01,355,342,13,3.7
30105,2020-10-01,4114,3982,132,3.2
30107,2020-10-01,778,740,38,4.9
30109,2020-10-01,468,449,19,4.1
30111,2020-10-01,82168,78918,3250,4
31001,2020-10-01,16768,16342,426,2.5
31003,2020-10-01,3813,3732,81,2.1
31005,2020-10-01,227,218,9,4
31007,2020-10-01,382,374,8,2.1
31009,2020-10-01,245,237,8,3.3
31011,2020-10-01,2880,2826,54,1.9
31013,2020-10-01,5389,5164,225,4.2
31015,2020-10-01,1037,1014,23,2.2
31017,2020-10-01,1365,1333,32,2.3
31019,2020-10-01,27331,26680,651,2.4
31021,2020-10-01,3525,3422,103,2.9
31023,2020-10-01,4560,4438,122,2.7
31025,2020-10-01,13268,12851,417,3.1
31027,2020-10-01,4402,4301,101,2.3
31029,2020-10-01,2256,2223,33,1.5
31031,2020-10-01,3289,3232,57,1.7
31033,2020-10-01,4121,3962,159,3.9
31035,2020-10-01,3190,3123,67,2.1
31037,2020-10-01,5585,5469,116,2.1
31039,2020-10-01,4749,4657,92,1.9
31041,2020-10-01,6221,6109,112,1.8
31043,2020-10-01,10579,10212,367,3.5
31045,2020-10-01,4985,4884,101,2
31047,2020-10-01,13120,12793,327,2.5
31049,2020-10-01,956,927,29,3
31051,2020-10-01,2923,2854,69,2.4
31053,2020-10-01,19962,19426,536,2.7
31055,2020-10-01,297309,285685,11624,3.9
31057,2020-10-01,1142,1120,22,1.9
31059,2020-10-01,3060,3002,58,1.9
31061,2020-10-01,1450,1410,40,2.8
31063,2020-10-01,1490,1459,31,2.1
31065,2020-10-01,2557,2502,55,2.2
31067,2020-10-01,10629,10324,305,2.9
31069,2020-10-01,1028,1002,26,2.5
31071,2020-10-01,1122,1104,18,1.6
31073,2020-10-01,1080,1059,21,1.9
31075,2020-10-01,405,398,7,1.7
31077,2020-10-01,1193,1167,26,2.2
31079,2020-10-01,31724,30340,1384,4.4
31081,2020-10-01,4700,4579,121,2.6
31083,2020-10-01,1670,1635,35,2.1
31085,2020-10-01,626,617,9,1.4
31087,2020-10-01,1276,1238,38,3
31089,2020-10-01,5588,5484,104,1.9
31091,2020-10-01,395,387,8,2
31093,2020-10-01,3287,3195,92,2.8
31095,2020-10-01,4154,4076,78,1.9
31097,2020-10-01,2019,1959,60,3
31099,2020-10-01,3732,3644,88,2.4
31101,2020-10-01,4433,4317,116,2.6
31103,2020-10-01,582,573,9,1.5
31105,2020-10-01,1925,1871,54,2.8
31107,2020-10-01,4587,4485,102,2.2
31109,2020-10-01,176468,170835,5633,3.2
31111,2020-10-01,18125,17645,480,2.6
31113,2020-10-01,459,451,8,1.7
31115,2020-10-01,402,397,5,1.2
31117,2020-10-01,437,430,7,1.6
31119,2020-10-01,19634,18951,683,3.5
31121,2020-10-01,3957,3844,113,2.9
31123,2020-10-01,2560,2486,74,2.9
31125,2020-10-01,1891,1848,43,2.3
31127,2020-10-01,3558,3475,83,2.3
31129,2020-10-01,2411,2365,46,1.9
31131,2020-10-01,8327,8108,219,2.6
31133,2020-10-01,1463,1431,32,2.2
31135,2020-10-01,1793,1770,23,1.3
31137,2020-10-01,4833,4729,104,2.2
31139,2020-10-01,4118,3982,136,3.3
31141,2020-10-01,17632,17192,440,2.5
31143,2020-10-01,2861,2805,56,2
31145,2020-10-01,5855,5686,169,2.9
31147,2020-10-01,4092,3992,100,2.4
31149,2020-10-01,864,852,12,1.4
31151,2020-10-01,7170,7000,170,2.4
31153,2020-10-01,95973,93167,2806,2.9
31155,2020-10-01,11024,10701,323,2.9
31157,2020-10-01,18327,17738,589,3.2
31159,2020-10-01,8767,8486,281,3.2
31161,2020-10-01,2652,2595,57,2.1
31163,2020-10-01,1645,1612,33,2
31165,2020-10-01,731,718,13,1.8
31167,2020-10-01,3525,3411,114,3.2
31169,2020-10-01,2749,2695,54,2
31171,2020-10-01,406,394,12,3
31173,2020-10-01,3077,2968,109,3.5
31175,2020-10-01,2059,2016,43,2.1
31177,2020-10-01,11049,10740,309,2.8
31179,2020-10-01,5624,5512,112,2
31181,2020-10-01,1622,1581,41,2.5
31183,2020-10-01,530,523,7,1.3
31185,2020-10-01,7289,7121,168,2.3
32001,2020-10-01,11488,10984,504,4.4
32003,2020-10-01,NA,973534,154325,13.7
32005,2020-10-01,22960,21427,1533,6.7
32007,2020-10-01,27539,26429,1110,4
32009,2020-10-01,434,410,24,5.5
32011,2020-10-01,1130,1100,30,2.7
32013,2020-10-01,8390,8050,340,4.1
32015,2020-10-01,3279,3137,142,4.3
32017,2020-10-01,2125,2028,97,4.6
32019,2020-10-01,23495,21874,1621,6.9
32021,2020-10-01,2120,2019,101,4.8
32023,2020-10-01,17999,16411,1588,8.8
32027,2020-10-01,2638,2545,93,3.5
32029,2020-10-01,2101,1964,137,6.5
32031,2020-10-01,260447,244672,15775,6.1
32033,2020-10-01,4756,4592,164,3.4
32510,2020-10-01,26583,24868,1715,6.5
33001,2020-10-01,31123,29836,1287,4.1
33003,2020-10-01,23112,22042,1070,4.6
33005,2020-10-01,39851,38214,1637,4.1
33007,2020-10-01,14219,13557,662,4.7
33009,2020-10-01,48215,46546,1669,3.5
33011,2020-10-01,237887,227094,10793,4.5
33013,2020-10-01,82330,79322,3008,3.7
33015,2020-10-01,184061,175935,8126,4.4
33017,2020-10-01,73053,70243,2810,3.8
33019,2020-10-01,23151,22288,863,3.7
34001,2020-10-01,115921,103576,12345,10.6
34003,2020-10-01,462054,428877,33177,7.2
34005,2020-10-01,226293,213154,13139,5.8
34007,2020-10-01,249472,231324,18148,7.3
34009,2020-10-01,45487,42157,3330,7.3
34011,2020-10-01,64899,60209,4690,7.2
34013,2020-10-01,361761,328024,33737,9.3
34015,2020-10-01,147004,137741,9263,6.3
34017,2020-10-01,348604,319396,29208,8.4
34019,2020-10-01,61790,58715,3075,5
34021,2020-10-01,201562,190239,11323,5.6
34023,2020-10-01,428247,400569,27678,6.5
34025,2020-10-01,320910,301421,19489,6.1
34027,2020-10-01,245257,231522,13735,5.6
34029,2020-10-01,271056,254120,16936,6.2
34031,2020-10-01,234984,212474,22510,9.6
34033,2020-10-01,29332,27391,1941,6.6
34035,2020-10-01,163289,153870,9419,5.8
34037,2020-10-01,71120,66736,4384,6.2
34039,2020-10-01,267115,246955,20160,7.5
34041,2020-10-01,54699,51644,3055,5.6
35001,2020-10-01,334977,309492,25485,7.6
35003,2020-10-01,1218,1140,78,6.4
35005,2020-10-01,29526,27193,2333,7.9
35006,2020-10-01,9636,8778,858,8.9
35007,2020-10-01,5477,5128,349,6.4
35009,2020-10-01,23542,22328,1214,5.2
35011,2020-10-01,742,705,37,5
35013,2020-10-01,98307,91190,7117,7.2
35015,2020-10-01,34087,31437,2650,7.8
35017,2020-10-01,12170,10953,1217,10
35019,2020-10-01,1624,1508,116,7.1
35021,2020-10-01,278,265,13,4.7
35023,2020-10-01,2059,1945,114,5.5
35025,2020-10-01,29699,25830,3869,13
35027,2020-10-01,9307,8573,734,7.9
35028,2020-10-01,10573,10240,333,3.1
35029,2020-10-01,10610,9215,1395,13.1
35031,2020-10-01,25045,22454,2591,10.3
35033,2020-10-01,2084,1938,146,7
35035,2020-10-01,26527,24470,2057,7.8
35037,2020-10-01,3241,2999,242,7.5
35039,2020-10-01,17428,16162,1266,7.3
35041,2020-10-01,8223,7744,479,5.8
35043,2020-10-01,67267,61895,5372,8
35045,2020-10-01,50998,46137,4861,9.5
35047,2020-10-01,10781,9961,820,7.6
35049,2020-10-01,70914,65374,5540,7.8
35051,2020-10-01,4390,4035,355,8.1
35053,2020-10-01,6456,6051,405,6.3
35055,2020-10-01,15144,13531,1613,10.7
35057,2020-10-01,5784,5278,506,8.7
35059,2020-10-01,1714,1628,86,5
35061,2020-10-01,30556,28122,2434,8
36001,2020-10-01,157089,148729,8360,5.3
36003,2020-10-01,19097,18117,980,5.1
36005,2020-10-01,585256,492682,92574,15.8
36007,2020-10-01,80586,75793,4793,5.9
36009,2020-10-01,32868,31023,1845,5.6
36011,2020-10-01,35174,33418,1756,5
36013,2020-10-01,52052,48730,3322,6.4
36015,2020-10-01,34843,32727,2116,6.1
36017,2020-10-01,21559,20565,994,4.6
36019,2020-10-01,35252,33475,1777,5
36021,2020-10-01,30138,28846,1292,4.3
36023,2020-10-01,22317,21199,1118,5
36025,2020-10-01,18636,17752,884,4.7
36027,2020-10-01,140856,133246,7610,5.4
36029,2020-10-01,436798,409018,27780,6.4
36031,2020-10-01,16164,15393,771,4.8
36033,2020-10-01,19189,18243,946,4.9
36035,2020-10-01,22265,20929,1336,6
36037,2020-10-01,28701,27372,1329,4.6
36039,2020-10-01,19977,18834,1143,5.7
36041,2020-10-01,2115,2029,86,4.1
36043,2020-10-01,27272,25629,1643,6
36045,2020-10-01,43196,40985,2211,5.1
36047,2020-10-01,NA,NA,136086,11.9
36049,2020-10-01,11379,10862,517,4.5
36051,2020-10-01,29505,28206,1299,4.4
36053,2020-10-01,31809,30310,1499,4.7
36055,2020-10-01,356728,334369,22359,6.3
36057,2020-10-01,21743,20403,1340,6.2
36059,2020-10-01,692329,650144,42185,6.1
36061,2020-10-01,852362,774380,77982,9.1
36063,2020-10-01,96557,90432,6125,6.3
36065,2020-10-01,99490,93978,5512,5.5
36067,2020-10-01,217459,204795,12664,5.8
36069,2020-10-01,53828,51322,2506,4.7
36071,2020-10-01,180487,169974,10513,5.8
36073,2020-10-01,16910,15992,918,5.4
36075,2020-10-01,51117,48191,2926,5.7
36077,2020-10-01,26471,25123,1348,5.1
36079,2020-10-01,49594,47026,2568,5.2
36081,2020-10-01,NA,957317,127038,11.7
36083,2020-10-01,80446,76528,3918,4.9
36085,2020-10-01,207841,187868,19973,9.6
36087,2020-10-01,151096,142150,8946,5.9
36089,2020-10-01,42996,40878,2118,4.9
36091,2020-10-01,118255,113029,5226,4.4
36093,2020-10-01,76610,72025,4585,6
36095,2020-10-01,14323,13646,677,4.7
36097,2020-10-01,7992,7578,414,5.2
36099,2020-10-01,14926,14136,790,5.3
36101,2020-10-01,41593,39356,2237,5.4
36103,2020-10-01,754625,710805,43820,5.8
36105,2020-10-01,35020,32809,2211,6.3
36107,2020-10-01,21792,20687,1105,5.1
36109,2020-10-01,47380,45281,2099,4.4
36111,2020-10-01,85363,80686,4677,5.5
36113,2020-10-01,30734,29145,1589,5.2
36115,2020-10-01,27345,26077,1268,4.6
36117,2020-10-01,42530,40454,2076,4.9
36119,2020-10-01,472785,442641,30144,6.4
36121,2020-10-01,17658,16873,785,4.4
36123,2020-10-01,11424,10966,458,4
37001,2020-10-01,82227,76998,5229,6.4
37003,2020-10-01,17986,16989,997,5.5
37005,2020-10-01,4371,4100,271,6.2
37007,2020-10-01,10717,9880,837,7.8
37009,2020-10-01,13167,12489,678,5.1
37011,2020-10-01,7638,7239,399,5.2
37013,2020-10-01,20007,18843,1164,5.8
37015,2020-10-01,7827,7339,488,6.2
37017,2020-10-01,14973,13973,1000,6.7
37019,2020-10-01,53056,49185,3871,7.3
37021,2020-10-01,138386,129479,8907,6.4
37023,2020-10-01,40773,38358,2415,5.9
37025,2020-10-01,110517,103806,6711,6.1
37027,2020-10-01,36578,34107,2471,6.8
37029,2020-10-01,4693,4466,227,4.8
37031,2020-10-01,32027,30407,1620,5.1
37033,2020-10-01,9783,9108,675,6.9
37035,2020-10-01,79052,74075,4977,6.3
37037,2020-10-01,36212,34480,1732,4.8
37039,2020-10-01,10991,10245,746,6.8
37041,2020-10-01,5617,5305,312,5.6
37043,2020-10-01,4176,3902,274,6.6
37045,2020-10-01,49697,46058,3639,7.3
37047,2020-10-01,23088,21274,1814,7.9
37049,2020-10-01,41881,39360,2521,6
37051,2020-10-01,128255,117107,11148,8.7
37053,2020-10-01,14055,13373,682,4.9
37055,2020-10-01,20118,18952,1166,5.8
37057,2020-10-01,80254,75328,4926,6.1
37059,2020-10-01,20381,19243,1138,5.6
37061,2020-10-01,25593,24284,1309,5.1
37063,2020-10-01,174123,163806,10317,5.9
37065,2020-10-01,21266,19017,2249,10.6
37067,2020-10-01,187567,174934,12633,6.7
37069,2020-10-01,31787,29809,1978,6.2
37071,2020-10-01,111587,103604,7983,7.2
37073,2020-10-01,5216,4940,276,5.3
37075,2020-10-01,3132,2872,260,8.3
37077,2020-10-01,30065,28476,1589,5.3
37079,2020-10-01,9966,9424,542,5.4
37081,2020-10-01,260731,240699,20032,7.7
37083,2020-10-01,20540,18672,1868,9.1
37085,2020-10-01,54241,50579,3662,6.8
37087,2020-10-01,29189,27429,1760,6
37089,2020-10-01,53591,50610,2981,5.6
37091,2020-10-01,9181,8564,617,6.7
37093,2020-10-01,20146,18527,1619,8
37095,2020-10-01,1889,1766,123,6.5
37097,2020-10-01,90288,84770,5518,6.1
37099,2020-10-01,20673,19534,1139,5.5
37101,2020-10-01,100644,95072,5572,5.5
37103,2020-10-01,4364,4136,228,5.2
37105,2020-10-01,26359,24517,1842,7
37107,2020-10-01,28235,26504,1731,6.1
37109,2020-10-01,44123,41655,2468,5.6
37111,2020-10-01,20805,19525,1280,6.2
37113,2020-10-01,16136,15242,894,5.5
37115,2020-10-01,9800,9246,554,5.7
37117,2020-10-01,9221,8612,609,6.6
37119,2020-10-01,629975,585855,44120,7
37121,2020-10-01,5993,5574,419,7
37123,2020-10-01,11595,10893,702,6.1
37125,2020-10-01,41748,39253,2495,6
37127,2020-10-01,42983,39594,3389,7.9
37129,2020-10-01,122966,115767,7199,5.9
37131,2020-10-01,7732,7173,559,7.2
37133,2020-10-01,66003,61855,4148,6.3
37135,2020-10-01,79470,75838,3632,4.6
37137,2020-10-01,5405,5126,279,5.2
37139,2020-10-01,16835,15747,1088,6.5
37141,2020-10-01,28709,27120,1589,5.5
37143,2020-10-01,4987,4698,289,5.8
37145,2020-10-01,18447,17279,1168,6.3
37147,2020-10-01,90477,84879,5598,6.2
37149,2020-10-01,9241,8739,502,5.4
37151,2020-10-01,64894,60856,4038,6.2
37153,2020-10-01,17112,15588,1524,8.9
37155,2020-10-01,50667,46163,4504,8.9
37157,2020-10-01,39539,36676,2863,7.2
37159,2020-10-01,66169,61732,4437,6.7
37161,2020-10-01,25209,23162,2047,8.1
37163,2020-10-01,29391,27821,1570,5.3
37165,2020-10-01,11640,10260,1380,11.9
37167,2020-10-01,30323,28652,1671,5.5
37169,2020-10-01,21419,20205,1214,5.7
37171,2020-10-01,33150,31272,1878,5.7
37173,2020-10-01,7026,6615,411,5.8
37175,2020-10-01,14557,13806,751,5.2
37177,2020-10-01,1445,1347,98,6.8
37179,2020-10-01,123760,117443,6317,5.1
37181,2020-10-01,17314,15576,1738,10
37183,2020-10-01,596244,562896,33348,5.6
37185,2020-10-01,6698,6082,616,9.2
37187,2020-10-01,4522,4163,359,7.9
37189,2020-10-01,28936,27596,1340,4.6
37191,2020-10-01,51761,48644,3117,6
37193,2020-10-01,28932,27246,1686,5.8
37195,2020-10-01,35120,32243,2877,8.2
37197,2020-10-01,17542,16571,971,5.5
37199,2020-10-01,8444,7973,471,5.6
38001,2020-10-01,986,957,29,2.9
38003,2020-10-01,5155,5040,115,2.2
38005,2020-10-01,2406,2295,111,4.6
38007,2020-10-01,411,396,15,3.6
38009,2020-10-01,2969,2858,111,3.7
38011,2020-10-01,1647,1605,42,2.6
38013,2020-10-01,1043,998,45,4.3
38015,2020-10-01,50418,48999,1419,2.8
38017,2020-10-01,104641,101616,3025,2.9
38019,2020-10-01,1942,1898,44,2.3
38021,2020-10-01,2327,2278,49,2.1
38023,2020-10-01,1435,1392,43,3
38025,2020-10-01,3017,2885,132,4.4
38027,2020-10-01,1199,1164,35,2.9
38029,2020-10-01,1531,1484,47,3.1
38031,2020-10-01,1548,1510,38,2.5
38033,2020-10-01,862,840,22,2.6
38035,2020-10-01,37134,36079,1055,2.8
38037,2020-10-01,1231,1211,20,1.6
38039,2020-10-01,1021,1001,20,2
38041,2020-10-01,1448,1401,47,3.2
38043,2020-10-01,1311,1274,37,2.8
38045,2020-10-01,2126,2089,37,1.7
38047,2020-10-01,869,854,15,1.7
38049,2020-10-01,3133,3020,113,3.6
38051,2020-10-01,1115,1088,27,2.4
38053,2020-10-01,8858,8208,650,7.3
38055,2020-10-01,4792,4657,135,2.8
38057,2020-10-01,3599,3458,141,3.9
38059,2020-10-01,16677,16117,560,3.4
38061,2020-10-01,6630,6291,339,5.1
38063,2020-10-01,1426,1380,46,3.2
38065,2020-10-01,893,859,34,3.8
38067,2020-10-01,3361,3267,94,2.8
38069,2020-10-01,1734,1693,41,2.4
38071,2020-10-01,5658,5510,148,2.6
38073,2020-10-01,2865,2811,54,1.9
38075,2020-10-01,1253,1209,44,3.5
38077,2020-10-01,8648,8480,168,1.9
38079,2020-10-01,4524,4042,482,10.7
38081,2020-10-01,2834,2767,67,2.4
38083,2020-10-01,698,674,24,3.4
38085,2020-10-01,1230,1188,42,3.4
38087,2020-10-01,405,396,9,2.2
38089,2020-10-01,17845,16702,1143,6.4
38091,2020-10-01,978,957,21,2.1
38093,2020-10-01,10460,10217,243,2.3
38095,2020-10-01,1201,1179,22,1.8
38097,2020-10-01,4584,4498,86,1.9
38099,2020-10-01,5153,5016,137,2.7
38101,2020-10-01,31558,30112,1446,4.6
38103,2020-10-01,1956,1905,51,2.6
38105,2020-10-01,21756,19577,2179,10
39001,2020-10-01,10980,10459,521,4.7
39003,2020-10-01,47808,45551,2257,4.7
39005,2020-10-01,26660,25742,918,3.4
39007,2020-10-01,43421,41397,2024,4.7
39009,2020-10-01,28918,27761,1157,4
39011,2020-10-01,24519,23737,782,3.2
39013,2020-10-01,28307,26842,1465,5.2
39015,2020-10-01,19172,18284,888,4.6
39017,2020-10-01,192523,184161,8362,4.3
39019,2020-10-01,12681,12044,637,5
39021,2020-10-01,19857,19131,726,3.7
39023,2020-10-01,61864,59028,2836,4.6
39025,2020-10-01,105372,101334,4038,3.8
39027,2020-10-01,17711,16886,825,4.7
39029,2020-10-01,46843,44518,2325,5
39031,2020-10-01,14004,13338,666,4.8
39033,2020-10-01,18595,17760,835,4.5
39035,2020-10-01,588392,540302,48090,8.2
39037,2020-10-01,25758,24942,816,3.2
39039,2020-10-01,17701,17047,654,3.7
39041,2020-10-01,111567,108149,3418,3.1
39043,2020-10-01,36449,34523,1926,5.3
39045,2020-10-01,78222,75303,2919,3.7
39047,2020-10-01,14023,13449,574,4.1
39049,2020-10-01,702631,669027,33604,4.8
39051,2020-10-01,21790,21024,766,3.5
39053,2020-10-01,12161,11647,514,4.2
39055,2020-10-01,46298,44168,2130,4.6
39057,2020-10-01,82175,79144,3031,3.7
39059,2020-10-01,18185,17312,873,4.8
39061,2020-10-01,412945,392582,20363,4.9
39063,2020-10-01,41694,40298,1396,3.3
39065,2020-10-01,14160,13610,550,3.9
39067,2020-10-01,6630,6264,366,5.5
39069,2020-10-01,13118,12637,481,3.7
39071,2020-10-01,17796,17012,784,4.4
39073,2020-10-01,12806,12319,487,3.8
39075,2020-10-01,21342,20914,428,2
39077,2020-10-01,27337,26172,1165,4.3
39079,2020-10-01,13155,12543,612,4.7
39081,2020-10-01,26802,25189,1613,6
39083,2020-10-01,31540,30516,1024,3.2
39085,2020-10-01,119591,112654,6937,5.8
39087,2020-10-01,23382,22364,1018,4.4
39089,2020-10-01,90287,87022,3265,3.6
39091,2020-10-01,22506,21722,784,3.5
39093,2020-10-01,146545,136660,9885,6.7
39095,2020-10-01,206155,194511,11644,5.6
39097,2020-10-01,20812,20127,685,3.3
39099,2020-10-01,99125,93359,5766,5.8
39101,2020-10-01,28115,26900,1215,4.3
39103,2020-10-01,92406,87809,4597,5
39105,2020-10-01,9212,8722,490,5.3
39107,2020-10-01,23461,22851,610,2.6
39109,2020-10-01,53561,51521,2040,3.8
39111,2020-10-01,5644,5324,320,5.7
39113,2020-10-01,250015,236944,13071,5.2
39115,2020-10-01,6676,6349,327,4.9
39117,2020-10-01,16741,16117,624,3.7
39119,2020-10-01,40479,38805,1674,4.1
39121,2020-10-01,4603,4344,259,5.6
39123,2020-10-01,20662,19761,901,4.4
39125,2020-10-01,8730,8437,293,3.4
39127,2020-10-01,15767,15002,765,4.9
39129,2020-10-01,26374,25387,987,3.7
39131,2020-10-01,10918,10389,529,4.8
39133,2020-10-01,84317,80864,3453,4.1
39135,2020-10-01,21312,20568,744,3.5
39137,2020-10-01,18819,18366,453,2.4
39139,2020-10-01,51090,48666,2424,4.7
39141,2020-10-01,35318,33896,1422,4
39143,2020-10-01,30225,29042,1183,3.9
39145,2020-10-01,29232,27840,1392,4.8
39147,2020-10-01,27199,26170,1029,3.8
39149,2020-10-01,23976,23089,887,3.7
39151,2020-10-01,181408,173200,8208,4.5
39153,2020-10-01,265059,252042,13017,4.9
39155,2020-10-01,83187,78362,4825,5.8
39157,2020-10-01,44438,42676,1762,4
39159,2020-10-01,29353,28491,862,2.9
39161,2020-10-01,14630,14164,466,3.2
39163,2020-10-01,5641,5376,265,4.7
39165,2020-10-01,118220,113885,4335,3.7
39167,2020-10-01,26588,25380,1208,4.5
39169,2020-10-01,60344,58413,1931,3.2
39171,2020-10-01,18718,17984,734,3.9
39173,2020-10-01,69424,66899,2525,3.6
39175,2020-10-01,13034,12644,390,3
40001,2020-10-01,8717,8356,361,4.1
40003,2020-10-01,2914,2830,84,2.9
40005,2020-10-01,5309,4991,318,6
40007,2020-10-01,2698,2644,54,2
40009,2020-10-01,10173,9482,691,6.8
40011,2020-10-01,4482,4242,240,5.4
40013,2020-10-01,23003,22080,923,4
40015,2020-10-01,12357,11758,599,4.8
40017,2020-10-01,76355,72934,3421,4.5
40019,2020-10-01,22112,20962,1150,5.2
40021,2020-10-01,20284,19411,873,4.3
40023,2020-10-01,5621,5268,353,6.3
40025,2020-10-01,1603,1578,25,1.6
40027,2020-10-01,142790,136816,5974,4.2
40029,2020-10-01,2407,2269,138,5.7
40031,2020-10-01,48008,45633,2375,4.9
40033,2020-10-01,2775,2630,145,5.2
40035,2020-10-01,5968,5713,255,4.3
40037,2020-10-01,31541,29823,1718,5.4
40039,2020-10-01,15214,14508,706,4.6
40041,2020-10-01,18837,18092,745,4
40043,2020-10-01,2759,2633,126,4.6
40045,2020-10-01,2256,2158,98,4.3
40047,2020-10-01,27007,25777,1230,4.6
40049,2020-10-01,13066,12387,679,5.2
40051,2020-10-01,26971,25633,1338,5
40053,2020-10-01,2957,2880,77,2.6
40055,2020-10-01,2036,1906,130,6.4
40057,2020-10-01,1259,1222,37,2.9
40059,2020-10-01,1946,1896,50,2.6
40061,2020-10-01,4400,4130,270,6.1
40063,2020-10-01,5615,5249,366,6.5
40065,2020-10-01,11138,10787,351,3.2
40067,2020-10-01,2684,2546,138,5.1
40069,2020-10-01,3788,3566,222,5.9
40071,2020-10-01,18364,17370,994,5.4
40073,2020-10-01,8900,8563,337,3.8
40075,2020-10-01,3688,3541,147,4
40077,2020-10-01,3220,2929,291,9
40079,2020-10-01,19676,18527,1149,5.8
40081,2020-10-01,15781,15072,709,4.5
40083,2020-10-01,22473,21543,930,4.1
40085,2020-10-01,6732,6510,222,3.3
40087,2020-10-01,20162,19284,878,4.4
40089,2020-10-01,15711,14840,871,5.5
40091,2020-10-01,7191,6694,497,6.9
40093,2020-10-01,3862,3688,174,4.5
40095,2020-10-01,6987,6665,322,4.6
40097,2020-10-01,19834,18986,848,4.3
40099,2020-10-01,6116,5786,330,5.4
40101,2020-10-01,29720,28278,1442,4.9
40103,2020-10-01,5672,5508,164,2.9
40105,2020-10-01,4768,4554,214,4.5
40107,2020-10-01,4550,4301,249,5.5
40109,2020-10-01,386593,366814,19779,5.1
40111,2020-10-01,15808,14826,982,6.2
40113,2020-10-01,20788,19665,1123,5.4
40115,2020-10-01,14350,13782,568,4
40117,2020-10-01,7426,7007,419,5.6
40119,2020-10-01,38726,37274,1452,3.7
40121,2020-10-01,16807,15724,1083,6.4
40123,2020-10-01,19587,18820,767,3.9
40125,2020-10-01,32771,31148,1623,5
40127,2020-10-01,4599,4355,244,5.3
40129,2020-10-01,1956,1883,73,3.7
40131,2020-10-01,45232,43104,2128,4.7
40133,2020-10-01,9386,8791,595,6.3
40135,2020-10-01,16835,15990,845,5
40137,2020-10-01,18512,17242,1270,6.9
40139,2020-10-01,11934,11705,229,1.9
40141,2020-10-01,3159,3058,101,3.2
40143,2020-10-01,324810,307577,17233,5.3
40145,2020-10-01,38357,36574,1783,4.6
40147,2020-10-01,22498,21427,1071,4.8
40149,2020-10-01,5297,4983,314,5.9
40151,2020-10-01,4840,4722,118,2.4
40153,2020-10-01,8948,8384,564,6.3
41001,2020-10-01,7454,7028,426,5.7
41003,2020-10-01,46573,44279,2294,4.9
41005,2020-10-01,220181,205902,14279,6.5
41007,2020-10-01,19371,18039,1332,6.9
41009,2020-10-01,24192,22526,1666,6.9
41011,2020-10-01,26862,25010,1852,6.9
41013,2020-10-01,10578,9812,766,7.2
41015,2020-10-01,9177,8564,613,6.7
41017,2020-10-01,100072,94027,6045,6
41019,2020-10-01,47843,44935,2908,6.1
41021,2020-10-01,1003,953,50,5
41023,2020-10-01,3258,3090,168,5.2
41025,2020-10-01,3834,3656,178,4.6
41027,2020-10-01,14447,13758,689,4.8
41029,2020-10-01,107133,100342,6791,6.3
41031,2020-10-01,10497,9794,703,6.7
41033,2020-10-01,37031,34660,2371,6.4
41035,2020-10-01,29943,27913,2030,6.8
41037,2020-10-01,3727,3557,170,4.6
41039,2020-10-01,177930,165984,11946,6.7
41041,2020-10-01,20590,18908,1682,8.2
41043,2020-10-01,58996,55116,3880,6.6
41045,2020-10-01,13099,12578,521,4
41047,2020-10-01,166269,156456,9813,5.9
41049,2020-10-01,5843,5597,246,4.2
41051,2020-10-01,461841,426009,35832,7.8
41053,2020-10-01,41118,38853,2265,5.5
41055,2020-10-01,984,933,51,5.2
41057,2020-10-01,11705,10939,766,6.5
41059,2020-10-01,37843,35820,2023,5.3
41061,2020-10-01,12172,11497,675,5.5
41063,2020-10-01,3589,3410,179,5
41065,2020-10-01,12834,12092,742,5.8
41067,2020-10-01,324881,306001,18880,5.8
41069,2020-10-01,705,675,30,4.3
41071,2020-10-01,54732,51610,3122,5.7
42001,2020-10-01,54405,52145,2260,4.2
42003,2020-10-01,629609,589012,40597,6.4
42005,2020-10-01,30906,28948,1958,6.3
42007,2020-10-01,81610,75827,5783,7.1
42009,2020-10-01,23241,21842,1399,6
42011,2020-10-01,208121,194376,13745,6.6
42013,2020-10-01,58606,55420,3186,5.4
42015,2020-10-01,28071,26641,1430,5.1
42017,2020-10-01,335303,316268,19035,5.7
42019,2020-10-01,95960,91226,4734,4.9
42021,2020-10-01,55254,51920,3334,6
42023,2020-10-01,2025,1889,136,6.7
42025,2020-10-01,31010,29066,1944,6.3
42027,2020-10-01,75621,72723,2898,3.8
42029,2020-10-01,280370,268121,12249,4.4
42031,2020-10-01,16929,16123,806,4.8
42033,2020-10-01,34956,32914,2042,5.8
42035,2020-10-01,17509,16518,991,5.7
42037,2020-10-01,33125,31440,1685,5.1
42039,2020-10-01,37676,35462,2214,5.9
42041,2020-10-01,130185,124340,5845,4.5
42043,2020-10-01,143332,134111,9221,6.4
42045,2020-10-01,292710,272903,19807,6.8
42047,2020-10-01,14588,13498,1090,7.5
42049,2020-10-01,125063,116460,8603,6.9
42051,2020-10-01,55076,50695,4381,8
42053,2020-10-01,1772,1663,109,6.2
42055,2020-10-01,76647,72623,4024,5.3
42057,2020-10-01,7855,7138,717,9.1
42059,2020-10-01,15831,14770,1061,6.7
42061,2020-10-01,19688,18291,1397,7.1
42063,2020-10-01,37190,35069,2121,5.7
42065,2020-10-01,19628,18528,1100,5.6
42067,2020-10-01,12629,12125,504,4
42069,2020-10-01,102691,95894,6797,6.6
42071,2020-10-01,280900,267219,13681,4.9
42073,2020-10-01,39482,36756,2726,6.9
42075,2020-10-01,71660,67810,3850,5.4
42077,2020-10-01,189228,176350,12878,6.8
42079,2020-10-01,155116,143205,11911,7.7
42081,2020-10-01,55228,51883,3345,6.1
42083,2020-10-01,16661,15658,1003,6
42085,2020-10-01,47509,44282,3227,6.8
42087,2020-10-01,20951,19820,1131,5.4
42089,2020-10-01,79711,73513,6198,7.8
42091,2020-10-01,443950,420259,23691,5.3
42093,2020-10-01,9090,8718,372,4.1
42095,2020-10-01,156821,147429,9392,6
42097,2020-10-01,41836,39245,2591,6.2
42099,2020-10-01,24029,23028,1001,4.2
42101,2020-10-01,707711,636189,71522,10.1
42103,2020-10-01,24114,22390,1724,7.1
42105,2020-10-01,7153,6739,414,5.8
42107,2020-10-01,64737,60596,4141,6.4
42109,2020-10-01,19376,18554,822,4.2
42111,2020-10-01,31985,30080,1905,6
42113,2020-10-01,2614,2467,147,5.6
42115,2020-10-01,19850,18901,949,4.8
42117,2020-10-01,18604,17520,1084,5.8
42119,2020-10-01,19298,18491,807,4.2
42121,2020-10-01,21696,20340,1356,6.3
42123,2020-10-01,18865,17834,1031,5.5
42125,2020-10-01,103709,96998,6711,6.5
42127,2020-10-01,21873,20643,1230,5.6
42129,2020-10-01,173912,163607,10305,5.9
42131,2020-10-01,13130,12443,687,5.2
42133,2020-10-01,230809,218446,12363,5.4
44001,2020-10-01,24757,23467,1290,5.2
44003,2020-10-01,86954,82199,4755,5.5
44005,2020-10-01,41944,39832,2112,5
44007,2020-10-01,316604,293495,23109,7.3
44009,2020-10-01,65146,61947,3199,4.9
45001,2020-10-01,10164,9648,516,5.1
45003,2020-10-01,77204,74213,2991,3.9
45005,2020-10-01,2692,2449,243,9
45007,2020-10-01,92439,88244,4195,4.5
45009,2020-10-01,4836,4429,407,8.4
45011,2020-10-01,8114,7574,540,6.7
45013,2020-10-01,78699,75499,3200,4.1
45015,2020-10-01,106761,101869,4892,4.6
45017,2020-10-01,6724,6357,367,5.5
45019,2020-10-01,214738,203713,11025,5.1
45021,2020-10-01,25965,24291,1674,6.4
45023,2020-10-01,13978,12903,1075,7.7
45025,2020-10-01,22198,21013,1185,5.3
45027,2020-10-01,12914,12159,755,5.8
45029,2020-10-01,17026,16063,963,5.7
45031,2020-10-01,31313,29507,1806,5.8
45033,2020-10-01,13533,12781,752,5.6
45035,2020-10-01,78981,75239,3742,4.7
45037,2020-10-01,11001,10582,419,3.8
45039,2020-10-01,9819,9152,667,6.8
45041,2020-10-01,68831,65415,3416,5
45043,2020-10-01,26608,24962,1646,6.2
45045,2020-10-01,260626,249213,11413,4.4
45047,2020-10-01,32097,30290,1807,5.6
45049,2020-10-01,8402,8020,382,4.5
45051,2020-10-01,148734,139647,9087,6.1
45053,2020-10-01,13040,12474,566,4.3
45055,2020-10-01,30102,28788,1314,4.4
45057,2020-10-01,43469,41072,2397,5.5
45059,2020-10-01,30667,29007,1660,5.4
45061,2020-10-01,6979,6521,458,6.6
45063,2020-10-01,153908,148279,5629,3.7
45065,2020-10-01,3386,3189,197,5.8
45067,2020-10-01,13732,12732,1000,7.3
45069,2020-10-01,9505,8712,793,8.3
45071,2020-10-01,19682,18909,773,3.9
45073,2020-10-01,35462,34114,1348,3.8
45075,2020-10-01,34835,31937,2898,8.3
45077,2020-10-01,58074,55773,2301,4
45079,2020-10-01,204814,194033,10781,5.3
45081,2020-10-01,8877,8584,293,3.3
45083,2020-10-01,162117,154048,8069,5
45085,2020-10-01,44827,42256,2571,5.7
45087,2020-10-01,12243,11348,895,7.3
45089,2020-10-01,12096,11240,856,7.1
45091,2020-10-01,147251,140080,7171,4.9
46003,2020-10-01,1546,1508,38,2.5
46005,2020-10-01,9507,9230,277,2.9
46007,2020-10-01,1103,1055,48,4.4
46009,2020-10-01,2952,2855,97,3.3
46011,2020-10-01,19214,18609,605,3.1
46013,2020-10-01,21101,20475,626,3
46015,2020-10-01,2551,2476,75,2.9
46017,2020-10-01,746,714,32,4.3
46019,2020-10-01,5111,4927,184,3.6
46021,2020-10-01,817,797,20,2.4
46023,2020-10-01,3882,3702,180,4.6
46025,2020-10-01,2431,2368,63,2.6
46027,2020-10-01,7603,7368,235,3.1
46029,2020-10-01,15627,15108,519,3.3
46031,2020-10-01,1420,1368,52,3.7
46033,2020-10-01,4188,4027,161,3.8
46035,2020-10-01,11247,10947,300,2.7
46037,2020-10-01,2775,2681,94,3.4
46039,2020-10-01,2575,2497,78,3
46041,2020-10-01,2338,2201,137,5.9
46043,2020-10-01,1627,1589,38,2.3
46045,2020-10-01,2097,2047,50,2.4
46047,2020-10-01,3067,2906,161,5.2
46049,2020-10-01,1128,1096,32,2.8
46051,2020-10-01,4495,4394,101,2.2
46053,2020-10-01,2157,2094,63,2.9
46055,2020-10-01,1139,1115,24,2.1
46057,2020-10-01,3501,3419,82,2.3
46059,2020-10-01,1916,1877,39,2
46061,2020-10-01,1813,1751,62,3.4
46063,2020-10-01,777,751,26,3.3
46065,2020-10-01,10249,10023,226,2.2
46067,2020-10-01,3717,3623,94,2.5
46069,2020-10-01,718,701,17,2.4
46071,2020-10-01,1265,1222,43,3.4
46073,2020-10-01,1269,1245,24,1.9
46075,2020-10-01,515,500,15,2.9
46077,2020-10-01,2769,2703,66,2.4
46079,2020-10-01,6648,6462,186,2.8
46081,2020-10-01,13968,13473,495,3.5
46083,2020-10-01,36347,35441,906,2.5
46085,2020-10-01,1728,1668,60,3.5
46087,2020-10-01,3173,3092,81,2.6
46089,2020-10-01,1059,1013,46,4.3
46091,2020-10-01,2544,2469,75,2.9
46093,2020-10-01,14145,13722,423,3
46095,2020-10-01,743,713,30,4
46097,2020-10-01,1184,1136,48,4.1
46099,2020-10-01,114570,111143,3427,3
46101,2020-10-01,4135,4015,120,2.9
46102,2020-10-01,3811,3416,395,10.4
46103,2020-10-01,57972,55937,2035,3.5
46105,2020-10-01,1463,1411,52,3.6
46107,2020-10-01,1059,1029,30,2.8
46109,2020-10-01,5055,4876,179,3.5
46111,2020-10-01,1215,1177,38,3.1
46115,2020-10-01,3237,3146,91,2.8
46117,2020-10-01,1975,1925,50,2.5
46119,2020-10-01,846,827,19,2.2
46121,2020-10-01,3090,2930,160,5.2
46123,2020-10-01,3194,3124,70,2.2
46125,2020-10-01,4780,4662,118,2.5
46127,2020-10-01,8728,8416,312,3.6
46129,2020-10-01,2169,2079,90,4.1
46135,2020-10-01,11837,11432,405,3.4
46137,2020-10-01,993,955,38,3.8
47001,2020-10-01,35619,33216,2403,6.7
47003,2020-10-01,21354,19848,1506,7.1
47005,2020-10-01,6920,6325,595,8.6
47007,2020-10-01,4434,4013,421,9.5
47009,2020-10-01,65590,61600,3990,6.1
47011,2020-10-01,54322,50527,3795,7
47013,2020-10-01,15277,14095,1182,7.7
47015,2020-10-01,6696,6286,410,6.1
47017,2020-10-01,12434,11470,964,7.8
47019,2020-10-01,24733,22913,1820,7.4
47021,2020-10-01,22029,20819,1210,5.5
47023,2020-10-01,8717,8190,527,6
47025,2020-10-01,13281,12404,877,6.6
47027,2020-10-01,2870,2636,234,8.2
47029,2020-10-01,14870,13619,1251,8.4
47031,2020-10-01,26159,24436,1723,6.6
47033,2020-10-01,7097,6660,437,6.2
47035,2020-10-01,23612,21790,1822,7.7
47037,2020-10-01,412745,382324,30421,7.4
47039,2020-10-01,4506,4113,393,8.7
47041,2020-10-01,8001,7324,677,8.5
47043,2020-10-01,27152,25630,1522,5.6
47045,2020-10-01,16464,15078,1386,8.4
47047,2020-10-01,19910,18376,1534,7.7
47049,2020-10-01,7880,7262,618,7.8
47051,2020-10-01,20124,18834,1290,6.4
47053,2020-10-01,22666,20932,1734,7.7
47055,2020-10-01,14970,13915,1055,7
47057,2020-10-01,9835,9116,719,7.3
47059,2020-10-01,29669,27199,2470,8.3
47061,2020-10-01,5253,4804,449,8.5
47063,2020-10-01,28902,26948,1954,6.8
47065,2020-10-01,188375,174988,13387,7.1
47067,2020-10-01,2253,2047,206,9.1
47069,2020-10-01,9633,8673,960,10
47071,2020-10-01,10708,9878,830,7.8
47073,2020-10-01,24180,22365,1815,7.5
47075,2020-10-01,8138,7310,828,10.2
47077,2020-10-01,12409,11472,937,7.6
47079,2020-10-01,13984,12878,1106,7.9
47081,2020-10-01,11506,10819,687,6
47083,2020-10-01,3359,3063,296,8.8
47085,2020-10-01,8947,8359,588,6.6
47087,2020-10-01,5004,4629,375,7.5
47089,2020-10-01,25312,23663,1649,6.5
47091,2020-10-01,8115,7569,546,6.7
47093,2020-10-01,251196,236554,14642,5.8
47095,2020-10-01,1782,1601,181,10.2
47097,2020-10-01,10266,9184,1082,10.5
47099,2020-10-01,19741,18397,1344,6.8
47101,2020-10-01,5498,5091,407,7.4
47103,2020-10-01,16700,15435,1265,7.6
47105,2020-10-01,24355,22856,1499,6.2
47107,2020-10-01,23953,22225,1728,7.2
47109,2020-10-01,8721,7856,865,9.9
47111,2020-10-01,11553,10766,787,6.8
47113,2020-10-01,51043,46982,4061,8
47115,2020-10-01,12783,11793,990,7.7
47117,2020-10-01,15666,14583,1083,6.9
47119,2020-10-01,50722,47394,3328,6.6
47121,2020-10-01,5423,4963,460,8.5
47123,2020-10-01,20741,19325,1416,6.8
47125,2020-10-01,90444,83383,7061,7.8
47127,2020-10-01,3711,3538,173,4.7
47129,2020-10-01,8002,7403,599,7.5
47131,2020-10-01,12675,11623,1052,8.3
47133,2020-10-01,10096,9481,615,6.1
47135,2020-10-01,3122,2872,250,8
47137,2020-10-01,2292,2155,137,6
47139,2020-10-01,7713,7139,574,7.4
47141,2020-10-01,36538,34176,2362,6.5
47143,2020-10-01,13392,12194,1198,8.9
47145,2020-10-01,23973,22278,1695,7.1
47147,2020-10-01,38526,36171,2355,6.1
47149,2020-10-01,188478,177448,11030,5.9
47151,2020-10-01,8373,7661,712,8.5
47153,2020-10-01,6385,5860,525,8.2
47155,2020-10-01,54166,51129,3037,5.6
47157,2020-10-01,472854,418408,54446,11.5
47159,2020-10-01,9516,8993,523,5.5
47161,2020-10-01,5659,5252,407,7.2
47163,2020-10-01,71890,66485,5405,7.5
47165,2020-10-01,105021,98681,6340,6
47167,2020-10-01,28704,26481,2223,7.7
47169,2020-10-01,5567,5223,344,6.2
47171,2020-10-01,7426,6753,673,9.1
47173,2020-10-01,7909,7356,553,7
47175,2020-10-01,2082,1913,169,8.1
47177,2020-10-01,17596,16282,1314,7.5
47179,2020-10-01,62128,58191,3937,6.3
47181,2020-10-01,6757,6253,504,7.5
47183,2020-10-01,16205,15146,1059,6.5
47185,2020-10-01,12504,11660,844,6.7
47187,2020-10-01,131203,125041,6162,4.7
47189,2020-10-01,78791,74283,4508,5.7
48001,2020-10-01,23580,22260,1320,5.6
48003,2020-10-01,9159,8371,788,8.6
48005,2020-10-01,35947,33378,2569,7.1
48007,2020-10-01,9133,8416,717,7.9
48009,2020-10-01,3963,3766,197,5
48011,2020-10-01,941,906,35,3.7
48013,2020-10-01,22469,20651,1818,8.1
48015,2020-10-01,13813,12930,883,6.4
48017,2020-10-01,2528,2423,105,4.2
48019,2020-10-01,10088,9566,522,5.2
48021,2020-10-01,43586,41275,2311,5.3
48023,2020-10-01,1812,1750,62,3.4
48025,2020-10-01,9973,8952,1021,10.2
48027,2020-10-01,146726,137483,9243,6.3
48029,2020-10-01,962833,899268,63565,6.6
48031,2020-10-01,6758,6533,225,3.3
48033,2020-10-01,452,437,15,3.3
48035,2020-10-01,8533,8140,393,4.6
48037,2020-10-01,39499,36994,2505,6.3
48039,2020-10-01,178782,164490,14292,8
48041,2020-10-01,120305,114732,5573,4.6
48043,2020-10-01,4109,3881,228,5.5
48045,2020-10-01,588,564,24,4.1
48047,2020-10-01,2550,2272,278,10.9
48049,2020-10-01,15453,14527,926,6
48051,2020-10-01,8465,7968,497,5.9
48053,2020-10-01,24221,23205,1016,4.2
48055,2020-10-01,19772,18664,1108,5.6
48057,2020-10-01,12481,11810,671,5.4
48059,2020-10-01,6078,5774,304,5
48061,2020-10-01,170201,154303,15898,9.3
48063,2020-10-01,5138,4770,368,7.2
48065,2020-10-01,3016,2905,111,3.7
48067,2020-10-01,12590,11611,979,7.8
48069,2020-10-01,3474,3359,115,3.3
48071,2020-10-01,19971,18165,1806,9
48073,2020-10-01,21724,20043,1681,7.7
48075,2020-10-01,3161,3060,101,3.2
48077,2020-10-01,4865,4610,255,5.2
48079,2020-10-01,1145,1064,81,7.1
48081,2020-10-01,1377,1302,75,5.4
48083,2020-10-01,2946,2749,197,6.7
48085,2020-10-01,581191,550246,30945,5.3
48087,2020-10-01,1130,1085,45,4
48089,2020-10-01,9799,9275,524,5.3
48091,2020-10-01,76571,72556,4015,5.2
48093,2020-10-01,5809,5504,305,5.3
48095,2020-10-01,1374,1320,54,3.9
48097,2020-10-01,19485,18215,1270,6.5
48099,2020-10-01,24352,22909,1443,5.9
48101,2020-10-01,589,567,22,3.7
48103,2020-10-01,1655,1411,244,14.7
48105,2020-10-01,1550,1422,128,8.3
48107,2020-10-01,2481,2361,120,4.8
48109,2020-10-01,1159,1087,72,6.2
48111,2020-10-01,3873,3775,98,2.5
48113,2020-10-01,NA,NA,95073,6.9
48115,2020-10-01,4662,4242,420,9
48117,2020-10-01,8782,8469,313,3.6
48119,2020-10-01,2474,2351,123,5
48121,2020-10-01,513001,485134,27867,5.4
48123,2020-10-01,9310,8730,580,6.2
48125,2020-10-01,684,644,40,5.8
48127,2020-10-01,6302,5866,436,6.9
48129,2020-10-01,1472,1419,53,3.6
48131,2020-10-01,4907,4282,625,12.7
48133,2020-10-01,7490,7011,479,6.4
48135,2020-10-01,81869,71803,10066,12.3
48137,2020-10-01,1379,1325,54,3.9
48139,2020-10-01,95580,90515,5065,5.3
48141,2020-10-01,369100,342346,26754,7.2
48143,2020-10-01,20840,19788,1052,5
48145,2020-10-01,6728,6364,364,5.4
48147,2020-10-01,17209,16490,719,4.2
48149,2020-10-01,11994,11447,547,4.6
48151,2020-10-01,1659,1583,76,4.6
48153,2020-10-01,2587,2456,131,5.1
48155,2020-10-01,587,565,22,3.7
48157,2020-10-01,397782,368935,28847,7.3
48159,2020-10-01,4978,4736,242,4.9
48161,2020-10-01,6369,5866,503,7.9
48163,2020-10-01,9398,8855,543,5.8
48165,2020-10-01,9889,9305,584,5.9
48167,2020-10-01,165049,152126,12923,7.8
48169,2020-10-01,2042,1903,139,6.8
48171,2020-10-01,13504,12976,528,3.9
48173,2020-10-01,816,785,31,3.8
48175,2020-10-01,3211,2964,247,7.7
48177,2020-10-01,9853,9332,521,5.3
48179,2020-10-01,7756,7117,639,8.2
48181,2020-10-01,65392,62017,3375,5.2
48183,2020-10-01,56999,52451,4548,8
48185,2020-10-01,11439,10544,895,7.8
48187,2020-10-01,82458,78168,4290,5.2
48189,2020-10-01,12094,11375,719,5.9
48191,2020-10-01,1118,1055,63,5.6
48193,2020-10-01,3872,3709,163,4.2
48195,2020-10-01,2616,2517,99,3.8
48197,2020-10-01,1755,1679,76,4.3
48199,2020-10-01,25193,23164,2029,8.1
48201,2020-10-01,NA,NA,188590,8.2
48203,2020-10-01,29410,27160,2250,7.7
48205,2020-10-01,2721,2675,46,1.7
48207,2020-10-01,2710,2600,110,4.1
48209,2020-10-01,123611,117153,6458,5.2
48211,2020-10-01,1844,1768,76,4.1
48213,2020-10-01,37956,35713,2243,5.9
48215,2020-10-01,362660,324846,37814,10.4
48217,2020-10-01,16618,15683,935,5.6
48219,2020-10-01,10707,9876,831,7.8
48221,2020-10-01,28224,26535,1689,6
48223,2020-10-01,17931,17090,841,4.7
48225,2020-10-01,10213,9678,535,5.2
48227,2020-10-01,13474,12315,1159,8.6
48229,2020-10-01,1917,1765,152,7.9
48231,2020-10-01,44386,41858,2528,5.7
48233,2020-10-01,8700,8145,555,6.4
48235,2020-10-01,780,726,54,6.9
48237,2020-10-01,3368,3144,224,6.7
48239,2020-10-01,7280,6869,411,5.6
48241,2020-10-01,12918,11583,1335,10.3
48243,2020-10-01,1017,973,44,4.3
48245,2020-10-01,106166,94646,11520,10.9
48247,2020-10-01,1932,1734,198,10.2
48249,2020-10-01,15892,13685,2207,13.9
48251,2020-10-01,84765,79925,4840,5.7
48253,2020-10-01,5867,5470,397,6.8
48255,2020-10-01,6910,6425,485,7
48257,2020-10-01,68771,64742,4029,5.9
48259,2020-10-01,22672,21704,968,4.3
48261,2020-10-01,177,165,12,6.8
48263,2020-10-01,454,439,15,3.3
48265,2020-10-01,21535,20479,1056,4.9
48267,2020-10-01,1850,1751,99,5.4
48269,2020-10-01,266,263,3,1.1
48271,2020-10-01,1310,1240,70,5.3
48273,2020-10-01,13822,12760,1062,7.7
48275,2020-10-01,1511,1429,82,5.4
48277,2020-10-01,24124,22718,1406,5.8
48279,2020-10-01,5335,5081,254,4.8
48281,2020-10-01,9207,8758,449,4.9
48283,2020-10-01,3546,3306,240,6.8
48285,2020-10-01,8532,8081,451,5.3
48287,2020-10-01,9276,8855,421,4.5
48289,2020-10-01,6297,5823,474,7.5
48291,2020-10-01,33996,30414,3582,10.5
48293,2020-10-01,8419,7813,606,7.2
48295,2020-10-01,1569,1510,59,3.8
48297,2020-10-01,5109,4695,414,8.1
48299,2020-10-01,8690,8236,454,5.2
48301,2020-10-01,315,312,3,1
48303,2020-10-01,160565,152334,8231,5.1
48305,2020-10-01,2838,2697,141,5
48307,2020-10-01,3315,3067,248,7.5
48309,2020-10-01,123376,116649,6727,5.5
48311,2020-10-01,704,685,19,2.7
48313,2020-10-01,4601,4278,323,7
48315,2020-10-01,4376,4041,335,7.7
48317,2020-10-01,2506,2350,156,6.2
48319,2020-10-01,1753,1655,98,5.6
48321,2020-10-01,16775,15145,1630,9.7
48323,2020-10-01,24389,20899,3490,14.3
48325,2020-10-01,22066,20796,1270,5.8
48327,2020-10-01,869,829,40,4.6
48329,2020-10-01,96203,87673,8530,8.9
48331,2020-10-01,9986,9345,641,6.4
48333,2020-10-01,1951,1875,76,3.9
48335,2020-10-01,2450,2237,213,8.7
48337,2020-10-01,9165,8594,571,6.2
48339,2020-10-01,287055,266820,20235,7
48341,2020-10-01,10826,10434,392,3.6
48343,2020-10-01,4792,4170,622,13
48345,2020-10-01,452,433,19,4.2
48347,2020-10-01,28691,27014,1677,5.8
48349,2020-10-01,23882,22625,1257,5.3
48351,2020-10-01,5077,4582,495,9.7
48353,2020-10-01,7399,7016,383,5.2
48355,2020-10-01,164860,151257,13603,8.3
48357,2020-10-01,4078,3849,229,5.6
48359,2020-10-01,921,887,34,3.7
48361,2020-10-01,36284,32793,3491,9.6
48363,2020-10-01,13383,12466,917,6.9
48365,2020-10-01,9406,8631,775,8.2
48367,2020-10-01,69776,66107,3669,5.3
48369,2020-10-01,5219,5091,128,2.5
48371,2020-10-01,6826,6252,574,8.4
48373,2020-10-01,18757,17213,1544,8.2
48375,2020-10-01,55494,52703,2791,5
48377,2020-10-01,3265,2806,459,14.1
48379,2020-10-01,6206,5951,255,4.1
48381,2020-10-01,74074,71253,2821,3.8
48383,2020-10-01,1788,1587,201,11.2
48385,2020-10-01,1101,1035,66,6
48387,2020-10-01,5306,4994,312,5.9
48389,2020-10-01,8567,7835,732,8.5
48391,2020-10-01,3140,2878,262,8.3
48393,2020-10-01,426,406,20,4.7
48395,2020-10-01,7621,7160,461,6
48397,2020-10-01,54175,51464,2711,5
48399,2020-10-01,4596,4396,200,4.4
48401,2020-10-01,22414,20755,1659,7.4
48403,2020-10-01,4005,3627,378,9.4
48405,2020-10-01,3001,2717,284,9.5
48407,2020-10-01,11839,10938,901,7.6
48409,2020-10-01,29440,26607,2833,9.6
48411,2020-10-01,2175,2075,100,4.6
48413,2020-10-01,1198,1109,89,7.4
48415,2020-10-01,6243,5734,509,8.2
48417,2020-10-01,1783,1687,96,5.4
48419,2020-10-01,11485,10736,749,6.5
48421,2020-10-01,1362,1316,46,3.4
48423,2020-10-01,110525,103877,6648,6
48425,2020-10-01,4413,4171,242,5.5
48427,2020-10-01,26309,22319,3990,15.2
48429,2020-10-01,4144,3861,283,6.8
48431,2020-10-01,583,547,36,6.2
48433,2020-10-01,590,560,30,5.1
48435,2020-10-01,1205,1077,128,10.6
48437,2020-10-01,2592,2471,121,4.7
48439,2020-10-01,NA,NA,71095,6.4
48441,2020-10-01,67105,63841,3264,4.9
48443,2020-10-01,402,387,15,3.7
48445,2020-10-01,4952,4589,363,7.3
48447,2020-10-01,649,618,31,4.8
48449,2020-10-01,13638,12821,817,6
48451,2020-10-01,54570,51416,3154,5.8
48453,2020-10-01,755808,715648,40160,5.3
48455,2020-10-01,5414,5009,405,7.5
48457,2020-10-01,7446,6779,667,9
48459,2020-10-01,17593,16298,1295,7.4
48461,2020-10-01,1843,1732,111,6
48463,2020-10-01,11435,10731,704,6.2
48465,2020-10-01,23383,21774,1609,6.9
48467,2020-10-01,26634,25153,1481,5.6
48469,2020-10-01,41473,38296,3177,7.7
48471,2020-10-01,24418,22745,1673,6.9
48473,2020-10-01,24071,22272,1799,7.5
48475,2020-10-01,5894,5250,644,10.9
48477,2020-10-01,15749,14919,830,5.3
48479,2020-10-01,116732,107457,9275,7.9
48481,2020-10-01,21712,20270,1442,6.6
48483,2020-10-01,2288,2132,156,6.8
48485,2020-10-01,55867,52314,3553,6.4
48487,2020-10-01,5061,4762,299,5.9
48489,2020-10-01,6592,5898,694,10.5
48491,2020-10-01,324954,309102,15852,4.9
48493,2020-10-01,25122,23839,1283,5.1
48495,2020-10-01,3947,3538,409,10.4
48497,2020-10-01,32843,30982,1861,5.7
48499,2020-10-01,18393,17305,1088,5.9
48501,2020-10-01,3486,3070,416,11.9
48503,2020-10-01,7971,7587,384,4.8
48505,2020-10-01,4357,3736,621,14.3
48507,2020-10-01,3430,2964,466,13.6
49001,2020-10-01,2834,2750,84,3
49003,2020-10-01,26339,25671,668,2.5
49005,2020-10-01,66258,64878,1380,2.1
49007,2020-10-01,8588,8241,347,4
49009,2020-10-01,410,397,13,3.2
49011,2020-10-01,176355,171138,5217,3
49013,2020-10-01,7625,7101,524,6.9
49015,2020-10-01,4400,4262,138,3.1
49017,2020-10-01,2793,2658,135,4.8
49019,2020-10-01,6350,6078,272,4.3
49021,2020-10-01,25570,24735,835,3.3
49023,2020-10-01,5985,5860,125,2.1
49025,2020-10-01,3805,3683,122,3.2
49027,2020-10-01,5892,5749,143,2.4
49029,2020-10-01,5590,5456,134,2.4
49031,2020-10-01,476,457,19,4
49033,2020-10-01,1115,1094,21,1.9
49035,2020-10-01,640469,616681,23788,3.7
49037,2020-10-01,5399,4988,411,7.6
49039,2020-10-01,12807,12448,359,2.8
49041,2020-10-01,9839,9542,297,3
49043,2020-10-01,22355,21253,1102,4.9
49045,2020-10-01,35003,33773,1230,3.5
49047,2020-10-01,13278,12171,1107,8.3
49049,2020-10-01,319189,310331,8858,2.8
49051,2020-10-01,15951,15300,651,4.1
49053,2020-10-01,81257,78263,2994,3.7
49055,2020-10-01,1477,1429,48,3.2
49057,2020-10-01,129853,125423,4430,3.4
50001,2020-10-01,19853,19384,469,2.4
50003,2020-10-01,16007,15432,575,3.6
50005,2020-10-01,13920,13555,365,2.6
50007,2020-10-01,90327,88066,2261,2.5
50009,2020-10-01,2503,2432,71,2.8
50011,2020-10-01,25256,24566,690,2.7
50013,2020-10-01,3868,3741,127,3.3
50015,2020-10-01,12478,12033,445,3.6
50017,2020-10-01,15020,14653,367,2.4
50019,2020-10-01,12021,11598,423,3.5
50021,2020-10-01,27961,26919,1042,3.7
50023,2020-10-01,31581,30839,742,2.3
50025,2020-10-01,19989,19261,728,3.6
50027,2020-10-01,26601,25825,776,2.9
51001,2020-10-01,16149,15294,855,5.3
51003,2020-10-01,54662,52116,2546,4.7
51005,2020-10-01,6784,6451,333,4.9
51007,2020-10-01,6126,5811,315,5.1
51009,2020-10-01,14542,13836,706,4.9
51011,2020-10-01,7012,6643,369,5.3
51013,2020-10-01,148844,141983,6861,4.6
51015,2020-10-01,36995,35593,1402,3.8
51017,2020-10-01,2237,2101,136,6.1
51019,2020-10-01,37250,35640,1610,4.3
51021,2020-10-01,2801,2687,114,4.1
51023,2020-10-01,16835,16215,620,3.7
51025,2020-10-01,5906,5432,474,8
51027,2020-10-01,6260,5739,521,8.3
51029,2020-10-01,6224,5804,420,6.7
51031,2020-10-01,25172,23884,1288,5.1
51033,2020-10-01,14678,13773,905,6.2
51035,2020-10-01,13084,12357,727,5.6
51036,2020-10-01,3556,3355,201,5.7
51037,2020-10-01,5123,4874,249,4.9
51041,2020-10-01,181516,171875,9641,5.3
51043,2020-10-01,7419,7137,282,3.8
51045,2020-10-01,2240,2152,88,3.9
51047,2020-10-01,24070,23071,999,4.2
51049,2020-10-01,4537,4280,257,5.7
51051,2020-10-01,4698,4377,321,6.8
51053,2020-10-01,13214,12421,793,6
51057,2020-10-01,5492,5134,358,6.5
51059,2020-10-01,616846,582389,34457,5.6
51061,2020-10-01,36333,34899,1434,3.9
51063,2020-10-01,8082,7785,297,3.7
51065,2020-10-01,13398,12790,608,4.5
51067,2020-10-01,25640,24411,1229,4.8
51069,2020-10-01,48125,46363,1762,3.7
51071,2020-10-01,7636,7290,346,4.5
51073,2020-10-01,19012,18125,887,4.7
51075,2020-10-01,10905,10446,459,4.2
51077,2020-10-01,8452,8115,337,4
51079,2020-10-01,9956,9536,420,4.2
51081,2020-10-01,4240,3951,289,6.8
51083,2020-10-01,15142,14205,937,6.2
51085,2020-10-01,56618,54229,2389,4.2
51087,2020-10-01,176183,165390,10793,6.1
51089,2020-10-01,24071,22454,1617,6.7
51091,2020-10-01,1326,1291,35,2.6
51093,2020-10-01,18949,18047,902,4.8
51095,2020-10-01,35789,33747,2042,5.7
51097,2020-10-01,3865,3681,184,4.8
51099,2020-10-01,13804,13281,523,3.8
51101,2020-10-01,8884,8454,430,4.8
51103,2020-10-01,5415,5108,307,5.7
51105,2020-10-01,8159,7748,411,5
51107,2020-10-01,218649,208167,10482,4.8
51109,2020-10-01,19943,19089,854,4.3
51111,2020-10-01,5336,5057,279,5.2
51113,2020-10-01,7337,7109,228,3.1
51115,2020-10-01,3995,3827,168,4.2
51117,2020-10-01,12803,12003,800,6.2
51119,2020-10-01,5128,4907,221,4.3
51121,2020-10-01,48157,46353,1804,3.7
51125,2020-10-01,7214,6863,351,4.9
51127,2020-10-01,12217,11740,477,3.9
51131,2020-10-01,5667,5292,375,6.6
51133,2020-10-01,5748,5458,290,5
51135,2020-10-01,7053,6684,369,5.2
51137,2020-10-01,17024,16219,805,4.7
51139,2020-10-01,12126,11533,593,4.9
51141,2020-10-01,7221,6822,399,5.5
51143,2020-10-01,30101,28567,1534,5.1
51145,2020-10-01,13595,13067,528,3.9
51147,2020-10-01,10129,9574,555,5.5
51149,2020-10-01,14604,13688,916,6.3
51153,2020-10-01,241090,226270,14820,6.1
51155,2020-10-01,15703,14819,884,5.6
51157,2020-10-01,3654,3513,141,3.9
51159,2020-10-01,4081,3911,170,4.2
51161,2020-10-01,47651,45631,2020,4.2
51163,2020-10-01,10583,10115,468,4.4
51165,2020-10-01,41514,40059,1455,3.5
51167,2020-10-01,11113,10518,595,5.4
51169,2020-10-01,8823,8445,378,4.3
51171,2020-10-01,22133,21182,951,4.3
51173,2020-10-01,13310,12618,692,5.2
51175,2020-10-01,9259,8836,423,4.6
51177,2020-10-01,65690,62255,3435,5.2
51179,2020-10-01,70803,67179,3624,5.1
51181,2020-10-01,3588,3416,172,4.8
51183,2020-10-01,3844,3510,334,8.7
51185,2020-10-01,15447,14442,1005,6.5
51187,2020-10-01,19769,18822,947,4.8
51191,2020-10-01,25440,24296,1144,4.5
51193,2020-10-01,9566,9067,499,5.2
51195,2020-10-01,12707,11842,865,6.8
51197,2020-10-01,13786,13046,740,5.4
51199,2020-10-01,31747,30302,1445,4.6
51510,2020-10-01,98773,92652,6121,6.2
51520,2020-10-01,7162,6675,487,6.8
51530,2020-10-01,3149,3005,144,4.6
51540,2020-10-01,24779,23386,1393,5.6
51550,2020-10-01,120352,113545,6807,5.7
51570,2020-10-01,8289,7728,561,6.8
51580,2020-10-01,2376,2208,168,7.1
51590,2020-10-01,19311,17605,1706,8.8
51595,2020-10-01,2389,2110,279,11.7
51600,2020-10-01,12746,12104,642,5
51610,2020-10-01,8139,7838,301,3.7
51620,2020-10-01,3703,3359,344,9.3
51630,2020-10-01,13688,12800,888,6.5
51640,2020-10-01,2861,2706,155,5.4
51650,2020-10-01,63772,58543,5229,8.2
51660,2020-10-01,23938,22768,1170,4.9
51670,2020-10-01,9670,8594,1076,11.1
51678,2020-10-01,2052,1936,116,5.7
51680,2020-10-01,35537,33201,2336,6.6
51683,2020-10-01,21232,19947,1285,6.1
51685,2020-10-01,9293,8693,600,6.5
51690,2020-10-01,5736,5139,597,10.4
51700,2020-10-01,88376,81134,7242,8.2
51710,2020-10-01,110620,101074,9546,8.6
51720,2020-10-01,1624,1515,109,6.7
51730,2020-10-01,13440,11365,2075,15.4
51735,2020-10-01,6175,5973,202,3.3
51740,2020-10-01,44562,40030,4532,10.2
51750,2020-10-01,8317,7915,402,4.8
51760,2020-10-01,117401,107304,10097,8.6
51770,2020-10-01,48234,44778,3456,7.2
51775,2020-10-01,12357,11773,584,4.7
51790,2020-10-01,12103,11477,626,5.2
51800,2020-10-01,44110,41299,2811,6.4
51810,2020-10-01,225951,213953,11998,5.3
51820,2020-10-01,10592,9985,607,5.7
51830,2020-10-01,6541,6090,451,6.9
51840,2020-10-01,14829,14090,739,5
53001,2020-10-01,8852,8423,429,4.8
53003,2020-10-01,10984,10593,391,3.6
53005,2020-10-01,106587,100789,5798,5.4
53007,2020-10-01,44464,42096,2368,5.3
53009,2020-10-01,30774,28738,2036,6.6
53011,2020-10-01,253545,237501,16044,6.3
53013,2020-10-01,1797,1712,85,4.7
53015,2020-10-01,50350,46928,3422,6.8
53017,2020-10-01,21326,20141,1185,5.6
53019,2020-10-01,2588,2402,186,7.2
53021,2020-10-01,42366,39776,2590,6.1
53023,2020-10-01,880,829,51,5.8
53025,2020-10-01,46899,44145,2754,5.9
53027,2020-10-01,29914,27385,2529,8.5
53029,2020-10-01,37887,35653,2234,5.9
53031,2020-10-01,13925,13069,856,6.1
53033,2020-10-01,NA,NA,80760,6.3
53035,2020-10-01,134351,126930,7421,5.5
53037,2020-10-01,22945,21687,1258,5.5
53039,2020-10-01,9928,9350,578,5.8
53041,2020-10-01,36277,34014,2263,6.2
53043,2020-10-01,5024,4804,220,4.4
53045,2020-10-01,27042,25109,1933,7.1
53047,2020-10-01,19792,18667,1125,5.7
53049,2020-10-01,8974,8298,676,7.5
53051,2020-10-01,5141,4758,383,7.4
53053,2020-10-01,464720,433235,31485,6.8
53055,2020-10-01,9458,9037,421,4.5
53057,2020-10-01,63935,59712,4223,6.6
53059,2020-10-01,5760,5366,394,6.8
53061,2020-10-01,438762,408241,30521,7
53063,2020-10-01,266060,250754,15306,5.8
53065,2020-10-01,19128,17994,1134,5.9
53067,2020-10-01,150459,142011,8448,5.6
53069,2020-10-01,1548,1459,89,5.7
53071,2020-10-01,31201,29747,1454,4.7
53073,2020-10-01,118551,110737,7814,6.6
53075,2020-10-01,22866,21873,993,4.3
53077,2020-10-01,127942,119572,8370,6.5
54001,2020-10-01,7536,7067,469,6.2
54003,2020-10-01,58935,56154,2781,4.7
54005,2020-10-01,7371,6753,618,8.4
54007,2020-10-01,5084,4691,393,7.7
54009,2020-10-01,9914,9201,713,7.2
54011,2020-10-01,42105,39559,2546,6
54013,2020-10-01,2410,2159,251,10.4
54015,2020-10-01,3074,2794,280,9.1
54017,2020-10-01,3777,3595,182,4.8
54019,2020-10-01,16346,15135,1211,7.4
54021,2020-10-01,2420,2247,173,7.1
54023,2020-10-01,5942,5681,261,4.4
54025,2020-10-01,15919,15056,863,5.4
54027,2020-10-01,11098,10644,454,4.1
54029,2020-10-01,13031,12041,990,7.6
54031,2020-10-01,5901,5596,305,5.2
54033,2020-10-01,33760,31652,2108,6.2
54035,2020-10-01,12722,11874,848,6.7
54037,2020-10-01,30614,29220,1394,4.6
54039,2020-10-01,82039,76169,5870,7.2
54041,2020-10-01,6257,5714,543,8.7
54043,2020-10-01,7248,6719,529,7.3
54045,2020-10-01,10980,9876,1104,10.1
54047,2020-10-01,4396,3915,481,10.9
54049,2020-10-01,25372,23745,1627,6.4
54051,2020-10-01,13632,12675,957,7
54053,2020-10-01,10552,9916,636,6
54055,2020-10-01,20925,19308,1617,7.7
54057,2020-10-01,12411,11734,677,5.5
54059,2020-10-01,6734,5961,773,11.5
54061,2020-10-01,55303,52742,2561,4.6
54063,2020-10-01,6245,5919,326,5.2
54065,2020-10-01,8560,8198,362,4.2
54067,2020-10-01,9724,9003,721,7.4
54069,2020-10-01,20631,19348,1283,6.2
54071,2020-10-01,3854,3730,124,3.2
54073,2020-10-01,2683,2461,222,8.3
54075,2020-10-01,3630,3375,255,7
54077,2020-10-01,15678,14900,778,5
54079,2020-10-01,27166,25737,1429,5.3
54081,2020-10-01,30860,28745,2115,6.9
54083,2020-10-01,12301,11492,809,6.6
54085,2020-10-01,4353,4081,272,6.2
54087,2020-10-01,5011,4545,466,9.3
54089,2020-10-01,4401,4139,262,6
54091,2020-10-01,7846,7422,424,5.4
54093,2020-10-01,3276,3087,189,5.8
54095,2020-10-01,3168,2914,254,8
54097,2020-10-01,9573,8827,746,7.8
54099,2020-10-01,15864,14877,987,6.2
54101,2020-10-01,3459,3209,250,7.2
54103,2020-10-01,6793,6299,494,7.3
54105,2020-10-01,2301,2105,196,8.5
54107,2020-10-01,36468,34062,2406,6.6
54109,2020-10-01,6305,5783,522,8.3
55001,2020-10-01,7886,7381,505,6.4
55003,2020-10-01,7648,7241,407,5.3
55005,2020-10-01,23516,22753,763,3.2
55007,2020-10-01,7292,6908,384,5.3
55009,2020-10-01,140025,134367,5658,4
55011,2020-10-01,6162,5929,233,3.8
55013,2020-10-01,7003,6630,373,5.3
55015,2020-10-01,26969,26152,817,3
55017,2020-10-01,32999,31811,1188,3.6
55019,2020-10-01,17097,16653,444,2.6
55021,2020-10-01,31134,29986,1148,3.7
55023,2020-10-01,7340,7063,277,3.8
55025,2020-10-01,321939,310807,11132,3.5
55027,2020-10-01,46998,45474,1524,3.2
55029,2020-10-01,15344,14808,536,3.5
55031,2020-10-01,22523,21381,1142,5.1
55033,2020-10-01,23965,23207,758,3.2
55035,2020-10-01,58804,56805,1999,3.4
55037,2020-10-01,2177,2057,120,5.5
55039,2020-10-01,55991,54125,1866,3.3
55041,2020-10-01,3818,3450,368,9.6
55043,2020-10-01,27524,26635,889,3.2
55045,2020-10-01,20515,19878,637,3.1
55047,2020-10-01,9129,8783,346,3.8
55049,2020-10-01,13303,12843,460,3.5
55051,2020-10-01,2497,2321,176,7
55053,2020-10-01,9590,8981,609,6.4
55055,2020-10-01,45225,43630,1595,3.5
55057,2020-10-01,13189,12575,614,4.7
55059,2020-10-01,88252,83851,4401,5
55061,2020-10-01,10558,10266,292,2.8
55063,2020-10-01,65240,63040,2200,3.4
55065,2020-10-01,9657,9390,267,2.8
55067,2020-10-01,9114,8726,388,4.3
55069,2020-10-01,14581,14071,510,3.5
55071,2020-10-01,40233,38734,1499,3.7
55073,2020-10-01,71538,69254,2284,3.2
55075,2020-10-01,19328,18399,929,4.8
55077,2020-10-01,7635,7309,326,4.3
55078,2020-10-01,1621,1408,213,13.1
55079,2020-10-01,463115,432098,31017,6.7
55081,2020-10-01,23052,22193,859,3.7
55083,2020-10-01,20018,19247,771,3.9
55085,2020-10-01,17440,16704,736,4.2
55087,2020-10-01,102221,98646,3575,3.5
55089,2020-10-01,47963,46082,1881,3.9
55091,2020-10-01,4044,3938,106,2.6
55093,2020-10-01,24258,23365,893,3.7
55095,2020-10-01,23838,22890,948,4
55097,2020-10-01,37610,36272,1338,3.6
55099,2020-10-01,6170,5928,242,3.9
55101,2020-10-01,96568,91336,5232,5.4
55103,2020-10-01,8904,8635,269,3
55105,2020-10-01,84125,80246,3879,4.6
55107,2020-10-01,6491,6239,252,3.9
55109,2020-10-01,48891,46951,1940,4
55111,2020-10-01,33604,32080,1524,4.5
55113,2020-10-01,7804,7423,381,4.9
55115,2020-10-01,20566,19715,851,4.1
55117,2020-10-01,61138,59036,2102,3.4
55119,2020-10-01,10791,10501,290,2.7
55121,2020-10-01,15301,14684,617,4
55123,2020-10-01,14740,14269,471,3.2
55125,2020-10-01,10106,9683,423,4.2
55127,2020-10-01,56609,54450,2159,3.8
55129,2020-10-01,7661,7369,292,3.8
55131,2020-10-01,75242,72474,2768,3.7
55133,2020-10-01,220288,211561,8727,4
55135,2020-10-01,25190,24244,946,3.8
55137,2020-10-01,10926,10505,421,3.9
55139,2020-10-01,90930,87759,3171,3.5
55141,2020-10-01,34321,32811,1510,4.4
56001,2020-10-01,18991,18432,559,2.9
56003,2020-10-01,5471,5295,176,3.2
56005,2020-10-01,22878,21536,1342,5.9
56007,2020-10-01,8353,8115,238,2.8
56009,2020-10-01,7846,7416,430,5.5
56011,2020-10-01,4019,3899,120,3
56013,2020-10-01,19328,18438,890,4.6
56015,2020-10-01,6730,6515,215,3.2
56017,2020-10-01,2235,2152,83,3.7
56019,2020-10-01,4218,4053,165,3.9
56021,2020-10-01,50521,48615,1906,3.8
56023,2020-10-01,9444,9134,310,3.3
56025,2020-10-01,40237,37598,2639,6.6
56027,2020-10-01,1288,1249,39,3
56029,2020-10-01,15683,15138,545,3.5
56031,2020-10-01,4686,4527,159,3.4
56033,2020-10-01,16188,15603,585,3.6
56035,2020-10-01,4035,3832,203,5
56037,2020-10-01,20460,19345,1115,5.4
56039,2020-10-01,14929,14380,549,3.7
56041,2020-10-01,9297,8858,439,4.7
56043,2020-10-01,3997,3864,133,3.3
56045,2020-10-01,3843,3731,112,2.9
72001,2020-10-01,4032,3606,426,10.6
72003,2020-10-01,11430,10472,958,8.4
72005,2020-10-01,13939,12682,1257,9
72007,2020-10-01,6234,5638,596,9.6
72009,2020-10-01,6111,5591,520,8.5
72011,2020-10-01,8549,7903,646,7.6
72013,2020-10-01,23146,21183,1963,8.5
72015,2020-10-01,4440,4078,362,8.2
72017,2020-10-01,5612,5056,556,9.9
72019,2020-10-01,7019,6378,641,9.1
72021,2020-10-01,63379,57746,5633,8.9
72023,2020-10-01,13321,12244,1077,8.1
72025,2020-10-01,45951,42352,3599,7.8
72027,2020-10-01,9208,8481,727,7.9
72029,2020-10-01,15736,14374,1362,8.7
72031,2020-10-01,60006,54700,5306,8.8
72033,2020-10-01,7622,6864,758,9.9
72035,2020-10-01,15306,14260,1046,6.8
72037,2020-10-01,3473,3138,335,9.6
72039,2020-10-01,3583,3141,442,12.3
72041,2020-10-01,14629,13773,856,5.9
72043,2020-10-01,9479,8621,858,9.1
72045,2020-10-01,4719,4249,470,10
72047,2020-10-01,8739,7717,1022,11.7
72049,2020-10-01,835,760,75,9
72051,2020-10-01,12906,11962,944,7.3
72053,2020-10-01,10347,9262,1085,10.5
72054,2020-10-01,3172,2816,356,11.2
72055,2020-10-01,3828,3423,405,10.6
72057,2020-10-01,10544,9752,792,7.5
72059,2020-10-01,4564,4098,466,10.2
72061,2020-10-01,36253,34233,2020,5.6
72063,2020-10-01,17549,16542,1007,5.7
72065,2020-10-01,12717,11804,913,7.2
72067,2020-10-01,5208,4789,419,8
72069,2020-10-01,16234,14961,1273,7.8
72071,2020-10-01,11337,10430,907,8
72073,2020-10-01,4273,3913,360,8.4
72075,2020-10-01,14910,13825,1085,7.3
72077,2020-10-01,11870,10847,1023,8.6
72079,2020-10-01,5054,4531,523,10.3
72081,2020-10-01,6842,6145,697,10.2
72083,2020-10-01,2633,2397,236,9
72085,2020-10-01,10837,9939,898,8.3
72087,2020-10-01,8168,7355,813,10
72089,2020-10-01,6004,5353,651,10.8
72091,2020-10-01,11151,10269,882,7.9
72093,2020-10-01,1919,1791,128,6.7
72095,2020-10-01,2594,2363,231,8.9
72097,2020-10-01,20707,19002,1705,8.2
72099,2020-10-01,10053,9134,919,9.1
72101,2020-10-01,7764,6971,793,10.2
72103,2020-10-01,7796,7189,607,7.8
72105,2020-10-01,6972,6153,819,11.7
72107,2020-10-01,4693,4165,528,11.3
72109,2020-10-01,3997,3636,361,9
72111,2020-10-01,5367,4816,551,10.3
72113,2020-10-01,42744,39145,3599,8.4
72115,2020-10-01,5814,5246,568,9.8
72117,2020-10-01,4411,4005,406,9.2
72119,2020-10-01,16581,14972,1609,9.7
72121,2020-10-01,5731,5249,482,8.4
72123,2020-10-01,6709,6026,683,10.2
72125,2020-10-01,9205,8435,770,8.4
72127,2020-10-01,130249,119390,10859,8.3
72129,2020-10-01,11050,10164,886,8
72131,2020-10-01,9774,8767,1007,10.3
72133,2020-10-01,8470,7846,624,7.4
72135,2020-10-01,26519,24588,1931,7.3
72137,2020-10-01,28285,26010,2275,8
72139,2020-10-01,26092,24418,1674,6.4
72141,2020-10-01,6318,5800,518,8.2
72143,2020-10-01,9529,8546,983,10.3
72145,2020-10-01,12794,11381,1413,11
72147,2020-10-01,2349,2090,259,11
72149,2020-10-01,6625,5987,638,9.6
72151,2020-10-01,8153,7355,798,9.8
72153,2020-10-01,9197,8261,936,10.2
01001,2020-11-01,26163,25344,819,3.1
01003,2020-11-01,95948,92658,3290,3.4
01005,2020-11-01,8730,8209,521,6
01007,2020-11-01,8710,8349,361,4.1
01009,2020-11-01,25120,24507,613,2.4
01011,2020-11-01,5074,4850,224,4.4
01013,2020-11-01,9152,8598,554,6.1
01015,2020-11-01,46426,44397,2029,4.4
01017,2020-11-01,16213,15523,690,4.3
01019,2020-11-01,11867,11558,309,2.6
01021,2020-11-01,19913,19327,586,2.9
01023,2020-11-01,4758,4552,206,4.3
01025,2020-11-01,7887,7388,499,6.3
01027,2020-11-01,6283,6100,183,2.9
01029,2020-11-01,5802,5654,148,2.6
01031,2020-11-01,22072,21444,628,2.8
01033,2020-11-01,23879,22972,907,3.8
01035,2020-11-01,4592,4358,234,5.1
01037,2020-11-01,4478,4314,164,3.7
01039,2020-11-01,15709,15232,477,3
01041,2020-11-01,6481,6264,217,3.3
01043,2020-11-01,39743,38796,947,2.4
01045,2020-11-01,21258,20527,731,3.4
01047,2020-11-01,14733,13598,1135,7.7
01049,2020-11-01,31495,30660,835,2.7
01051,2020-11-01,37039,35892,1147,3.1
01053,2020-11-01,14670,14068,602,4.1
01055,2020-11-01,40603,38788,1815,4.5
01057,2020-11-01,6717,6500,217,3.2
01059,2020-11-01,14810,14434,376,2.5
01061,2020-11-01,11064,10762,302,2.7
01063,2020-11-01,2999,2767,232,7.7
01065,2020-11-01,6140,5744,396,6.4
01067,2020-11-01,6912,6676,236,3.4
01069,2020-11-01,46806,45020,1786,3.8
01071,2020-11-01,23447,22750,697,3
01073,2020-11-01,319935,306098,13837,4.3
01075,2020-11-01,5853,5688,165,2.8
01077,2020-11-01,42624,41296,1328,3.1
01079,2020-11-01,14584,14144,440,3
01081,2020-11-01,77720,75251,2469,3.2
01083,2020-11-01,45506,44364,1142,2.5
01085,2020-11-01,3664,3290,374,10.2
01087,2020-11-01,8158,7605,553,6.8
01089,2020-11-01,190862,185151,5711,3
01091,2020-11-01,7925,7554,371,4.7
01093,2020-11-01,13464,13050,414,3.1
01095,2020-11-01,45655,44511,1144,2.5
01097,2020-11-01,192007,181621,10386,5.4
01099,2020-11-01,7565,7138,427,5.6
01101,2020-11-01,107964,101762,6202,5.7
01103,2020-11-01,59837,58151,1686,2.8
01105,2020-11-01,3507,3216,291,8.3
01107,2020-11-01,7756,7412,344,4.4
01109,2020-11-01,16190,15634,556,3.4
01111,2020-11-01,9543,9284,259,2.7
01113,2020-11-01,23464,22660,804,3.4
01115,2020-11-01,40600,39427,1173,2.9
01117,2020-11-01,115948,113270,2678,2.3
01119,2020-11-01,4904,4668,236,4.8
01121,2020-11-01,36434,34918,1516,4.2
01123,2020-11-01,18177,17343,834,4.6
01125,2020-11-01,102393,98154,4239,4.1
01127,2020-11-01,25155,24208,947,3.8
01129,2020-11-01,6843,6482,361,5.3
01131,2020-11-01,2877,2547,330,11.5
01133,2020-11-01,10129,9818,311,3.1
02013,2020-11-01,1569,1500,69,4.4
02016,2020-11-01,2665,2538,127,4.8
02020,2020-11-01,152637,143604,9033,5.9
02050,2020-11-01,6984,6296,688,9.9
02060,2020-11-01,242,222,20,8.3
02068,2020-11-01,744,667,77,10.3
02070,2020-11-01,1618,1502,116,7.2
02090,2020-11-01,45607,43376,2231,4.9
02100,2020-11-01,949,844,105,11.1
02105,2020-11-01,973,874,99,10.2
02110,2020-11-01,16614,15787,827,5
02122,2020-11-01,26362,24286,2076,7.9
02130,2020-11-01,6551,6060,491,7.5
02150,2020-11-01,5918,5592,326,5.5
02158,2020-11-01,2569,2188,381,14.8
02164,2020-11-01,571,527,44,7.7
02170,2020-11-01,48971,45829,3142,6.4
02180,2020-11-01,4028,3719,309,7.7
02185,2020-11-01,2972,2789,183,6.2
02188,2020-11-01,3098,2804,294,9.5
02195,2020-11-01,1297,1210,87,6.7
02198,2020-11-01,2831,2640,191,6.7
02220,2020-11-01,4015,3811,204,5.1
02230,2020-11-01,609,513,96,15.8
02240,2020-11-01,2908,2722,186,6.4
02261,2020-11-01,4206,3877,329,7.8
02275,2020-11-01,987,925,62,6.3
02282,2020-11-01,234,217,17,7.3
02290,2020-11-01,2294,2107,187,8.2
04001,2020-11-01,19748,17661,2087,10.6
04003,2020-11-01,52813,50047,2766,5.2
04005,2020-11-01,74894,69342,5552,7.4
04007,2020-11-01,20996,19657,1339,6.4
04009,2020-11-01,16377,15548,829,5.1
04011,2020-11-01,4386,4158,228,5.2
04012,2020-11-01,9490,8964,526,5.5
04013,2020-11-01,NA,NA,143134,6.1
04015,2020-11-01,87518,81213,6305,7.2
04017,2020-11-01,40282,37075,3207,8
04019,2020-11-01,494410,462565,31845,6.4
04021,2020-11-01,193748,181932,11816,6.1
04023,2020-11-01,19420,17507,1913,9.9
04025,2020-11-01,107075,100969,6106,5.7
04027,2020-11-01,97409,85959,11450,11.8
05001,2020-11-01,9292,8963,329,3.5
05003,2020-11-01,6948,6407,541,7.8
05005,2020-11-01,16147,15440,707,4.4
05007,2020-11-01,139822,134994,4828,3.5
05009,2020-11-01,15461,14874,587,3.8
05011,2020-11-01,4266,4064,202,4.7
05013,2020-11-01,2389,2293,96,4
05015,2020-11-01,12339,11825,514,4.2
05017,2020-11-01,3184,2894,290,9.1
05019,2020-11-01,9240,8824,416,4.5
05021,2020-11-01,5397,5178,219,4.1
05023,2020-11-01,8840,8336,504,5.7
05025,2020-11-01,3177,3009,168,5.3
05027,2020-11-01,8928,8402,526,5.9
05029,2020-11-01,8242,7860,382,4.6
05031,2020-11-01,54640,52455,2185,4
05033,2020-11-01,26066,24984,1082,4.2
05035,2020-11-01,20791,19443,1348,6.5
05037,2020-11-01,7091,6741,350,4.9
05039,2020-11-01,2817,2709,108,3.8
05041,2020-11-01,5192,4896,296,5.7
05043,2020-11-01,7553,7152,401,5.3
05045,2020-11-01,59837,57383,2454,4.1
05047,2020-11-01,7339,7022,317,4.3
05049,2020-11-01,4755,4551,204,4.3
05051,2020-11-01,40043,37558,2485,6.2
05053,2020-11-01,8018,7695,323,4
05055,2020-11-01,18876,18075,801,4.2
05057,2020-11-01,9292,8932,360,3.9
05059,2020-11-01,13810,13196,614,4.4
05061,2020-11-01,5437,5228,209,3.8
05063,2020-11-01,16188,15520,668,4.1
05065,2020-11-01,4440,4159,281,6.3
05067,2020-11-01,5743,5421,322,5.6
05069,2020-11-01,26989,25093,1896,7
05071,2020-11-01,9958,9508,450,4.5
05073,2020-11-01,2398,2226,172,7.2
05075,2020-11-01,6714,6400,314,4.7
05077,2020-11-01,2747,2581,166,6
05079,2020-11-01,3788,3607,181,4.8
05081,2020-11-01,5253,4983,270,5.1
05083,2020-11-01,8462,8055,407,4.8
05085,2020-11-01,32687,31261,1426,4.4
05087,2020-11-01,7469,7226,243,3.3
05089,2020-11-01,5903,5575,328,5.6
05091,2020-11-01,18849,17831,1018,5.4
05093,2020-11-01,16652,15409,1243,7.5
05095,2020-11-01,2658,2489,169,6.4
05097,2020-11-01,2928,2770,158,5.4
05099,2020-11-01,3422,3270,152,4.4
05101,2020-11-01,3187,3078,109,3.4
05103,2020-11-01,9573,9144,429,4.5
05105,2020-11-01,4070,3901,169,4.2
05107,2020-11-01,6260,5798,462,7.4
05109,2020-11-01,4221,4006,215,5.1
05111,2020-11-01,9781,9358,423,4.3
05113,2020-11-01,7859,7449,410,5.2
05115,2020-11-01,27239,26046,1193,4.4
05117,2020-11-01,3595,3438,157,4.4
05119,2020-11-01,183319,171990,11329,6.2
05121,2020-11-01,7399,7049,350,4.7
05123,2020-11-01,7742,7226,516,6.7
05125,2020-11-01,56522,54323,2199,3.9
05127,2020-11-01,4287,4129,158,3.7
05129,2020-11-01,2768,2643,125,4.5
05131,2020-11-01,55246,52708,2538,4.6
05133,2020-11-01,5407,5138,269,5
05135,2020-11-01,5552,5228,324,5.8
05137,2020-11-01,4537,4265,272,6
05139,2020-11-01,15059,14057,1002,6.7
05141,2020-11-01,5632,5300,332,5.9
05143,2020-11-01,125953,121391,4562,3.6
05145,2020-11-01,33265,31675,1590,4.8
05147,2020-11-01,2772,2633,139,5
05149,2020-11-01,7916,7610,306,3.9
06001,2020-11-01,801292,746563,54729,6.8
06003,2020-11-01,492,455,37,7.5
06005,2020-11-01,14181,13196,985,6.9
06007,2020-11-01,90313,84106,6207,6.9
06009,2020-11-01,20942,19767,1175,5.6
06011,2020-11-01,10203,9170,1033,10.1
06013,2020-11-01,532913,496126,36787,6.9
06015,2020-11-01,9121,8432,689,7.6
06017,2020-11-01,89936,84832,5104,5.7
06019,2020-11-01,439439,402165,37274,8.5
06021,2020-11-01,12169,11419,750,6.2
06023,2020-11-01,58694,55061,3633,6.2
06025,2020-11-01,64823,54183,10640,16.4
06027,2020-11-01,8183,7711,472,5.8
06029,2020-11-01,379585,345235,34350,9
06031,2020-11-01,54311,49532,4779,8.8
06033,2020-11-01,27812,25759,2053,7.4
06035,2020-11-01,9872,9380,492,5
06037,2020-11-01,NA,NA,588980,11.9
06039,2020-11-01,60387,55594,4793,7.9
06041,2020-11-01,128817,122497,6320,4.9
06043,2020-11-01,6610,6057,553,8.4
06045,2020-11-01,35950,33528,2422,6.7
06047,2020-11-01,112988,102967,10021,8.9
06049,2020-11-01,3160,2974,186,5.9
06051,2020-11-01,7218,6632,586,8.1
06053,2020-11-01,205841,191509,14332,7
06055,2020-11-01,66078,61825,4253,6.4
06057,2020-11-01,45647,43042,2605,5.7
06059,2020-11-01,NA,NA,100770,6.6
06061,2020-11-01,184108,174545,9563,5.2
06063,2020-11-01,7164,6634,530,7.4
06065,2020-11-01,NA,NA,85081,7.7
06067,2020-11-01,705193,653558,51635,7.3
06069,2020-11-01,30697,28584,2113,6.9
06071,2020-11-01,972556,896177,76379,7.9
06073,2020-11-01,NA,NA,104336,6.8
06075,2020-11-01,541049,509017,32032,5.9
06077,2020-11-01,330682,302022,28660,8.7
06079,2020-11-01,131197,124053,7144,5.4
06081,2020-11-01,424019,401600,22419,5.3
06083,2020-11-01,215776,203484,12292,5.7
06085,2020-11-01,NA,957194,52742,5.2
06087,2020-11-01,129330,120750,8580,6.6
06089,2020-11-01,72421,67704,4717,6.5
06091,2020-11-01,1285,1219,66,5.1
06093,2020-11-01,16814,15665,1149,6.8
06095,2020-11-01,201219,186037,15182,7.5
06097,2020-11-01,238960,225261,13699,5.7
06099,2020-11-01,237923,218723,19200,8.1
06101,2020-11-01,43690,40179,3511,8
06103,2020-11-01,25360,23698,1662,6.6
06105,2020-11-01,4468,4214,254,5.7
06107,2020-11-01,192076,173599,18477,9.6
06109,2020-11-01,19623,18179,1444,7.4
06111,2020-11-01,403604,377879,25725,6.4
06113,2020-11-01,104461,98413,6048,5.8
06115,2020-11-01,29427,26979,2448,8.3
08001,2020-11-01,280272,258676,21596,7.7
08003,2020-11-01,8486,7957,529,6.2
08005,2020-11-01,373862,346059,27803,7.4
08007,2020-11-01,7265,6829,436,6
08009,2020-11-01,2209,2158,51,2.3
08011,2020-11-01,1912,1817,95,5
08013,2020-11-01,194912,184259,10653,5.5
08014,2020-11-01,40846,38474,2372,5.8
08015,2020-11-01,9860,9350,510,5.2
08017,2020-11-01,1132,1100,32,2.8
08019,2020-11-01,6216,5763,453,7.3
08021,2020-11-01,4136,3904,232,5.6
08023,2020-11-01,1837,1701,136,7.4
08025,2020-11-01,1566,1470,96,6.1
08027,2020-11-01,2106,2007,99,4.7
08029,2020-11-01,14388,13509,879,6.1
08031,2020-11-01,431983,398285,33698,7.8
08033,2020-11-01,1168,1101,67,5.7
08035,2020-11-01,197734,187848,9886,5
08037,2020-11-01,33595,30953,2642,7.9
08039,2020-11-01,15267,14633,634,4.2
08041,2020-11-01,352258,329353,22905,6.5
08043,2020-11-01,15596,14391,1205,7.7
08045,2020-11-01,30399,28570,1829,6
08047,2020-11-01,3918,3646,272,6.9
08049,2020-11-01,9029,8437,592,6.6
08051,2020-11-01,10799,10221,578,5.4
08053,2020-11-01,362,347,15,4.1
08055,2020-11-01,2702,2456,246,9.1
08057,2020-11-01,951,912,39,4.1
08059,2020-11-01,339074,317484,21590,6.4
08061,2020-11-01,998,974,24,2.4
08063,2020-11-01,4338,4214,124,2.9
08065,2020-11-01,4686,4355,331,7.1
08067,2020-11-01,31560,29589,1971,6.2
08069,2020-11-01,208848,197298,11550,5.5
08071,2020-11-01,6657,6133,524,7.9
08073,2020-11-01,2428,2312,116,4.8
08075,2020-11-01,11265,10721,544,4.8
08077,2020-11-01,77424,72228,5196,6.7
08079,2020-11-01,412,388,24,5.8
08081,2020-11-01,7394,7041,353,4.8
08083,2020-11-01,12605,11822,783,6.2
08085,2020-11-01,21648,20379,1269,5.9
08087,2020-11-01,16457,15537,920,5.6
08089,2020-11-01,8422,7869,553,6.6
08091,2020-11-01,2429,2263,166,6.8
08093,2020-11-01,11259,10721,538,4.8
08095,2020-11-01,2476,2411,65,2.6
08097,2020-11-01,10874,9719,1155,10.6
08099,2020-11-01,6351,6043,308,4.8
08101,2020-11-01,80292,73173,7119,8.9
08103,2020-11-01,2991,2838,153,5.1
08105,2020-11-01,5596,5207,389,7
08107,2020-11-01,15972,15033,939,5.9
08109,2020-11-01,3527,3265,262,7.4
08111,2020-11-01,397,376,21,5.3
08113,2020-11-01,4631,4101,530,11.4
08115,2020-11-01,1186,1146,40,3.4
08117,2020-11-01,22663,21215,1448,6.4
08119,2020-11-01,13151,12384,767,5.8
08121,2020-11-01,2992,2900,92,3.1
08123,2020-11-01,170062,158078,11984,7
08125,2020-11-01,5674,5514,160,2.8
09001,2020-11-01,457928,423594,34334,7.5
09003,2020-11-01,469562,432644,36918,7.9
09005,2020-11-01,100116,93804,6312,6.3
09007,2020-11-01,91134,85603,5531,6.1
09009,2020-11-01,454506,418912,35594,7.8
09011,2020-11-01,128906,117895,11011,8.5
09013,2020-11-01,83220,78513,4707,5.7
09015,2020-11-01,60695,56263,4432,7.3
10001,2020-11-01,78349,73950,4399,5.6
10003,2020-11-01,298531,282897,15634,5.2
10005,2020-11-01,104777,100054,4723,4.5
11001,2020-11-01,409289,375016,34273,8.4
12001,2020-11-01,135360,130603,4757,3.5
12003,2020-11-01,11978,11538,440,3.7
12005,2020-11-01,81758,78688,3070,3.8
12007,2020-11-01,10891,10470,421,3.9
12009,2020-11-01,279277,268086,11191,4
12011,2020-11-01,995849,944346,51503,5.2
12013,2020-11-01,4800,4615,185,3.9
12015,2020-11-01,70796,67818,2978,4.2
12017,2020-11-01,45980,43560,2420,5.3
12019,2020-11-01,106697,103218,3479,3.3
12021,2020-11-01,177151,170602,6549,3.7
12023,2020-11-01,30089,28800,1289,4.3
12027,2020-11-01,14019,13533,486,3.5
12029,2020-11-01,6011,5784,227,3.8
12031,2020-11-01,487294,466705,20589,4.2
12033,2020-11-01,144127,137866,6261,4.3
12035,2020-11-01,46114,44059,2055,4.5
12037,2020-11-01,4728,4558,170,3.6
12039,2020-11-01,18812,17819,993,5.3
12041,2020-11-01,7084,6832,252,3.6
12043,2020-11-01,5368,5181,187,3.5
12045,2020-11-01,4966,4778,188,3.8
12047,2020-11-01,4145,3911,234,5.6
12049,2020-11-01,8525,8151,374,4.4
12051,2020-11-01,15837,15057,780,4.9
12053,2020-11-01,70739,67335,3404,4.8
12055,2020-11-01,34561,32792,1769,5.1
12057,2020-11-01,751673,720078,31595,4.2
12059,2020-11-01,6856,6606,250,3.6
12061,2020-11-01,63511,60702,2809,4.4
12063,2020-11-01,17478,16760,718,4.1
12065,2020-11-01,5388,5162,226,4.2
12067,2020-11-01,2802,2709,93,3.3
12069,2020-11-01,147723,140290,7433,5
12071,2020-11-01,342425,328081,14344,4.2
12073,2020-11-01,150634,144632,6002,4
12075,2020-11-01,16743,16067,676,4
12077,2020-11-01,2591,2503,88,3.4
12079,2020-11-01,7709,7378,331,4.3
12081,2020-11-01,176098,169214,6884,3.9
12083,2020-11-01,139449,133047,6402,4.6
12085,2020-11-01,71382,68937,2445,3.4
12086,2020-11-01,NA,NA,106956,8.2
12087,2020-11-01,43865,42294,1571,3.6
12089,2020-11-01,41560,40207,1353,3.3
12091,2020-11-01,96012,92954,3058,3.2
12093,2020-11-01,17327,16682,645,3.7
12095,2020-11-01,700801,658922,41879,6
12097,2020-11-01,173444,160691,12753,7.4
12099,2020-11-01,707214,676405,30809,4.4
12101,2020-11-01,236624,226470,10154,4.3
12103,2020-11-01,480471,461156,19315,4
12105,2020-11-01,313280,296344,16936,5.4
12107,2020-11-01,26482,24975,1507,5.7
12109,2020-11-01,134378,130410,3968,3
12111,2020-11-01,142932,136204,6728,4.7
12113,2020-11-01,82609,80004,2605,3.2
12115,2020-11-01,183242,176186,7056,3.9
12117,2020-11-01,230444,220635,9809,4.3
12119,2020-11-01,31575,29933,1642,5.2
12121,2020-11-01,17745,17036,709,4
12123,2020-11-01,8085,7692,393,4.9
12125,2020-11-01,4526,4366,160,3.5
12127,2020-11-01,246839,235681,11158,4.5
12129,2020-11-01,14936,14511,425,2.8
12131,2020-11-01,31887,30808,1079,3.4
12133,2020-11-01,9388,9033,355,3.8
13001,2020-11-01,9151,8798,353,3.9
13003,2020-11-01,4551,4414,137,3
13005,2020-11-01,4686,4496,190,4.1
13007,2020-11-01,1179,1116,63,5.3
13009,2020-11-01,17783,16704,1079,6.1
13011,2020-11-01,10212,9915,297,2.9
13013,2020-11-01,40485,38934,1551,3.8
13015,2020-11-01,50026,47705,2321,4.6
13017,2020-11-01,5505,5141,364,6.6
13019,2020-11-01,7691,7373,318,4.1
13021,2020-11-01,68694,64045,4649,6.8
13023,2020-11-01,4599,4337,262,5.7
13025,2020-11-01,7121,6822,299,4.2
13027,2020-11-01,7156,6828,328,4.6
13029,2020-11-01,19174,18415,759,4
13031,2020-11-01,38111,36073,2038,5.3
13033,2020-11-01,9219,8623,596,6.5
13035,2020-11-01,10894,10311,583,5.4
13037,2020-11-01,2320,2217,103,4.4
13039,2020-11-01,21565,20786,779,3.6
13043,2020-11-01,5739,5509,230,4
13045,2020-11-01,54962,52224,2738,5
13047,2020-11-01,33189,32236,953,2.9
13049,2020-11-01,4956,4809,147,3
13051,2020-11-01,143516,134871,8645,6
13053,2020-11-01,2004,1893,111,5.5
13055,2020-11-01,9659,9114,545,5.6
13057,2020-11-01,134177,129505,4672,3.5
13059,2020-11-01,59196,56184,3012,5.1
13061,2020-11-01,910,805,105,11.5
13063,2020-11-01,141748,128210,13538,9.6
13065,2020-11-01,3059,2956,103,3.4
13067,2020-11-01,418253,398847,19406,4.6
13069,2020-11-01,19410,18451,959,4.9
13071,2020-11-01,22654,21790,864,3.8
13073,2020-11-01,75500,73160,2340,3.1
13075,2020-11-01,8331,7986,345,4.1
13077,2020-11-01,74474,70995,3479,4.7
13079,2020-11-01,5587,5365,222,4
13081,2020-11-01,9787,8999,788,8.1
13083,2020-11-01,8040,7803,237,2.9
13085,2020-11-01,12463,12027,436,3.5
13087,2020-11-01,11510,11010,500,4.3
13089,2020-11-01,399833,372464,27369,6.8
13091,2020-11-01,7093,6742,351,4.9
13093,2020-11-01,4984,4663,321,6.4
13095,2020-11-01,38116,35023,3093,8.1
13097,2020-11-01,73062,68455,4607,6.3
13099,2020-11-01,4479,4213,266,5.9
13101,2020-11-01,1990,1926,64,3.2
13103,2020-11-01,32187,30965,1222,3.8
13105,2020-11-01,8035,7537,498,6.2
13107,2020-11-01,8750,8165,585,6.7
13109,2020-11-01,5174,4931,243,4.7
13111,2020-11-01,11387,11013,374,3.3
13113,2020-11-01,56916,54602,2314,4.1
13115,2020-11-01,43657,41677,1980,4.5
13117,2020-11-01,121983,118044,3939,3.2
13119,2020-11-01,10050,9606,444,4.4
13121,2020-11-01,562908,524341,38567,6.9
13123,2020-11-01,12152,11732,420,3.5
13125,2020-11-01,1262,1224,38,3
13127,2020-11-01,38483,36511,1972,5.1
13129,2020-11-01,28572,27424,1148,4
13131,2020-11-01,10883,10477,406,3.7
13133,2020-11-01,7071,6704,367,5.2
13135,2020-11-01,485551,461315,24236,5
13137,2020-11-01,18742,17974,768,4.1
13139,2020-11-01,104150,100633,3517,3.4
13141,2020-11-01,2595,2375,220,8.5
13143,2020-11-01,12350,11796,554,4.5
13145,2020-11-01,16522,15993,529,3.2
13147,2020-11-01,11570,11071,499,4.3
13149,2020-11-01,5179,4916,263,5.1
13151,2020-11-01,116378,109220,7158,6.2
13153,2020-11-01,71805,68759,3046,4.2
13155,2020-11-01,3567,3400,167,4.7
13157,2020-11-01,42076,40817,1259,3
13159,2020-11-01,6859,6584,275,4
13161,2020-11-01,6140,5865,275,4.5
13163,2020-11-01,6748,6351,397,5.9
13165,2020-11-01,3259,3091,168,5.2
13167,2020-11-01,4167,3987,180,4.3
13169,2020-11-01,13594,13098,496,3.6
13171,2020-11-01,8081,7651,430,5.3
13173,2020-11-01,3869,3695,174,4.5
13175,2020-11-01,19947,18896,1051,5.3
13177,2020-11-01,14829,14314,515,3.5
13179,2020-11-01,26145,24762,1383,5.3
13181,2020-11-01,3566,3411,155,4.3
13183,2020-11-01,8308,8014,294,3.5
13185,2020-11-01,53380,50705,2675,5
13187,2020-11-01,16602,16084,518,3.1
13189,2020-11-01,8774,8230,544,6.2
13191,2020-11-01,6068,5777,291,4.8
13193,2020-11-01,4710,4408,302,6.4
13195,2020-11-01,13218,12704,514,3.9
13197,2020-11-01,3209,3076,133,4.1
13199,2020-11-01,8893,8265,628,7.1
13201,2020-11-01,2832,2734,98,3.5
13205,2020-11-01,8392,7871,521,6.2
13207,2020-11-01,12936,12397,539,4.2
13209,2020-11-01,3994,3820,174,4.4
13211,2020-11-01,9290,8883,407,4.4
13213,2020-11-01,15447,14626,821,5.3
13215,2020-11-01,77183,72106,5077,6.6
13217,2020-11-01,52511,49323,3188,6.1
13219,2020-11-01,19595,19091,504,2.6
13221,2020-11-01,6943,6691,252,3.6
13223,2020-11-01,86107,82569,3538,4.1
13225,2020-11-01,12111,11451,660,5.4
13227,2020-11-01,15066,14535,531,3.5
13229,2020-11-01,8687,8363,324,3.7
13231,2020-11-01,8790,8475,315,3.6
13233,2020-11-01,18544,17683,861,4.6
13235,2020-11-01,4078,3926,152,3.7
13237,2020-11-01,8293,7861,432,5.2
13239,2020-11-01,815,771,44,5.4
13241,2020-11-01,7278,7017,261,3.6
13243,2020-11-01,2516,2378,138,5.5
13245,2020-11-01,86414,80685,5729,6.6
13247,2020-11-01,44531,41586,2945,6.6
13249,2020-11-01,2175,2098,77,3.5
13251,2020-11-01,5152,4802,350,6.8
13253,2020-11-01,3118,2978,140,4.5
13255,2020-11-01,28664,26766,1898,6.6
13257,2020-11-01,10540,10000,540,5.1
13259,2020-11-01,2542,2411,131,5.2
13261,2020-11-01,12765,11864,901,7.1
13263,2020-11-01,2784,2618,166,6
13265,2020-11-01,527,496,31,5.9
13267,2020-11-01,9740,9386,354,3.6
13269,2020-11-01,2775,2604,171,6.2
13271,2020-11-01,3776,3461,315,8.3
13273,2020-11-01,3574,3294,280,7.8
13275,2020-11-01,17104,16166,938,5.5
13277,2020-11-01,21357,20454,903,4.2
13279,2020-11-01,12348,11713,635,5.1
13281,2020-11-01,3885,3704,181,4.7
13283,2020-11-01,2776,2639,137,4.9
13285,2020-11-01,37810,35634,2176,5.8
13287,2020-11-01,3368,3112,256,7.6
13289,2020-11-01,2821,2653,168,6
13291,2020-11-01,10699,10369,330,3.1
13293,2020-11-01,11398,10801,597,5.2
13295,2020-11-01,31167,30095,1072,3.4
13297,2020-11-01,45338,43455,1883,4.2
13299,2020-11-01,15576,14859,717,4.6
13301,2020-11-01,2690,2546,144,5.4
13303,2020-11-01,7051,6620,431,6.1
13305,2020-11-01,11803,11249,554,4.7
13307,2020-11-01,1019,970,49,4.8
13309,2020-11-01,1626,1531,95,5.8
13311,2020-11-01,16466,15990,476,2.9
13313,2020-11-01,43473,41324,2149,4.9
13315,2020-11-01,2809,2668,141,5
13317,2020-11-01,3730,3504,226,6.1
13319,2020-11-01,3802,3613,189,5
13321,2020-11-01,8980,8537,443,4.9
15001,2020-11-01,90285,81151,9134,10.1
15003,2020-11-01,451660,410768,40892,9.1
15007,2020-11-01,34791,29852,4939,14.2
15009,2020-11-01,81498,68099,13399,16.4
16001,2020-11-01,259816,249183,10633,4.1
16003,2020-11-01,1734,1597,137,7.9
16005,2020-11-01,43847,42185,1662,3.8
16007,2020-11-01,3104,3004,100,3.2
16009,2020-11-01,4104,3886,218,5.3
16011,2020-11-01,23950,23143,807,3.4
16013,2020-11-01,12231,11624,607,5
16015,2020-11-01,3615,3389,226,6.3
16017,2020-11-01,21337,20174,1163,5.5
16019,2020-11-01,59757,57827,1930,3.2
16021,2020-11-01,5512,5248,264,4.8
16023,2020-11-01,1415,1374,41,2.9
16025,2020-11-01,676,654,22,3.3
16027,2020-11-01,106192,101335,4857,4.6
16029,2020-11-01,4179,4041,138,3.3
16031,2020-11-01,12597,12222,375,3
16033,2020-11-01,378,366,12,3.2
16035,2020-11-01,3039,2845,194,6.4
16037,2020-11-01,2127,2029,98,4.6
16039,2020-11-01,12144,11682,462,3.8
16041,2020-11-01,7146,6945,201,2.8
16043,2020-11-01,8302,8044,258,3.1
16045,2020-11-01,8526,8102,424,5
16047,2020-11-01,8463,8199,264,3.1
16049,2020-11-01,6766,6408,358,5.3
16051,2020-11-01,14480,14096,384,2.7
16053,2020-11-01,12331,11919,412,3.3
16055,2020-11-01,82030,77727,4303,5.2
16057,2020-11-01,20188,19460,728,3.6
16059,2020-11-01,3612,3415,197,5.5
16061,2020-11-01,1664,1561,103,6.2
16063,2020-11-01,2627,2515,112,4.3
16065,2020-11-01,23697,23168,529,2.2
16067,2020-11-01,11952,11560,392,3.3
16069,2020-11-01,20780,20019,761,3.7
16071,2020-11-01,2339,2262,77,3.3
16073,2020-11-01,5315,5057,258,4.9
16075,2020-11-01,12179,11652,527,4.3
16077,2020-11-01,4150,3987,163,3.9
16079,2020-11-01,5456,5027,429,7.9
16081,2020-11-01,6334,5999,335,5.3
16083,2020-11-01,41606,39936,1670,4
16085,2020-11-01,5440,5096,344,6.3
16087,2020-11-01,4877,4680,197,4
17001,2020-11-01,30810,29520,1290,4.2
17003,2020-11-01,1906,1760,146,7.7
17005,2020-11-01,7352,7028,324,4.4
17007,2020-11-01,24403,22852,1551,6.4
17009,2020-11-01,2927,2851,76,2.6
17011,2020-11-01,15890,15077,813,5.1
17013,2020-11-01,2169,2076,93,4.3
17015,2020-11-01,7179,6848,331,4.6
17017,2020-11-01,5659,5370,289,5.1
17019,2020-11-01,110753,105485,5268,4.8
17021,2020-11-01,13330,12603,727,5.5
17023,2020-11-01,7159,6830,329,4.6
17025,2020-11-01,5823,5516,307,5.3
17027,2020-11-01,19519,18816,703,3.6
17029,2020-11-01,23187,21934,1253,5.4
17031,2020-11-01,NA,NA,243913,9.7
17033,2020-11-01,8336,7941,395,4.7
17035,2020-11-01,5887,5639,248,4.2
17037,2020-11-01,51913,48886,3027,5.8
17039,2020-11-01,7084,6726,358,5.1
17041,2020-11-01,10048,9657,391,3.9
17043,2020-11-01,480617,448729,31888,6.6
17045,2020-11-01,8665,8320,345,4
17047,2020-11-01,2640,2526,114,4.3
17049,2020-11-01,19047,18271,776,4.1
17051,2020-11-01,9625,9160,465,4.8
17053,2020-11-01,6277,5995,282,4.5
17055,2020-11-01,15431,14457,974,6.3
17057,2020-11-01,14177,13391,786,5.5
17059,2020-11-01,1974,1848,126,6.4
17061,2020-11-01,5914,5626,288,4.9
17063,2020-11-01,23870,22270,1600,6.7
17065,2020-11-01,4145,3989,156,3.8
17067,2020-11-01,7845,7522,323,4.1
17069,2020-11-01,1269,1187,82,6.5
17071,2020-11-01,3486,3362,124,3.6
17073,2020-11-01,23451,22265,1186,5.1
17075,2020-11-01,13233,12640,593,4.5
17077,2020-11-01,27457,25954,1503,5.5
17079,2020-11-01,4636,4441,195,4.2
17081,2020-11-01,16558,15564,994,6
17083,2020-11-01,10473,9982,491,4.7
17085,2020-11-01,10134,9652,482,4.8
17087,2020-11-01,4003,3780,223,5.6
17089,2020-11-01,255310,238951,16359,6.4
17091,2020-11-01,52305,48848,3457,6.6
17093,2020-11-01,65469,61244,4225,6.5
17095,2020-11-01,20534,19218,1316,6.4
17097,2020-11-01,359694,338457,21237,5.9
17099,2020-11-01,51331,48173,3158,6.2
17101,2020-11-01,5714,5390,324,5.7
17103,2020-11-01,16912,16113,799,4.7
17105,2020-11-01,15527,14840,687,4.4
17107,2020-11-01,11967,11398,569,4.8
17109,2020-11-01,12950,12306,644,5
17111,2020-11-01,156369,146146,10223,6.5
17113,2020-11-01,84515,80457,4058,4.8
17115,2020-11-01,46115,42386,3729,8.1
17117,2020-11-01,21724,20787,937,4.3
17119,2020-11-01,129331,122678,6653,5.1
17121,2020-11-01,16641,15674,967,5.8
17123,2020-11-01,4998,4738,260,5.2
17125,2020-11-01,5782,5458,324,5.6
17127,2020-11-01,5272,4962,310,5.9
17129,2020-11-01,6035,5777,258,4.3
17131,2020-11-01,7484,7125,359,4.8
17133,2020-11-01,18160,17557,603,3.3
17135,2020-11-01,11094,10474,620,5.6
17137,2020-11-01,15667,14870,797,5.1
17139,2020-11-01,7222,6954,268,3.7
17141,2020-11-01,23713,22443,1270,5.4
17143,2020-11-01,81995,75827,6168,7.5
17145,2020-11-01,7831,7409,422,5.4
17147,2020-11-01,8606,8268,338,3.9
17149,2020-11-01,6581,6323,258,3.9
17151,2020-11-01,1634,1552,82,5
17153,2020-11-01,1746,1590,156,8.9
17155,2020-11-01,2916,2769,147,5
17157,2020-11-01,13444,12853,591,4.4
17159,2020-11-01,7204,6888,316,4.4
17161,2020-11-01,67169,63173,3996,5.9
17163,2020-11-01,123035,115171,7864,6.4
17165,2020-11-01,9260,8684,576,6.2
17167,2020-11-01,96139,90140,5999,6.2
17169,2020-11-01,3002,2872,130,4.3
17171,2020-11-01,2296,2186,110,4.8
17173,2020-11-01,10003,9588,415,4.1
17175,2020-11-01,2330,2207,123,5.3
17177,2020-11-01,20750,19621,1129,5.4
17179,2020-11-01,60723,57522,3201,5.3
17181,2020-11-01,6997,6619,378,5.4
17183,2020-11-01,32061,29994,2067,6.4
17185,2020-11-01,5508,5257,251,4.6
17187,2020-11-01,7881,7505,376,4.8
17189,2020-11-01,9489,9231,258,2.7
17191,2020-11-01,6577,6269,308,4.7
17193,2020-11-01,5929,5657,272,4.6
17195,2020-11-01,27303,25898,1405,5.1
17197,2020-11-01,339896,313858,26038,7.7
17199,2020-11-01,31434,29743,1691,5.4
17201,2020-11-01,130921,121039,9882,7.5
17203,2020-11-01,17813,17071,742,4.2
18001,2020-11-01,17010,16515,495,2.9
18003,2020-11-01,186420,177224,9196,4.9
18005,2020-11-01,44095,42378,1717,3.9
18007,2020-11-01,4450,4291,159,3.6
18009,2020-11-01,4830,4622,208,4.3
18011,2020-11-01,36366,35244,1122,3.1
18013,2020-11-01,7639,7313,326,4.3
18015,2020-11-01,9933,9574,359,3.6
18017,2020-11-01,17402,16684,718,4.1
18019,2020-11-01,61374,58523,2851,4.6
18021,2020-11-01,11552,10994,558,4.8
18023,2020-11-01,17136,16492,644,3.8
18025,2020-11-01,4845,4609,236,4.9
18027,2020-11-01,16670,16225,445,2.7
18029,2020-11-01,25133,24081,1052,4.2
18031,2020-11-01,14933,14351,582,3.9
18033,2020-11-01,22025,21193,832,3.8
18035,2020-11-01,53341,50767,2574,4.8
18037,2020-11-01,22585,21829,756,3.3
18039,2020-11-01,112975,108246,4729,4.2
18041,2020-11-01,8397,7880,517,6.2
18043,2020-11-01,41334,39651,1683,4.1
18045,2020-11-01,7800,7525,275,3.5
18047,2020-11-01,11431,11036,395,3.5
18049,2020-11-01,9721,9314,407,4.2
18051,2020-11-01,19721,19051,670,3.4
18053,2020-11-01,32124,30809,1315,4.1
18055,2020-11-01,13467,12893,574,4.3
18057,2020-11-01,185945,179990,5955,3.2
18059,2020-11-01,40886,39352,1534,3.8
18061,2020-11-01,19999,19240,759,3.8
18063,2020-11-01,90741,87534,3207,3.5
18065,2020-11-01,21846,20931,915,4.2
18067,2020-11-01,35161,33114,2047,5.8
18069,2020-11-01,18154,17501,653,3.6
18071,2020-11-01,23441,22566,875,3.7
18073,2020-11-01,15590,14940,650,4.2
18075,2020-11-01,8802,8512,290,3.3
18077,2020-11-01,15029,14404,625,4.2
18079,2020-11-01,13657,13029,628,4.6
18081,2020-11-01,83318,80231,3087,3.7
18083,2020-11-01,18483,17800,683,3.7
18085,2020-11-01,41490,39790,1700,4.1
18087,2020-11-01,19535,18961,574,2.9
18089,2020-11-01,223464,206694,16770,7.5
18091,2020-11-01,47435,44192,3243,6.8
18093,2020-11-01,20741,19782,959,4.6
18095,2020-11-01,59073,55930,3143,5.3
18097,2020-11-01,502281,470353,31928,6.4
18099,2020-11-01,22685,21801,884,3.9
18101,2020-11-01,5485,5307,178,3.2
18103,2020-11-01,14885,14131,754,5.1
18105,2020-11-01,69017,66400,2617,3.8
18107,2020-11-01,18605,17961,644,3.5
18109,2020-11-01,36153,34826,1327,3.7
18111,2020-11-01,6605,6348,257,3.9
18113,2020-11-01,22412,21431,981,4.4
18115,2020-11-01,3126,2995,131,4.2
18117,2020-11-01,8211,7692,519,6.3
18119,2020-11-01,9143,8747,396,4.3
18121,2020-11-01,6913,6663,250,3.6
18123,2020-11-01,9031,8655,376,4.2
18125,2020-11-01,6277,6046,231,3.7
18127,2020-11-01,83328,79056,4272,5.1
18129,2020-11-01,12984,12550,434,3.3
18131,2020-11-01,6432,6199,233,3.6
18133,2020-11-01,16499,15854,645,3.9
18135,2020-11-01,11255,10782,473,4.2
18137,2020-11-01,13789,13277,512,3.7
18139,2020-11-01,8819,8499,320,3.6
18141,2020-11-01,133145,125274,7871,5.9
18143,2020-11-01,10441,9914,527,5
18145,2020-11-01,23091,22167,924,4
18147,2020-11-01,10057,9669,388,3.9
18149,2020-11-01,9857,9312,545,5.5
18151,2020-11-01,20024,19307,717,3.6
18153,2020-11-01,7947,7582,365,4.6
18155,2020-11-01,4689,4448,241,5.1
18157,2020-11-01,96520,92150,4370,4.5
18159,2020-11-01,9045,8755,290,3.2
18161,2020-11-01,3457,3351,106,3.1
18163,2020-11-01,91429,86944,4485,4.9
18165,2020-11-01,6602,6286,316,4.8
18167,2020-11-01,45797,43265,2532,5.5
18169,2020-11-01,14768,14213,555,3.8
18171,2020-11-01,4069,3932,137,3.4
18173,2020-11-01,31744,30642,1102,3.5
18175,2020-11-01,13601,13047,554,4.1
18177,2020-11-01,30019,28559,1460,4.9
18179,2020-11-01,14270,13780,490,3.4
18181,2020-11-01,13373,12930,443,3.3
18183,2020-11-01,17380,16779,601,3.5
19001,2020-11-01,4259,4150,109,2.6
19003,2020-11-01,1993,1938,55,2.8
19005,2020-11-01,6986,6764,222,3.2
19007,2020-11-01,5896,5672,224,3.8
19009,2020-11-01,3050,2975,75,2.5
19011,2020-11-01,12687,12245,442,3.5
19013,2020-11-01,65679,62833,2846,4.3
19015,2020-11-01,14235,13843,392,2.8
19017,2020-11-01,13355,13017,338,2.5
19019,2020-11-01,10966,10582,384,3.5
19021,2020-11-01,11778,11443,335,2.8
19023,2020-11-01,7677,7432,245,3.2
19025,2020-11-01,4107,3980,127,3.1
19027,2020-11-01,10378,10102,276,2.7
19029,2020-11-01,6727,6545,182,2.7
19031,2020-11-01,10238,9919,319,3.1
19033,2020-11-01,22505,21666,839,3.7
19035,2020-11-01,6242,6079,163,2.6
19037,2020-11-01,6220,6043,177,2.8
19039,2020-11-01,4707,4548,159,3.4
19041,2020-11-01,8176,7931,245,3
19043,2020-11-01,9527,9203,324,3.4
19045,2020-11-01,21446,20426,1020,4.8
19047,2020-11-01,7930,7616,314,4
19049,2020-11-01,48798,47560,1238,2.5
19051,2020-11-01,4105,3976,129,3.1
19053,2020-11-01,4316,4220,96,2.2
19055,2020-11-01,10365,10091,274,2.6
19057,2020-11-01,18006,17109,897,5
19059,2020-11-01,9069,8779,290,3.2
19061,2020-11-01,53274,51161,2113,4
19063,2020-11-01,4892,4733,159,3.3
19065,2020-11-01,10304,9927,377,3.7
19067,2020-11-01,8128,7798,330,4.1
19069,2020-11-01,5598,5431,167,3
19071,2020-11-01,3736,3650,86,2.3
19073,2020-11-01,5338,5179,159,3
19075,2020-11-01,6281,6087,194,3.1
19077,2020-11-01,5396,5221,175,3.2
19079,2020-11-01,6730,6515,215,3.2
19081,2020-11-01,5713,5540,173,3
19083,2020-11-01,7680,7432,248,3.2
19085,2020-11-01,7008,6815,193,2.8
19087,2020-11-01,9602,9264,338,3.5
19089,2020-11-01,4995,4859,136,2.7
19091,2020-11-01,4902,4776,126,2.6
19093,2020-11-01,3920,3814,106,2.7
19095,2020-11-01,9849,9584,265,2.7
19097,2020-11-01,10394,9933,461,4.4
19099,2020-11-01,18803,18022,781,4.2
19101,2020-11-01,9354,8976,378,4
19103,2020-11-01,81693,78871,2822,3.5
19105,2020-11-01,10059,9685,374,3.7
19107,2020-11-01,5140,4971,169,3.3
19109,2020-11-01,8036,7836,200,2.5
19111,2020-11-01,15226,14508,718,4.7
19113,2020-11-01,115147,109714,5433,4.7
19115,2020-11-01,5932,5720,212,3.6
19117,2020-11-01,4653,4539,114,2.5
19119,2020-11-01,6855,6730,125,1.8
19121,2020-11-01,8188,7894,294,3.6
19123,2020-11-01,11677,11288,389,3.3
19125,2020-11-01,17646,17145,501,2.8
19127,2020-11-01,17044,16163,881,5.2
19129,2020-11-01,7058,6877,181,2.6
19131,2020-11-01,6031,5884,147,2.4
19133,2020-11-01,4307,4162,145,3.4
19135,2020-11-01,3833,3706,127,3.3
19137,2020-11-01,4781,4613,168,3.5
19139,2020-11-01,20172,19278,894,4.4
19141,2020-11-01,7955,7760,195,2.5
19143,2020-11-01,3534,3466,68,1.9
19145,2020-11-01,6112,5890,222,3.6
19147,2020-11-01,4432,4294,138,3.1
19149,2020-11-01,14182,13803,379,2.7
19151,2020-11-01,4258,4141,117,2.7
19153,2020-11-01,258403,247924,10479,4.1
19155,2020-11-01,46061,44447,1614,3.5
19157,2020-11-01,9537,9226,311,3.3
19159,2020-11-01,2390,2331,59,2.5
19161,2020-11-01,5148,5025,123,2.4
19163,2020-11-01,83805,79706,4099,4.9
19165,2020-11-01,6193,6041,152,2.5
19167,2020-11-01,20964,20617,347,1.7
19169,2020-11-01,56002,54634,1368,2.4
19171,2020-11-01,9001,8669,332,3.7
19173,2020-11-01,3043,2961,82,2.7
19175,2020-11-01,6083,5839,244,4
19177,2020-11-01,3610,3507,103,2.9
19179,2020-11-01,16894,16193,701,4.1
19181,2020-11-01,27040,26215,825,3.1
19183,2020-11-01,11307,10996,311,2.8
19185,2020-11-01,2822,2729,93,3.3
19187,2020-11-01,18256,17539,717,3.9
19189,2020-11-01,4865,4670,195,4
19191,2020-11-01,11223,10892,331,2.9
19193,2020-11-01,53099,51116,1983,3.7
19195,2020-11-01,3981,3849,132,3.3
19197,2020-11-01,6750,6539,211,3.1
20001,2020-11-01,6514,6253,261,4
20003,2020-11-01,4409,4275,134,3
20005,2020-11-01,6900,6586,314,4.6
20007,2020-11-01,2408,2347,61,2.5
20009,2020-11-01,13803,13296,507,3.7
20011,2020-11-01,6918,6629,289,4.2
20013,2020-11-01,5276,5121,155,2.9
20015,2020-11-01,32579,31088,1491,4.6
20017,2020-11-01,1461,1416,45,3.1
20019,2020-11-01,1533,1463,70,4.6
20021,2020-11-01,10128,9790,338,3.3
20023,2020-11-01,1395,1374,21,1.5
20025,2020-11-01,1222,1205,17,1.4
20027,2020-11-01,3993,3865,128,3.2
20029,2020-11-01,4036,3897,139,3.4
20031,2020-11-01,3863,3737,126,3.3
20033,2020-11-01,901,882,19,2.1
20035,2020-11-01,16874,16089,785,4.7
20037,2020-11-01,19334,18572,762,3.9
20039,2020-11-01,1331,1292,39,2.9
20041,2020-11-01,9092,8782,310,3.4
20043,2020-11-01,4234,4117,117,2.8
20045,2020-11-01,65275,62564,2711,4.2
20047,2020-11-01,1538,1496,42,2.7
20049,2020-11-01,1206,1170,36,3
20051,2020-11-01,17213,16759,454,2.6
20053,2020-11-01,2829,2755,74,2.6
20055,2020-11-01,21303,20692,611,2.9
20057,2020-11-01,17665,17150,515,2.9
20059,2020-11-01,14559,13993,566,3.9
20061,2020-11-01,11796,11195,601,5.1
20063,2020-11-01,1560,1510,50,3.2
20065,2020-11-01,1103,1061,42,3.8
20067,2020-11-01,3181,3050,131,4.1
20069,2020-11-01,3556,3486,70,2
20071,2020-11-01,872,857,15,1.7
20073,2020-11-01,3208,3091,117,3.6
20075,2020-11-01,1754,1727,27,1.5
20077,2020-11-01,2841,2744,97,3.4
20079,2020-11-01,17075,16409,666,3.9
20081,2020-11-01,2371,2330,41,1.7
20083,2020-11-01,1071,1052,19,1.8
20085,2020-11-01,7256,7031,225,3.1
20087,2020-11-01,10368,10012,356,3.4
20089,2020-11-01,1304,1279,25,1.9
20091,2020-11-01,346902,334428,12474,3.6
20093,2020-11-01,2153,2109,44,2
20095,2020-11-01,3432,3292,140,4.1
20097,2020-11-01,1343,1302,41,3.1
20099,2020-11-01,9807,9392,415,4.2
20101,2020-11-01,820,801,19,2.3
20103,2020-11-01,37084,35713,1371,3.7
20105,2020-11-01,1867,1815,52,2.8
20107,2020-11-01,4418,4220,198,4.5
20109,2020-11-01,1699,1657,42,2.5
20111,2020-11-01,16911,16299,612,3.6
20113,2020-11-01,17460,16956,504,2.9
20115,2020-11-01,6030,5825,205,3.4
20117,2020-11-01,5649,5509,140,2.5
20119,2020-11-01,2242,2193,49,2.2
20121,2020-11-01,17969,17324,645,3.6
20123,2020-11-01,3554,3468,86,2.4
20125,2020-11-01,14675,13932,743,5.1
20127,2020-11-01,3191,3112,79,2.5
20129,2020-11-01,1206,1173,33,2.7
20131,2020-11-01,5804,5672,132,2.3
20133,2020-11-01,6320,6001,319,5
20135,2020-11-01,1376,1337,39,2.8
20137,2020-11-01,2706,2638,68,2.5
20139,2020-11-01,8120,7833,287,3.5
20141,2020-11-01,2020,1976,44,2.2
20143,2020-11-01,3107,3001,106,3.4
20145,2020-11-01,2935,2853,82,2.8
20147,2020-11-01,2778,2699,79,2.8
20149,2020-11-01,12301,11933,368,3
20151,2020-11-01,5043,4911,132,2.6
20153,2020-11-01,1628,1598,30,1.8
20155,2020-11-01,29742,28459,1283,4.3
20157,2020-11-01,2416,2352,64,2.6
20159,2020-11-01,5216,5041,175,3.4
20161,2020-11-01,34864,33624,1240,3.6
20163,2020-11-01,2623,2542,81,3.1
20165,2020-11-01,1586,1540,46,2.9
20167,2020-11-01,3403,3301,102,3
20169,2020-11-01,29948,28812,1136,3.8
20171,2020-11-01,2992,2927,65,2.2
20173,2020-11-01,255521,239512,16009,6.3
20175,2020-11-01,10100,9690,410,4.1
20177,2020-11-01,92117,88220,3897,4.2
20179,2020-11-01,1549,1528,21,1.4
20181,2020-11-01,3012,2912,100,3.3
20183,2020-11-01,2119,2075,44,2.1
20185,2020-11-01,2151,2089,62,2.9
20187,2020-11-01,1175,1139,36,3.1
20189,2020-11-01,2940,2873,67,2.3
20191,2020-11-01,11075,10414,661,6
20193,2020-11-01,4429,4327,102,2.3
20195,2020-11-01,1519,1483,36,2.4
20197,2020-11-01,3788,3672,116,3.1
20199,2020-11-01,874,856,18,2.1
20201,2020-11-01,3242,3183,59,1.8
20203,2020-11-01,1327,1302,25,1.9
20205,2020-11-01,3991,3781,210,5.3
20207,2020-11-01,1539,1475,64,4.2
20209,2020-11-01,78544,74585,3959,5
21001,2020-11-01,6936,6576,360,5.2
21003,2020-11-01,8843,8507,336,3.8
21005,2020-11-01,11606,11079,527,4.5
21007,2020-11-01,3285,3114,171,5.2
21009,2020-11-01,17903,16824,1079,6
21011,2020-11-01,4499,4239,260,5.8
21013,2020-11-01,8159,7682,477,5.8
21015,2020-11-01,68861,65871,2990,4.3
21017,2020-11-01,9643,9265,378,3.9
21019,2020-11-01,17080,15987,1093,6.4
21021,2020-11-01,12402,11727,675,5.4
21023,2020-11-01,3680,3507,173,4.7
21025,2020-11-01,3225,2986,239,7.4
21027,2020-11-01,7748,7320,428,5.5
21029,2020-11-01,41253,39457,1796,4.4
21031,2020-11-01,4959,4732,227,4.6
21033,2020-11-01,5541,5281,260,4.7
21035,2020-11-01,17668,16751,917,5.2
21037,2020-11-01,48764,46583,2181,4.5
21039,2020-11-01,2128,2045,83,3.9
21041,2020-11-01,5161,4935,226,4.4
21043,2020-11-01,9455,8780,675,7.1
21045,2020-11-01,6587,6316,271,4.1
21047,2020-11-01,24368,23006,1362,5.6
21049,2020-11-01,16966,16091,875,5.2
21051,2020-11-01,5125,4753,372,7.3
21053,2020-11-01,3938,3796,142,3.6
21055,2020-11-01,3598,3451,147,4.1
21057,2020-11-01,3278,3165,113,3.4
21059,2020-11-01,44705,42574,2131,4.8
21061,2020-11-01,4582,4352,230,5
21063,2020-11-01,1904,1773,131,6.9
21065,2020-11-01,5002,4738,264,5.3
21067,2020-11-01,172169,164372,7797,4.5
21069,2020-11-01,6061,5775,286,4.7
21071,2020-11-01,10492,9679,813,7.7
21073,2020-11-01,24532,23210,1322,5.4
21075,2020-11-01,1946,1853,93,4.8
21077,2020-11-01,3964,3767,197,5
21079,2020-11-01,7429,7095,334,4.5
21081,2020-11-01,11263,10663,600,5.3
21083,2020-11-01,15435,14669,766,5
21085,2020-11-01,10500,9867,633,6
21087,2020-11-01,5042,4855,187,3.7
21089,2020-11-01,12872,12004,868,6.7
21091,2020-11-01,3723,3547,176,4.7
21093,2020-11-01,46250,43918,2332,5
21095,2020-11-01,6299,5686,613,9.7
21097,2020-11-01,8619,8262,357,4.1
21099,2020-11-01,7469,7131,338,4.5
21101,2020-11-01,20545,19568,977,4.8
21103,2020-11-01,7970,7678,292,3.7
21105,2020-11-01,1689,1617,72,4.3
21107,2020-11-01,17937,17028,909,5.1
21109,2020-11-01,3970,3709,261,6.6
21111,2020-11-01,385762,364555,21207,5.5
21113,2020-11-01,26140,24976,1164,4.5
21115,2020-11-01,6395,5910,485,7.6
21117,2020-11-01,84534,80555,3979,4.7
21119,2020-11-01,4308,3982,326,7.6
21121,2020-11-01,9905,9242,663,6.7
21123,2020-11-01,5689,5409,280,4.9
21125,2020-11-01,24587,23376,1211,4.9
21127,2020-11-01,5000,4672,328,6.6
21129,2020-11-01,1958,1848,110,5.6
21131,2020-11-01,2570,2345,225,8.8
21133,2020-11-01,5958,5452,506,8.5
21135,2020-11-01,4468,4171,297,6.6
21137,2020-11-01,9228,8666,562,6.1
21139,2020-11-01,3440,3235,205,6
21141,2020-11-01,11944,11516,428,3.6
21143,2020-11-01,3101,2971,130,4.2
21145,2020-11-01,27746,26145,1601,5.8
21147,2020-11-01,4828,4550,278,5.8
21149,2020-11-01,3967,3795,172,4.3
21151,2020-11-01,45712,43699,2013,4.4
21153,2020-11-01,3128,2696,432,13.8
21155,2020-11-01,9101,8666,435,4.8
21157,2020-11-01,14545,13829,716,4.9
21159,2020-11-01,2348,2129,219,9.3
21161,2020-11-01,6834,6452,382,5.6
21163,2020-11-01,11471,10865,606,5.3
21165,2020-11-01,2233,2067,166,7.4
21167,2020-11-01,9761,9254,507,5.2
21169,2020-11-01,3956,3730,226,5.7
21171,2020-11-01,4530,4343,187,4.1
21173,2020-11-01,11167,10515,652,5.8
21175,2020-11-01,4216,3981,235,5.6
21177,2020-11-01,9745,9070,675,6.9
21179,2020-11-01,22391,21431,960,4.3
21181,2020-11-01,3224,3089,135,4.2
21183,2020-11-01,8917,8436,481,5.4
21185,2020-11-01,32094,30979,1115,3.5
21187,2020-11-01,5008,4752,256,5.1
21189,2020-11-01,1034,966,68,6.6
21191,2020-11-01,6684,6425,259,3.9
21193,2020-11-01,8013,7442,571,7.1
21195,2020-11-01,18825,17502,1323,7
21197,2020-11-01,5036,4767,269,5.3
21199,2020-11-01,25260,23913,1347,5.3
21201,2020-11-01,776,744,32,4.1
21203,2020-11-01,6393,6057,336,5.3
21205,2020-11-01,9766,9250,516,5.3
21207,2020-11-01,5905,5570,335,5.7
21209,2020-11-01,28996,27869,1127,3.9
21211,2020-11-01,24935,23977,958,3.8
21213,2020-11-01,8596,8219,377,4.4
21215,2020-11-01,10075,9694,381,3.8
21217,2020-11-01,12965,12464,501,3.9
21219,2020-11-01,5305,5129,176,3.3
21221,2020-11-01,6041,5720,321,5.3
21223,2020-11-01,3748,3558,190,5.1
21225,2020-11-01,5902,5667,235,4
21227,2020-11-01,63288,60503,2785,4.4
21229,2020-11-01,5998,5759,239,4
21231,2020-11-01,7368,6980,388,5.3
21233,2020-11-01,5301,5053,248,4.7
21235,2020-11-01,13726,12933,793,5.8
21237,2020-11-01,1987,1879,108,5.4
21239,2020-11-01,15113,14536,577,3.8
22001,2020-11-01,23545,22036,1509,6.4
22003,2020-11-01,8264,7632,632,7.6
22005,2020-11-01,65545,61964,3581,5.5
22007,2020-11-01,8976,8162,814,9.1
22009,2020-11-01,15064,14085,979,6.5
22011,2020-11-01,14250,13502,748,5.2
22013,2020-11-01,5442,5054,388,7.1
22015,2020-11-01,57207,54233,2974,5.2
22017,2020-11-01,104061,95325,8736,8.4
22019,2020-11-01,94937,86372,8565,9
22021,2020-11-01,3688,3479,209,5.7
22023,2020-11-01,3387,3210,177,5.2
22025,2020-11-01,3529,3306,223,6.3
22027,2020-11-01,5582,5257,325,5.8
22029,2020-11-01,6976,6525,451,6.5
22031,2020-11-01,10701,10049,652,6.1
22033,2020-11-01,234741,218828,15913,6.8
22035,2020-11-01,1852,1652,200,10.8
22037,2020-11-01,7966,7501,465,5.8
22039,2020-11-01,11901,11113,788,6.6
22041,2020-11-01,7423,6914,509,6.9
22043,2020-11-01,8363,7923,440,5.3
22045,2020-11-01,28183,25632,2551,9.1
22047,2020-11-01,14369,13040,1329,9.2
22049,2020-11-01,6746,6446,300,4.4
22051,2020-11-01,212980,195411,17569,8.2
22053,2020-11-01,12659,11826,833,6.6
22055,2020-11-01,114036,107310,6726,5.9
22057,2020-11-01,42380,40084,2296,5.4
22059,2020-11-01,7025,6747,278,4
22061,2020-11-01,20879,19789,1090,5.2
22063,2020-11-01,69573,66154,3419,4.9
22065,2020-11-01,3597,3345,252,7
22067,2020-11-01,10191,9312,879,8.6
22069,2020-11-01,16076,15137,939,5.8
22071,2020-11-01,185103,162649,22454,12.1
22073,2020-11-01,71133,66650,4483,6.3
22075,2020-11-01,9641,9113,528,5.5
22077,2020-11-01,9852,9184,668,6.8
22079,2020-11-01,56601,53692,2909,5.1
22081,2020-11-01,3610,3403,207,5.7
22083,2020-11-01,8129,7619,510,6.3
22085,2020-11-01,9238,8831,407,4.4
22087,2020-11-01,20201,18303,1898,9.4
22089,2020-11-01,24780,23124,1656,6.7
22091,2020-11-01,4435,3938,497,11.2
22093,2020-11-01,9160,8316,844,9.2
22095,2020-11-01,19770,17606,2164,10.9
22097,2020-11-01,32732,30170,2562,7.8
22099,2020-11-01,22119,20540,1579,7.1
22101,2020-11-01,19399,17730,1669,8.6
22103,2020-11-01,116513,110572,5941,5.1
22105,2020-11-01,57519,52815,4704,8.2
22107,2020-11-01,1342,1250,92,6.9
22109,2020-11-01,47303,44068,3235,6.8
22111,2020-11-01,9120,8563,557,6.1
22113,2020-11-01,23863,22308,1555,6.5
22115,2020-11-01,15745,14940,805,5.1
22117,2020-11-01,17064,15828,1236,7.2
22119,2020-11-01,14228,13243,985,6.9
22121,2020-11-01,13870,12984,886,6.4
22123,2020-11-01,3556,3300,256,7.2
22125,2020-11-01,5422,5162,260,4.8
22127,2020-11-01,4648,4359,289,6.2
23001,2020-11-01,53745,51192,2553,4.8
23003,2020-11-01,28406,27060,1346,4.7
23005,2020-11-01,158909,152080,6829,4.3
23007,2020-11-01,13570,12895,675,5
23009,2020-11-01,25885,24578,1307,5
23011,2020-11-01,60302,57785,2517,4.2
23013,2020-11-01,18638,17806,832,4.5
23015,2020-11-01,15649,14885,764,4.9
23017,2020-11-01,24888,23355,1533,6.2
23019,2020-11-01,73754,70500,3254,4.4
23021,2020-11-01,6985,6644,341,4.9
23023,2020-11-01,18905,18168,737,3.9
23025,2020-11-01,21524,20246,1278,5.9
23027,2020-11-01,19439,18548,891,4.6
23029,2020-11-01,13440,12722,718,5.3
23031,2020-11-01,109662,104278,5384,4.9
24001,2020-11-01,30090,28174,1916,6.4
24003,2020-11-01,306463,290170,16293,5.3
24005,2020-11-01,440391,412407,27984,6.4
24009,2020-11-01,47371,45045,2326,4.9
24011,2020-11-01,16682,15830,852,5.1
24013,2020-11-01,91038,87033,4005,4.4
24015,2020-11-01,51091,48379,2712,5.3
24017,2020-11-01,84181,78659,5522,6.6
24019,2020-11-01,14457,13478,979,6.8
24021,2020-11-01,128792,121749,7043,5.5
24023,2020-11-01,14347,13580,767,5.3
24025,2020-11-01,135934,129243,6691,4.9
24027,2020-11-01,182646,173757,8889,4.9
24029,2020-11-01,9071,8528,543,6
24031,2020-11-01,538637,503060,35577,6.6
24033,2020-11-01,498645,453275,45370,9.1
24035,2020-11-01,26274,25053,1221,4.6
24037,2020-11-01,56230,53798,2432,4.3
24039,2020-11-01,8244,7594,650,7.9
24041,2020-11-01,17517,16556,961,5.5
24043,2020-11-01,71362,67255,4107,5.8
24045,2020-11-01,48165,44915,3250,6.7
24047,2020-11-01,24038,21768,2270,9.4
24510,2020-11-01,279193,254963,24230,8.7
25001,2020-11-01,106895,98198,8697,8.1
25003,2020-11-01,61712,56706,5006,8.1
25005,2020-11-01,296676,273263,23413,7.9
25007,2020-11-01,8571,7820,751,8.8
25009,2020-11-01,419773,384547,35226,8.4
25011,2020-11-01,40126,37568,2558,6.4
25013,2020-11-01,224334,203908,20426,9.1
25015,2020-11-01,88069,82097,5972,6.8
25017,2020-11-01,896572,836743,59829,6.7
25019,2020-11-01,6850,6299,551,8
25021,2020-11-01,383753,355669,28084,7.3
25023,2020-11-01,278891,256904,21987,7.9
25025,2020-11-01,448875,411510,37365,8.3
25027,2020-11-01,438692,405074,33618,7.7
26001,2020-11-01,3889,3627,262,6.7
26003,2020-11-01,3027,2758,269,8.9
26005,2020-11-01,61936,58958,2978,4.8
26007,2020-11-01,13380,12648,732,5.5
26009,2020-11-01,10048,9374,674,6.7
26011,2020-11-01,5801,5352,449,7.7
26013,2020-11-01,3188,2922,266,8.3
26015,2020-11-01,31263,29752,1511,4.8
26017,2020-11-01,49222,46116,3106,6.3
26019,2020-11-01,8626,8129,497,5.8
26021,2020-11-01,72254,67684,4570,6.3
26023,2020-11-01,19653,18540,1113,5.7
26025,2020-11-01,61845,57528,4317,7
26027,2020-11-01,24088,22668,1420,5.9
26029,2020-11-01,12506,11764,742,5.9
26031,2020-11-01,9795,8868,927,9.5
26033,2020-11-01,16430,15397,1033,6.3
26035,2020-11-01,11963,10992,971,8.1
26037,2020-11-01,39702,38000,1702,4.3
26039,2020-11-01,5700,5312,388,6.8
26041,2020-11-01,17102,16027,1075,6.3
26043,2020-11-01,12305,11650,655,5.3
26045,2020-11-01,55459,52659,2800,5
26047,2020-11-01,16706,15590,1116,6.7
26049,2020-11-01,179312,165818,13494,7.5
26051,2020-11-01,9973,9294,679,6.8
26053,2020-11-01,5800,5459,341,5.9
26055,2020-11-01,49130,46601,2529,5.1
26057,2020-11-01,17850,16869,981,5.5
26059,2020-11-01,19979,18883,1096,5.5
26061,2020-11-01,16189,15409,780,4.8
26063,2020-11-01,15429,14712,717,4.6
26065,2020-11-01,146465,138252,8213,5.6
26067,2020-11-01,30558,29106,1452,4.8
26069,2020-11-01,10145,9439,706,7
26071,2020-11-01,4969,4681,288,5.8
26073,2020-11-01,32993,31209,1784,5.4
26075,2020-11-01,73241,68687,4554,6.2
26077,2020-11-01,131827,124628,7199,5.5
26079,2020-11-01,7855,7299,556,7.1
26081,2020-11-01,357851,338843,19008,5.3
26083,2020-11-01,899,836,63,7
26085,2020-11-01,4013,3679,334,8.3
26087,2020-11-01,39696,36463,3233,8.1
26089,2020-11-01,10275,9768,507,4.9
26091,2020-11-01,45304,42868,2436,5.4
26093,2020-11-01,100711,94404,6307,6.3
26095,2020-11-01,2238,2084,154,6.9
26097,2020-11-01,4258,3845,413,9.7
26099,2020-11-01,441947,402585,39362,8.9
26101,2020-11-01,10265,9581,684,6.7
26103,2020-11-01,31743,30026,1717,5.4
26105,2020-11-01,13390,12512,878,6.6
26107,2020-11-01,18694,17530,1164,6.2
26109,2020-11-01,10738,10252,486,4.5
26111,2020-11-01,39856,37823,2033,5.1
26113,2020-11-01,6865,6505,360,5.2
26115,2020-11-01,73277,69209,4068,5.6
26117,2020-11-01,27795,26185,1610,5.8
26119,2020-11-01,3004,2716,288,9.6
26121,2020-11-01,76792,70307,6485,8.4
26123,2020-11-01,23278,21918,1360,5.8
26125,2020-11-01,660670,612259,48411,7.3
26127,2020-11-01,11787,10903,884,7.5
26129,2020-11-01,8017,7453,564,7
26131,2020-11-01,2056,1907,149,7.2
26133,2020-11-01,11741,11119,622,5.3
26135,2020-11-01,2956,2738,218,7.4
26137,2020-11-01,11584,10785,799,6.9
26139,2020-11-01,158760,151800,6960,4.4
26141,2020-11-01,4896,4532,364,7.4
26143,2020-11-01,7664,7039,625,8.2
26145,2020-11-01,85491,79406,6085,7.1
26147,2020-11-01,73771,67600,6171,8.4
26149,2020-11-01,28636,26988,1648,5.8
26151,2020-11-01,19249,18202,1047,5.4
26153,2020-11-01,3227,3011,216,6.7
26155,2020-11-01,32632,30795,1837,5.6
26157,2020-11-01,23597,22185,1412,6
26159,2020-11-01,34468,32394,2074,6
26161,2020-11-01,194032,184928,9104,4.7
26163,2020-11-01,812266,714507,97759,12
26165,2020-11-01,14916,14029,887,5.9
27001,2020-11-01,7513,7059,454,6
27003,2020-11-01,194532,185894,8638,4.4
27005,2020-11-01,18548,17742,806,4.3
27007,2020-11-01,24852,23662,1190,4.8
27009,2020-11-01,22047,20896,1151,5.2
27011,2020-11-01,2508,2438,70,2.8
27013,2020-11-01,40464,38999,1465,3.6
27015,2020-11-01,14214,13680,534,3.8
27017,2020-11-01,17581,16749,832,4.7
27019,2020-11-01,57835,55752,2083,3.6
27021,2020-11-01,13496,12577,919,6.8
27023,2020-11-01,6781,6553,228,3.4
27025,2020-11-01,29606,28165,1441,4.9
27027,2020-11-01,36373,35267,1106,3
27029,2020-11-01,4533,4221,312,6.9
27031,2020-11-01,2733,2565,168,6.1
27033,2020-11-01,6658,6405,253,3.8
27035,2020-11-01,31890,30097,1793,5.6
27037,2020-11-01,237274,227576,9698,4.1
27039,2020-11-01,12025,11569,456,3.8
27041,2020-11-01,21227,20460,767,3.6
27043,2020-11-01,6996,6651,345,4.9
27045,2020-11-01,11653,11276,377,3.2
27047,2020-11-01,16183,15552,631,3.9
27049,2020-11-01,26316,25310,1006,3.8
27051,2020-11-01,3390,3265,125,3.7
27053,2020-11-01,695696,664427,31269,4.5
27055,2020-11-01,10374,10097,277,2.7
27057,2020-11-01,9657,9144,513,5.3
27059,2020-11-01,21092,20011,1081,5.1
27061,2020-11-01,21643,20330,1313,6.1
27063,2020-11-01,5791,5596,195,3.4
27065,2020-11-01,9145,8560,585,6.4
27067,2020-11-01,24753,23849,904,3.7
27069,2020-11-01,2434,2356,78,3.2
27071,2020-11-01,5583,5255,328,5.9
27073,2020-11-01,3605,3483,122,3.4
27075,2020-11-01,5025,4789,236,4.7
27077,2020-11-01,2360,2212,148,6.3
27079,2020-11-01,15972,15161,811,5.1
27081,2020-11-01,3137,3034,103,3.3
27083,2020-11-01,14251,13765,486,3.4
27085,2020-11-01,19051,18238,813,4.3
27087,2020-11-01,2086,1905,181,8.7
27089,2020-11-01,5567,5288,279,5
27091,2020-11-01,9881,9543,338,3.4
27093,2020-11-01,13254,12685,569,4.3
27095,2020-11-01,12729,11880,849,6.7
27097,2020-11-01,18129,17024,1105,6.1
27099,2020-11-01,21035,20238,797,3.8
27101,2020-11-01,4900,4699,201,4.1
27103,2020-11-01,20861,20194,667,3.2
27105,2020-11-01,11755,11396,359,3.1
27107,2020-11-01,3286,3144,142,4.3
27109,2020-11-01,90336,87082,3254,3.6
27111,2020-11-01,31185,30019,1166,3.7
27113,2020-11-01,8618,8308,310,3.6
27115,2020-11-01,14278,13453,825,5.8
27117,2020-11-01,4697,4571,126,2.7
27119,2020-11-01,16648,15941,707,4.2
27121,2020-11-01,6490,6260,230,3.5
27123,2020-11-01,284052,270401,13651,4.8
27125,2020-11-01,2263,2170,93,4.1
27127,2020-11-01,7742,7445,297,3.8
27129,2020-11-01,8938,8603,335,3.7
27131,2020-11-01,36797,35402,1395,3.8
27133,2020-11-01,5944,5830,114,1.9
27135,2020-11-01,7863,7548,315,4
27137,2020-11-01,100558,95559,4999,5
27139,2020-11-01,82143,79024,3119,3.8
27141,2020-11-01,51644,49315,2329,4.5
27143,2020-11-01,8363,8006,357,4.3
27145,2020-11-01,90841,86934,3907,4.3
27147,2020-11-01,20557,19767,790,3.8
27149,2020-11-01,5564,5411,153,2.7
27151,2020-11-01,4927,4692,235,4.8
27153,2020-11-01,13934,13284,650,4.7
27155,2020-11-01,1773,1727,46,2.6
27157,2020-11-01,12424,11990,434,3.5
27159,2020-11-01,6051,5732,319,5.3
27161,2020-11-01,8969,8585,384,4.3
27163,2020-11-01,140885,135655,5230,3.7
27165,2020-11-01,6799,6593,206,3
27167,2020-11-01,3498,3383,115,3.3
27169,2020-11-01,28156,27252,904,3.2
27171,2020-11-01,74630,71676,2954,4
27173,2020-11-01,5363,5182,181,3.4
28001,2020-11-01,10707,9631,1076,10
28003,2020-11-01,15301,14538,763,5
28005,2020-11-01,4490,4126,364,8.1
28007,2020-11-01,6941,6448,493,7.1
28009,2020-11-01,3058,2853,205,6.7
28011,2020-11-01,11429,10562,867,7.6
28013,2020-11-01,5346,5053,293,5.5
28015,2020-11-01,3407,3190,217,6.4
28017,2020-11-01,6933,6424,509,7.3
28019,2020-11-01,3560,3358,202,5.7
28021,2020-11-01,3055,2667,388,12.7
28023,2020-11-01,5830,5420,410,7
28025,2020-11-01,7901,7190,711,9
28027,2020-11-01,8094,7288,806,10
28029,2020-11-01,10903,10107,796,7.3
28031,2020-11-01,8555,8029,526,6.1
28033,2020-11-01,92678,88493,4185,4.5
28035,2020-11-01,34345,32131,2214,6.4
28037,2020-11-01,2784,2574,210,7.5
28039,2020-11-01,8987,8338,649,7.2
28041,2020-11-01,4265,3942,323,7.6
28043,2020-11-01,9315,8776,539,5.8
28045,2020-11-01,18996,17722,1274,6.7
28047,2020-11-01,88288,82517,5771,6.5
28049,2020-11-01,105659,97913,7746,7.3
28051,2020-11-01,5307,4613,694,13.1
28053,2020-11-01,2061,1790,271,13.1
28055,2020-11-01,301,277,24,8
28057,2020-11-01,10530,10050,480,4.6
28059,2020-11-01,59293,55253,4040,6.8
28061,2020-11-01,5990,5512,478,8
28063,2020-11-01,1955,1615,340,17.4
28065,2020-11-01,4057,3710,347,8.6
28067,2020-11-01,25358,23782,1576,6.2
28069,2020-11-01,3367,3093,274,8.1
28071,2020-11-01,27460,26276,1184,4.3
28073,2020-11-01,31956,30492,1464,4.6
28075,2020-11-01,29871,28064,1807,6
28077,2020-11-01,4725,4358,367,7.8
28079,2020-11-01,7912,7436,476,6
28081,2020-11-01,42286,39997,2289,5.4
28083,2020-11-01,9808,8879,929,9.5
28085,2020-11-01,14769,13895,874,5.9
28087,2020-11-01,25524,23857,1667,6.5
28089,2020-11-01,53010,50553,2457,4.6
28091,2020-11-01,10474,9849,625,6
28093,2020-11-01,14408,13518,890,6.2
28095,2020-11-01,15870,14874,996,6.3
28097,2020-11-01,3894,3627,267,6.9
28099,2020-11-01,9945,9339,606,6.1
28101,2020-11-01,7938,7475,463,5.8
28103,2020-11-01,3847,3496,351,9.1
28105,2020-11-01,22892,21572,1320,5.8
28107,2020-11-01,12890,11832,1058,8.2
28109,2020-11-01,23680,22145,1535,6.5
28111,2020-11-01,4386,4076,310,7.1
28113,2020-11-01,14936,13699,1237,8.3
28115,2020-11-01,15091,14368,723,4.8
28117,2020-11-01,11322,10752,570,5
28119,2020-11-01,2258,2047,211,9.3
28121,2020-11-01,75793,72859,2934,3.9
28123,2020-11-01,12918,12295,623,4.8
28125,2020-11-01,1389,1252,137,9.9
28127,2020-11-01,10593,9973,620,5.9
28129,2020-11-01,6580,6259,321,4.9
28131,2020-11-01,7185,6769,416,5.8
28133,2020-11-01,7333,6582,751,10.2
28135,2020-11-01,4988,4650,338,6.8
28137,2020-11-01,12187,11403,784,6.4
28139,2020-11-01,9572,9109,463,4.8
28141,2020-11-01,8328,7939,389,4.7
28143,2020-11-01,4482,3994,488,10.9
28145,2020-11-01,14150,13506,644,4.6
28147,2020-11-01,5027,4642,385,7.7
28149,2020-11-01,20020,18649,1371,6.8
28151,2020-11-01,16036,14475,1561,9.7
28153,2020-11-01,7299,6736,563,7.7
28155,2020-11-01,3957,3735,222,5.6
28157,2020-11-01,2870,2455,415,14.5
28159,2020-11-01,7211,6687,524,7.3
28161,2020-11-01,4964,4662,302,6.1
28163,2020-11-01,9766,9006,760,7.8
29001,2020-11-01,10248,9866,382,3.7
29003,2020-11-01,9799,9520,279,2.8
29005,2020-11-01,2739,2663,76,2.8
29007,2020-11-01,10295,9940,355,3.4
29009,2020-11-01,15512,14822,690,4.4
29011,2020-11-01,5244,5070,174,3.3
29013,2020-11-01,7696,7397,299,3.9
29015,2020-11-01,7320,6931,389,5.3
29017,2020-11-01,5446,5231,215,3.9
29019,2020-11-01,98243,95334,2909,3
29021,2020-11-01,43993,42354,1639,3.7
29023,2020-11-01,18332,17497,835,4.6
29025,2020-11-01,4284,4126,158,3.7
29027,2020-11-01,21440,20784,656,3.1
29029,2020-11-01,18348,17458,890,4.9
29031,2020-11-01,40615,39233,1382,3.4
29033,2020-11-01,4744,4479,265,5.6
29035,2020-11-01,2514,2395,119,4.7
29037,2020-11-01,54341,52267,2074,3.8
29039,2020-11-01,5832,5626,206,3.5
29041,2020-11-01,3864,3755,109,2.8
29043,2020-11-01,45755,44306,1449,3.2
29045,2020-11-01,3168,3014,154,4.9
29047,2020-11-01,135960,130787,5173,3.8
29049,2020-11-01,10502,10119,383,3.6
29051,2020-11-01,39339,38159,1180,3
29053,2020-11-01,7252,6988,264,3.6
29055,2020-11-01,10819,10327,492,4.5
29057,2020-11-01,3598,3489,109,3
29059,2020-11-01,7084,6794,290,4.1
29061,2020-11-01,4151,4020,131,3.2
29063,2020-11-01,4787,4646,141,2.9
29065,2020-11-01,6429,6171,258,4
29067,2020-11-01,5184,4956,228,4.4
29069,2020-11-01,11438,10832,606,5.3
29071,2020-11-01,52421,50287,2134,4.1
29073,2020-11-01,7618,7330,288,3.8
29075,2020-11-01,3392,3300,92,2.7
29077,2020-11-01,152066,146764,5302,3.5
29079,2020-11-01,4362,4237,125,2.9
29081,2020-11-01,3826,3715,111,2.9
29083,2020-11-01,9779,9371,408,4.2
29085,2020-11-01,3892,3732,160,4.1
29087,2020-11-01,2568,2506,62,2.4
29089,2020-11-01,4904,4763,141,2.9
29091,2020-11-01,16202,15344,858,5.3
29093,2020-11-01,3484,3306,178,5.1
29095,2020-11-01,360370,341549,18821,5.2
29097,2020-11-01,56516,54307,2209,3.9
29099,2020-11-01,116478,111772,4706,4
29101,2020-11-01,23294,22335,959,4.1
29103,2020-11-01,1768,1710,58,3.3
29105,2020-11-01,16379,15631,748,4.6
29107,2020-11-01,16618,15988,630,3.8
29109,2020-11-01,17750,16978,772,4.3
29111,2020-11-01,4945,4798,147,3
29113,2020-11-01,28467,27391,1076,3.8
29115,2020-11-01,5156,4940,216,4.2
29117,2020-11-01,7402,7190,212,2.9
29119,2020-11-01,10839,10426,413,3.8
29121,2020-11-01,7456,7217,239,3.2
29123,2020-11-01,5461,5224,237,4.3
29125,2020-11-01,3983,3826,157,3.9
29127,2020-11-01,14493,14025,468,3.2
29129,2020-11-01,1896,1847,49,2.6
29131,2020-11-01,12338,11849,489,4
29133,2020-11-01,5697,5440,257,4.5
29135,2020-11-01,7359,7158,201,2.7
29137,2020-11-01,3745,3602,143,3.8
29139,2020-11-01,5721,5535,186,3.3
29141,2020-11-01,8222,7876,346,4.2
29143,2020-11-01,8553,8194,359,4.2
29145,2020-11-01,26840,25787,1053,3.9
29147,2020-11-01,10701,10376,325,3
29149,2020-11-01,3967,3758,209,5.3
29151,2020-11-01,7112,6948,164,2.3
29153,2020-11-01,3428,3251,177,5.2
29155,2020-11-01,6230,5817,413,6.6
29157,2020-11-01,9848,9552,296,3
29159,2020-11-01,20345,19516,829,4.1
29161,2020-11-01,20112,19362,750,3.7
29163,2020-11-01,7578,7296,282,3.7
29165,2020-11-01,58433,56376,2057,3.5
29167,2020-11-01,14581,14080,501,3.4
29169,2020-11-01,14558,13931,627,4.3
29171,2020-11-01,2269,2207,62,2.7
29173,2020-11-01,5703,5532,171,3
29175,2020-11-01,10250,9813,437,4.3
29177,2020-11-01,10832,10417,415,3.8
29179,2020-11-01,2852,2729,123,4.3
29181,2020-11-01,4944,4656,288,5.8
29183,2020-11-01,223843,216395,7448,3.3
29185,2020-11-01,3835,3667,168,4.4
29186,2020-11-01,9298,8988,310,3.3
29187,2020-11-01,26253,25048,1205,4.6
29189,2020-11-01,524558,501002,23556,4.5
29195,2020-11-01,10715,10376,339,3.2
29197,2020-11-01,1962,1897,65,3.3
29199,2020-11-01,2414,2359,55,2.3
29201,2020-11-01,19917,19117,800,4
29203,2020-11-01,3349,3173,176,5.3
29205,2020-11-01,3057,2961,96,3.1
29207,2020-11-01,13229,12682,547,4.1
29209,2020-11-01,13232,12576,656,5
29211,2020-11-01,2792,2688,104,3.7
29213,2020-11-01,25731,24271,1460,5.7
29215,2020-11-01,9111,8687,424,4.7
29217,2020-11-01,9560,9221,339,3.5
29219,2020-11-01,18145,17453,692,3.8
29221,2020-11-01,10095,9620,475,4.7
29223,2020-11-01,5064,4825,239,4.7
29225,2020-11-01,17435,16847,588,3.4
29227,2020-11-01,1173,1140,33,2.8
29229,2020-11-01,7323,6993,330,4.5
29510,2020-11-01,151413,141850,9563,6.3
30001,2020-11-01,5051,4895,156,3.1
30003,2020-11-01,4818,4555,263,5.5
30005,2020-11-01,2300,2205,95,4.1
30007,2020-11-01,2575,2448,127,4.9
30009,2020-11-01,5513,5269,244,4.4
30011,2020-11-01,696,677,19,2.7
30013,2020-11-01,37353,35683,1670,4.5
30015,2020-11-01,2525,2442,83,3.3
30017,2020-11-01,6177,5958,219,3.5
30019,2020-11-01,911,892,19,2.1
30021,2020-11-01,4684,4468,216,4.6
30023,2020-11-01,4921,4735,186,3.8
30025,2020-11-01,1654,1595,59,3.6
30027,2020-11-01,5874,5671,203,3.5
30029,2020-11-01,47732,45171,2561,5.4
30031,2020-11-01,69714,67186,2528,3.6
30033,2020-11-01,766,748,18,2.3
30035,2020-11-01,5088,4637,451,8.9
30037,2020-11-01,364,353,11,3
30039,2020-11-01,1526,1442,84,5.5
30041,2020-11-01,7570,7273,297,3.9
30043,2020-11-01,5763,5548,215,3.7
30045,2020-11-01,1034,1001,33,3.2
30047,2020-11-01,13478,12857,621,4.6
30049,2020-11-01,36202,34897,1305,3.6
30051,2020-11-01,1024,991,33,3.2
30053,2020-11-01,7836,7278,558,7.1
30055,2020-11-01,993,972,21,2.1
30057,2020-11-01,4070,3877,193,4.7
30059,2020-11-01,990,948,42,4.2
30061,2020-11-01,1688,1580,108,6.4
30063,2020-11-01,62854,60181,2673,4.3
30065,2020-11-01,2319,2209,110,4.7
30067,2020-11-01,8646,8186,460,5.3
30069,2020-11-01,274,265,9,3.3
30071,2020-11-01,1926,1851,75,3.9
30073,2020-11-01,2734,2618,116,4.2
30075,2020-11-01,1036,1012,24,2.3
30077,2020-11-01,2994,2904,90,3
30079,2020-11-01,489,457,32,6.5
30081,2020-11-01,20655,19763,892,4.3
30083,2020-11-01,5909,5607,302,5.1
30085,2020-11-01,4466,4256,210,4.7
30087,2020-11-01,3689,3523,166,4.5
30089,2020-11-01,5042,4752,290,5.8
30091,2020-11-01,1802,1721,81,4.5
30093,2020-11-01,17019,16238,781,4.6
30095,2020-11-01,5349,5152,197,3.7
30097,2020-11-01,1892,1844,48,2.5
30099,2020-11-01,2791,2691,100,3.6
30101,2020-11-01,2150,2065,85,4
30103,2020-11-01,353,341,12,3.4
30105,2020-11-01,4105,3964,141,3.4
30107,2020-11-01,779,734,45,5.8
30109,2020-11-01,458,436,22,4.8
30111,2020-11-01,81936,78711,3225,3.9
31001,2020-11-01,16685,16249,436,2.6
31003,2020-11-01,3885,3813,72,1.9
31005,2020-11-01,235,227,8,3.4
31007,2020-11-01,390,381,9,2.3
31009,2020-11-01,254,247,7,2.8
31011,2020-11-01,2926,2873,53,1.8
31013,2020-11-01,5337,5139,198,3.7
31015,2020-11-01,1046,1028,18,1.7
31017,2020-11-01,1385,1354,31,2.2
31019,2020-11-01,27296,26685,611,2.2
31021,2020-11-01,3544,3445,99,2.8
31023,2020-11-01,4572,4462,110,2.4
31025,2020-11-01,13266,12886,380,2.9
31027,2020-11-01,4432,4340,92,2.1
31029,2020-11-01,2271,2242,29,1.3
31031,2020-11-01,3307,3252,55,1.7
31033,2020-11-01,4114,3973,141,3.4
31035,2020-11-01,3216,3156,60,1.9
31037,2020-11-01,5597,5482,115,2.1
31039,2020-11-01,4758,4672,86,1.8
31041,2020-11-01,6254,6158,96,1.5
31043,2020-11-01,10418,10086,332,3.2
31045,2020-11-01,4975,4870,105,2.1
31047,2020-11-01,13116,12820,296,2.3
31049,2020-11-01,955,933,22,2.3
31051,2020-11-01,2925,2860,65,2.2
31053,2020-11-01,19952,19451,501,2.5
31055,2020-11-01,295714,285531,10183,3.4
31057,2020-11-01,1163,1139,24,2.1
31059,2020-11-01,3084,3026,58,1.9
31061,2020-11-01,1464,1427,37,2.5
31063,2020-11-01,1513,1485,28,1.9
31065,2020-11-01,2578,2528,50,1.9
31067,2020-11-01,10638,10361,277,2.6
31069,2020-11-01,1039,1016,23,2.2
31071,2020-11-01,1133,1119,14,1.2
31073,2020-11-01,1071,1052,19,1.8
31075,2020-11-01,417,411,6,1.4
31077,2020-11-01,1212,1185,27,2.2
31079,2020-11-01,31586,30168,1418,4.5
31081,2020-11-01,4724,4593,131,2.8
31083,2020-11-01,1683,1653,30,1.8
31085,2020-11-01,634,626,8,1.3
31087,2020-11-01,1286,1250,36,2.8
31089,2020-11-01,5675,5585,90,1.6
31091,2020-11-01,436,428,8,1.8
31093,2020-11-01,3345,3200,145,4.3
31095,2020-11-01,4166,4088,78,1.9
31097,2020-11-01,2033,1967,66,3.2
31099,2020-11-01,3734,3656,78,2.1
31101,2020-11-01,4437,4331,106,2.4
31103,2020-11-01,610,599,11,1.8
31105,2020-11-01,1931,1884,47,2.4
31107,2020-11-01,4650,4548,102,2.2
31109,2020-11-01,174968,169697,5271,3
31111,2020-11-01,18030,17595,435,2.4
31113,2020-11-01,468,462,6,1.3
31115,2020-11-01,413,407,6,1.5
31117,2020-11-01,444,435,9,2
31119,2020-11-01,19700,19059,641,3.3
31121,2020-11-01,3985,3854,131,3.3
31123,2020-11-01,2578,2509,69,2.7
31125,2020-11-01,1899,1857,42,2.2
31127,2020-11-01,3575,3490,85,2.4
31129,2020-11-01,2458,2415,43,1.7
31131,2020-11-01,8301,8095,206,2.5
31133,2020-11-01,1468,1441,27,1.8
31135,2020-11-01,1824,1800,24,1.3
31137,2020-11-01,4841,4753,88,1.8
31139,2020-11-01,4121,3990,131,3.2
31141,2020-11-01,17600,17191,409,2.3
31143,2020-11-01,2893,2840,53,1.8
31145,2020-11-01,5854,5710,144,2.5
31147,2020-11-01,4089,3997,92,2.2
31149,2020-11-01,884,874,10,1.1
31151,2020-11-01,7154,6989,165,2.3
31153,2020-11-01,95620,93076,2544,2.7
31155,2020-11-01,11058,10770,288,2.6
31157,2020-11-01,18160,17616,544,3
31159,2020-11-01,8805,8507,298,3.4
31161,2020-11-01,2681,2635,46,1.7
31163,2020-11-01,1660,1627,33,2
31165,2020-11-01,734,725,9,1.2
31167,2020-11-01,3547,3434,113,3.2
31169,2020-11-01,2784,2734,50,1.8
31171,2020-11-01,415,404,11,2.7
31173,2020-11-01,3047,2950,97,3.2
31175,2020-11-01,2074,2035,39,1.9
31177,2020-11-01,11029,10766,263,2.4
31179,2020-11-01,5676,5556,120,2.1
31181,2020-11-01,1641,1605,36,2.2
31183,2020-11-01,558,552,6,1.1
31185,2020-11-01,7135,6988,147,2.1
32001,2020-11-01,11223,10842,381,3.4
32003,2020-11-01,NA,990656,108054,9.8
32005,2020-11-01,22649,21520,1129,5
32007,2020-11-01,27297,26468,829,3
32009,2020-11-01,407,388,19,4.7
32011,2020-11-01,1022,999,23,2.3
32013,2020-11-01,8113,7858,255,3.1
32015,2020-11-01,3217,3113,104,3.2
32017,2020-11-01,2041,1966,75,3.7
32019,2020-11-01,23136,21903,1233,5.3
32021,2020-11-01,2113,2043,70,3.3
32023,2020-11-01,17650,16521,1129,6.4
32027,2020-11-01,2522,2447,75,3
32029,2020-11-01,2104,2001,103,4.9
32031,2020-11-01,260410,248832,11578,4.4
32033,2020-11-01,4721,4596,125,2.6
32510,2020-11-01,26212,24947,1265,4.8
33001,2020-11-01,31124,29853,1271,4.1
33003,2020-11-01,22934,21902,1032,4.5
33005,2020-11-01,40004,38482,1522,3.8
33007,2020-11-01,14355,13637,718,5
33009,2020-11-01,48451,46776,1675,3.5
33011,2020-11-01,239542,229602,9940,4.1
33013,2020-11-01,82763,79889,2874,3.5
33015,2020-11-01,184242,176719,7523,4.1
33017,2020-11-01,73113,70434,2679,3.7
33019,2020-11-01,23254,22430,824,3.5
34001,2020-11-01,120334,103236,17098,14.2
34003,2020-11-01,475209,429905,45304,9.5
34005,2020-11-01,231397,212944,18453,8
34007,2020-11-01,257091,231463,25628,10
34009,2020-11-01,45537,40056,5481,12
34011,2020-11-01,66868,60017,6851,10.2
34013,2020-11-01,373279,326657,46622,12.5
34015,2020-11-01,150959,137744,13215,8.8
34017,2020-11-01,360288,320331,39957,11.1
34019,2020-11-01,62562,58176,4386,7
34021,2020-11-01,207677,191590,16087,7.7
34023,2020-11-01,440557,402304,38253,8.7
34025,2020-11-01,329411,302268,27143,8.2
34027,2020-11-01,249654,230451,19203,7.7
34029,2020-11-01,278778,254995,23783,8.5
34031,2020-11-01,244252,212971,31281,12.8
34033,2020-11-01,29722,26908,2814,9.5
34035,2020-11-01,166344,153128,13216,7.9
34037,2020-11-01,72489,66250,6239,8.6
34039,2020-11-01,273958,245971,27987,10.2
34041,2020-11-01,56326,51906,4420,7.8
35001,2020-11-01,335012,309535,25477,7.6
35003,2020-11-01,1232,1158,74,6
35005,2020-11-01,29768,27372,2396,8
35006,2020-11-01,9738,8827,911,9.4
35007,2020-11-01,5532,5164,368,6.7
35009,2020-11-01,23658,22410,1248,5.3
35011,2020-11-01,749,710,39,5.2
35013,2020-11-01,98690,91122,7568,7.7
35015,2020-11-01,34368,31625,2743,8
35017,2020-11-01,12225,11036,1189,9.7
35019,2020-11-01,1634,1520,114,7
35021,2020-11-01,285,273,12,4.2
35023,2020-11-01,2048,1935,113,5.5
35025,2020-11-01,30023,26070,3953,13.2
35027,2020-11-01,9424,8677,747,7.9
35028,2020-11-01,10634,10306,328,3.1
35029,2020-11-01,10608,8948,1660,15.6
35031,2020-11-01,25339,22681,2658,10.5
35033,2020-11-01,2105,1951,154,7.3
35035,2020-11-01,26675,24637,2038,7.6
35037,2020-11-01,3258,3010,248,7.6
35039,2020-11-01,17581,16277,1304,7.4
35041,2020-11-01,8303,7804,499,6
35043,2020-11-01,67205,61805,5400,8
35045,2020-11-01,51030,46194,4836,9.5
35047,2020-11-01,10862,10027,835,7.7
35049,2020-11-01,71799,66430,5369,7.5
35051,2020-11-01,4408,4049,359,8.1
35053,2020-11-01,6520,6092,428,6.6
35055,2020-11-01,15285,13678,1607,10.5
35057,2020-11-01,5469,4962,507,9.3
35059,2020-11-01,1683,1608,75,4.5
35061,2020-11-01,30646,28164,2482,8.1
36001,2020-11-01,158110,149716,8394,5.3
36003,2020-11-01,19341,18277,1064,5.5
36005,2020-11-01,586143,493215,92928,15.9
36007,2020-11-01,80947,75957,4990,6.2
36009,2020-11-01,33137,31151,1986,6
36011,2020-11-01,35453,33623,1830,5.2
36013,2020-11-01,52066,48545,3521,6.8
36015,2020-11-01,35194,32879,2315,6.6
36017,2020-11-01,21713,20642,1071,4.9
36019,2020-11-01,35727,33884,1843,5.2
36021,2020-11-01,30305,28986,1319,4.4
36023,2020-11-01,22615,21349,1266,5.6
36025,2020-11-01,18700,17770,930,5
36027,2020-11-01,141790,134175,7615,5.4
36029,2020-11-01,437448,409193,28255,6.5
36031,2020-11-01,16049,15181,868,5.4
36033,2020-11-01,19309,18251,1058,5.5
36035,2020-11-01,22439,21061,1378,6.1
36037,2020-11-01,28925,27513,1412,4.9
36039,2020-11-01,19983,18812,1171,5.9
36041,2020-11-01,2078,1949,129,6.2
36043,2020-11-01,27581,25756,1825,6.6
36045,2020-11-01,43166,40774,2392,5.5
36047,2020-11-01,NA,NA,136070,11.9
36049,2020-11-01,11484,10882,602,5.2
36051,2020-11-01,29854,28443,1411,4.7
36053,2020-11-01,32261,30671,1590,4.9
36055,2020-11-01,359307,336159,23148,6.4
36057,2020-11-01,22006,20589,1417,6.4
36059,2020-11-01,697097,655817,41280,5.9
36061,2020-11-01,851981,774414,77567,9.1
36063,2020-11-01,96847,90528,6319,6.5
36065,2020-11-01,100194,94373,5821,5.8
36067,2020-11-01,219762,206771,12991,5.9
36069,2020-11-01,54318,51649,2669,4.9
36071,2020-11-01,182554,171986,10568,5.8
36073,2020-11-01,17156,16171,985,5.7
36075,2020-11-01,51827,48673,3154,6.1
36077,2020-11-01,26427,25021,1406,5.3
36079,2020-11-01,49895,47318,2577,5.2
36081,2020-11-01,NA,957823,124654,11.5
36083,2020-11-01,81035,77027,4008,4.9
36085,2020-11-01,208332,188189,20143,9.7
36087,2020-11-01,152254,143486,8768,5.8
36089,2020-11-01,43456,41147,2309,5.3
36091,2020-11-01,119045,113738,5307,4.5
36093,2020-11-01,77153,72494,4659,6
36095,2020-11-01,14487,13771,716,4.9
36097,2020-11-01,7916,7451,465,5.9
36099,2020-11-01,15033,14205,828,5.5
36101,2020-11-01,41933,39569,2364,5.6
36103,2020-11-01,761096,717507,43589,5.7
36105,2020-11-01,35403,33120,2283,6.4
36107,2020-11-01,21891,20763,1128,5.2
36109,2020-11-01,47555,45390,2165,4.6
36111,2020-11-01,85906,81193,4713,5.5
36113,2020-11-01,30703,28946,1757,5.7
36115,2020-11-01,27326,25999,1327,4.9
36117,2020-11-01,43022,40828,2194,5.1
36119,2020-11-01,476027,446476,29551,6.2
36121,2020-11-01,17784,16887,897,5
36123,2020-11-01,11606,11098,508,4.4
37001,2020-11-01,82051,76982,5069,6.2
37003,2020-11-01,17914,16905,1009,5.6
37005,2020-11-01,4290,4028,262,6.1
37007,2020-11-01,10675,9878,797,7.5
37009,2020-11-01,13169,12475,694,5.3
37011,2020-11-01,7388,6981,407,5.5
37013,2020-11-01,19923,18759,1164,5.8
37015,2020-11-01,7808,7318,490,6.3
37017,2020-11-01,14804,13826,978,6.6
37019,2020-11-01,52483,48686,3797,7.2
37021,2020-11-01,137951,129688,8263,6
37023,2020-11-01,40591,38243,2348,5.8
37025,2020-11-01,110333,103889,6444,5.8
37027,2020-11-01,36438,34019,2419,6.6
37029,2020-11-01,4657,4431,226,4.9
37031,2020-11-01,32091,30489,1602,5
37033,2020-11-01,9778,9099,679,6.9
37035,2020-11-01,78701,73862,4839,6.1
37037,2020-11-01,36005,34347,1658,4.6
37039,2020-11-01,11018,10305,713,6.5
37041,2020-11-01,5738,5414,324,5.6
37043,2020-11-01,4161,3890,271,6.5
37045,2020-11-01,49368,45985,3383,6.9
37047,2020-11-01,22909,21144,1765,7.7
37049,2020-11-01,41561,39102,2459,5.9
37051,2020-11-01,127901,116953,10948,8.6
37053,2020-11-01,14002,13322,680,4.9
37055,2020-11-01,19142,17964,1178,6.2
37057,2020-11-01,79956,75092,4864,6.1
37059,2020-11-01,20275,19160,1115,5.5
37061,2020-11-01,25264,23922,1342,5.3
37063,2020-11-01,172948,163051,9897,5.7
37065,2020-11-01,21223,19059,2164,10.2
37067,2020-11-01,186549,174407,12142,6.5
37069,2020-11-01,31789,29870,1919,6
37071,2020-11-01,111435,103732,7703,6.9
37073,2020-11-01,5179,4902,277,5.3
37075,2020-11-01,3051,2795,256,8.4
37077,2020-11-01,29930,28380,1550,5.2
37079,2020-11-01,9905,9391,514,5.2
37081,2020-11-01,258823,239586,19237,7.4
37083,2020-11-01,20461,18645,1816,8.9
37085,2020-11-01,54339,50751,3588,6.6
37087,2020-11-01,29148,27454,1694,5.8
37089,2020-11-01,53463,50626,2837,5.3
37091,2020-11-01,9140,8530,610,6.7
37093,2020-11-01,20109,18487,1622,8.1
37095,2020-11-01,1819,1696,123,6.8
37097,2020-11-01,90207,84838,5369,6
37099,2020-11-01,20513,19371,1142,5.6
37101,2020-11-01,100663,95182,5481,5.4
37103,2020-11-01,4306,4077,229,5.3
37105,2020-11-01,26212,24445,1767,6.7
37107,2020-11-01,28145,26404,1741,6.2
37109,2020-11-01,44092,41709,2383,5.4
37111,2020-11-01,20649,19438,1211,5.9
37113,2020-11-01,15898,15052,846,5.3
37115,2020-11-01,9792,9249,543,5.5
37117,2020-11-01,9207,8590,617,6.7
37119,2020-11-01,628740,586832,41908,6.7
37121,2020-11-01,5930,5540,390,6.6
37123,2020-11-01,11588,10930,658,5.7
37125,2020-11-01,41816,39385,2431,5.8
37127,2020-11-01,43035,39743,3292,7.6
37129,2020-11-01,122956,116002,6954,5.7
37131,2020-11-01,7695,7148,547,7.1
37133,2020-11-01,66189,62044,4145,6.3
37135,2020-11-01,79231,75566,3665,4.6
37137,2020-11-01,5361,5077,284,5.3
37139,2020-11-01,16762,15674,1088,6.5
37141,2020-11-01,28667,27103,1564,5.5
37143,2020-11-01,4940,4659,281,5.7
37145,2020-11-01,18308,17170,1138,6.2
37147,2020-11-01,90043,84452,5591,6.2
37149,2020-11-01,9120,8619,501,5.5
37151,2020-11-01,64425,60500,3925,6.1
37153,2020-11-01,17151,15655,1496,8.7
37155,2020-11-01,50857,46405,4452,8.8
37157,2020-11-01,39297,36482,2815,7.2
37159,2020-11-01,66069,61792,4277,6.5
37161,2020-11-01,25055,23068,1987,7.9
37163,2020-11-01,29108,27515,1593,5.5
37165,2020-11-01,11642,10298,1344,11.5
37167,2020-11-01,30278,28647,1631,5.4
37169,2020-11-01,21361,20150,1211,5.7
37171,2020-11-01,32999,31177,1822,5.5
37173,2020-11-01,6882,6486,396,5.8
37175,2020-11-01,14217,13495,722,5.1
37177,2020-11-01,1371,1263,108,7.9
37179,2020-11-01,123955,117550,6405,5.2
37181,2020-11-01,17393,15672,1721,9.9
37183,2020-11-01,596553,564491,32062,5.4
37185,2020-11-01,6655,6047,608,9.1
37187,2020-11-01,4509,4149,360,8
37189,2020-11-01,29357,27980,1377,4.7
37191,2020-11-01,51720,48572,3148,6.1
37193,2020-11-01,29156,27500,1656,5.7
37195,2020-11-01,34955,32166,2789,8
37197,2020-11-01,17418,16473,945,5.4
37199,2020-11-01,8358,7908,450,5.4
38001,2020-11-01,957,925,32,3.3
38003,2020-11-01,5066,4922,144,2.8
38005,2020-11-01,2356,2241,115,4.9
38007,2020-11-01,364,351,13,3.6
38009,2020-11-01,2910,2770,140,4.8
38011,2020-11-01,1610,1562,48,3
38013,2020-11-01,1007,966,41,4.1
38015,2020-11-01,50483,48765,1718,3.4
38017,2020-11-01,104315,100913,3402,3.3
38019,2020-11-01,1851,1806,45,2.4
38021,2020-11-01,2261,2202,59,2.6
38023,2020-11-01,1376,1333,43,3.1
38025,2020-11-01,2891,2743,148,5.1
38027,2020-11-01,1170,1127,43,3.7
38029,2020-11-01,1469,1413,56,3.8
38031,2020-11-01,1511,1468,43,2.8
38033,2020-11-01,827,800,27,3.3
38035,2020-11-01,36920,35660,1260,3.4
38037,2020-11-01,1160,1127,33,2.8
38039,2020-11-01,982,951,31,3.2
38041,2020-11-01,1388,1336,52,3.7
38043,2020-11-01,1260,1199,61,4.8
38045,2020-11-01,2049,2005,44,2.1
38047,2020-11-01,849,832,17,2
38049,2020-11-01,3078,2911,167,5.4
38051,2020-11-01,1075,1043,32,3
38053,2020-11-01,8586,7908,678,7.9
38055,2020-11-01,4673,4490,183,3.9
38057,2020-11-01,3517,3327,190,5.4
38059,2020-11-01,16587,15953,634,3.8
38061,2020-11-01,6579,6228,351,5.3
38063,2020-11-01,1369,1316,53,3.9
38065,2020-11-01,867,832,35,4
38067,2020-11-01,3262,3135,127,3.9
38069,2020-11-01,1697,1636,61,3.6
38071,2020-11-01,5564,5377,187,3.4
38073,2020-11-01,2831,2747,84,3
38075,2020-11-01,1206,1157,49,4.1
38077,2020-11-01,8427,8185,242,2.9
38079,2020-11-01,4489,3978,511,11.4
38081,2020-11-01,2781,2698,83,3
38083,2020-11-01,665,626,39,5.9
38085,2020-11-01,1202,1162,40,3.3
38087,2020-11-01,377,366,11,2.9
38089,2020-11-01,17673,16480,1193,6.8
38091,2020-11-01,930,906,24,2.6
38093,2020-11-01,10328,10028,300,2.9
38095,2020-11-01,1131,1096,35,3.1
38097,2020-11-01,4509,4396,113,2.5
38099,2020-11-01,5007,4815,192,3.8
38101,2020-11-01,31435,29820,1615,5.1
38103,2020-11-01,1882,1815,67,3.6
38105,2020-11-01,21368,19231,2137,10
39001,2020-11-01,10847,10277,570,5.3
39003,2020-11-01,48521,46364,2157,4.4
39005,2020-11-01,26366,25391,975,3.7
39007,2020-11-01,42744,40705,2039,4.8
39009,2020-11-01,28768,27634,1134,3.9
39011,2020-11-01,24284,23519,765,3.2
39013,2020-11-01,28347,26807,1540,5.4
39015,2020-11-01,19130,18210,920,4.8
39017,2020-11-01,192012,184047,7965,4.1
39019,2020-11-01,12684,12048,636,5
39021,2020-11-01,19735,19028,707,3.6
39023,2020-11-01,62268,59474,2794,4.5
39025,2020-11-01,105186,101182,4004,3.8
39027,2020-11-01,17540,16722,818,4.7
39029,2020-11-01,46392,44015,2377,5.1
39031,2020-11-01,13703,12992,711,5.2
39033,2020-11-01,18329,17471,858,4.7
39035,2020-11-01,596065,548822,47243,7.9
39037,2020-11-01,25586,24733,853,3.3
39039,2020-11-01,17618,16925,693,3.9
39041,2020-11-01,112496,109082,3414,3
39043,2020-11-01,34392,32387,2005,5.8
39045,2020-11-01,78853,75954,2899,3.7
39047,2020-11-01,13946,13391,555,4
39049,2020-11-01,707837,675513,32324,4.6
39051,2020-11-01,21770,20965,805,3.7
39053,2020-11-01,11955,11416,539,4.5
39055,2020-11-01,46793,44677,2116,4.5
39057,2020-11-01,82426,79464,2962,3.6
39059,2020-11-01,17929,16989,940,5.2
39061,2020-11-01,411583,392192,19391,4.7
39063,2020-11-01,41515,40081,1434,3.5
39065,2020-11-01,14079,13519,560,4
39067,2020-11-01,6564,6181,383,5.8
39069,2020-11-01,12933,12403,530,4.1
39071,2020-11-01,17531,16708,823,4.7
39073,2020-11-01,12916,12423,493,3.8
39075,2020-11-01,20985,20545,440,2.1
39077,2020-11-01,26692,25416,1276,4.8
39079,2020-11-01,12969,12372,597,4.6
39081,2020-11-01,27005,25380,1625,6
39083,2020-11-01,31298,30276,1022,3.3
39085,2020-11-01,121403,114406,6997,5.8
39087,2020-11-01,23323,22317,1006,4.3
39089,2020-11-01,90925,87698,3227,3.5
39091,2020-11-01,22300,21505,795,3.6
39093,2020-11-01,148826,138769,10057,6.8
39095,2020-11-01,205739,194478,11261,5.5
39097,2020-11-01,20934,20263,671,3.2
39099,2020-11-01,99681,93987,5694,5.7
39101,2020-11-01,28011,26774,1237,4.4
39103,2020-11-01,93744,89114,4630,4.9
39105,2020-11-01,9039,8543,496,5.5
39107,2020-11-01,23161,22558,603,2.6
39109,2020-11-01,53750,51758,1992,3.7
39111,2020-11-01,5551,5208,343,6.2
39113,2020-11-01,250798,238098,12700,5.1
39115,2020-11-01,6593,6253,340,5.2
39117,2020-11-01,16884,16230,654,3.9
39119,2020-11-01,40553,38832,1721,4.2
39121,2020-11-01,4546,4260,286,6.3
39123,2020-11-01,19638,18545,1093,5.6
39125,2020-11-01,8590,8275,315,3.7
39127,2020-11-01,15868,15127,741,4.7
39129,2020-11-01,26569,25578,991,3.7
39131,2020-11-01,10731,10168,563,5.2
39133,2020-11-01,85019,81570,3449,4.1
39135,2020-11-01,21066,20330,736,3.5
39137,2020-11-01,18668,18164,504,2.7
39139,2020-11-01,51851,49344,2507,4.8
39141,2020-11-01,35013,33570,1443,4.1
39143,2020-11-01,29806,28519,1287,4.3
39145,2020-11-01,28985,27536,1449,5
39147,2020-11-01,26820,25716,1104,4.1
39149,2020-11-01,23704,22803,901,3.8
39151,2020-11-01,181782,173663,8119,4.5
39153,2020-11-01,267209,254426,12783,4.8
39155,2020-11-01,83684,78859,4825,5.8
39157,2020-11-01,43972,42164,1808,4.1
39159,2020-11-01,29516,28650,866,2.9
39161,2020-11-01,14500,13995,505,3.5
39163,2020-11-01,5540,5255,285,5.1
39165,2020-11-01,117984,113753,4231,3.6
39167,2020-11-01,26333,25094,1239,4.7
39169,2020-11-01,59639,57767,1872,3.1
39171,2020-11-01,18495,17754,741,4
39173,2020-11-01,69334,66863,2471,3.6
39175,2020-11-01,12891,12492,399,3.1
40001,2020-11-01,8739,8384,355,4.1
40003,2020-11-01,2872,2793,79,2.8
40005,2020-11-01,5328,5018,310,5.8
40007,2020-11-01,2681,2624,57,2.1
40009,2020-11-01,10080,9441,639,6.3
40011,2020-11-01,4419,4204,215,4.9
40013,2020-11-01,23180,22276,904,3.9
40015,2020-11-01,12426,11829,597,4.8
40017,2020-11-01,76847,73680,3167,4.1
40019,2020-11-01,22180,21080,1100,5
40021,2020-11-01,20375,19482,893,4.4
40023,2020-11-01,5648,5290,358,6.3
40025,2020-11-01,1574,1551,23,1.5
40027,2020-11-01,143940,138328,5612,3.9
40029,2020-11-01,2420,2278,142,5.9
40031,2020-11-01,48576,46325,2251,4.6
40033,2020-11-01,2783,2652,131,4.7
40035,2020-11-01,5947,5705,242,4.1
40037,2020-11-01,31628,29929,1699,5.4
40039,2020-11-01,15218,14554,664,4.4
40041,2020-11-01,18908,18156,752,4
40043,2020-11-01,2759,2627,132,4.8
40045,2020-11-01,2227,2129,98,4.4
40047,2020-11-01,27261,26064,1197,4.4
40049,2020-11-01,13203,12523,680,5.2
40051,2020-11-01,27156,25851,1305,4.8
40053,2020-11-01,2935,2854,81,2.8
40055,2020-11-01,2022,1892,130,6.4
40057,2020-11-01,1272,1234,38,3
40059,2020-11-01,1925,1868,57,3
40061,2020-11-01,4403,4123,280,6.4
40063,2020-11-01,5623,5253,370,6.6
40065,2020-11-01,11215,10856,359,3.2
40067,2020-11-01,2677,2537,140,5.2
40069,2020-11-01,3805,3580,225,5.9
40071,2020-11-01,18369,17411,958,5.2
40073,2020-11-01,8922,8592,330,3.7
40075,2020-11-01,3675,3530,145,3.9
40077,2020-11-01,3221,2935,286,8.9
40079,2020-11-01,19826,18721,1105,5.6
40081,2020-11-01,15901,15195,706,4.4
40083,2020-11-01,22646,21742,904,4
40085,2020-11-01,6730,6530,200,3
40087,2020-11-01,20264,19433,831,4.1
40089,2020-11-01,15548,14697,851,5.5
40091,2020-11-01,7234,6720,514,7.1
40093,2020-11-01,3869,3693,176,4.5
40095,2020-11-01,6979,6659,320,4.6
40097,2020-11-01,19904,19045,859,4.3
40099,2020-11-01,6124,5801,323,5.3
40101,2020-11-01,29895,28427,1468,4.9
40103,2020-11-01,5690,5524,166,2.9
40105,2020-11-01,4770,4554,216,4.5
40107,2020-11-01,4549,4292,257,5.6
40109,2020-11-01,389554,370764,18790,4.8
40111,2020-11-01,15858,14870,988,6.2
40113,2020-11-01,20804,19727,1077,5.2
40115,2020-11-01,14451,13872,579,4
40117,2020-11-01,7428,7021,407,5.5
40119,2020-11-01,38823,37389,1434,3.7
40121,2020-11-01,16825,15778,1047,6.2
40123,2020-11-01,19767,18994,773,3.9
40125,2020-11-01,33008,31382,1626,4.9
40127,2020-11-01,4645,4375,270,5.8
40129,2020-11-01,1951,1879,72,3.7
40131,2020-11-01,45376,43289,2087,4.6
40133,2020-11-01,9422,8844,578,6.1
40135,2020-11-01,16987,16154,833,4.9
40137,2020-11-01,18529,17343,1186,6.4
40139,2020-11-01,11911,11666,245,2.1
40141,2020-11-01,3174,3074,100,3.2
40143,2020-11-01,325322,308835,16487,5.1
40145,2020-11-01,38465,36720,1745,4.5
40147,2020-11-01,22535,21504,1031,4.6
40149,2020-11-01,5286,4988,298,5.6
40151,2020-11-01,4836,4718,118,2.4
40153,2020-11-01,8915,8371,544,6.1
41001,2020-11-01,7473,7028,445,6
41003,2020-11-01,46802,44759,2043,4.4
41005,2020-11-01,221355,208019,13336,6
41007,2020-11-01,19211,17919,1292,6.7
41009,2020-11-01,24405,22792,1613,6.6
41011,2020-11-01,27035,25226,1809,6.7
41013,2020-11-01,10573,9794,779,7.4
41015,2020-11-01,8954,8347,607,6.8
41017,2020-11-01,100371,94465,5906,5.9
41019,2020-11-01,48030,45155,2875,6
41021,2020-11-01,997,944,53,5.3
41023,2020-11-01,3261,3044,217,6.7
41025,2020-11-01,3869,3683,186,4.8
41027,2020-11-01,14033,13337,696,5
41029,2020-11-01,107474,101083,6391,5.9
41031,2020-11-01,10402,9692,710,6.8
41033,2020-11-01,36798,34519,2279,6.2
41035,2020-11-01,29622,27633,1989,6.7
41037,2020-11-01,3670,3495,175,4.8
41039,2020-11-01,179310,168342,10968,6.1
41041,2020-11-01,20294,18704,1590,7.8
41043,2020-11-01,59500,55807,3693,6.2
41045,2020-11-01,12936,12409,527,4.1
41047,2020-11-01,165799,156437,9362,5.6
41049,2020-11-01,5754,5503,251,4.4
41051,2020-11-01,463867,430497,33370,7.2
41053,2020-11-01,41070,38931,2139,5.2
41055,2020-11-01,971,928,43,4.4
41057,2020-11-01,11633,10908,725,6.2
41059,2020-11-01,37401,35477,1924,5.1
41061,2020-11-01,12281,11596,685,5.6
41063,2020-11-01,3517,3321,196,5.6
41065,2020-11-01,12893,12165,728,5.6
41067,2020-11-01,326474,309109,17365,5.3
41069,2020-11-01,715,686,29,4.1
41071,2020-11-01,54640,51678,2962,5.4
42001,2020-11-01,53894,51668,2226,4.1
42003,2020-11-01,626788,586191,40597,6.5
42005,2020-11-01,30872,28773,2099,6.8
42007,2020-11-01,81324,75443,5881,7.2
42009,2020-11-01,22878,21632,1246,5.4
42011,2020-11-01,208230,194447,13783,6.6
42013,2020-11-01,58718,55272,3446,5.9
42015,2020-11-01,27935,26439,1496,5.4
42017,2020-11-01,333148,314574,18574,5.6
42019,2020-11-01,95728,90728,5000,5.2
42021,2020-11-01,55252,51679,3573,6.5
42023,2020-11-01,2009,1861,148,7.4
42025,2020-11-01,31358,29345,2013,6.4
42027,2020-11-01,74962,71983,2979,4
42029,2020-11-01,277917,265966,11951,4.3
42031,2020-11-01,16861,15938,923,5.5
42033,2020-11-01,35032,32851,2181,6.2
42035,2020-11-01,17575,16472,1103,6.3
42037,2020-11-01,33220,31480,1740,5.2
42039,2020-11-01,37665,35281,2384,6.3
42041,2020-11-01,130370,124539,5831,4.5
42043,2020-11-01,143868,134426,9442,6.6
42045,2020-11-01,291939,272246,19693,6.7
42047,2020-11-01,14538,13445,1093,7.5
42049,2020-11-01,125069,116016,9053,7.2
42051,2020-11-01,54991,50418,4573,8.3
42053,2020-11-01,1758,1626,132,7.5
42055,2020-11-01,76087,72284,3803,5
42057,2020-11-01,7546,7115,431,5.7
42059,2020-11-01,15813,14725,1088,6.9
42061,2020-11-01,19422,18056,1366,7
42063,2020-11-01,37005,34760,2245,6.1
42065,2020-11-01,19654,18476,1178,6
42067,2020-11-01,12569,11936,633,5
42069,2020-11-01,103223,96253,6970,6.8
42071,2020-11-01,278771,265164,13607,4.9
42073,2020-11-01,39456,36512,2944,7.5
42075,2020-11-01,71340,67370,3970,5.6
42077,2020-11-01,191169,178123,13046,6.8
42079,2020-11-01,156084,143738,12346,7.9
42081,2020-11-01,55605,52139,3466,6.2
42083,2020-11-01,16662,15585,1077,6.5
42085,2020-11-01,47715,44300,3415,7.2
42087,2020-11-01,21052,19690,1362,6.5
42089,2020-11-01,79621,73366,6255,7.9
42091,2020-11-01,441256,418082,23174,5.3
42093,2020-11-01,9114,8728,386,4.2
42095,2020-11-01,158347,148910,9437,6
42097,2020-11-01,41418,38656,2762,6.7
42099,2020-11-01,24042,23008,1034,4.3
42101,2020-11-01,705264,633533,71731,10.2
42103,2020-11-01,23933,22223,1710,7.1
42105,2020-11-01,7122,6674,448,6.3
42107,2020-11-01,64792,60502,4290,6.6
42109,2020-11-01,19476,18556,920,4.7
42111,2020-11-01,31961,29891,2070,6.5
42113,2020-11-01,2606,2453,153,5.9
42115,2020-11-01,19754,18777,977,4.9
42117,2020-11-01,18578,17397,1181,6.4
42119,2020-11-01,19170,18343,827,4.3
42121,2020-11-01,21757,20246,1511,6.9
42123,2020-11-01,18724,17653,1071,5.7
42125,2020-11-01,103454,96491,6963,6.7
42127,2020-11-01,21876,20553,1323,6
42129,2020-11-01,173477,162766,10711,6.2
42131,2020-11-01,13214,12461,753,5.7
42133,2020-11-01,231445,219022,12423,5.4
44001,2020-11-01,25122,23412,1710,6.8
44003,2020-11-01,88065,82008,6057,6.9
44005,2020-11-01,42552,39739,2813,6.6
44007,2020-11-01,319557,292815,26742,8.4
44009,2020-11-01,65790,61558,4232,6.4
45001,2020-11-01,9861,9314,547,5.5
45003,2020-11-01,73933,70656,3277,4.4
45005,2020-11-01,2545,2312,233,9.2
45007,2020-11-01,89494,85041,4453,5
45009,2020-11-01,4640,4205,435,9.4
45011,2020-11-01,7760,7185,575,7.4
45013,2020-11-01,76224,72883,3341,4.4
45015,2020-11-01,102907,97790,5117,5
45017,2020-11-01,6468,6083,385,6
45019,2020-11-01,206950,195941,11009,5.3
45021,2020-11-01,25014,23275,1739,7
45023,2020-11-01,13415,12328,1087,8.1
45025,2020-11-01,21308,20067,1241,5.8
45027,2020-11-01,12329,11535,794,6.4
45029,2020-11-01,16330,15311,1019,6.2
45031,2020-11-01,30171,28327,1844,6.1
45033,2020-11-01,12959,12137,822,6.3
45035,2020-11-01,76117,72230,3887,5.1
45037,2020-11-01,10530,10053,477,4.5
45039,2020-11-01,9466,8762,704,7.4
45041,2020-11-01,66655,63073,3582,5.4
45043,2020-11-01,25269,23560,1709,6.8
45045,2020-11-01,252078,240231,11847,4.7
45047,2020-11-01,31004,29142,1862,6
45049,2020-11-01,8005,7598,407,5.1
45051,2020-11-01,141746,132225,9521,6.7
45053,2020-11-01,12695,12103,592,4.7
45055,2020-11-01,28972,27566,1406,4.9
45057,2020-11-01,41738,39313,2425,5.8
45059,2020-11-01,29625,27947,1678,5.7
45061,2020-11-01,6664,6193,471,7.1
45063,2020-11-01,148249,142198,6051,4.1
45065,2020-11-01,3269,3054,215,6.6
45067,2020-11-01,13139,12059,1080,8.2
45069,2020-11-01,9103,8259,844,9.3
45071,2020-11-01,18799,17954,845,4.5
45073,2020-11-01,34149,32675,1474,4.3
45075,2020-11-01,34122,31066,3056,9
45077,2020-11-01,56327,53812,2515,4.5
45079,2020-11-01,197470,186158,11312,5.7
45081,2020-11-01,8463,8125,338,4
45083,2020-11-01,155444,147243,8201,5.3
45085,2020-11-01,43250,40534,2716,6.3
45087,2020-11-01,11750,10853,897,7.6
45089,2020-11-01,11510,10638,872,7.6
45091,2020-11-01,141506,134268,7238,5.1
46003,2020-11-01,1460,1425,35,2.4
46005,2020-11-01,9146,8855,291,3.2
46007,2020-11-01,1055,1011,44,4.2
46009,2020-11-01,2801,2699,102,3.6
46011,2020-11-01,18483,17843,640,3.5
46013,2020-11-01,20278,19667,611,3
46015,2020-11-01,2418,2350,68,2.8
46017,2020-11-01,714,681,33,4.6
46019,2020-11-01,4904,4718,186,3.8
46021,2020-11-01,774,751,23,3
46023,2020-11-01,3707,3523,184,5
46025,2020-11-01,2282,2228,54,2.4
46027,2020-11-01,7377,7130,247,3.3
46029,2020-11-01,15087,14535,552,3.7
46031,2020-11-01,1350,1297,53,3.9
46033,2020-11-01,3989,3803,186,4.7
46035,2020-11-01,10794,10468,326,3
46037,2020-11-01,2649,2540,109,4.1
46039,2020-11-01,2444,2350,94,3.8
46041,2020-11-01,2239,2112,127,5.7
46043,2020-11-01,1537,1501,36,2.3
46045,2020-11-01,1997,1946,51,2.6
46047,2020-11-01,2898,2745,153,5.3
46049,2020-11-01,1056,1026,30,2.8
46051,2020-11-01,4282,4170,112,2.6
46053,2020-11-01,2060,2004,56,2.7
46055,2020-11-01,1082,1057,25,2.3
46057,2020-11-01,3347,3263,84,2.5
46059,2020-11-01,1817,1781,36,2
46061,2020-11-01,1722,1663,59,3.4
46063,2020-11-01,723,700,23,3.2
46065,2020-11-01,9842,9616,226,2.3
46067,2020-11-01,3530,3426,104,2.9
46069,2020-11-01,680,660,20,2.9
46071,2020-11-01,1149,1101,48,4.2
46073,2020-11-01,1207,1184,23,1.9
46075,2020-11-01,482,467,15,3.1
46077,2020-11-01,2635,2561,74,2.8
46079,2020-11-01,6393,6200,193,3
46081,2020-11-01,13250,12761,489,3.7
46083,2020-11-01,35051,34160,891,2.5
46085,2020-11-01,1635,1571,64,3.9
46087,2020-11-01,3030,2958,72,2.4
46089,2020-11-01,1005,959,46,4.6
46091,2020-11-01,2402,2321,81,3.4
46093,2020-11-01,13457,13032,425,3.2
46095,2020-11-01,707,674,33,4.7
46097,2020-11-01,1126,1073,53,4.7
46099,2020-11-01,110626,107183,3443,3.1
46101,2020-11-01,3932,3813,119,3
46102,2020-11-01,3721,3308,413,11.1
46103,2020-11-01,55215,53154,2061,3.7
46105,2020-11-01,1389,1331,58,4.2
46107,2020-11-01,993,970,23,2.3
46109,2020-11-01,4785,4584,201,4.2
46111,2020-11-01,1145,1114,31,2.7
46115,2020-11-01,3064,2977,87,2.8
46117,2020-11-01,1880,1832,48,2.6
46119,2020-11-01,795,779,16,2
46121,2020-11-01,2993,2828,165,5.5
46123,2020-11-01,3033,2962,71,2.3
46125,2020-11-01,4584,4462,122,2.7
46127,2020-11-01,8355,8024,331,4
46129,2020-11-01,2078,1979,99,4.8
46135,2020-11-01,11370,10990,380,3.3
46137,2020-11-01,954,913,41,4.3
47001,2020-11-01,34769,33113,1656,4.8
47003,2020-11-01,20993,19938,1055,5
47005,2020-11-01,6696,6301,395,5.9
47007,2020-11-01,4332,4045,287,6.6
47009,2020-11-01,64299,61512,2787,4.3
47011,2020-11-01,53592,50999,2593,4.8
47013,2020-11-01,14891,14072,819,5.5
47015,2020-11-01,6609,6329,280,4.2
47017,2020-11-01,12244,11569,675,5.5
47019,2020-11-01,24086,22816,1270,5.3
47021,2020-11-01,21725,20876,849,3.9
47023,2020-11-01,8644,8263,381,4.4
47025,2020-11-01,13099,12443,656,5
47027,2020-11-01,2796,2619,177,6.3
47029,2020-11-01,14401,13563,838,5.8
47031,2020-11-01,25630,24446,1184,4.6
47033,2020-11-01,7086,6782,304,4.3
47035,2020-11-01,23016,21688,1328,5.8
47037,2020-11-01,403008,383175,19833,4.9
47039,2020-11-01,4376,4093,283,6.5
47041,2020-11-01,7837,7380,457,5.8
47043,2020-11-01,26773,25738,1035,3.9
47045,2020-11-01,16085,15136,949,5.9
47047,2020-11-01,19600,18565,1035,5.3
47049,2020-11-01,7816,7366,450,5.8
47051,2020-11-01,19833,18915,918,4.6
47053,2020-11-01,22252,21054,1198,5.4
47055,2020-11-01,14698,13965,733,5
47057,2020-11-01,9623,9137,486,5.1
47059,2020-11-01,29011,27331,1680,5.8
47061,2020-11-01,5149,4831,318,6.2
47063,2020-11-01,28369,27041,1328,4.7
47065,2020-11-01,184473,175428,9045,4.9
47067,2020-11-01,2208,2076,132,6
47069,2020-11-01,9452,8740,712,7.5
47071,2020-11-01,10461,9857,604,5.8
47073,2020-11-01,23650,22383,1267,5.4
47075,2020-11-01,7945,7402,543,6.8
47077,2020-11-01,12150,11529,621,5.1
47079,2020-11-01,13661,12892,769,5.6
47081,2020-11-01,11342,10875,467,4.1
47083,2020-11-01,3296,3075,221,6.7
47085,2020-11-01,8788,8382,406,4.6
47087,2020-11-01,4929,4657,272,5.5
47089,2020-11-01,24908,23743,1165,4.7
47091,2020-11-01,7956,7556,400,5
47093,2020-11-01,246241,235930,10311,4.2
47095,2020-11-01,1750,1607,143,8.2
47097,2020-11-01,9978,9271,707,7.1
47099,2020-11-01,19461,18512,949,4.9
47101,2020-11-01,5426,5152,274,5
47103,2020-11-01,16294,15415,879,5.4
47105,2020-11-01,24010,22942,1068,4.4
47107,2020-11-01,23559,22351,1208,5.1
47109,2020-11-01,8491,7881,610,7.2
47111,2020-11-01,11511,10958,553,4.8
47113,2020-11-01,49967,47135,2832,5.7
47115,2020-11-01,12477,11821,656,5.3
47117,2020-11-01,15302,14547,755,4.9
47119,2020-11-01,49879,47590,2289,4.6
47121,2020-11-01,5234,4936,298,5.7
47123,2020-11-01,20366,19396,970,4.8
47125,2020-11-01,88138,83337,4801,5.4
47127,2020-11-01,3704,3572,132,3.6
47129,2020-11-01,7815,7420,395,5.1
47131,2020-11-01,12458,11706,752,6
47133,2020-11-01,9936,9506,430,4.3
47135,2020-11-01,3085,2890,195,6.3
47137,2020-11-01,2252,2143,109,4.8
47139,2020-11-01,7595,7217,378,5
47141,2020-11-01,35969,34261,1708,4.7
47143,2020-11-01,13166,12334,832,6.3
47145,2020-11-01,23495,22262,1233,5.2
47147,2020-11-01,38027,36477,1550,4.1
47149,2020-11-01,185435,178021,7414,4
47151,2020-11-01,8187,7677,510,6.2
47153,2020-11-01,6221,5880,341,5.5
47155,2020-11-01,53008,50934,2074,3.9
47157,2020-11-01,453962,419230,34732,7.7
47159,2020-11-01,9421,9058,363,3.9
47161,2020-11-01,5577,5271,306,5.5
47163,2020-11-01,70212,66450,3762,5.4
47165,2020-11-01,103319,98942,4377,4.2
47167,2020-11-01,28156,26623,1533,5.4
47169,2020-11-01,5491,5259,232,4.2
47171,2020-11-01,7266,6796,470,6.5
47173,2020-11-01,7736,7335,401,5.2
47175,2020-11-01,2024,1909,115,5.7
47177,2020-11-01,17373,16466,907,5.2
47179,2020-11-01,60861,57994,2867,4.7
47181,2020-11-01,6604,6250,354,5.4
47183,2020-11-01,16071,15322,749,4.7
47185,2020-11-01,12329,11742,587,4.8
47187,2020-11-01,129728,125390,4338,3.3
47189,2020-11-01,77639,74623,3016,3.9
48001,2020-11-01,23369,22024,1345,5.8
48003,2020-11-01,9060,8304,756,8.3
48005,2020-11-01,35479,32899,2580,7.3
48007,2020-11-01,8998,8263,735,8.2
48009,2020-11-01,3900,3700,200,5.1
48011,2020-11-01,917,881,36,3.9
48013,2020-11-01,22121,20308,1813,8.2
48015,2020-11-01,13635,12746,889,6.5
48017,2020-11-01,2418,2307,111,4.6
48019,2020-11-01,9947,9406,541,5.4
48021,2020-11-01,43062,40757,2305,5.4
48023,2020-11-01,1776,1712,64,3.6
48025,2020-11-01,9839,8843,996,10.1
48027,2020-11-01,146085,136674,9411,6.4
48029,2020-11-01,951322,888808,62514,6.6
48031,2020-11-01,6638,6414,224,3.4
48033,2020-11-01,446,431,15,3.4
48035,2020-11-01,8398,7977,421,5
48037,2020-11-01,38943,36407,2536,6.5
48039,2020-11-01,177681,163043,14638,8.2
48041,2020-11-01,119212,113569,5643,4.7
48043,2020-11-01,4100,3871,229,5.6
48045,2020-11-01,564,538,26,4.6
48047,2020-11-01,2571,2284,287,11.2
48049,2020-11-01,15267,14316,951,6.2
48051,2020-11-01,8359,7851,508,6.1
48053,2020-11-01,23941,22884,1057,4.4
48055,2020-11-01,19564,18438,1126,5.8
48057,2020-11-01,12425,11758,667,5.4
48059,2020-11-01,6009,5701,308,5.1
48061,2020-11-01,168881,152793,16088,9.5
48063,2020-11-01,5038,4664,374,7.4
48065,2020-11-01,2945,2830,115,3.9
48067,2020-11-01,12364,11348,1016,8.2
48069,2020-11-01,3307,3187,120,3.6
48071,2020-11-01,19902,18013,1889,9.5
48073,2020-11-01,21504,19838,1666,7.7
48075,2020-11-01,3104,3000,104,3.4
48077,2020-11-01,4780,4518,262,5.5
48079,2020-11-01,1082,1005,77,7.1
48081,2020-11-01,1345,1270,75,5.6
48083,2020-11-01,2893,2691,202,7
48085,2020-11-01,576628,545759,30869,5.4
48087,2020-11-01,1069,1019,50,4.7
48089,2020-11-01,9610,9065,545,5.7
48091,2020-11-01,75707,71639,4068,5.4
48093,2020-11-01,5674,5360,314,5.5
48095,2020-11-01,1315,1255,60,4.6
48097,2020-11-01,19202,17936,1266,6.6
48099,2020-11-01,24232,22762,1470,6.1
48101,2020-11-01,581,554,27,4.6
48103,2020-11-01,1627,1392,235,14.4
48105,2020-11-01,1520,1381,139,9.1
48107,2020-11-01,2385,2262,123,5.2
48109,2020-11-01,1146,1077,69,6
48111,2020-11-01,3746,3636,110,2.9
48113,2020-11-01,NA,NA,93590,6.8
48115,2020-11-01,4582,4167,415,9.1
48117,2020-11-01,8532,8197,335,3.9
48119,2020-11-01,2442,2313,129,5.3
48121,2020-11-01,509132,481241,27891,5.5
48123,2020-11-01,9092,8512,580,6.4
48125,2020-11-01,655,615,40,6.1
48127,2020-11-01,6178,5733,445,7.2
48129,2020-11-01,1425,1365,60,4.2
48131,2020-11-01,4803,4177,626,13
48133,2020-11-01,7467,6987,480,6.4
48135,2020-11-01,80578,70752,9826,12.2
48137,2020-11-01,1323,1268,55,4.2
48139,2020-11-01,94821,89702,5119,5.4
48141,2020-11-01,370112,340515,29597,8
48143,2020-11-01,20342,19245,1097,5.4
48145,2020-11-01,6631,6247,384,5.8
48147,2020-11-01,17017,16270,747,4.4
48149,2020-11-01,11661,11062,599,5.1
48151,2020-11-01,1611,1533,78,4.8
48153,2020-11-01,2497,2359,138,5.5
48155,2020-11-01,568,545,23,4
48157,2020-11-01,394667,365739,28928,7.3
48159,2020-11-01,4925,4660,265,5.4
48161,2020-11-01,6284,5772,512,8.1
48163,2020-11-01,9126,8589,537,5.9
48165,2020-11-01,9608,9008,600,6.2
48167,2020-11-01,163892,150718,13174,8
48169,2020-11-01,2004,1859,145,7.2
48171,2020-11-01,13406,12883,523,3.9
48173,2020-11-01,751,720,31,4.1
48175,2020-11-01,3169,2918,251,7.9
48177,2020-11-01,9633,9084,549,5.7
48179,2020-11-01,7655,6970,685,8.9
48181,2020-11-01,65063,61623,3440,5.3
48183,2020-11-01,56328,51848,4480,8
48185,2020-11-01,11233,10317,916,8.2
48187,2020-11-01,81574,77217,4357,5.3
48189,2020-11-01,11822,11081,741,6.3
48191,2020-11-01,1075,1016,59,5.5
48193,2020-11-01,3814,3639,175,4.6
48195,2020-11-01,2505,2406,99,4
48197,2020-11-01,1709,1631,78,4.6
48199,2020-11-01,25029,22975,2054,8.2
48201,2020-11-01,NA,NA,181400,8
48203,2020-11-01,29115,26796,2319,8
48205,2020-11-01,2631,2581,50,1.9
48207,2020-11-01,2611,2497,114,4.4
48209,2020-11-01,122278,115916,6362,5.2
48211,2020-11-01,1866,1775,91,4.9
48213,2020-11-01,37628,35390,2238,5.9
48215,2020-11-01,359852,321200,38652,10.7
48217,2020-11-01,16442,15472,970,5.9
48219,2020-11-01,10498,9651,847,8.1
48221,2020-11-01,27980,26267,1713,6.1
48223,2020-11-01,17693,16834,859,4.9
48225,2020-11-01,10048,9481,567,5.6
48227,2020-11-01,13330,12196,1134,8.5
48229,2020-11-01,1870,1714,156,8.3
48231,2020-11-01,44053,41449,2604,5.9
48233,2020-11-01,8601,8014,587,6.8
48235,2020-11-01,748,702,46,6.1
48237,2020-11-01,3322,3084,238,7.2
48239,2020-11-01,7153,6744,409,5.7
48241,2020-11-01,12803,11450,1353,10.6
48243,2020-11-01,970,925,45,4.6
48245,2020-11-01,105401,93839,11562,11
48247,2020-11-01,1897,1694,203,10.7
48249,2020-11-01,15613,13432,2181,14
48251,2020-11-01,84319,79335,4984,5.9
48253,2020-11-01,5776,5367,409,7.1
48255,2020-11-01,6807,6322,485,7.1
48257,2020-11-01,68265,64207,4058,5.9
48259,2020-11-01,22313,21320,993,4.5
48261,2020-11-01,165,153,12,7.3
48263,2020-11-01,427,413,14,3.3
48265,2020-11-01,21524,20436,1088,5.1
48267,2020-11-01,1826,1724,102,5.6
48269,2020-11-01,252,248,4,1.6
48271,2020-11-01,1294,1216,78,6
48273,2020-11-01,13593,12507,1086,8
48275,2020-11-01,1444,1358,86,6
48277,2020-11-01,23901,22459,1442,6
48279,2020-11-01,5158,4885,273,5.3
48281,2020-11-01,9143,8670,473,5.2
48283,2020-11-01,3485,3244,241,6.9
48285,2020-11-01,8313,7859,454,5.5
48287,2020-11-01,9046,8612,434,4.8
48289,2020-11-01,6162,5660,502,8.1
48291,2020-11-01,33781,30082,3699,10.9
48293,2020-11-01,8294,7681,613,7.4
48295,2020-11-01,1521,1457,64,4.2
48297,2020-11-01,5153,4714,439,8.5
48299,2020-11-01,8532,8052,480,5.6
48301,2020-11-01,303,300,3,1
48303,2020-11-01,158765,150360,8405,5.3
48305,2020-11-01,2744,2597,147,5.4
48307,2020-11-01,3244,3002,242,7.5
48309,2020-11-01,122379,115489,6890,5.6
48311,2020-11-01,690,670,20,2.9
48313,2020-11-01,4506,4166,340,7.5
48315,2020-11-01,4307,3965,342,7.9
48317,2020-11-01,2456,2295,161,6.6
48319,2020-11-01,1712,1603,109,6.4
48321,2020-11-01,16204,14540,1664,10.3
48323,2020-11-01,24711,21023,3688,14.9
48325,2020-11-01,21714,20443,1271,5.9
48327,2020-11-01,861,817,44,5.1
48329,2020-11-01,95458,87156,8302,8.7
48331,2020-11-01,9779,9102,677,6.9
48333,2020-11-01,1911,1828,83,4.3
48335,2020-11-01,2411,2190,221,9.2
48337,2020-11-01,8968,8402,566,6.3
48339,2020-11-01,284710,264319,20391,7.2
48341,2020-11-01,10595,10203,392,3.7
48343,2020-11-01,4755,4107,648,13.6
48345,2020-11-01,427,408,19,4.4
48347,2020-11-01,28376,26570,1806,6.4
48349,2020-11-01,23551,22246,1305,5.5
48351,2020-11-01,5028,4530,498,9.9
48353,2020-11-01,7239,6831,408,5.6
48355,2020-11-01,162774,149082,13692,8.4
48357,2020-11-01,3978,3732,246,6.2
48359,2020-11-01,893,860,33,3.7
48361,2020-11-01,36057,32534,3523,9.8
48363,2020-11-01,13189,12241,948,7.2
48365,2020-11-01,9326,8520,806,8.6
48367,2020-11-01,69217,65535,3682,5.3
48369,2020-11-01,5042,4897,145,2.9
48371,2020-11-01,6709,6146,563,8.4
48373,2020-11-01,18558,16928,1630,8.8
48375,2020-11-01,54823,52050,2773,5.1
48377,2020-11-01,3157,2735,422,13.4
48379,2020-11-01,6110,5848,262,4.3
48381,2020-11-01,73234,70306,2928,4
48383,2020-11-01,1733,1538,195,11.3
48385,2020-11-01,1070,997,73,6.8
48387,2020-11-01,5215,4894,321,6.2
48389,2020-11-01,8298,7587,711,8.6
48391,2020-11-01,3053,2802,251,8.2
48393,2020-11-01,414,399,15,3.6
48395,2020-11-01,7525,7034,491,6.5
48397,2020-11-01,53782,51028,2754,5.1
48399,2020-11-01,4503,4305,198,4.4
48401,2020-11-01,22133,20462,1671,7.5
48403,2020-11-01,3961,3557,404,10.2
48405,2020-11-01,2988,2678,310,10.4
48407,2020-11-01,11743,10787,956,8.1
48409,2020-11-01,29057,26174,2883,9.9
48411,2020-11-01,2145,2038,107,5
48413,2020-11-01,1187,1095,92,7.8
48415,2020-11-01,6151,5629,522,8.5
48417,2020-11-01,1733,1640,93,5.4
48419,2020-11-01,11311,10551,760,6.7
48421,2020-11-01,1294,1249,45,3.5
48423,2020-11-01,109384,102729,6655,6.1
48425,2020-11-01,4390,4138,252,5.7
48427,2020-11-01,26145,21857,4288,16.4
48429,2020-11-01,4090,3820,270,6.6
48431,2020-11-01,547,510,37,6.8
48433,2020-11-01,563,534,29,5.2
48435,2020-11-01,1208,1069,139,11.5
48437,2020-11-01,2510,2383,127,5.1
48439,2020-11-01,NA,NA,70751,6.4
48441,2020-11-01,66595,63242,3353,5
48443,2020-11-01,403,386,17,4.2
48445,2020-11-01,4790,4421,369,7.7
48447,2020-11-01,625,590,35,5.6
48449,2020-11-01,13426,12594,832,6.2
48451,2020-11-01,53937,50683,3254,6
48453,2020-11-01,747189,708272,38917,5.2
48455,2020-11-01,5353,4924,429,8
48457,2020-11-01,7344,6641,703,9.6
48459,2020-11-01,17374,16067,1307,7.5
48461,2020-11-01,1815,1708,107,5.9
48463,2020-11-01,11138,10402,736,6.6
48465,2020-11-01,23170,21570,1600,6.9
48467,2020-11-01,26305,24799,1506,5.7
48469,2020-11-01,41099,37893,3206,7.8
48471,2020-11-01,24197,22455,1742,7.2
48473,2020-11-01,23838,21989,1849,7.8
48475,2020-11-01,5834,5198,636,10.9
48477,2020-11-01,15475,14588,887,5.7
48479,2020-11-01,115757,106579,9178,7.9
48481,2020-11-01,21254,19839,1415,6.7
48483,2020-11-01,2247,2074,173,7.7
48485,2020-11-01,55407,51789,3618,6.5
48487,2020-11-01,4992,4663,329,6.6
48489,2020-11-01,6471,5761,710,11
48491,2020-11-01,321914,306045,15869,4.9
48493,2020-11-01,24801,23502,1299,5.2
48495,2020-11-01,3927,3535,392,10
48497,2020-11-01,32565,30671,1894,5.8
48499,2020-11-01,18100,16982,1118,6.2
48501,2020-11-01,3367,2963,404,12
48503,2020-11-01,7801,7390,411,5.3
48505,2020-11-01,4288,3651,637,14.9
48507,2020-11-01,3419,2912,507,14.8
49001,2020-11-01,2882,2798,84,2.9
49003,2020-11-01,26551,25897,654,2.5
49005,2020-11-01,66683,65314,1369,2.1
49007,2020-11-01,8601,8243,358,4.2
49009,2020-11-01,394,373,21,5.3
49011,2020-11-01,177190,172273,4917,2.8
49013,2020-11-01,7594,7114,480,6.3
49015,2020-11-01,4359,4210,149,3.4
49017,2020-11-01,2400,2234,166,6.9
49019,2020-11-01,5877,5594,283,4.8
49021,2020-11-01,25749,24951,798,3.1
49023,2020-11-01,6039,5928,111,1.8
49025,2020-11-01,3654,3529,125,3.4
49027,2020-11-01,5948,5813,135,2.3
49029,2020-11-01,5616,5491,125,2.2
49031,2020-11-01,481,457,24,5
49033,2020-11-01,1051,1027,24,2.3
49035,2020-11-01,642405,620650,21755,3.4
49037,2020-11-01,5252,4838,414,7.9
49039,2020-11-01,12804,12433,371,2.9
49041,2020-11-01,9875,9573,302,3.1
49043,2020-11-01,22364,21338,1026,4.6
49045,2020-11-01,35215,34055,1160,3.3
49047,2020-11-01,13112,12124,988,7.5
49049,2020-11-01,321974,313498,8476,2.6
49051,2020-11-01,15820,15194,626,4
49053,2020-11-01,81297,78530,2767,3.4
49055,2020-11-01,1399,1332,67,4.8
49057,2020-11-01,130666,126451,4215,3.2
50001,2020-11-01,19806,19273,533,2.7
50003,2020-11-01,15962,15298,664,4.2
50005,2020-11-01,13761,13316,445,3.2
50007,2020-11-01,90463,87956,2507,2.8
50009,2020-11-01,2496,2406,90,3.6
50011,2020-11-01,25202,24419,783,3.1
50013,2020-11-01,3876,3735,141,3.6
50015,2020-11-01,12317,11804,513,4.2
50017,2020-11-01,14939,14513,426,2.9
50019,2020-11-01,11994,11493,501,4.2
50021,2020-11-01,27932,26805,1127,4
50023,2020-11-01,31574,30712,862,2.7
50025,2020-11-01,20039,19221,818,4.1
50027,2020-11-01,26567,25699,868,3.3
51001,2020-11-01,16028,15168,860,5.4
51003,2020-11-01,54445,51999,2446,4.5
51005,2020-11-01,6706,6369,337,5
51007,2020-11-01,6116,5799,317,5.2
51009,2020-11-01,14414,13702,712,4.9
51011,2020-11-01,6954,6574,380,5.5
51013,2020-11-01,148560,141678,6882,4.6
51015,2020-11-01,36837,35390,1447,3.9
51017,2020-11-01,2208,2086,122,5.5
51019,2020-11-01,37008,35342,1666,4.5
51021,2020-11-01,2815,2687,128,4.5
51023,2020-11-01,16895,16241,654,3.9
51025,2020-11-01,5853,5408,445,7.6
51027,2020-11-01,6303,5759,544,8.6
51029,2020-11-01,6215,5787,428,6.9
51031,2020-11-01,24939,23670,1269,5.1
51033,2020-11-01,14671,13762,909,6.2
51035,2020-11-01,13033,12306,727,5.6
51036,2020-11-01,3548,3344,204,5.7
51037,2020-11-01,5111,4859,252,4.9
51041,2020-11-01,181004,171785,9219,5.1
51043,2020-11-01,7402,7111,291,3.9
51045,2020-11-01,2248,2157,91,4
51047,2020-11-01,24022,23033,989,4.1
51049,2020-11-01,4514,4268,246,5.4
51051,2020-11-01,4692,4365,327,7
51053,2020-11-01,13199,12415,784,5.9
51057,2020-11-01,5462,5129,333,6.1
51059,2020-11-01,614527,581448,33079,5.4
51061,2020-11-01,36223,34774,1449,4
51063,2020-11-01,8103,7787,316,3.9
51065,2020-11-01,13368,12768,600,4.5
51067,2020-11-01,25681,24453,1228,4.8
51069,2020-11-01,47930,46180,1750,3.7
51071,2020-11-01,7670,7308,362,4.7
51073,2020-11-01,18852,17992,860,4.6
51075,2020-11-01,10900,10449,451,4.1
51077,2020-11-01,8489,8143,346,4.1
51079,2020-11-01,9937,9519,418,4.2
51081,2020-11-01,4242,3954,288,6.8
51083,2020-11-01,15084,14164,920,6.1
51085,2020-11-01,56512,54179,2333,4.1
51087,2020-11-01,175284,165295,9989,5.7
51089,2020-11-01,24023,22486,1537,6.4
51091,2020-11-01,1296,1261,35,2.7
51093,2020-11-01,18782,17918,864,4.6
51095,2020-11-01,35448,33528,1920,5.4
51097,2020-11-01,3850,3669,181,4.7
51099,2020-11-01,13839,13312,527,3.8
51101,2020-11-01,8861,8455,406,4.6
51103,2020-11-01,5469,5170,299,5.5
51105,2020-11-01,8232,7798,434,5.3
51107,2020-11-01,217712,207619,10093,4.6
51109,2020-11-01,20017,19164,853,4.3
51111,2020-11-01,5312,5046,266,5
51113,2020-11-01,7379,7143,236,3.2
51115,2020-11-01,3976,3801,175,4.4
51117,2020-11-01,12726,11983,743,5.8
51119,2020-11-01,5120,4902,218,4.3
51121,2020-11-01,48289,46474,1815,3.8
51125,2020-11-01,7195,6855,340,4.7
51127,2020-11-01,12216,11733,483,4
51131,2020-11-01,5576,5204,372,6.7
51133,2020-11-01,5772,5499,273,4.7
51135,2020-11-01,7038,6696,342,4.9
51137,2020-11-01,17002,16207,795,4.7
51139,2020-11-01,12004,11406,598,5
51141,2020-11-01,7159,6783,376,5.3
51143,2020-11-01,30205,28689,1516,5
51145,2020-11-01,13609,13069,540,4
51147,2020-11-01,10110,9568,542,5.4
51149,2020-11-01,14565,13672,893,6.1
51153,2020-11-01,239685,225734,13951,5.8
51155,2020-11-01,15730,14867,863,5.5
51157,2020-11-01,3656,3510,146,4
51159,2020-11-01,4095,3917,178,4.3
51161,2020-11-01,47764,45748,2016,4.2
51163,2020-11-01,10678,10051,627,5.9
51165,2020-11-01,41290,39808,1482,3.6
51167,2020-11-01,11077,10481,596,5.4
51169,2020-11-01,8788,8410,378,4.3
51171,2020-11-01,22005,21048,957,4.3
51173,2020-11-01,13312,12643,669,5
51175,2020-11-01,9205,8785,420,4.6
51177,2020-11-01,65398,62104,3294,5
51179,2020-11-01,70497,66983,3514,5
51181,2020-11-01,3592,3427,165,4.6
51183,2020-11-01,3797,3483,314,8.3
51185,2020-11-01,15449,14462,987,6.4
51187,2020-11-01,19744,18791,953,4.8
51191,2020-11-01,25344,24199,1145,4.5
51193,2020-11-01,9589,9089,500,5.2
51195,2020-11-01,12819,11928,891,7
51197,2020-11-01,13726,13006,720,5.2
51199,2020-11-01,31473,30085,1388,4.4
51510,2020-11-01,98402,92458,5944,6
51520,2020-11-01,7127,6662,465,6.5
51530,2020-11-01,3192,2979,213,6.7
51540,2020-11-01,24622,23327,1295,5.3
51550,2020-11-01,119049,112692,6357,5.3
51570,2020-11-01,8262,7725,537,6.5
51580,2020-11-01,2353,2175,178,7.6
51590,2020-11-01,19432,17866,1566,8.1
51595,2020-11-01,2359,2109,250,10.6
51600,2020-11-01,12696,12087,609,4.8
51610,2020-11-01,8131,7828,303,3.7
51620,2020-11-01,3675,3358,317,8.6
51630,2020-11-01,13599,12768,831,6.1
51640,2020-11-01,2859,2705,154,5.4
51650,2020-11-01,62959,58105,4854,7.7
51660,2020-11-01,23790,22655,1135,4.8
51670,2020-11-01,9573,8583,990,10.3
51678,2020-11-01,2054,1930,124,6
51680,2020-11-01,35122,32887,2235,6.4
51683,2020-11-01,21082,19909,1173,5.6
51685,2020-11-01,9243,8683,560,6.1
51690,2020-11-01,5722,5166,556,9.7
51700,2020-11-01,87150,80523,6627,7.6
51710,2020-11-01,109201,100317,8884,8.1
51720,2020-11-01,1628,1523,105,6.4
51730,2020-11-01,13269,11356,1913,14.4
51735,2020-11-01,6127,5925,202,3.3
51740,2020-11-01,43902,39740,4162,9.5
51750,2020-11-01,8321,7933,388,4.7
51760,2020-11-01,116500,107276,9224,7.9
51770,2020-11-01,48128,44899,3229,6.7
51775,2020-11-01,12358,11800,558,4.5
51790,2020-11-01,12033,11425,608,5.1
51800,2020-11-01,43607,40975,2632,6
51810,2020-11-01,223868,212474,11394,5.1
51820,2020-11-01,10505,9940,565,5.4
51830,2020-11-01,6476,6049,427,6.6
51840,2020-11-01,14681,14026,655,4.5
53001,2020-11-01,8566,8013,553,6.5
53003,2020-11-01,10294,9896,398,3.9
53005,2020-11-01,100158,93954,6204,6.2
53007,2020-11-01,41681,39036,2645,6.3
53009,2020-11-01,29075,26966,2109,7.3
53011,2020-11-01,237180,221350,15830,6.7
53013,2020-11-01,1686,1587,99,5.9
53015,2020-11-01,46972,43561,3411,7.3
53017,2020-11-01,19896,18595,1301,6.5
53019,2020-11-01,2461,2267,194,7.9
53021,2020-11-01,40341,37272,3069,7.6
53023,2020-11-01,799,745,54,6.8
53025,2020-11-01,45734,42407,3327,7.3
53027,2020-11-01,28694,26051,2643,9.2
53029,2020-11-01,35806,33509,2297,6.4
53031,2020-11-01,12842,11961,881,6.9
53033,2020-11-01,NA,NA,75918,5.9
53035,2020-11-01,125744,118236,7508,6
53037,2020-11-01,21420,20028,1392,6.5
53039,2020-11-01,9472,8854,618,6.5
53041,2020-11-01,34275,31950,2325,6.8
53043,2020-11-01,4606,4370,236,5.1
53045,2020-11-01,25449,23437,2012,7.9
53047,2020-11-01,18709,17420,1289,6.9
53049,2020-11-01,8693,7988,705,8.1
53051,2020-11-01,4836,4427,409,8.5
53053,2020-11-01,436982,405122,31860,7.3
53055,2020-11-01,8618,8147,471,5.5
53057,2020-11-01,60255,55824,4431,7.4
53059,2020-11-01,5398,4999,399,7.4
53061,2020-11-01,441973,412810,29163,6.6
53063,2020-11-01,249538,233677,15861,6.4
53065,2020-11-01,17969,16739,1230,6.8
53067,2020-11-01,141391,132760,8631,6.1
53069,2020-11-01,1455,1360,95,6.5
53071,2020-11-01,29371,27760,1611,5.5
53073,2020-11-01,111275,103436,7839,7
53075,2020-11-01,21358,20282,1076,5
53077,2020-11-01,122353,112768,9585,7.8
54001,2020-11-01,7509,7015,494,6.6
54003,2020-11-01,59067,56289,2778,4.7
54005,2020-11-01,7402,6774,628,8.5
54007,2020-11-01,5067,4636,431,8.5
54009,2020-11-01,9938,9206,732,7.4
54011,2020-11-01,41836,39272,2564,6.1
54013,2020-11-01,2439,2103,336,13.8
54015,2020-11-01,3089,2795,294,9.5
54017,2020-11-01,3770,3571,199,5.3
54019,2020-11-01,16205,14910,1295,8
54021,2020-11-01,2429,2242,187,7.7
54023,2020-11-01,5902,5614,288,4.9
54025,2020-11-01,15661,14774,887,5.7
54027,2020-11-01,11009,10518,491,4.5
54029,2020-11-01,13056,12073,983,7.5
54031,2020-11-01,5838,5499,339,5.8
54033,2020-11-01,33924,31761,2163,6.4
54035,2020-11-01,12628,11754,874,6.9
54037,2020-11-01,30359,28964,1395,4.6
54039,2020-11-01,82298,76429,5869,7.1
54041,2020-11-01,6270,5686,584,9.3
54043,2020-11-01,7257,6676,581,8
54045,2020-11-01,10933,9846,1087,9.9
54047,2020-11-01,4414,3921,493,11.2
54049,2020-11-01,25468,23837,1631,6.4
54051,2020-11-01,13608,12591,1017,7.5
54053,2020-11-01,10458,9782,676,6.5
54055,2020-11-01,21022,19387,1635,7.8
54057,2020-11-01,12309,11585,724,5.9
54059,2020-11-01,6677,5903,774,11.6
54061,2020-11-01,55381,52788,2593,4.7
54063,2020-11-01,6112,5795,317,5.2
54065,2020-11-01,8467,8111,356,4.2
54067,2020-11-01,9645,8936,709,7.4
54069,2020-11-01,20561,19223,1338,6.5
54071,2020-11-01,3785,3652,133,3.5
54073,2020-11-01,2686,2442,244,9.1
54075,2020-11-01,3656,3377,279,7.6
54077,2020-11-01,15684,14826,858,5.5
54079,2020-11-01,26969,25519,1450,5.4
54081,2020-11-01,30452,28324,2128,7
54083,2020-11-01,12267,11394,873,7.1
54085,2020-11-01,4352,4050,302,6.9
54087,2020-11-01,5043,4525,518,10.3
54089,2020-11-01,4319,4030,289,6.7
54091,2020-11-01,7882,7440,442,5.6
54093,2020-11-01,3238,3036,202,6.2
54095,2020-11-01,3199,2905,294,9.2
54097,2020-11-01,9507,8734,773,8.1
54099,2020-11-01,15770,14766,1004,6.4
54101,2020-11-01,3358,3115,243,7.2
54103,2020-11-01,6899,6331,568,8.2
54105,2020-11-01,2287,2081,206,9
54107,2020-11-01,36410,33916,2494,6.8
54109,2020-11-01,6295,5733,562,8.9
55001,2020-11-01,7886,7340,546,6.9
55003,2020-11-01,7539,7087,452,6
55005,2020-11-01,23632,22769,863,3.7
55007,2020-11-01,7274,6781,493,6.8
55009,2020-11-01,140260,135008,5252,3.7
55011,2020-11-01,6216,5960,256,4.1
55013,2020-11-01,7083,6665,418,5.9
55015,2020-11-01,27128,26346,782,2.9
55017,2020-11-01,33415,32084,1331,4
55019,2020-11-01,17387,16876,511,2.9
55021,2020-11-01,31222,30072,1150,3.7
55023,2020-11-01,7424,7122,302,4.1
55025,2020-11-01,321693,311345,10348,3.2
55027,2020-11-01,47162,45588,1574,3.3
55029,2020-11-01,14229,13564,665,4.7
55031,2020-11-01,22617,21506,1111,4.9
55033,2020-11-01,24225,23425,800,3.3
55035,2020-11-01,59270,57221,2049,3.5
55037,2020-11-01,2184,2068,116,5.3
55039,2020-11-01,56690,54720,1970,3.5
55041,2020-11-01,3766,3457,309,8.2
55043,2020-11-01,27715,26860,855,3.1
55045,2020-11-01,20587,19970,617,3
55047,2020-11-01,9104,8716,388,4.3
55049,2020-11-01,13386,12924,462,3.5
55051,2020-11-01,2506,2318,188,7.5
55053,2020-11-01,9557,8995,562,5.9
55055,2020-11-01,45454,43870,1584,3.5
55057,2020-11-01,13194,12572,622,4.7
55059,2020-11-01,88231,84175,4056,4.6
55061,2020-11-01,10667,10357,310,2.9
55063,2020-11-01,65709,63557,2152,3.3
55065,2020-11-01,9776,9520,256,2.6
55067,2020-11-01,9267,8854,413,4.5
55069,2020-11-01,14714,14188,526,3.6
55071,2020-11-01,40338,38825,1513,3.8
55073,2020-11-01,72179,69884,2295,3.2
55075,2020-11-01,19587,18627,960,4.9
55077,2020-11-01,7659,7314,345,4.5
55078,2020-11-01,1578,1426,152,9.6
55079,2020-11-01,460330,432416,27914,6.1
55081,2020-11-01,23197,22335,862,3.7
55083,2020-11-01,20182,19383,799,4
55085,2020-11-01,17428,16640,788,4.5
55087,2020-11-01,102601,99238,3363,3.3
55089,2020-11-01,47860,46177,1683,3.5
55091,2020-11-01,4071,3929,142,3.5
55093,2020-11-01,24300,23401,899,3.7
55095,2020-11-01,24112,23001,1111,4.6
55097,2020-11-01,37882,36562,1320,3.5
55099,2020-11-01,6182,5909,273,4.4
55101,2020-11-01,96863,92047,4816,5
55103,2020-11-01,8987,8697,290,3.2
55105,2020-11-01,84235,80583,3652,4.3
55107,2020-11-01,6569,6267,302,4.6
55109,2020-11-01,48911,46979,1932,4
55111,2020-11-01,33627,32129,1498,4.5
55113,2020-11-01,7705,7251,454,5.9
55115,2020-11-01,20763,19954,809,3.9
55117,2020-11-01,61498,59402,2096,3.4
55119,2020-11-01,10884,10521,363,3.3
55121,2020-11-01,15328,14702,626,4.1
55123,2020-11-01,14916,14436,480,3.2
55125,2020-11-01,9930,9441,489,4.9
55127,2020-11-01,56437,54310,2127,3.8
55129,2020-11-01,7637,7317,320,4.2
55131,2020-11-01,75221,72572,2649,3.5
55133,2020-11-01,219829,211766,8063,3.7
55135,2020-11-01,25339,24427,912,3.6
55137,2020-11-01,11094,10658,436,3.9
55139,2020-11-01,91341,88275,3066,3.4
55141,2020-11-01,34328,32816,1512,4.4
56001,2020-11-01,19447,18796,651,3.3
56003,2020-11-01,5389,5192,197,3.7
56005,2020-11-01,23236,21895,1341,5.8
56007,2020-11-01,8237,7949,288,3.5
56009,2020-11-01,7938,7486,452,5.7
56011,2020-11-01,3914,3793,121,3.1
56013,2020-11-01,19478,18500,978,5
56015,2020-11-01,6745,6491,254,3.8
56017,2020-11-01,2268,2174,94,4.1
56019,2020-11-01,4148,3973,175,4.2
56021,2020-11-01,51064,49041,2023,4
56023,2020-11-01,9299,8945,354,3.8
56025,2020-11-01,41188,38435,2753,6.7
56027,2020-11-01,1261,1221,40,3.2
56029,2020-11-01,14867,14212,655,4.4
56031,2020-11-01,4665,4480,185,4
56033,2020-11-01,16301,15667,634,3.9
56035,2020-11-01,3986,3772,214,5.4
56037,2020-11-01,20888,19648,1240,5.9
56039,2020-11-01,13091,12279,812,6.2
56041,2020-11-01,9467,8992,475,5
56043,2020-11-01,4055,3878,177,4.4
56045,2020-11-01,3889,3767,122,3.1
72001,2020-11-01,3991,3523,468,11.7
72003,2020-11-01,11379,10298,1081,9.5
72005,2020-11-01,13902,12457,1445,10.4
72007,2020-11-01,6180,5523,657,10.6
72009,2020-11-01,6006,5454,552,9.2
72011,2020-11-01,8497,7764,733,8.6
72013,2020-11-01,22993,20802,2191,9.5
72015,2020-11-01,4449,4014,435,9.8
72017,2020-11-01,5538,4941,597,10.8
72019,2020-11-01,6936,6228,708,10.2
72021,2020-11-01,62811,56664,6147,9.8
72023,2020-11-01,13202,12040,1162,8.8
72025,2020-11-01,45484,41521,3963,8.7
72027,2020-11-01,9112,8334,778,8.5
72029,2020-11-01,15549,14086,1463,9.4
72031,2020-11-01,59309,53626,5683,9.6
72033,2020-11-01,7541,6743,798,10.6
72035,2020-11-01,15162,13997,1165,7.7
72037,2020-11-01,3457,3084,373,10.8
72039,2020-11-01,3538,3069,469,13.3
72041,2020-11-01,14474,13495,979,6.8
72043,2020-11-01,9449,8467,982,10.4
72045,2020-11-01,4689,4157,532,11.3
72047,2020-11-01,8655,7549,1106,12.8
72049,2020-11-01,838,761,77,9.2
72051,2020-11-01,12713,11731,982,7.7
72053,2020-11-01,10287,9086,1201,11.7
72054,2020-11-01,3143,2751,392,12.5
72055,2020-11-01,3819,3352,467,12.2
72057,2020-11-01,10478,9596,882,8.4
72059,2020-11-01,4561,4029,532,11.7
72061,2020-11-01,35854,33665,2189,6.1
72063,2020-11-01,17345,16201,1144,6.6
72065,2020-11-01,12676,11583,1093,8.6
72067,2020-11-01,5192,4710,482,9.3
72069,2020-11-01,16154,14686,1468,9.1
72071,2020-11-01,11261,10238,1023,9.1
72073,2020-11-01,4233,3793,440,10.4
72075,2020-11-01,14920,13659,1261,8.5
72077,2020-11-01,11774,10600,1174,10
72079,2020-11-01,5010,4431,579,11.6
72081,2020-11-01,6734,5933,801,11.9
72083,2020-11-01,2613,2347,266,10.2
72085,2020-11-01,10718,9732,986,9.2
72087,2020-11-01,8088,7199,889,11
72089,2020-11-01,5944,5254,690,11.6
72091,2020-11-01,10995,10029,966,8.8
72093,2020-11-01,1894,1751,143,7.6
72095,2020-11-01,2563,2315,248,9.7
72097,2020-11-01,20602,18679,1923,9.3
72099,2020-11-01,10012,8968,1044,10.4
72101,2020-11-01,7672,6809,863,11.2
72103,2020-11-01,7701,7039,662,8.6
72105,2020-11-01,6912,6015,897,13
72107,2020-11-01,4671,4077,594,12.7
72109,2020-11-01,4035,3581,454,11.3
72111,2020-11-01,5398,4756,642,11.9
72113,2020-11-01,42721,38711,4010,9.4
72115,2020-11-01,5796,5163,633,10.9
72117,2020-11-01,4406,3937,469,10.6
72119,2020-11-01,16414,14650,1764,10.7
72121,2020-11-01,5724,5163,561,9.8
72123,2020-11-01,6622,5873,749,11.3
72125,2020-11-01,9217,8304,913,9.9
72127,2020-11-01,129121,117520,11601,9
72129,2020-11-01,10952,9948,1004,9.2
72131,2020-11-01,9715,8582,1133,11.7
72133,2020-11-01,8255,7515,740,9
72135,2020-11-01,26189,24097,2092,8
72137,2020-11-01,27934,25484,2450,8.8
72139,2020-11-01,25796,23945,1851,7.2
72141,2020-11-01,6261,5667,594,9.5
72143,2020-11-01,9426,8357,1069,11.3
72145,2020-11-01,12686,11131,1555,12.3
72147,2020-11-01,2357,2072,285,12.1
72149,2020-11-01,6685,5922,763,11.4
72151,2020-11-01,8107,7204,903,11.1
72153,2020-11-01,9231,8104,1127,12.2
01001,2020-12-01,25835,25079,756,2.9
01003,2020-12-01,95879,92891,2988,3.1
01005,2020-12-01,8580,8090,490,5.7
01007,2020-12-01,8657,8328,329,3.8
01009,2020-12-01,24962,24407,555,2.2
01011,2020-12-01,4939,4730,209,4.2
01013,2020-12-01,8923,8399,524,5.9
01015,2020-12-01,46235,44369,1866,4
01017,2020-12-01,16026,15397,629,3.9
01019,2020-12-01,11685,11396,289,2.5
01021,2020-12-01,19762,19230,532,2.7
01023,2020-12-01,4753,4549,204,4.3
01025,2020-12-01,7776,7299,477,6.1
01027,2020-12-01,6154,5987,167,2.7
01029,2020-12-01,5780,5646,134,2.3
01031,2020-12-01,21626,21060,566,2.6
01033,2020-12-01,23492,22671,821,3.5
01035,2020-12-01,4501,4285,216,4.8
01037,2020-12-01,4384,4242,142,3.2
01039,2020-12-01,15337,14894,443,2.9
01041,2020-12-01,6246,6040,206,3.3
01043,2020-12-01,38986,38161,825,2.1
01045,2020-12-01,20947,20262,685,3.3
01047,2020-12-01,14377,13309,1068,7.4
01049,2020-12-01,30864,30104,760,2.5
01051,2020-12-01,36584,35543,1041,2.8
01053,2020-12-01,14353,13792,561,3.9
01055,2020-12-01,40335,38707,1628,4
01057,2020-12-01,6584,6391,193,2.9
01059,2020-12-01,14513,14191,322,2.2
01061,2020-12-01,10996,10714,282,2.6
01063,2020-12-01,2940,2724,216,7.3
01065,2020-12-01,6007,5638,369,6.1
01067,2020-12-01,6894,6677,217,3.1
01069,2020-12-01,46762,45158,1604,3.4
01071,2020-12-01,23030,22391,639,2.8
01073,2020-12-01,318167,305709,12458,3.9
01075,2020-12-01,5781,5616,165,2.9
01077,2020-12-01,41996,40774,1222,2.9
01079,2020-12-01,14538,14126,412,2.8
01081,2020-12-01,77267,75088,2179,2.8
01083,2020-12-01,45312,44276,1036,2.3
01085,2020-12-01,3596,3244,352,9.8
01087,2020-12-01,8004,7498,506,6.3
01089,2020-12-01,190075,185016,5059,2.7
01091,2020-12-01,7763,7418,345,4.4
01093,2020-12-01,13227,12833,394,3
01095,2020-12-01,44916,43908,1008,2.2
01097,2020-12-01,190797,181178,9619,5
01099,2020-12-01,7439,7024,415,5.6
01101,2020-12-01,106379,100763,5616,5.3
01103,2020-12-01,59710,58184,1526,2.6
01105,2020-12-01,3415,3138,277,8.1
01107,2020-12-01,7627,7317,310,4.1
01109,2020-12-01,15784,15277,507,3.2
01111,2020-12-01,9368,9137,231,2.5
01113,2020-12-01,23368,22658,710,3
01115,2020-12-01,40429,39354,1075,2.7
01117,2020-12-01,115487,113122,2365,2
01119,2020-12-01,4785,4569,216,4.5
01121,2020-12-01,35895,34480,1415,3.9
01123,2020-12-01,17841,17073,768,4.3
01125,2020-12-01,101189,97368,3821,3.8
01127,2020-12-01,25028,24162,866,3.5
01129,2020-12-01,6697,6378,319,4.8
01131,2020-12-01,2826,2514,312,11
01133,2020-12-01,9945,9652,293,2.9
02013,2020-12-01,1154,1049,105,9.1
02016,2020-12-01,2586,2381,205,7.9
02020,2020-12-01,152457,143093,9364,6.1
02050,2020-12-01,7133,6383,750,10.5
02060,2020-12-01,255,230,25,9.8
02068,2020-12-01,611,527,84,13.7
02070,2020-12-01,1673,1557,116,6.9
02090,2020-12-01,45314,43016,2298,5.1
02100,2020-12-01,961,848,113,11.8
02105,2020-12-01,977,873,104,10.6
02110,2020-12-01,16682,15876,806,4.8
02122,2020-12-01,26256,24181,2075,7.9
02130,2020-12-01,6524,6042,482,7.4
02150,2020-12-01,5671,5070,601,10.6
02158,2020-12-01,2662,2261,401,15.1
02164,2020-12-01,562,511,51,9.1
02170,2020-12-01,48964,45727,3237,6.6
02180,2020-12-01,4115,3818,297,7.2
02185,2020-12-01,3043,2864,179,5.9
02188,2020-12-01,3156,2876,280,8.9
02195,2020-12-01,1363,1251,112,8.2
02198,2020-12-01,2751,2566,185,6.7
02220,2020-12-01,4076,3828,248,6.1
02230,2020-12-01,549,453,96,17.5
02240,2020-12-01,2929,2733,196,6.7
02261,2020-12-01,4194,3866,328,7.8
02275,2020-12-01,997,928,69,6.9
02282,2020-12-01,235,217,18,7.7
02290,2020-12-01,2365,2162,203,8.6
04001,2020-12-01,19763,17486,2277,11.5
04003,2020-12-01,52415,49420,2995,5.7
04005,2020-12-01,73895,67814,6081,8.2
04007,2020-12-01,20796,19366,1430,6.9
04009,2020-12-01,16407,15449,958,5.8
04011,2020-12-01,4313,4063,250,5.8
04012,2020-12-01,9112,8549,563,6.2
04013,2020-12-01,NA,NA,149524,6.4
04015,2020-12-01,86877,80250,6627,7.6
04017,2020-12-01,39844,36373,3471,8.7
04019,2020-12-01,493760,459909,33851,6.9
04021,2020-12-01,192731,180188,12543,6.5
04023,2020-12-01,19462,17524,1938,10
04025,2020-12-01,106138,99676,6462,6.1
04027,2020-12-01,94245,83670,10575,11.2
05001,2020-12-01,9572,9243,329,3.4
05003,2020-12-01,7078,6524,554,7.8
05005,2020-12-01,16656,15910,746,4.5
05007,2020-12-01,143616,138759,4857,3.4
05009,2020-12-01,15880,15294,586,3.7
05011,2020-12-01,4401,4194,207,4.7
05013,2020-12-01,2454,2357,97,4
05015,2020-12-01,12568,12000,568,4.5
05017,2020-12-01,3252,2940,312,9.6
05019,2020-12-01,9504,9057,447,4.7
05021,2020-12-01,5504,5255,249,4.5
05023,2020-12-01,9073,8546,527,5.8
05025,2020-12-01,3250,3083,167,5.1
05027,2020-12-01,9276,8637,639,6.9
05029,2020-12-01,8515,8125,390,4.6
05031,2020-12-01,56421,54239,2182,3.9
05033,2020-12-01,26649,25541,1108,4.2
05035,2020-12-01,21465,20168,1297,6
05037,2020-12-01,7236,6886,350,4.8
05039,2020-12-01,2894,2787,107,3.7
05041,2020-12-01,5293,4991,302,5.7
05043,2020-12-01,7784,7345,439,5.6
05045,2020-12-01,61937,59402,2535,4.1
05047,2020-12-01,7520,7188,332,4.4
05049,2020-12-01,4899,4675,224,4.6
05051,2020-12-01,41671,39201,2470,5.9
05053,2020-12-01,8290,7953,337,4.1
05055,2020-12-01,19295,18479,816,4.2
05057,2020-12-01,9510,9139,371,3.9
05059,2020-12-01,14253,13633,620,4.3
05061,2020-12-01,5579,5368,211,3.8
05063,2020-12-01,16778,16059,719,4.3
05065,2020-12-01,4567,4272,295,6.5
05067,2020-12-01,5904,5552,352,6
05069,2020-12-01,27809,25862,1947,7
05071,2020-12-01,10255,9756,499,4.9
05073,2020-12-01,2437,2262,175,7.2
05075,2020-12-01,6878,6536,342,5
05077,2020-12-01,2810,2628,182,6.5
05079,2020-12-01,3880,3692,188,4.8
05081,2020-12-01,5437,5152,285,5.2
05083,2020-12-01,8668,8254,414,4.8
05085,2020-12-01,33716,32297,1419,4.2
05087,2020-12-01,7622,7374,248,3.3
05089,2020-12-01,6073,5731,342,5.6
05091,2020-12-01,19445,18422,1023,5.3
05093,2020-12-01,17019,15797,1222,7.2
05095,2020-12-01,2728,2553,175,6.4
05097,2020-12-01,2991,2818,173,5.8
05099,2020-12-01,3511,3354,157,4.5
05101,2020-12-01,3271,3152,119,3.6
05103,2020-12-01,9884,9455,429,4.3
05105,2020-12-01,4210,4025,185,4.4
05107,2020-12-01,6435,5927,508,7.9
05109,2020-12-01,4326,4106,220,5.1
05111,2020-12-01,10072,9629,443,4.4
05113,2020-12-01,8043,7622,421,5.2
05115,2020-12-01,28143,26853,1290,4.6
05117,2020-12-01,3664,3501,163,4.4
05119,2020-12-01,189195,178184,11011,5.8
05121,2020-12-01,7606,7235,371,4.9
05123,2020-12-01,7962,7431,531,6.7
05125,2020-12-01,58484,56275,2209,3.8
05127,2020-12-01,4412,4232,180,4.1
05129,2020-12-01,2789,2657,132,4.7
05131,2020-12-01,56472,53936,2536,4.5
05133,2020-12-01,5557,5272,285,5.1
05135,2020-12-01,5712,5362,350,6.1
05137,2020-12-01,4614,4322,292,6.3
05139,2020-12-01,15525,14514,1011,6.5
05141,2020-12-01,5780,5407,373,6.5
05143,2020-12-01,129311,124768,4543,3.5
05145,2020-12-01,34383,32693,1690,4.9
05147,2020-12-01,2836,2692,144,5.1
05149,2020-12-01,8142,7799,343,4.2
06001,2020-12-01,806820,746371,60449,7.5
06003,2020-12-01,598,552,46,7.7
06005,2020-12-01,14233,13083,1150,8.1
06007,2020-12-01,89710,82421,7289,8.1
06009,2020-12-01,21199,19762,1437,6.8
06011,2020-12-01,10275,8837,1438,14
06013,2020-12-01,537240,495824,41416,7.7
06015,2020-12-01,9179,8356,823,9
06017,2020-12-01,90451,84339,6112,6.8
06019,2020-12-01,445244,400855,44389,10
06021,2020-12-01,12231,11300,931,7.6
06023,2020-12-01,58850,54490,4360,7.4
06025,2020-12-01,65501,54033,11468,17.5
06027,2020-12-01,8176,7627,549,6.7
06029,2020-12-01,379429,338539,40890,10.8
06031,2020-12-01,55459,49560,5899,10.6
06033,2020-12-01,28060,25592,2468,8.8
06035,2020-12-01,9311,8684,627,6.7
06037,2020-12-01,NA,NA,597356,12.3
06039,2020-12-01,62060,56234,5826,9.4
06041,2020-12-01,128206,121074,7132,5.6
06043,2020-12-01,6560,5851,709,10.8
06045,2020-12-01,36221,33414,2807,7.7
06047,2020-12-01,113692,101146,12546,11
06049,2020-12-01,3114,2854,260,8.3
06051,2020-12-01,7865,7152,713,9.1
06053,2020-12-01,202020,181280,20740,10.3
06055,2020-12-01,66109,61118,4991,7.5
06057,2020-12-01,46599,43487,3112,6.7
06059,2020-12-01,NA,NA,114705,7.4
06061,2020-12-01,184709,173591,11118,6
06063,2020-12-01,7155,6408,747,10.4
06065,2020-12-01,NA,NA,96617,8.7
06067,2020-12-01,708894,650082,58812,8.3
06069,2020-12-01,30733,28128,2605,8.5
06071,2020-12-01,981220,894651,86569,8.8
06073,2020-12-01,NA,NA,122650,8
06075,2020-12-01,541641,506712,34929,6.4
06077,2020-12-01,332738,299361,33377,10
06079,2020-12-01,128509,119956,8553,6.7
06081,2020-12-01,424429,399693,24736,5.8
06083,2020-12-01,213126,197642,15484,7.3
06085,2020-12-01,NA,950884,59609,5.9
06087,2020-12-01,128460,118012,10448,8.1
06089,2020-12-01,72623,66955,5668,7.8
06091,2020-12-01,1270,1181,89,7
06093,2020-12-01,16472,14907,1565,9.5
06095,2020-12-01,202785,185284,17501,8.6
06097,2020-12-01,236250,220659,15591,6.6
06099,2020-12-01,239462,216977,22485,9.4
06101,2020-12-01,43849,39493,4356,9.9
06103,2020-12-01,25180,23157,2023,8
06105,2020-12-01,4461,4120,341,7.6
06107,2020-12-01,191261,169335,21926,11.5
06109,2020-12-01,19864,18068,1796,9
06111,2020-12-01,404484,374552,29932,7.4
06113,2020-12-01,105034,97847,7187,6.8
06115,2020-12-01,29494,26600,2894,9.8
08001,2020-12-01,278097,256803,21294,7.7
08003,2020-12-01,8688,8074,614,7.1
08005,2020-12-01,370217,343021,27196,7.3
08007,2020-12-01,7325,6829,496,6.8
08009,2020-12-01,2363,2307,56,2.4
08011,2020-12-01,2019,1908,111,5.5
08013,2020-12-01,194211,182991,11220,5.8
08014,2020-12-01,40664,38135,2529,6.2
08015,2020-12-01,10006,9465,541,5.4
08017,2020-12-01,1202,1168,34,2.8
08019,2020-12-01,6226,5719,507,8.1
08021,2020-12-01,4238,4017,221,5.2
08023,2020-12-01,1890,1745,145,7.7
08025,2020-12-01,1561,1466,95,6.1
08027,2020-12-01,2110,2006,104,4.9
08029,2020-12-01,14721,13787,934,6.3
08031,2020-12-01,428037,394814,33223,7.8
08033,2020-12-01,1217,1142,75,6.2
08035,2020-12-01,196942,186236,10706,5.4
08037,2020-12-01,36889,34656,2233,6.1
08039,2020-12-01,15388,14683,705,4.6
08041,2020-12-01,349175,323374,25801,7.4
08043,2020-12-01,15560,14381,1179,7.6
08045,2020-12-01,33139,31241,1898,5.7
08047,2020-12-01,3953,3616,337,8.5
08049,2020-12-01,9927,9280,647,6.5
08051,2020-12-01,11746,11161,585,5
08053,2020-12-01,405,383,22,5.4
08055,2020-12-01,2762,2517,245,8.9
08057,2020-12-01,964,923,41,4.3
08059,2020-12-01,337351,314819,22532,6.7
08061,2020-12-01,1068,1040,28,2.6
08063,2020-12-01,4540,4412,128,2.8
08065,2020-12-01,5005,4709,296,5.9
08067,2020-12-01,32189,29767,2422,7.5
08069,2020-12-01,207120,193967,13153,6.4
08071,2020-12-01,6728,6217,511,7.6
08073,2020-12-01,2506,2379,127,5.1
08075,2020-12-01,11508,10904,604,5.2
08077,2020-12-01,76533,71032,5501,7.2
08079,2020-12-01,523,503,20,3.8
08081,2020-12-01,7562,7165,397,5.2
08083,2020-12-01,12721,11856,865,6.8
08085,2020-12-01,22087,20723,1364,6.2
08087,2020-12-01,16898,15962,936,5.5
08089,2020-12-01,8530,7936,594,7
08091,2020-12-01,2417,2260,157,6.5
08093,2020-12-01,11244,10673,571,5.1
08095,2020-12-01,2692,2622,70,2.6
08097,2020-12-01,11472,10588,884,7.7
08099,2020-12-01,6632,6266,366,5.5
08101,2020-12-01,79447,72240,7207,9.1
08103,2020-12-01,3051,2874,177,5.8
08105,2020-12-01,5752,5378,374,6.5
08107,2020-12-01,17264,16096,1168,6.8
08109,2020-12-01,3633,3404,229,6.3
08111,2020-12-01,444,416,28,6.3
08113,2020-12-01,5580,5108,472,8.5
08115,2020-12-01,1248,1198,50,4
08117,2020-12-01,25006,23363,1643,6.6
08119,2020-12-01,12996,12152,844,6.5
08121,2020-12-01,3141,3043,98,3.1
08123,2020-12-01,170163,158145,12018,7.1
08125,2020-12-01,6095,5919,176,2.9
09001,2020-12-01,453356,418594,34762,7.7
09003,2020-12-01,465565,428561,37004,7.9
09005,2020-12-01,99596,92663,6933,7
09007,2020-12-01,90454,84773,5681,6.3
09009,2020-12-01,451247,415551,35696,7.9
09011,2020-12-01,127560,116628,10932,8.6
09013,2020-12-01,82866,77796,5070,6.1
09015,2020-12-01,60700,55799,4901,8.1
10001,2020-12-01,78864,73857,5007,6.3
10003,2020-12-01,298349,281199,17150,5.7
10005,2020-12-01,105080,99440,5640,5.4
11001,2020-12-01,413158,376699,36459,8.8
12001,2020-12-01,134549,130623,3926,2.9
12003,2020-12-01,11951,11592,359,3
12005,2020-12-01,81588,78884,2704,3.3
12007,2020-12-01,10791,10451,340,3.2
12009,2020-12-01,278089,269051,9038,3.3
12011,2020-12-01,989486,948237,41249,4.2
12013,2020-12-01,4763,4616,147,3.1
12015,2020-12-01,70940,68465,2475,3.5
12017,2020-12-01,45982,43915,2067,4.5
12019,2020-12-01,106495,103640,2855,2.7
12021,2020-12-01,179568,174332,5236,2.9
12023,2020-12-01,29901,28856,1045,3.5
12027,2020-12-01,14786,14367,419,2.8
12029,2020-12-01,6017,5823,194,3.2
12031,2020-12-01,485979,469083,16896,3.5
12033,2020-12-01,143632,138499,5133,3.6
12035,2020-12-01,45890,44155,1735,3.8
12037,2020-12-01,4671,4535,136,2.9
12039,2020-12-01,18325,17511,814,4.4
12041,2020-12-01,7050,6833,217,3.1
12043,2020-12-01,5379,5223,156,2.9
12045,2020-12-01,4949,4789,160,3.2
12047,2020-12-01,4082,3881,201,4.9
12049,2020-12-01,8656,8342,314,3.6
12051,2020-12-01,16103,15469,634,3.9
12053,2020-12-01,70482,67691,2791,4
12055,2020-12-01,34402,32886,1516,4.4
12057,2020-12-01,749504,723938,25566,3.4
12059,2020-12-01,6876,6664,212,3.1
12061,2020-12-01,63485,61192,2293,3.6
12063,2020-12-01,17452,16841,611,3.5
12065,2020-12-01,5297,5115,182,3.4
12067,2020-12-01,2782,2700,82,2.9
12069,2020-12-01,146379,140400,5979,4.1
12071,2020-12-01,339999,328487,11512,3.4
12073,2020-12-01,148335,143369,4966,3.3
12075,2020-12-01,16670,16094,576,3.5
12077,2020-12-01,2574,2501,73,2.8
12079,2020-12-01,7638,7358,280,3.7
12081,2020-12-01,176279,170681,5598,3.2
12083,2020-12-01,138721,133430,5291,3.8
12085,2020-12-01,71764,69744,2020,2.8
12086,2020-12-01,NA,NA,103260,7.9
12087,2020-12-01,44721,43514,1207,2.7
12089,2020-12-01,41536,40407,1129,2.7
12091,2020-12-01,95553,92934,2619,2.7
12093,2020-12-01,17345,16807,538,3.1
12095,2020-12-01,690409,658450,31959,4.6
12097,2020-12-01,170063,160536,9527,5.6
12099,2020-12-01,710625,685824,24801,3.5
12101,2020-12-01,235917,227596,8321,3.5
12103,2020-12-01,479182,463521,15661,3.3
12105,2020-12-01,312201,298723,13478,4.3
12107,2020-12-01,26348,25089,1259,4.8
12109,2020-12-01,134491,131235,3256,2.4
12111,2020-12-01,143177,137706,5471,3.8
12113,2020-12-01,82575,80343,2232,2.7
12115,2020-12-01,183733,177872,5861,3.2
12117,2020-12-01,228421,220572,7849,3.4
12119,2020-12-01,31719,30340,1379,4.3
12121,2020-12-01,17548,16967,581,3.3
12123,2020-12-01,8041,7721,320,4
12125,2020-12-01,4507,4377,130,2.9
12127,2020-12-01,245427,236292,9135,3.7
12129,2020-12-01,14722,14364,358,2.4
12131,2020-12-01,31757,30820,937,3
12133,2020-12-01,9435,9114,321,3.4
13001,2020-12-01,8916,8481,435,4.9
13003,2020-12-01,4453,4299,154,3.5
13005,2020-12-01,4567,4345,222,4.9
13007,2020-12-01,1142,1059,83,7.3
13009,2020-12-01,17750,16529,1221,6.9
13011,2020-12-01,10058,9694,364,3.6
13013,2020-12-01,40692,38974,1718,4.2
13015,2020-12-01,50266,47699,2567,5.1
13017,2020-12-01,5447,5038,409,7.5
13019,2020-12-01,7542,7171,371,4.9
13021,2020-12-01,68798,63856,4942,7.2
13023,2020-12-01,4548,4241,307,6.8
13025,2020-12-01,7074,6699,375,5.3
13027,2020-12-01,6928,6564,364,5.3
13029,2020-12-01,19217,18390,827,4.3
13031,2020-12-01,37629,35466,2163,5.7
13033,2020-12-01,9242,8593,649,7
13035,2020-12-01,10940,10312,628,5.7
13037,2020-12-01,2253,2135,118,5.2
13039,2020-12-01,21598,20681,917,4.2
13043,2020-12-01,5622,5362,260,4.6
13045,2020-12-01,55114,52129,2985,5.4
13047,2020-12-01,33032,31900,1132,3.4
13049,2020-12-01,4932,4742,190,3.9
13051,2020-12-01,144110,134970,9140,6.3
13053,2020-12-01,2015,1881,134,6.7
13055,2020-12-01,9660,8971,689,7.1
13057,2020-12-01,134611,129516,5095,3.8
13059,2020-12-01,58797,55584,3213,5.5
13061,2020-12-01,877,755,122,13.9
13063,2020-12-01,141911,128464,13447,9.5
13065,2020-12-01,2991,2878,113,3.8
13067,2020-12-01,419203,399132,20071,4.8
13069,2020-12-01,19003,17937,1066,5.6
13071,2020-12-01,22048,21028,1020,4.6
13073,2020-12-01,76069,73342,2727,3.6
13075,2020-12-01,8222,7837,385,4.7
13077,2020-12-01,74778,71061,3717,5
13079,2020-12-01,5579,5310,269,4.8
13081,2020-12-01,9730,8862,868,8.9
13083,2020-12-01,7940,7644,296,3.7
13085,2020-12-01,12447,11957,490,3.9
13087,2020-12-01,11312,10734,578,5.1
13089,2020-12-01,400623,373114,27509,6.9
13091,2020-12-01,7034,6619,415,5.9
13093,2020-12-01,4924,4567,357,7.3
13095,2020-12-01,38308,34937,3371,8.8
13097,2020-12-01,73260,68546,4714,6.4
13099,2020-12-01,4420,4129,291,6.6
13101,2020-12-01,1910,1837,73,3.8
13103,2020-12-01,32400,31005,1395,4.3
13105,2020-12-01,8019,7477,542,6.8
13107,2020-12-01,8662,8008,654,7.6
13109,2020-12-01,5094,4832,262,5.1
13111,2020-12-01,11321,10857,464,4.1
13113,2020-12-01,57107,54704,2403,4.2
13115,2020-12-01,43988,41701,2287,5.2
13117,2020-12-01,122376,118075,4301,3.5
13119,2020-12-01,9934,9448,486,4.9
13121,2020-12-01,563697,524883,38814,6.9
13123,2020-12-01,12038,11524,514,4.3
13125,2020-12-01,1249,1201,48,3.8
13127,2020-12-01,38664,36545,2119,5.5
13129,2020-12-01,28639,27341,1298,4.5
13131,2020-12-01,10719,10265,454,4.2
13133,2020-12-01,7049,6630,419,5.9
13135,2020-12-01,485966,461362,24604,5.1
13137,2020-12-01,18645,17725,920,4.9
13139,2020-12-01,103556,99610,3946,3.8
13141,2020-12-01,2531,2300,231,9.1
13143,2020-12-01,12398,11780,618,5
13145,2020-12-01,16539,15910,629,3.8
13147,2020-12-01,11420,10836,584,5.1
13149,2020-12-01,5182,4897,285,5.5
13151,2020-12-01,116856,109605,7251,6.2
13153,2020-12-01,71807,68391,3416,4.8
13155,2020-12-01,3487,3283,204,5.9
13157,2020-12-01,42049,40630,1419,3.4
13159,2020-12-01,6875,6547,328,4.8
13161,2020-12-01,6091,5762,329,5.4
13163,2020-12-01,6683,6237,446,6.7
13165,2020-12-01,3258,3057,201,6.2
13167,2020-12-01,4133,3935,198,4.8
13169,2020-12-01,13569,12998,571,4.2
13171,2020-12-01,8134,7639,495,6.1
13173,2020-12-01,3820,3631,189,4.9
13175,2020-12-01,19936,18753,1183,5.9
13177,2020-12-01,14855,14260,595,4
13179,2020-12-01,26404,24868,1536,5.8
13181,2020-12-01,3553,3373,180,5.1
13183,2020-12-01,8301,7949,352,4.2
13185,2020-12-01,53182,50171,3011,5.7
13187,2020-12-01,16519,15881,638,3.9
13189,2020-12-01,8851,8258,593,6.7
13191,2020-12-01,6041,5710,331,5.5
13193,2020-12-01,4608,4267,341,7.4
13195,2020-12-01,13109,12518,591,4.5
13197,2020-12-01,3213,3050,163,5.1
13199,2020-12-01,8894,8212,682,7.7
13201,2020-12-01,2740,2637,103,3.8
13205,2020-12-01,8207,7631,576,7
13207,2020-12-01,12893,12279,614,4.8
13209,2020-12-01,3962,3749,213,5.4
13211,2020-12-01,9211,8766,445,4.8
13213,2020-12-01,15405,14483,922,6
13215,2020-12-01,77680,72078,5602,7.2
13217,2020-12-01,52692,49338,3354,6.4
13219,2020-12-01,19410,18813,597,3.1
13221,2020-12-01,6847,6558,289,4.2
13223,2020-12-01,86460,82687,3773,4.4
13225,2020-12-01,12046,11268,778,6.5
13227,2020-12-01,15170,14553,617,4.1
13229,2020-12-01,8593,8210,383,4.5
13231,2020-12-01,8814,8442,372,4.2
13233,2020-12-01,18538,17546,992,5.4
13235,2020-12-01,4050,3853,197,4.9
13237,2020-12-01,8202,7697,505,6.2
13239,2020-12-01,797,749,48,6
13241,2020-12-01,7136,6812,324,4.5
13243,2020-12-01,2456,2294,162,6.6
13245,2020-12-01,87264,81148,6116,7
13247,2020-12-01,44622,41633,2989,6.7
13249,2020-12-01,2151,2058,93,4.3
13251,2020-12-01,5075,4682,393,7.7
13253,2020-12-01,3049,2887,162,5.3
13255,2020-12-01,28797,26765,2032,7.1
13257,2020-12-01,10422,9808,614,5.9
13259,2020-12-01,2516,2371,145,5.8
13261,2020-12-01,12621,11637,984,7.8
13263,2020-12-01,2786,2597,189,6.8
13265,2020-12-01,525,487,38,7.2
13267,2020-12-01,9592,9178,414,4.3
13269,2020-12-01,2748,2542,206,7.5
13271,2020-12-01,3782,3401,381,10.1
13273,2020-12-01,3572,3268,304,8.5
13275,2020-12-01,17112,16048,1064,6.2
13277,2020-12-01,21006,19977,1029,4.9
13279,2020-12-01,12207,11478,729,6
13281,2020-12-01,3835,3607,228,5.9
13283,2020-12-01,2759,2606,153,5.5
13285,2020-12-01,38001,35660,2341,6.2
13287,2020-12-01,3337,3055,282,8.5
13289,2020-12-01,2839,2649,190,6.7
13291,2020-12-01,10518,10100,418,4
13293,2020-12-01,11389,10691,698,6.1
13295,2020-12-01,31022,29732,1290,4.2
13297,2020-12-01,45564,43499,2065,4.5
13299,2020-12-01,15462,14633,829,5.4
13301,2020-12-01,2720,2553,167,6.1
13303,2020-12-01,6932,6444,488,7
13305,2020-12-01,11719,11087,632,5.4
13307,2020-12-01,1016,952,64,6.3
13309,2020-12-01,1591,1466,125,7.9
13311,2020-12-01,16348,15766,582,3.6
13313,2020-12-01,43390,41049,2341,5.4
13315,2020-12-01,2753,2591,162,5.9
13317,2020-12-01,3681,3427,254,6.9
13319,2020-12-01,3888,3665,223,5.7
13321,2020-12-01,8927,8434,493,5.5
15001,2020-12-01,88928,80776,8152,9.2
15003,2020-12-01,446117,408943,37174,8.3
15007,2020-12-01,33293,28925,4368,13.1
15009,2020-12-01,80420,69636,10784,13.4
16001,2020-12-01,261220,251567,9653,3.7
16003,2020-12-01,1711,1586,125,7.3
16005,2020-12-01,43437,41787,1650,3.8
16007,2020-12-01,3081,2970,111,3.6
16009,2020-12-01,4080,3848,232,5.7
16011,2020-12-01,23425,22646,779,3.3
16013,2020-12-01,12716,12153,563,4.4
16015,2020-12-01,3617,3411,206,5.7
16017,2020-12-01,21316,20133,1183,5.5
16019,2020-12-01,59748,57861,1887,3.2
16021,2020-12-01,5435,5146,289,5.3
16023,2020-12-01,1419,1364,55,3.9
16025,2020-12-01,675,650,25,3.7
16027,2020-12-01,106715,101944,4771,4.5
16029,2020-12-01,4107,3978,129,3.1
16031,2020-12-01,12346,11949,397,3.2
16033,2020-12-01,368,357,11,3
16035,2020-12-01,2944,2778,166,5.6
16037,2020-12-01,2065,1948,117,5.7
16039,2020-12-01,11926,11470,456,3.8
16041,2020-12-01,7163,6946,217,3
16043,2020-12-01,8140,7876,264,3.2
16045,2020-12-01,8510,8096,414,4.9
16047,2020-12-01,8384,8109,275,3.3
16049,2020-12-01,6634,6274,360,5.4
16051,2020-12-01,14448,14049,399,2.8
16053,2020-12-01,12261,11817,444,3.6
16055,2020-12-01,81059,76889,4170,5.1
16057,2020-12-01,19835,19109,726,3.7
16059,2020-12-01,3552,3333,219,6.2
16061,2020-12-01,1612,1513,99,6.1
16063,2020-12-01,2681,2561,120,4.5
16065,2020-12-01,23248,22755,493,2.1
16067,2020-12-01,11575,11149,426,3.7
16069,2020-12-01,20890,20111,779,3.7
16071,2020-12-01,2328,2258,70,3
16073,2020-12-01,5248,4961,287,5.5
16075,2020-12-01,12015,11483,532,4.4
16077,2020-12-01,3967,3779,188,4.7
16079,2020-12-01,5461,5092,369,6.8
16081,2020-12-01,6428,6187,241,3.7
16083,2020-12-01,41413,39796,1617,3.9
16085,2020-12-01,5687,5330,357,6.3
16087,2020-12-01,4764,4561,203,4.3
17001,2020-12-01,30864,29269,1595,5.2
17003,2020-12-01,1895,1744,151,8
17005,2020-12-01,7245,6874,371,5.1
17007,2020-12-01,24347,22503,1844,7.6
17009,2020-12-01,2901,2817,84,2.9
17011,2020-12-01,15701,14733,968,6.2
17013,2020-12-01,2164,2034,130,6
17015,2020-12-01,7039,6652,387,5.5
17017,2020-12-01,5601,5265,336,6
17019,2020-12-01,109309,103069,6240,5.7
17021,2020-12-01,13188,12319,869,6.6
17023,2020-12-01,7147,6752,395,5.5
17025,2020-12-01,5787,5406,381,6.6
17027,2020-12-01,19269,18453,816,4.2
17029,2020-12-01,22961,21539,1422,6.2
17031,2020-12-01,NA,NA,232798,9.4
17033,2020-12-01,8341,7859,482,5.8
17035,2020-12-01,5830,5545,285,4.9
17037,2020-12-01,51385,48005,3380,6.6
17039,2020-12-01,7009,6555,454,6.5
17041,2020-12-01,9899,9464,435,4.4
17043,2020-12-01,476404,444289,32115,6.7
17045,2020-12-01,8553,8153,400,4.7
17047,2020-12-01,2627,2478,149,5.7
17049,2020-12-01,19138,18251,887,4.6
17051,2020-12-01,9593,9049,544,5.7
17053,2020-12-01,6133,5806,327,5.3
17055,2020-12-01,15356,14243,1113,7.2
17057,2020-12-01,14002,13050,952,6.8
17059,2020-12-01,1962,1832,130,6.6
17061,2020-12-01,5770,5452,318,5.5
17063,2020-12-01,23694,22016,1678,7.1
17065,2020-12-01,4106,3929,177,4.3
17067,2020-12-01,7735,7344,391,5.1
17069,2020-12-01,1342,1247,95,7.1
17071,2020-12-01,3465,3316,149,4.3
17073,2020-12-01,23313,21899,1414,6.1
17075,2020-12-01,13080,12355,725,5.5
17077,2020-12-01,26948,25320,1628,6
17079,2020-12-01,4596,4383,213,4.6
17081,2020-12-01,16525,15424,1101,6.7
17083,2020-12-01,10426,9816,610,5.9
17085,2020-12-01,10126,9540,586,5.8
17087,2020-12-01,3973,3697,276,6.9
17089,2020-12-01,253832,234884,18948,7.5
17091,2020-12-01,51686,47807,3879,7.5
17093,2020-12-01,64993,60548,4445,6.8
17095,2020-12-01,20312,18739,1573,7.7
17097,2020-12-01,356962,331810,25152,7
17099,2020-12-01,51162,47489,3673,7.2
17101,2020-12-01,5724,5342,382,6.7
17103,2020-12-01,16792,15861,931,5.5
17105,2020-12-01,15345,14517,828,5.4
17107,2020-12-01,11988,11269,719,6
17109,2020-12-01,12771,12007,764,6
17111,2020-12-01,155402,144604,10798,6.9
17113,2020-12-01,83592,78717,4875,5.8
17115,2020-12-01,45917,41686,4231,9.2
17117,2020-12-01,21602,20396,1206,5.6
17119,2020-12-01,128468,120746,7722,6
17121,2020-12-01,16600,15505,1095,6.6
17123,2020-12-01,4905,4587,318,6.5
17125,2020-12-01,5679,5301,378,6.7
17127,2020-12-01,5246,4890,356,6.8
17129,2020-12-01,5944,5606,338,5.7
17131,2020-12-01,7412,6990,422,5.7
17133,2020-12-01,17974,17265,709,3.9
17135,2020-12-01,10979,10256,723,6.6
17137,2020-12-01,15495,14539,956,6.2
17139,2020-12-01,7213,6895,318,4.4
17141,2020-12-01,23334,21820,1514,6.5
17143,2020-12-01,80812,73773,7039,8.7
17145,2020-12-01,7792,7308,484,6.2
17147,2020-12-01,8446,8043,403,4.8
17149,2020-12-01,6510,6192,318,4.9
17151,2020-12-01,1621,1533,88,5.4
17153,2020-12-01,1727,1561,166,9.6
17155,2020-12-01,2885,2712,173,6
17157,2020-12-01,13359,12668,691,5.2
17159,2020-12-01,7139,6783,356,5
17161,2020-12-01,67042,62406,4636,6.9
17163,2020-12-01,121867,113405,8462,6.9
17165,2020-12-01,9259,8571,688,7.4
17167,2020-12-01,94707,87702,7005,7.4
17169,2020-12-01,2952,2795,157,5.3
17171,2020-12-01,2296,2151,145,6.3
17173,2020-12-01,9860,9353,507,5.1
17175,2020-12-01,2285,2128,157,6.9
17177,2020-12-01,20655,19302,1353,6.6
17179,2020-12-01,59683,55894,3789,6.3
17181,2020-12-01,6943,6502,441,6.4
17183,2020-12-01,31887,29548,2339,7.3
17185,2020-12-01,5497,5212,285,5.2
17187,2020-12-01,7863,7417,446,5.7
17189,2020-12-01,9448,9128,320,3.4
17191,2020-12-01,6572,6227,345,5.2
17193,2020-12-01,5868,5568,300,5.1
17195,2020-12-01,27145,25603,1542,5.7
17197,2020-12-01,336883,310436,26447,7.9
17199,2020-12-01,30923,29036,1887,6.1
17201,2020-12-01,130290,119381,10909,8.4
17203,2020-12-01,17472,16571,901,5.2
18001,2020-12-01,16924,16483,441,2.6
18003,2020-12-01,184261,176045,8216,4.5
18005,2020-12-01,44111,42516,1595,3.6
18007,2020-12-01,4478,4329,149,3.3
18009,2020-12-01,4820,4614,206,4.3
18011,2020-12-01,36280,35321,959,2.6
18013,2020-12-01,7612,7320,292,3.8
18015,2020-12-01,9947,9629,318,3.2
18017,2020-12-01,17315,16631,684,4
18019,2020-12-01,60623,58052,2571,4.2
18021,2020-12-01,11463,10949,514,4.5
18023,2020-12-01,17138,16567,571,3.3
18025,2020-12-01,4803,4583,220,4.6
18027,2020-12-01,16800,16383,417,2.5
18029,2020-12-01,24970,23995,975,3.9
18031,2020-12-01,14943,14428,515,3.4
18033,2020-12-01,21953,21205,748,3.4
18035,2020-12-01,52683,50276,2407,4.6
18037,2020-12-01,22759,22052,707,3.1
18039,2020-12-01,112653,108706,3947,3.5
18041,2020-12-01,8272,7808,464,5.6
18043,2020-12-01,40836,39342,1494,3.7
18045,2020-12-01,7788,7514,274,3.5
18047,2020-12-01,11371,11002,369,3.2
18049,2020-12-01,9686,9288,398,4.1
18051,2020-12-01,19619,19040,579,3
18053,2020-12-01,31930,30649,1281,4
18055,2020-12-01,13296,12758,538,4
18057,2020-12-01,185662,180273,5389,2.9
18059,2020-12-01,40783,39430,1353,3.3
18061,2020-12-01,19784,19093,691,3.5
18063,2020-12-01,90534,87675,2859,3.2
18065,2020-12-01,21832,20963,869,4
18067,2020-12-01,35361,33344,2017,5.7
18069,2020-12-01,17994,17389,605,3.4
18071,2020-12-01,23357,22539,818,3.5
18073,2020-12-01,15497,14913,584,3.8
18075,2020-12-01,8779,8507,272,3.1
18077,2020-12-01,14972,14367,605,4
18079,2020-12-01,13642,13023,619,4.5
18081,2020-12-01,83130,80386,2744,3.3
18083,2020-12-01,18530,17871,659,3.6
18085,2020-12-01,41268,39810,1458,3.5
18087,2020-12-01,19511,19004,507,2.6
18089,2020-12-01,221349,205543,15806,7.1
18091,2020-12-01,47311,44231,3080,6.5
18093,2020-12-01,20441,19544,897,4.4
18095,2020-12-01,58940,56047,2893,4.9
18097,2020-12-01,499320,470959,28361,5.7
18099,2020-12-01,22535,21757,778,3.5
18101,2020-12-01,5506,5332,174,3.2
18103,2020-12-01,14788,14095,693,4.7
18105,2020-12-01,66854,64381,2473,3.7
18107,2020-12-01,18491,17881,610,3.3
18109,2020-12-01,36125,34885,1240,3.4
18111,2020-12-01,6609,6339,270,4.1
18113,2020-12-01,22313,21442,871,3.9
18115,2020-12-01,3103,2981,122,3.9
18117,2020-12-01,8299,7844,455,5.5
18119,2020-12-01,8912,8506,406,4.6
18121,2020-12-01,6884,6637,247,3.6
18123,2020-12-01,9034,8674,360,4
18125,2020-12-01,6303,6078,225,3.6
18127,2020-12-01,82472,78623,3849,4.7
18129,2020-12-01,12925,12523,402,3.1
18131,2020-12-01,6418,6188,230,3.6
18133,2020-12-01,16514,15896,618,3.7
18135,2020-12-01,11166,10727,439,3.9
18137,2020-12-01,13778,13321,457,3.3
18139,2020-12-01,8866,8557,309,3.5
18141,2020-12-01,131271,124278,6993,5.3
18143,2020-12-01,10310,9839,471,4.6
18145,2020-12-01,23036,22217,819,3.6
18147,2020-12-01,10022,9661,361,3.6
18149,2020-12-01,9785,9273,512,5.2
18151,2020-12-01,19678,19026,652,3.3
18153,2020-12-01,7918,7565,353,4.5
18155,2020-12-01,4647,4427,220,4.7
18157,2020-12-01,96117,92315,3802,4
18159,2020-12-01,9077,8803,274,3
18161,2020-12-01,3443,3346,97,2.8
18163,2020-12-01,90568,86583,3985,4.4
18165,2020-12-01,6576,6267,309,4.7
18167,2020-12-01,45368,43030,2338,5.2
18169,2020-12-01,14546,13997,549,3.8
18171,2020-12-01,4070,3940,130,3.2
18173,2020-12-01,31489,30513,976,3.1
18175,2020-12-01,13517,12994,523,3.9
18177,2020-12-01,29780,28473,1307,4.4
18179,2020-12-01,14172,13725,447,3.2
18181,2020-12-01,13391,12986,405,3
18183,2020-12-01,17238,16688,550,3.2
19001,2020-12-01,4228,4100,128,3
19003,2020-12-01,2016,1956,60,3
19005,2020-12-01,7003,6681,322,4.6
19007,2020-12-01,5828,5598,230,3.9
19009,2020-12-01,3065,2976,89,2.9
19011,2020-12-01,12662,12155,507,4
19013,2020-12-01,64461,61451,3010,4.7
19015,2020-12-01,14078,13637,441,3.1
19017,2020-12-01,13155,12766,389,3
19019,2020-12-01,10887,10464,423,3.9
19021,2020-12-01,11732,11375,357,3
19023,2020-12-01,7649,7357,292,3.8
19025,2020-12-01,4094,3960,134,3.3
19027,2020-12-01,10436,10115,321,3.1
19029,2020-12-01,6691,6471,220,3.3
19031,2020-12-01,10137,9789,348,3.4
19033,2020-12-01,22434,21493,941,4.2
19035,2020-12-01,6212,6015,197,3.2
19037,2020-12-01,6205,5996,209,3.4
19039,2020-12-01,4728,4534,194,4.1
19041,2020-12-01,8170,7901,269,3.3
19043,2020-12-01,9550,9054,496,5.2
19045,2020-12-01,21256,20200,1056,5
19047,2020-12-01,7987,7549,438,5.5
19049,2020-12-01,48349,47004,1345,2.8
19051,2020-12-01,4062,3934,128,3.2
19053,2020-12-01,4347,4223,124,2.9
19055,2020-12-01,10337,10010,327,3.2
19057,2020-12-01,17906,16877,1029,5.7
19059,2020-12-01,9061,8685,376,4.1
19061,2020-12-01,52931,50641,2290,4.3
19063,2020-12-01,4872,4691,181,3.7
19065,2020-12-01,10292,9807,485,4.7
19067,2020-12-01,8148,7782,366,4.5
19069,2020-12-01,5586,5394,192,3.4
19071,2020-12-01,3745,3648,97,2.6
19073,2020-12-01,5341,5173,168,3.1
19075,2020-12-01,6194,5991,203,3.3
19077,2020-12-01,5381,5182,199,3.7
19079,2020-12-01,6672,6436,236,3.5
19081,2020-12-01,5677,5500,177,3.1
19083,2020-12-01,7675,7374,301,3.9
19085,2020-12-01,7067,6815,252,3.6
19087,2020-12-01,9535,9172,363,3.8
19089,2020-12-01,5020,4827,193,3.8
19091,2020-12-01,4897,4731,166,3.4
19093,2020-12-01,3929,3812,117,3
19095,2020-12-01,9779,9435,344,3.5
19097,2020-12-01,10305,9828,477,4.6
19099,2020-12-01,18576,17809,767,4.1
19101,2020-12-01,9320,8926,394,4.2
19103,2020-12-01,79902,76957,2945,3.7
19105,2020-12-01,10036,9622,414,4.1
19107,2020-12-01,5125,4916,209,4.1
19109,2020-12-01,8080,7854,226,2.8
19111,2020-12-01,15189,14378,811,5.3
19113,2020-12-01,114185,108644,5541,4.9
19115,2020-12-01,5924,5683,241,4.1
19117,2020-12-01,4666,4525,141,3
19119,2020-12-01,6907,6756,151,2.2
19121,2020-12-01,8139,7812,327,4
19123,2020-12-01,11572,11157,415,3.6
19125,2020-12-01,17536,17017,519,3
19127,2020-12-01,17162,15943,1219,7.1
19129,2020-12-01,7092,6874,218,3.1
19131,2020-12-01,5937,5772,165,2.8
19133,2020-12-01,4329,4161,168,3.9
19135,2020-12-01,3872,3717,155,4
19137,2020-12-01,4795,4613,182,3.8
19139,2020-12-01,19958,18985,973,4.9
19141,2020-12-01,7937,7718,219,2.8
19143,2020-12-01,3577,3493,84,2.3
19145,2020-12-01,6098,5875,223,3.7
19147,2020-12-01,4388,4246,142,3.2
19149,2020-12-01,14149,13735,414,2.9
19151,2020-12-01,4164,4044,120,2.9
19153,2020-12-01,256277,244857,11420,4.5
19155,2020-12-01,46203,44363,1840,4
19157,2020-12-01,9392,9034,358,3.8
19159,2020-12-01,2392,2332,60,2.5
19161,2020-12-01,5175,5008,167,3.2
19163,2020-12-01,83371,78826,4545,5.5
19165,2020-12-01,6216,6026,190,3.1
19167,2020-12-01,20983,20548,435,2.1
19169,2020-12-01,54477,53036,1441,2.6
19171,2020-12-01,9090,8604,486,5.3
19173,2020-12-01,3050,2964,86,2.8
19175,2020-12-01,6064,5807,257,4.2
19177,2020-12-01,3589,3473,116,3.2
19179,2020-12-01,16886,16088,798,4.7
19181,2020-12-01,26824,25894,930,3.5
19183,2020-12-01,11158,10777,381,3.4
19185,2020-12-01,2809,2717,92,3.3
19187,2020-12-01,18137,17344,793,4.4
19189,2020-12-01,4791,4589,202,4.2
19191,2020-12-01,11119,10669,450,4
19193,2020-12-01,52973,50743,2230,4.2
19195,2020-12-01,4001,3832,169,4.2
19197,2020-12-01,6771,6529,242,3.6
20001,2020-12-01,6494,6223,271,4.2
20003,2020-12-01,4401,4267,134,3
20005,2020-12-01,6892,6549,343,5
20007,2020-12-01,2399,2322,77,3.2
20009,2020-12-01,13726,13215,511,3.7
20011,2020-12-01,6867,6606,261,3.8
20013,2020-12-01,5279,5098,181,3.4
20015,2020-12-01,32446,30984,1462,4.5
20017,2020-12-01,1462,1414,48,3.3
20019,2020-12-01,1521,1457,64,4.2
20021,2020-12-01,10130,9812,318,3.1
20023,2020-12-01,1414,1387,27,1.9
20025,2020-12-01,1189,1172,17,1.4
20027,2020-12-01,3954,3814,140,3.5
20029,2020-12-01,3999,3859,140,3.5
20031,2020-12-01,3846,3701,145,3.8
20033,2020-12-01,892,865,27,3
20035,2020-12-01,16714,16009,705,4.2
20037,2020-12-01,19339,18537,802,4.1
20039,2020-12-01,1339,1295,44,3.3
20041,2020-12-01,9002,8675,327,3.6
20043,2020-12-01,4206,4101,105,2.5
20045,2020-12-01,64168,61219,2949,4.6
20047,2020-12-01,1539,1495,44,2.9
20049,2020-12-01,1222,1188,34,2.8
20051,2020-12-01,17142,16625,517,3
20053,2020-12-01,2849,2738,111,3.9
20055,2020-12-01,21300,20596,704,3.3
20057,2020-12-01,17573,17023,550,3.1
20059,2020-12-01,14453,13868,585,4
20061,2020-12-01,11541,11036,505,4.4
20063,2020-12-01,1547,1501,46,3
20065,2020-12-01,1089,1041,48,4.4
20067,2020-12-01,3092,2970,122,3.9
20069,2020-12-01,3464,3391,73,2.1
20071,2020-12-01,860,845,15,1.7
20073,2020-12-01,3271,3157,114,3.5
20075,2020-12-01,1706,1675,31,1.8
20077,2020-12-01,2851,2737,114,4
20079,2020-12-01,17023,16349,674,4
20081,2020-12-01,2344,2294,50,2.1
20083,2020-12-01,1046,1028,18,1.7
20085,2020-12-01,7237,6980,257,3.6
20087,2020-12-01,10330,9944,386,3.7
20089,2020-12-01,1296,1262,34,2.6
20091,2020-12-01,348841,335428,13413,3.8
20093,2020-12-01,2116,2063,53,2.5
20095,2020-12-01,3411,3254,157,4.6
20097,2020-12-01,1325,1288,37,2.8
20099,2020-12-01,9796,9376,420,4.3
20101,2020-12-01,815,791,24,2.9
20103,2020-12-01,37248,35772,1476,4
20105,2020-12-01,1812,1769,43,2.4
20107,2020-12-01,4394,4221,173,3.9
20109,2020-12-01,1706,1661,45,2.6
20111,2020-12-01,16947,16262,685,4
20113,2020-12-01,17520,16951,569,3.2
20115,2020-12-01,5954,5758,196,3.3
20117,2020-12-01,5628,5461,167,3
20119,2020-12-01,2246,2190,56,2.5
20121,2020-12-01,18035,17361,674,3.7
20123,2020-12-01,3529,3422,107,3
20125,2020-12-01,14529,13898,631,4.3
20127,2020-12-01,3160,3076,84,2.7
20129,2020-12-01,1165,1135,30,2.6
20131,2020-12-01,5819,5630,189,3.2
20133,2020-12-01,6306,5974,332,5.3
20135,2020-12-01,1362,1320,42,3.1
20137,2020-12-01,2679,2601,78,2.9
20139,2020-12-01,8099,7792,307,3.8
20141,2020-12-01,2019,1957,62,3.1
20143,2020-12-01,3087,2974,113,3.7
20145,2020-12-01,2947,2829,118,4
20147,2020-12-01,2743,2655,88,3.2
20149,2020-12-01,11970,11505,465,3.9
20151,2020-12-01,5046,4883,163,3.2
20153,2020-12-01,1618,1587,31,1.9
20155,2020-12-01,29629,28359,1270,4.3
20157,2020-12-01,2383,2307,76,3.2
20159,2020-12-01,5204,5028,176,3.4
20161,2020-12-01,33667,32383,1284,3.8
20163,2020-12-01,2566,2474,92,3.6
20165,2020-12-01,1588,1538,50,3.1
20167,2020-12-01,3404,3284,120,3.5
20169,2020-12-01,29817,28620,1197,4
20171,2020-12-01,2962,2884,78,2.6
20173,2020-12-01,252590,239031,13559,5.4
20175,2020-12-01,10090,9657,433,4.3
20177,2020-12-01,92216,87789,4427,4.8
20179,2020-12-01,1523,1497,26,1.7
20181,2020-12-01,3004,2897,107,3.6
20183,2020-12-01,2088,2046,42,2
20185,2020-12-01,2128,2064,64,3
20187,2020-12-01,1145,1119,26,2.3
20189,2020-12-01,2900,2819,81,2.8
20191,2020-12-01,10880,10340,540,5
20193,2020-12-01,4385,4242,143,3.3
20195,2020-12-01,1512,1460,52,3.4
20197,2020-12-01,3736,3618,118,3.2
20199,2020-12-01,837,821,16,1.9
20201,2020-12-01,3237,3170,67,2.1
20203,2020-12-01,1281,1253,28,2.2
20205,2020-12-01,3930,3743,187,4.8
20207,2020-12-01,1568,1502,66,4.2
20209,2020-12-01,78136,74710,3426,4.4
21001,2020-12-01,6869,6483,386,5.6
21003,2020-12-01,8699,8319,380,4.4
21005,2020-12-01,11557,11023,534,4.6
21007,2020-12-01,3281,3094,187,5.7
21009,2020-12-01,17856,16712,1144,6.4
21011,2020-12-01,4478,4181,297,6.6
21013,2020-12-01,8225,7702,523,6.4
21015,2020-12-01,68867,65685,3182,4.6
21017,2020-12-01,9488,9074,414,4.4
21019,2020-12-01,17305,16053,1252,7.2
21021,2020-12-01,12475,11723,752,6
21023,2020-12-01,3707,3497,210,5.7
21025,2020-12-01,3193,2938,255,8
21027,2020-12-01,7699,7234,465,6
21029,2020-12-01,41105,39206,1899,4.6
21031,2020-12-01,4903,4654,249,5.1
21033,2020-12-01,5521,5229,292,5.3
21035,2020-12-01,17029,16043,986,5.8
21037,2020-12-01,48878,46482,2396,4.9
21039,2020-12-01,2131,2033,98,4.6
21041,2020-12-01,5115,4874,241,4.7
21043,2020-12-01,9552,8690,862,9
21045,2020-12-01,6569,6257,312,4.7
21047,2020-12-01,24267,22839,1428,5.9
21049,2020-12-01,16743,15859,884,5.3
21051,2020-12-01,5077,4698,379,7.5
21053,2020-12-01,3941,3776,165,4.2
21055,2020-12-01,3579,3413,166,4.6
21057,2020-12-01,3172,3048,124,3.9
21059,2020-12-01,44089,41730,2359,5.4
21061,2020-12-01,4524,4261,263,5.8
21063,2020-12-01,1914,1744,170,8.9
21065,2020-12-01,4991,4693,298,6
21067,2020-12-01,170085,161892,8193,4.8
21069,2020-12-01,6095,5756,339,5.6
21071,2020-12-01,10445,9610,835,8
21073,2020-12-01,24469,23097,1372,5.6
21075,2020-12-01,1949,1841,108,5.5
21077,2020-12-01,3949,3751,198,5
21079,2020-12-01,7395,7041,354,4.8
21081,2020-12-01,11248,10632,616,5.5
21083,2020-12-01,15367,14522,845,5.5
21085,2020-12-01,10523,9858,665,6.3
21087,2020-12-01,5072,4865,207,4.1
21089,2020-12-01,13056,12044,1012,7.8
21091,2020-12-01,3672,3476,196,5.3
21093,2020-12-01,45953,43461,2492,5.4
21095,2020-12-01,6328,5675,653,10.3
21097,2020-12-01,8538,8154,384,4.5
21099,2020-12-01,7474,7087,387,5.2
21101,2020-12-01,20584,19511,1073,5.2
21103,2020-12-01,7971,7618,353,4.4
21105,2020-12-01,1668,1582,86,5.2
21107,2020-12-01,18004,16975,1029,5.7
21109,2020-12-01,3964,3674,290,7.3
21111,2020-12-01,383791,362475,21316,5.6
21113,2020-12-01,25869,24633,1236,4.8
21115,2020-12-01,6470,5926,544,8.4
21117,2020-12-01,84732,80341,4391,5.2
21119,2020-12-01,4303,3972,331,7.7
21121,2020-12-01,9825,9138,687,7
21123,2020-12-01,5682,5365,317,5.6
21125,2020-12-01,24425,23116,1309,5.4
21127,2020-12-01,5037,4660,377,7.5
21129,2020-12-01,1944,1824,120,6.2
21131,2020-12-01,2575,2342,233,9
21133,2020-12-01,5927,5422,505,8.5
21135,2020-12-01,4543,4175,368,8.1
21137,2020-12-01,9295,8655,640,6.9
21139,2020-12-01,3473,3213,260,7.5
21141,2020-12-01,11804,11344,460,3.9
21143,2020-12-01,3011,2857,154,5.1
21145,2020-12-01,27799,26008,1791,6.4
21147,2020-12-01,4814,4507,307,6.4
21149,2020-12-01,3904,3713,191,4.9
21151,2020-12-01,45168,42965,2203,4.9
21153,2020-12-01,3148,2707,441,14
21155,2020-12-01,9068,8638,430,4.7
21157,2020-12-01,14334,13515,819,5.7
21159,2020-12-01,2385,2159,226,9.5
21161,2020-12-01,6905,6465,440,6.4
21163,2020-12-01,11404,10741,663,5.8
21165,2020-12-01,2231,2039,192,8.6
21167,2020-12-01,9635,9109,526,5.5
21169,2020-12-01,3946,3702,244,6.2
21171,2020-12-01,4472,4281,191,4.3
21173,2020-12-01,11076,10385,691,6.2
21175,2020-12-01,4260,3974,286,6.7
21177,2020-12-01,9519,8802,717,7.5
21179,2020-12-01,22396,21335,1061,4.7
21181,2020-12-01,3220,3065,155,4.8
21183,2020-12-01,8871,8319,552,6.2
21185,2020-12-01,31989,30789,1200,3.8
21187,2020-12-01,4990,4726,264,5.3
21189,2020-12-01,1026,950,76,7.4
21191,2020-12-01,6719,6412,307,4.6
21193,2020-12-01,8030,7437,593,7.4
21195,2020-12-01,18626,17215,1411,7.6
21197,2020-12-01,5004,4721,283,5.7
21199,2020-12-01,25545,24025,1520,6
21201,2020-12-01,785,741,44,5.6
21203,2020-12-01,6317,5955,362,5.7
21205,2020-12-01,9300,8733,567,6.1
21207,2020-12-01,5965,5589,376,6.3
21209,2020-12-01,28697,27441,1256,4.4
21211,2020-12-01,24820,23797,1023,4.1
21213,2020-12-01,8569,8171,398,4.6
21215,2020-12-01,10030,9638,392,3.9
21217,2020-12-01,13041,12493,548,4.2
21219,2020-12-01,5306,5108,198,3.7
21221,2020-12-01,6020,5664,356,5.9
21223,2020-12-01,3729,3531,198,5.3
21225,2020-12-01,5950,5688,262,4.4
21227,2020-12-01,62219,59210,3009,4.8
21229,2020-12-01,6032,5785,247,4.1
21231,2020-12-01,7347,6941,406,5.5
21233,2020-12-01,5287,5020,267,5.1
21235,2020-12-01,13587,12774,813,6
21237,2020-12-01,2008,1873,135,6.7
21239,2020-12-01,14852,14263,589,4
22001,2020-12-01,23454,21972,1482,6.3
22003,2020-12-01,8130,7509,621,7.6
22005,2020-12-01,64990,61430,3560,5.5
22007,2020-12-01,8895,8104,791,8.9
22009,2020-12-01,15022,14036,986,6.6
22011,2020-12-01,13865,13125,740,5.3
22013,2020-12-01,5443,5042,401,7.4
22015,2020-12-01,57073,54166,2907,5.1
22017,2020-12-01,103772,95182,8590,8.3
22019,2020-12-01,93525,85532,7993,8.5
22021,2020-12-01,3673,3468,205,5.6
22023,2020-12-01,3346,3181,165,4.9
22025,2020-12-01,3531,3300,231,6.5
22027,2020-12-01,5600,5275,325,5.8
22029,2020-12-01,6926,6463,463,6.7
22031,2020-12-01,10712,10046,666,6.2
22033,2020-12-01,232690,216922,15768,6.8
22035,2020-12-01,1838,1633,205,11.2
22037,2020-12-01,7897,7441,456,5.8
22039,2020-12-01,11849,11074,775,6.5
22041,2020-12-01,7421,6914,507,6.8
22043,2020-12-01,8291,7860,431,5.2
22045,2020-12-01,28094,25530,2564,9.1
22047,2020-12-01,14288,12951,1337,9.4
22049,2020-12-01,6711,6404,307,4.6
22051,2020-12-01,211430,194352,17078,8.1
22053,2020-12-01,12558,11758,800,6.4
22055,2020-12-01,113348,106654,6694,5.9
22057,2020-12-01,41801,39495,2306,5.5
22059,2020-12-01,6976,6692,284,4.1
22061,2020-12-01,20662,19557,1105,5.3
22063,2020-12-01,68983,65610,3373,4.9
22065,2020-12-01,3610,3350,260,7.2
22067,2020-12-01,10191,9286,905,8.9
22069,2020-12-01,16102,15185,917,5.7
22071,2020-12-01,183513,161751,21762,11.9
22073,2020-12-01,70728,66279,4449,6.3
22075,2020-12-01,9610,9097,513,5.3
22077,2020-12-01,9804,9137,667,6.8
22079,2020-12-01,56135,53247,2888,5.1
22081,2020-12-01,3617,3416,201,5.6
22083,2020-12-01,8132,7609,523,6.4
22085,2020-12-01,9258,8842,416,4.5
22087,2020-12-01,20055,18220,1835,9.1
22089,2020-12-01,24634,23000,1634,6.6
22091,2020-12-01,4430,3910,520,11.7
22093,2020-12-01,9144,8280,864,9.4
22095,2020-12-01,19651,17509,2142,10.9
22097,2020-12-01,32594,30049,2545,7.8
22099,2020-12-01,22047,20448,1599,7.3
22101,2020-12-01,19253,17607,1646,8.5
22103,2020-12-01,115736,109972,5764,5
22105,2020-12-01,57143,52454,4689,8.2
22107,2020-12-01,1339,1245,94,7
22109,2020-12-01,46730,43456,3274,7
22111,2020-12-01,9108,8548,560,6.1
22113,2020-12-01,23793,22205,1588,6.7
22115,2020-12-01,15484,14612,872,5.6
22117,2020-12-01,16954,15694,1260,7.4
22119,2020-12-01,14196,13229,967,6.8
22121,2020-12-01,13753,12869,884,6.4
22123,2020-12-01,3570,3303,267,7.5
22125,2020-12-01,5388,5128,260,4.8
22127,2020-12-01,4660,4366,294,6.3
23001,2020-12-01,53964,51158,2806,5.2
23003,2020-12-01,28482,26793,1689,5.9
23005,2020-12-01,157397,150167,7230,4.6
23007,2020-12-01,13761,12949,812,5.9
23009,2020-12-01,25847,24191,1656,6.4
23011,2020-12-01,60381,57468,2913,4.8
23013,2020-12-01,18644,17750,894,4.8
23015,2020-12-01,15672,14853,819,5.2
23017,2020-12-01,25503,23845,1658,6.5
23019,2020-12-01,73440,69702,3738,5.1
23021,2020-12-01,7103,6651,452,6.4
23023,2020-12-01,18825,18039,786,4.2
23025,2020-12-01,21579,20080,1499,6.9
23027,2020-12-01,19425,18369,1056,5.4
23029,2020-12-01,13339,12524,815,6.1
23031,2020-12-01,108722,102995,5727,5.3
24001,2020-12-01,30077,27822,2255,7.5
24003,2020-12-01,305553,289071,16482,5.4
24005,2020-12-01,439408,410811,28597,6.5
24009,2020-12-01,47117,44704,2413,5.1
24011,2020-12-01,16728,15825,903,5.4
24013,2020-12-01,90978,86924,4054,4.5
24015,2020-12-01,51101,48221,2880,5.6
24017,2020-12-01,83700,78159,5541,6.6
24019,2020-12-01,14565,13516,1049,7.2
24021,2020-12-01,128438,121230,7208,5.6
24023,2020-12-01,14452,13543,909,6.3
24025,2020-12-01,135950,128937,7013,5.2
24027,2020-12-01,182004,173021,8983,4.9
24029,2020-12-01,9239,8646,593,6.4
24031,2020-12-01,532257,498480,33777,6.3
24033,2020-12-01,493343,450047,43296,8.8
24035,2020-12-01,26378,25100,1278,4.8
24037,2020-12-01,56290,53707,2583,4.6
24039,2020-12-01,8323,7592,731,8.8
24041,2020-12-01,17543,16513,1030,5.9
24043,2020-12-01,71457,67119,4338,6.1
24045,2020-12-01,47657,44211,3446,7.2
24047,2020-12-01,24138,21442,2696,11.2
24510,2020-12-01,278897,254092,24805,8.9
25001,2020-12-01,107477,98284,9193,8.6
25003,2020-12-01,61956,56926,5030,8.1
25005,2020-12-01,295725,272231,23494,7.9
25007,2020-12-01,8778,8002,776,8.8
25009,2020-12-01,419630,385798,33832,8.1
25011,2020-12-01,40370,37625,2745,6.8
25013,2020-12-01,223387,203032,20355,9.1
25015,2020-12-01,87789,81741,6048,6.9
25017,2020-12-01,895476,840217,55259,6.2
25019,2020-12-01,7005,6231,774,11
25021,2020-12-01,381909,356618,25291,6.6
25023,2020-12-01,277735,256747,20988,7.6
25025,2020-12-01,447799,412814,34985,7.8
25027,2020-12-01,439480,406864,32616,7.4
26001,2020-12-01,3834,3527,307,8
26003,2020-12-01,3070,2752,318,10.4
26005,2020-12-01,61683,58161,3522,5.7
26007,2020-12-01,13333,12433,900,6.8
26009,2020-12-01,10000,9085,915,9.2
26011,2020-12-01,5679,5127,552,9.7
26013,2020-12-01,3127,2837,290,9.3
26015,2020-12-01,31175,29395,1780,5.7
26017,2020-12-01,48989,45361,3628,7.4
26019,2020-12-01,8390,7718,672,8
26021,2020-12-01,72036,66840,5196,7.2
26023,2020-12-01,19689,18515,1174,6
26025,2020-12-01,61668,56930,4738,7.7
26027,2020-12-01,24193,22717,1476,6.1
26029,2020-12-01,12441,11441,1000,8
26031,2020-12-01,9798,8496,1302,13.3
26033,2020-12-01,16201,14902,1299,8
26035,2020-12-01,11837,10715,1122,9.5
26037,2020-12-01,39417,37494,1923,4.9
26039,2020-12-01,5610,5148,462,8.2
26041,2020-12-01,17139,15857,1282,7.5
26043,2020-12-01,12277,11523,754,6.1
26045,2020-12-01,55165,52030,3135,5.7
26047,2020-12-01,16807,15271,1536,9.1
26049,2020-12-01,179125,164227,14898,8.3
26051,2020-12-01,9762,8960,802,8.2
26053,2020-12-01,5995,5599,396,6.6
26055,2020-12-01,47630,44250,3380,7.1
26057,2020-12-01,17712,16589,1123,6.3
26059,2020-12-01,19774,18524,1250,6.3
26061,2020-12-01,16001,15054,947,5.9
26063,2020-12-01,15204,14251,953,6.3
26065,2020-12-01,145639,136642,8997,6.2
26067,2020-12-01,30486,28867,1619,5.3
26069,2020-12-01,10011,9138,873,8.7
26071,2020-12-01,4994,4634,360,7.2
26073,2020-12-01,32834,30700,2134,6.5
26075,2020-12-01,72992,67900,5092,7
26077,2020-12-01,130470,122534,7936,6.1
26079,2020-12-01,7634,6934,700,9.2
26081,2020-12-01,356274,335414,20860,5.9
26083,2020-12-01,887,814,73,8.2
26085,2020-12-01,3948,3558,390,9.9
26087,2020-12-01,40429,36194,4235,10.5
26089,2020-12-01,9998,9268,730,7.3
26091,2020-12-01,45557,42674,2883,6.3
26093,2020-12-01,101188,93730,7458,7.4
26095,2020-12-01,2197,2005,192,8.7
26097,2020-12-01,4053,3378,675,16.7
26099,2020-12-01,444386,400238,44148,9.9
26101,2020-12-01,10239,9189,1050,10.3
26103,2020-12-01,32000,29907,2093,6.5
26105,2020-12-01,13159,12116,1043,7.9
26107,2020-12-01,18211,16827,1384,7.6
26109,2020-12-01,10788,10214,574,5.3
26111,2020-12-01,39776,37422,2354,5.9
26113,2020-12-01,6778,6320,458,6.8
26115,2020-12-01,72980,68469,4511,6.2
26117,2020-12-01,27783,25898,1885,6.8
26119,2020-12-01,2945,2612,333,11.3
26121,2020-12-01,76888,70044,6844,8.9
26123,2020-12-01,23042,21444,1598,6.9
26125,2020-12-01,661576,608173,53403,8.1
26127,2020-12-01,11716,10649,1067,9.1
26129,2020-12-01,7988,7210,778,9.7
26131,2020-12-01,2044,1872,172,8.4
26133,2020-12-01,11667,10930,737,6.3
26135,2020-12-01,2886,2603,283,9.8
26137,2020-12-01,11478,10512,966,8.4
26139,2020-12-01,158238,150196,8042,5.1
26141,2020-12-01,4890,4438,452,9.2
26143,2020-12-01,7660,6804,856,11.2
26145,2020-12-01,85294,78522,6772,7.9
26147,2020-12-01,74618,67119,7499,10
26149,2020-12-01,28695,26905,1790,6.2
26151,2020-12-01,19327,18030,1297,6.7
26153,2020-12-01,3228,2925,303,9.4
26155,2020-12-01,32366,30292,2074,6.4
26157,2020-12-01,23625,21916,1709,7.2
26159,2020-12-01,34312,31796,2516,7.3
26161,2020-12-01,192619,182951,9668,5
26163,2020-12-01,813306,710349,102957,12.7
26165,2020-12-01,14743,13663,1080,7.3
27001,2020-12-01,7574,6980,594,7.8
27003,2020-12-01,193466,183461,10005,5.2
27005,2020-12-01,18651,17654,997,5.3
27007,2020-12-01,24942,23622,1320,5.3
27009,2020-12-01,21858,20524,1334,6.1
27011,2020-12-01,2497,2387,110,4.4
27013,2020-12-01,39877,38178,1699,4.3
27015,2020-12-01,14244,13611,633,4.4
27017,2020-12-01,17383,16439,944,5.4
27019,2020-12-01,57384,55019,2365,4.1
27021,2020-12-01,13500,12365,1135,8.4
27023,2020-12-01,6877,6588,289,4.2
27025,2020-12-01,29530,27780,1750,5.9
27027,2020-12-01,36765,35582,1183,3.2
27029,2020-12-01,4541,4197,344,7.6
27031,2020-12-01,2743,2513,230,8.4
27033,2020-12-01,6735,6453,282,4.2
27035,2020-12-01,32131,29735,2396,7.5
27037,2020-12-01,235540,224612,10928,4.6
27039,2020-12-01,11914,11396,518,4.3
27041,2020-12-01,21394,20362,1032,4.8
27043,2020-12-01,7031,6661,370,5.3
27045,2020-12-01,11588,11112,476,4.1
27047,2020-12-01,16309,15595,714,4.4
27049,2020-12-01,26470,25301,1169,4.4
27051,2020-12-01,3436,3261,175,5.1
27053,2020-12-01,687635,655345,32290,4.7
27055,2020-12-01,10516,10158,358,3.4
27057,2020-12-01,9730,9075,655,6.7
27059,2020-12-01,21064,19750,1314,6.2
27061,2020-12-01,21730,20289,1441,6.6
27063,2020-12-01,5854,5613,241,4.1
27065,2020-12-01,9202,8470,732,8
27067,2020-12-01,25172,24041,1131,4.5
27069,2020-12-01,2460,2372,88,3.6
27071,2020-12-01,5678,5331,347,6.1
27073,2020-12-01,3612,3465,147,4.1
27075,2020-12-01,5058,4739,319,6.3
27077,2020-12-01,2502,2373,129,5.2
27079,2020-12-01,16002,14962,1040,6.5
27081,2020-12-01,3181,3052,129,4.1
27083,2020-12-01,14309,13766,543,3.8
27085,2020-12-01,19188,18185,1003,5.2
27087,2020-12-01,2102,1930,172,8.2
27089,2020-12-01,5563,5234,329,5.9
27091,2020-12-01,9980,9565,415,4.2
27093,2020-12-01,13331,12647,684,5.1
27095,2020-12-01,12802,11721,1081,8.4
27097,2020-12-01,18222,16909,1313,7.2
27099,2020-12-01,21084,20193,891,4.2
27101,2020-12-01,4965,4717,248,5
27103,2020-12-01,20538,19763,775,3.8
27105,2020-12-01,11824,11435,389,3.3
27107,2020-12-01,3375,3203,172,5.1
27109,2020-12-01,89276,85683,3593,4
27111,2020-12-01,31596,29968,1628,5.2
27113,2020-12-01,8659,8225,434,5
27115,2020-12-01,14497,13401,1096,7.6
27117,2020-12-01,4643,4455,188,4
27119,2020-12-01,16427,15705,722,4.4
27121,2020-12-01,6563,6281,282,4.3
27123,2020-12-01,280983,266768,14215,5.1
27125,2020-12-01,2263,2148,115,5.1
27127,2020-12-01,7906,7575,331,4.2
27129,2020-12-01,8840,8436,404,4.6
27131,2020-12-01,36911,35232,1679,4.5
27133,2020-12-01,6049,5902,147,2.4
27135,2020-12-01,7953,7630,323,4.1
27137,2020-12-01,99637,93812,5825,5.8
27139,2020-12-01,81746,77986,3760,4.6
27141,2020-12-01,51543,48680,2863,5.6
27143,2020-12-01,8319,7917,402,4.8
27145,2020-12-01,89843,85431,4412,4.9
27147,2020-12-01,20229,19327,902,4.5
27149,2020-12-01,5581,5385,196,3.5
27151,2020-12-01,4971,4684,287,5.8
27153,2020-12-01,14026,13324,702,5
27155,2020-12-01,1777,1709,68,3.8
27157,2020-12-01,12341,11810,531,4.3
27159,2020-12-01,6117,5707,410,6.7
27161,2020-12-01,8938,8481,457,5.1
27163,2020-12-01,139952,133908,6044,4.3
27165,2020-12-01,6876,6637,239,3.5
27167,2020-12-01,3514,3391,123,3.5
27169,2020-12-01,28154,27074,1080,3.8
27171,2020-12-01,74203,70713,3490,4.7
27173,2020-12-01,5442,5220,222,4.1
28001,2020-12-01,10711,9567,1144,10.7
28003,2020-12-01,15571,14730,841,5.4
28005,2020-12-01,4608,4207,401,8.7
28007,2020-12-01,7063,6544,519,7.3
28009,2020-12-01,3094,2880,214,6.9
28011,2020-12-01,11651,10673,978,8.4
28013,2020-12-01,5480,5161,319,5.8
28015,2020-12-01,3446,3214,232,6.7
28017,2020-12-01,7017,6490,527,7.5
28019,2020-12-01,3601,3383,218,6.1
28021,2020-12-01,3082,2685,397,12.9
28023,2020-12-01,5908,5468,440,7.4
28025,2020-12-01,7906,7185,721,9.1
28027,2020-12-01,8175,7304,871,10.7
28029,2020-12-01,11002,10151,851,7.7
28031,2020-12-01,8607,8050,557,6.5
28033,2020-12-01,93424,89160,4264,4.6
28035,2020-12-01,34206,31901,2305,6.7
28037,2020-12-01,2801,2584,217,7.7
28039,2020-12-01,9107,8393,714,7.8
28041,2020-12-01,4418,4027,391,8.9
28043,2020-12-01,9429,8870,559,5.9
28045,2020-12-01,19060,17716,1344,7.1
28047,2020-12-01,88386,82504,5882,6.7
28049,2020-12-01,105803,97783,8020,7.6
28051,2020-12-01,5301,4561,740,14
28053,2020-12-01,2164,1845,319,14.7
28055,2020-12-01,324,290,34,10.5
28057,2020-12-01,10622,10109,513,4.8
28059,2020-12-01,59467,55247,4220,7.1
28061,2020-12-01,6102,5581,521,8.5
28063,2020-12-01,2026,1644,382,18.9
28065,2020-12-01,4052,3689,363,9
28067,2020-12-01,25629,23980,1649,6.4
28069,2020-12-01,3430,3149,281,8.2
28071,2020-12-01,26442,25171,1271,4.8
28073,2020-12-01,31729,30241,1488,4.7
28075,2020-12-01,30102,28210,1892,6.3
28077,2020-12-01,4783,4400,383,8
28079,2020-12-01,8093,7551,542,6.7
28081,2020-12-01,42403,40073,2330,5.5
28083,2020-12-01,9937,8921,1016,10.2
28085,2020-12-01,14844,13914,930,6.3
28087,2020-12-01,25715,23959,1756,6.8
28089,2020-12-01,53088,50491,2597,4.9
28091,2020-12-01,10545,9888,657,6.2
28093,2020-12-01,14560,13636,924,6.3
28095,2020-12-01,15811,14788,1023,6.5
28097,2020-12-01,3941,3654,287,7.3
28099,2020-12-01,10133,9505,628,6.2
28101,2020-12-01,7973,7476,497,6.2
28103,2020-12-01,3935,3582,353,9
28105,2020-12-01,22519,21142,1377,6.1
28107,2020-12-01,13045,11949,1096,8.4
28109,2020-12-01,23688,22040,1648,7
28111,2020-12-01,4396,4062,334,7.6
28113,2020-12-01,15125,13858,1267,8.4
28115,2020-12-01,15174,14420,754,5
28117,2020-12-01,11347,10758,589,5.2
28119,2020-12-01,2350,2119,231,9.8
28121,2020-12-01,75893,72773,3120,4.1
28123,2020-12-01,13101,12425,676,5.2
28125,2020-12-01,1416,1253,163,11.5
28127,2020-12-01,10680,10007,673,6.3
28129,2020-12-01,6722,6371,351,5.2
28131,2020-12-01,7161,6726,435,6.1
28133,2020-12-01,7501,6687,814,10.9
28135,2020-12-01,5144,4787,357,6.9
28137,2020-12-01,12309,11544,765,6.2
28139,2020-12-01,9593,9106,487,5.1
28141,2020-12-01,8369,7958,411,4.9
28143,2020-12-01,4556,4071,485,10.6
28145,2020-12-01,14196,13520,676,4.8
28147,2020-12-01,5055,4648,407,8.1
28149,2020-12-01,20156,18719,1437,7.1
28151,2020-12-01,16457,14771,1686,10.2
28153,2020-12-01,7393,6804,589,8
28155,2020-12-01,3936,3698,238,6
28157,2020-12-01,2908,2472,436,15
28159,2020-12-01,7250,6690,560,7.7
28161,2020-12-01,4937,4599,338,6.8
28163,2020-12-01,9875,9097,778,7.9
29001,2020-12-01,10162,9692,470,4.6
29003,2020-12-01,9802,9475,327,3.3
29005,2020-12-01,2651,2566,85,3.2
29007,2020-12-01,10251,9827,424,4.1
29009,2020-12-01,15298,14535,763,5
29011,2020-12-01,5164,4959,205,4
29013,2020-12-01,7672,7312,360,4.7
29015,2020-12-01,7241,6805,436,6
29017,2020-12-01,5406,5167,239,4.4
29019,2020-12-01,97720,94439,3281,3.4
29021,2020-12-01,44263,42400,1863,4.2
29023,2020-12-01,18504,17491,1013,5.5
29025,2020-12-01,4262,4068,194,4.6
29027,2020-12-01,21463,20682,781,3.6
29029,2020-12-01,18262,17139,1123,6.1
29031,2020-12-01,40791,39181,1610,3.9
29033,2020-12-01,4923,4389,534,10.8
29035,2020-12-01,2537,2384,153,6
29037,2020-12-01,54633,52364,2269,4.2
29039,2020-12-01,5770,5535,235,4.1
29041,2020-12-01,3850,3712,138,3.6
29043,2020-12-01,45975,44312,1663,3.6
29045,2020-12-01,3098,2941,157,5.1
29047,2020-12-01,136987,131347,5640,4.1
29049,2020-12-01,10515,10083,432,4.1
29051,2020-12-01,39413,38073,1340,3.4
29053,2020-12-01,7195,6891,304,4.2
29055,2020-12-01,10744,10217,527,4.9
29057,2020-12-01,3525,3396,129,3.7
29059,2020-12-01,7065,6721,344,4.9
29061,2020-12-01,4025,3879,146,3.6
29063,2020-12-01,4758,4587,171,3.6
29065,2020-12-01,6411,6100,311,4.9
29067,2020-12-01,5197,4942,255,4.9
29069,2020-12-01,11303,10605,698,6.2
29071,2020-12-01,52247,49929,2318,4.4
29073,2020-12-01,7495,7181,314,4.2
29075,2020-12-01,3314,3211,103,3.1
29077,2020-12-01,152817,146898,5919,3.9
29079,2020-12-01,4289,4138,151,3.5
29081,2020-12-01,3742,3600,142,3.8
29083,2020-12-01,9782,9329,453,4.6
29085,2020-12-01,3845,3659,186,4.8
29087,2020-12-01,2498,2429,69,2.8
29089,2020-12-01,4871,4707,164,3.4
29091,2020-12-01,16227,15284,943,5.8
29093,2020-12-01,3505,3291,214,6.1
29095,2020-12-01,363246,343195,20051,5.5
29097,2020-12-01,57127,54675,2452,4.3
29099,2020-12-01,116635,111232,5403,4.6
29101,2020-12-01,23132,22064,1068,4.6
29103,2020-12-01,1728,1659,69,4
29105,2020-12-01,16289,15450,839,5.2
29107,2020-12-01,16620,15912,708,4.3
29109,2020-12-01,17498,16725,773,4.4
29111,2020-12-01,4913,4735,178,3.6
29113,2020-12-01,28352,27155,1197,4.2
29115,2020-12-01,5127,4849,278,5.4
29117,2020-12-01,7343,7091,252,3.4
29119,2020-12-01,10758,10320,438,4.1
29121,2020-12-01,7456,7141,315,4.2
29123,2020-12-01,5471,5199,272,5
29125,2020-12-01,3950,3785,165,4.2
29127,2020-12-01,14401,13858,543,3.8
29129,2020-12-01,1814,1753,61,3.4
29131,2020-12-01,12245,11676,569,4.6
29133,2020-12-01,5610,5332,278,5
29135,2020-12-01,7284,7037,247,3.4
29137,2020-12-01,3714,3538,176,4.7
29139,2020-12-01,5659,5445,214,3.8
29141,2020-12-01,8184,7766,418,5.1
29143,2020-12-01,8436,8018,418,5
29145,2020-12-01,27002,25853,1149,4.3
29147,2020-12-01,10583,10203,380,3.6
29149,2020-12-01,3935,3688,247,6.3
29151,2020-12-01,7057,6856,201,2.8
29153,2020-12-01,3349,3129,220,6.6
29155,2020-12-01,6181,5722,459,7.4
29157,2020-12-01,9829,9498,331,3.4
29159,2020-12-01,20132,19316,816,4.1
29161,2020-12-01,20078,19260,818,4.1
29163,2020-12-01,7546,7240,306,4.1
29165,2020-12-01,58842,56597,2245,3.8
29167,2020-12-01,14529,13953,576,4
29169,2020-12-01,14460,13740,720,5
29171,2020-12-01,2202,2119,83,3.8
29173,2020-12-01,5648,5439,209,3.7
29175,2020-12-01,10206,9738,468,4.6
29177,2020-12-01,10893,10423,470,4.3
29179,2020-12-01,2835,2702,133,4.7
29181,2020-12-01,4924,4615,309,6.3
29183,2020-12-01,223537,215180,8357,3.7
29185,2020-12-01,3799,3601,198,5.2
29186,2020-12-01,9276,8920,356,3.8
29187,2020-12-01,26447,25090,1357,5.1
29189,2020-12-01,524338,498464,25874,4.9
29195,2020-12-01,10616,10200,416,3.9
29197,2020-12-01,1906,1826,80,4.2
29199,2020-12-01,2355,2284,71,3
29201,2020-12-01,19914,18994,920,4.6
29203,2020-12-01,3286,3080,206,6.3
29205,2020-12-01,3003,2857,146,4.9
29207,2020-12-01,13128,12473,655,5
29209,2020-12-01,12976,12189,787,6.1
29211,2020-12-01,2770,2638,132,4.8
29213,2020-12-01,25122,23547,1575,6.3
29215,2020-12-01,8986,8505,481,5.4
29217,2020-12-01,9417,9046,371,3.9
29219,2020-12-01,18060,17308,752,4.2
29221,2020-12-01,10098,9547,551,5.5
29223,2020-12-01,5063,4783,280,5.5
29225,2020-12-01,17399,16716,683,3.9
29227,2020-12-01,1134,1096,38,3.4
29229,2020-12-01,7128,6770,358,5
29510,2020-12-01,151343,141167,10176,6.7
30001,2020-12-01,4933,4758,175,3.5
30003,2020-12-01,4747,4427,320,6.7
30005,2020-12-01,2257,2149,108,4.8
30007,2020-12-01,2520,2379,141,5.6
30009,2020-12-01,5382,5148,234,4.3
30011,2020-12-01,670,653,17,2.5
30013,2020-12-01,36663,35040,1623,4.4
30015,2020-12-01,2469,2383,86,3.5
30017,2020-12-01,6093,5834,259,4.3
30019,2020-12-01,898,873,25,2.8
30021,2020-12-01,4613,4401,212,4.6
30023,2020-12-01,4863,4632,231,4.8
30025,2020-12-01,1632,1569,63,3.9
30027,2020-12-01,5728,5498,230,4
30029,2020-12-01,47542,44730,2812,5.9
30031,2020-12-01,68840,66512,2328,3.4
30033,2020-12-01,770,747,23,3
30035,2020-12-01,5026,4565,461,9.2
30037,2020-12-01,359,345,14,3.9
30039,2020-12-01,1555,1465,90,5.8
30041,2020-12-01,7410,7121,289,3.9
30043,2020-12-01,5668,5442,226,4
30045,2020-12-01,1014,973,41,4
30047,2020-12-01,13244,12573,671,5.1
30049,2020-12-01,35661,34230,1431,4
30051,2020-12-01,1010,980,30,3
30053,2020-12-01,7598,6999,599,7.9
30055,2020-12-01,983,958,25,2.5
30057,2020-12-01,4855,4659,196,4
30059,2020-12-01,1000,963,37,3.7
30061,2020-12-01,1637,1510,127,7.8
30063,2020-12-01,61531,58630,2901,4.7
30065,2020-12-01,2290,2160,130,5.7
30067,2020-12-01,8445,7967,478,5.7
30069,2020-12-01,270,260,10,3.7
30071,2020-12-01,1911,1816,95,5
30073,2020-12-01,2675,2563,112,4.2
30075,2020-12-01,1002,970,32,3.2
30077,2020-12-01,2945,2858,87,3
30079,2020-12-01,471,443,28,5.9
30081,2020-12-01,20253,19221,1032,5.1
30083,2020-12-01,5781,5486,295,5.1
30085,2020-12-01,4370,4168,202,4.6
30087,2020-12-01,3609,3431,178,4.9
30089,2020-12-01,4916,4574,342,7
30091,2020-12-01,1786,1689,97,5.4
30093,2020-12-01,16712,15881,831,5
30095,2020-12-01,5243,5034,209,4
30097,2020-12-01,1856,1799,57,3.1
30099,2020-12-01,2718,2617,101,3.7
30101,2020-12-01,2104,2024,80,3.8
30103,2020-12-01,340,329,11,3.2
30105,2020-12-01,3990,3839,151,3.8
30107,2020-12-01,766,709,57,7.4
30109,2020-12-01,452,431,21,4.6
30111,2020-12-01,80199,76945,3254,4.1
31001,2020-12-01,16340,15890,450,2.8
31003,2020-12-01,3848,3778,70,1.8
31005,2020-12-01,229,223,6,2.6
31007,2020-12-01,389,380,9,2.3
31009,2020-12-01,252,243,9,3.6
31011,2020-12-01,2885,2840,45,1.6
31013,2020-12-01,5268,5070,198,3.8
31015,2020-12-01,1040,1020,20,1.9
31017,2020-12-01,1363,1334,29,2.1
31019,2020-12-01,26981,26391,590,2.2
31021,2020-12-01,3514,3402,112,3.2
31023,2020-12-01,4532,4427,105,2.3
31025,2020-12-01,13225,12836,389,2.9
31027,2020-12-01,4421,4331,90,2
31029,2020-12-01,2242,2219,23,1
31031,2020-12-01,3244,3193,51,1.6
31033,2020-12-01,4078,3942,136,3.3
31035,2020-12-01,3163,3097,66,2.1
31037,2020-12-01,5521,5415,106,1.9
31039,2020-12-01,4705,4632,73,1.6
31041,2020-12-01,6211,6113,98,1.6
31043,2020-12-01,10334,9986,348,3.4
31045,2020-12-01,4806,4698,108,2.2
31047,2020-12-01,12997,12700,297,2.3
31049,2020-12-01,947,922,25,2.6
31051,2020-12-01,2897,2830,67,2.3
31053,2020-12-01,19779,19237,542,2.7
31055,2020-12-01,294993,284455,10538,3.6
31057,2020-12-01,1157,1134,23,2
31059,2020-12-01,3069,3014,55,1.8
31061,2020-12-01,1461,1422,39,2.7
31063,2020-12-01,1506,1481,25,1.7
31065,2020-12-01,2537,2489,48,1.9
31067,2020-12-01,10515,10215,300,2.9
31069,2020-12-01,1032,1001,31,3
31071,2020-12-01,1119,1106,13,1.2
31073,2020-12-01,1057,1041,16,1.5
31075,2020-12-01,412,406,6,1.5
31077,2020-12-01,1210,1185,25,2.1
31079,2020-12-01,31569,29955,1614,5.1
31081,2020-12-01,4696,4559,137,2.9
31083,2020-12-01,1651,1625,26,1.6
31085,2020-12-01,624,614,10,1.6
31087,2020-12-01,1282,1248,34,2.7
31089,2020-12-01,5660,5568,92,1.6
31091,2020-12-01,383,374,9,2.3
31093,2020-12-01,3348,3175,173,5.2
31095,2020-12-01,4126,4056,70,1.7
31097,2020-12-01,2012,1948,64,3.2
31099,2020-12-01,3682,3612,70,1.9
31101,2020-12-01,4387,4272,115,2.6
31103,2020-12-01,601,591,10,1.7
31105,2020-12-01,1902,1854,48,2.5
31107,2020-12-01,4602,4500,102,2.2
31109,2020-12-01,172973,167489,5484,3.2
31111,2020-12-01,17807,17354,453,2.5
31113,2020-12-01,458,454,4,0.9
31115,2020-12-01,409,402,7,1.7
31117,2020-12-01,434,428,6,1.4
31119,2020-12-01,19337,18637,700,3.6
31121,2020-12-01,3968,3824,144,3.6
31123,2020-12-01,2552,2481,71,2.8
31125,2020-12-01,1892,1850,42,2.2
31127,2020-12-01,3488,3406,82,2.4
31129,2020-12-01,2433,2385,48,2
31131,2020-12-01,8210,7996,214,2.6
31133,2020-12-01,1474,1443,31,2.1
31135,2020-12-01,1804,1782,22,1.2
31137,2020-12-01,4806,4721,85,1.8
31139,2020-12-01,4077,3922,155,3.8
31141,2020-12-01,17349,16980,369,2.1
31143,2020-12-01,2865,2813,52,1.8
31145,2020-12-01,5788,5655,133,2.3
31147,2020-12-01,4073,3965,108,2.7
31149,2020-12-01,870,863,7,0.8
31151,2020-12-01,7105,6915,190,2.7
31153,2020-12-01,95188,92716,2472,2.6
31155,2020-12-01,11020,10731,289,2.6
31157,2020-12-01,17820,17266,554,3.1
31159,2020-12-01,8711,8403,308,3.5
31161,2020-12-01,2645,2600,45,1.7
31163,2020-12-01,1643,1608,35,2.1
31165,2020-12-01,749,739,10,1.3
31167,2020-12-01,3495,3381,114,3.3
31169,2020-12-01,2762,2717,45,1.6
31171,2020-12-01,412,402,10,2.4
31173,2020-12-01,3015,2919,96,3.2
31175,2020-12-01,2066,2028,38,1.8
31177,2020-12-01,10992,10721,271,2.5
31179,2020-12-01,5644,5527,117,2.1
31181,2020-12-01,1619,1584,35,2.2
31183,2020-12-01,560,556,4,0.7
31185,2020-12-01,7069,6939,130,1.8
32001,2020-12-01,11160,10787,373,3.3
32003,2020-12-01,NA,992442,104844,9.6
32005,2020-12-01,22682,21530,1152,5.1
32007,2020-12-01,27345,26491,854,3.1
32009,2020-12-01,401,379,22,5.5
32011,2020-12-01,995,969,26,2.6
32013,2020-12-01,8059,7795,264,3.3
32015,2020-12-01,3215,3104,111,3.5
32017,2020-12-01,2023,1944,79,3.9
32019,2020-12-01,23188,21935,1253,5.4
32021,2020-12-01,2129,2050,79,3.7
32023,2020-12-01,17675,16516,1159,6.6
32027,2020-12-01,2509,2419,90,3.6
32029,2020-12-01,2117,2012,105,5
32031,2020-12-01,261978,250348,11630,4.4
32033,2020-12-01,4727,4599,128,2.7
32510,2020-12-01,26453,25136,1317,5
33001,2020-12-01,31070,29846,1224,3.9
33003,2020-12-01,22845,21891,954,4.2
33005,2020-12-01,40005,38528,1477,3.7
33007,2020-12-01,14377,13667,710,4.9
33009,2020-12-01,48256,46669,1587,3.3
33011,2020-12-01,239247,230008,9239,3.9
33013,2020-12-01,82514,79762,2752,3.3
33015,2020-12-01,184186,177345,6841,3.7
33017,2020-12-01,72282,69811,2471,3.4
33019,2020-12-01,23184,22441,743,3.2
34001,2020-12-01,114806,101871,12935,11.3
34003,2020-12-01,461262,429103,32159,7
34005,2020-12-01,226429,212915,13514,6
34007,2020-12-01,250443,231529,18914,7.6
34009,2020-12-01,44588,40007,4581,10.3
34011,2020-12-01,64717,59255,5462,8.4
34013,2020-12-01,360555,326663,33892,9.4
34015,2020-12-01,147587,137768,9819,6.7
34017,2020-12-01,348139,319824,28315,8.1
34019,2020-12-01,61299,58095,3204,5.2
34021,2020-12-01,202995,191245,11750,5.8
34023,2020-12-01,430646,403174,27472,6.4
34025,2020-12-01,322528,302658,19870,6.2
34027,2020-12-01,244361,230423,13938,5.7
34029,2020-12-01,272968,255354,17614,6.5
34031,2020-12-01,235493,212617,22876,9.7
34033,2020-12-01,29001,26821,2180,7.5
34035,2020-12-01,162531,153123,9408,5.8
34037,2020-12-01,70935,66189,4746,6.7
34039,2020-12-01,266330,246028,20302,7.6
34041,2020-12-01,55200,51797,3403,6.2
35001,2020-12-01,336673,309868,26805,8
35003,2020-12-01,1216,1142,74,6.1
35005,2020-12-01,29642,27181,2461,8.3
35006,2020-12-01,9842,8770,1072,10.9
35007,2020-12-01,5497,5122,375,6.8
35009,2020-12-01,23545,22211,1334,5.7
35011,2020-12-01,746,706,40,5.4
35013,2020-12-01,99084,91359,7725,7.8
35015,2020-12-01,34074,31401,2673,7.8
35017,2020-12-01,12030,10939,1091,9.1
35019,2020-12-01,1628,1509,119,7.3
35021,2020-12-01,288,276,12,4.2
35023,2020-12-01,2025,1910,115,5.7
35025,2020-12-01,29532,25860,3672,12.4
35027,2020-12-01,9470,8602,868,9.2
35028,2020-12-01,10547,10215,332,3.1
35029,2020-12-01,10436,8814,1622,15.5
35031,2020-12-01,25177,22482,2695,10.7
35033,2020-12-01,2089,1942,147,7
35035,2020-12-01,26535,24501,2034,7.7
35037,2020-12-01,3231,2984,247,7.6
35039,2020-12-01,17519,16094,1425,8.1
35041,2020-12-01,8256,7751,505,6.1
35043,2020-12-01,67409,61867,5542,8.2
35045,2020-12-01,50877,45926,4951,9.7
35047,2020-12-01,10831,9941,890,8.2
35049,2020-12-01,71470,65834,5636,7.9
35051,2020-12-01,4317,3956,361,8.4
35053,2020-12-01,6499,6048,451,6.9
35055,2020-12-01,15329,13629,1700,11.1
35057,2020-12-01,5458,4962,496,9.1
35059,2020-12-01,1655,1585,70,4.2
35061,2020-12-01,30743,28203,2540,8.3
36001,2020-12-01,157772,148972,8800,5.6
36003,2020-12-01,19661,18402,1259,6.4
36005,2020-12-01,584793,491927,92866,15.9
36007,2020-12-01,81787,76212,5575,6.8
36009,2020-12-01,33713,31453,2260,6.7
36011,2020-12-01,35748,33647,2101,5.9
36013,2020-12-01,53048,48769,4279,8.1
36015,2020-12-01,35437,32953,2484,7
36017,2020-12-01,21987,20719,1268,5.8
36019,2020-12-01,36067,33861,2206,6.1
36021,2020-12-01,30482,29046,1436,4.7
36023,2020-12-01,22760,21258,1502,6.6
36025,2020-12-01,18747,17660,1087,5.8
36027,2020-12-01,141199,133371,7828,5.5
36029,2020-12-01,442280,407121,35159,7.9
36031,2020-12-01,16668,15663,1005,6
36033,2020-12-01,19503,18343,1160,5.9
36035,2020-12-01,22603,21083,1520,6.7
36037,2020-12-01,29235,27605,1630,5.6
36039,2020-12-01,20633,19356,1277,6.2
36041,2020-12-01,2057,1924,133,6.5
36043,2020-12-01,27815,25703,2112,7.6
36045,2020-12-01,43582,40844,2738,6.3
36047,2020-12-01,NA,NA,135374,11.9
36049,2020-12-01,11690,10972,718,6.1
36051,2020-12-01,29978,28296,1682,5.6
36053,2020-12-01,32393,30501,1892,5.8
36055,2020-12-01,359362,333804,25558,7.1
36057,2020-12-01,22144,20575,1569,7.1
36059,2020-12-01,694968,654591,40377,5.8
36061,2020-12-01,849706,772590,77116,9.1
36063,2020-12-01,97573,90096,7477,7.7
36065,2020-12-01,100524,94110,6414,6.4
36067,2020-12-01,219654,205318,14336,6.5
36069,2020-12-01,54378,51341,3037,5.6
36071,2020-12-01,182644,171598,11046,6
36073,2020-12-01,17226,16090,1136,6.6
36075,2020-12-01,51988,48354,3634,7
36077,2020-12-01,26292,24714,1578,6
36079,2020-12-01,49624,47022,2602,5.2
36081,2020-12-01,NA,955453,121905,11.3
36083,2020-12-01,81007,76666,4341,5.4
36085,2020-12-01,208245,187620,20625,9.9
36087,2020-12-01,151850,143190,8660,5.7
36089,2020-12-01,43813,41112,2701,6.2
36091,2020-12-01,118838,113238,5600,4.7
36093,2020-12-01,76982,72140,4842,6.3
36095,2020-12-01,14563,13731,832,5.7
36097,2020-12-01,7918,7358,560,7.1
36099,2020-12-01,15050,14113,937,6.2
36101,2020-12-01,42303,39626,2677,6.3
36103,2020-12-01,759935,716123,43812,5.8
36105,2020-12-01,35382,33029,2353,6.7
36107,2020-12-01,22093,20835,1258,5.7
36109,2020-12-01,47720,45457,2263,4.7
36111,2020-12-01,85823,80831,4992,5.8
36113,2020-12-01,30953,28948,2005,6.5
36115,2020-12-01,27528,26037,1491,5.4
36117,2020-12-01,43038,40601,2437,5.7
36119,2020-12-01,475225,445660,29565,6.2
36121,2020-12-01,18028,16910,1118,6.2
36123,2020-12-01,11678,11078,600,5.1
37001,2020-12-01,81749,76763,4986,6.1
37003,2020-12-01,17872,16904,968,5.4
37005,2020-12-01,4223,3947,276,6.5
37007,2020-12-01,10565,9783,782,7.4
37009,2020-12-01,12968,12301,667,5.1
37011,2020-12-01,7428,7013,415,5.6
37013,2020-12-01,19899,18727,1172,5.9
37015,2020-12-01,7813,7319,494,6.3
37017,2020-12-01,14801,13803,998,6.7
37019,2020-12-01,51973,48063,3910,7.5
37021,2020-12-01,136944,129158,7786,5.7
37023,2020-12-01,40568,38213,2355,5.8
37025,2020-12-01,110007,103776,6231,5.7
37027,2020-12-01,36360,33988,2372,6.5
37029,2020-12-01,4644,4403,241,5.2
37031,2020-12-01,31875,30212,1663,5.2
37033,2020-12-01,9717,9063,654,6.7
37035,2020-12-01,78507,73859,4648,5.9
37037,2020-12-01,35890,34216,1674,4.7
37039,2020-12-01,10845,10134,711,6.6
37041,2020-12-01,5777,5430,347,6
37043,2020-12-01,4083,3817,266,6.5
37045,2020-12-01,48969,45686,3283,6.7
37047,2020-12-01,22431,20653,1778,7.9
37049,2020-12-01,41443,38925,2518,6.1
37051,2020-12-01,127861,117161,10700,8.4
37053,2020-12-01,13961,13233,728,5.2
37055,2020-12-01,18415,17075,1340,7.3
37057,2020-12-01,79865,75108,4757,6
37059,2020-12-01,20251,19169,1082,5.3
37061,2020-12-01,25179,23827,1352,5.4
37063,2020-12-01,172443,162845,9598,5.6
37065,2020-12-01,21208,19156,2052,9.7
37067,2020-12-01,186248,174508,11740,6.3
37069,2020-12-01,31786,29854,1932,6.1
37071,2020-12-01,110984,103619,7365,6.6
37073,2020-12-01,5161,4874,287,5.6
37075,2020-12-01,2995,2729,266,8.9
37077,2020-12-01,29939,28443,1496,5
37079,2020-12-01,9863,9353,510,5.2
37081,2020-12-01,257568,239339,18229,7.1
37083,2020-12-01,20491,18727,1764,8.6
37085,2020-12-01,53525,49954,3571,6.7
37087,2020-12-01,29011,27353,1658,5.7
37089,2020-12-01,53265,50432,2833,5.3
37091,2020-12-01,9144,8479,665,7.3
37093,2020-12-01,20078,18510,1568,7.8
37095,2020-12-01,1752,1630,122,7
37097,2020-12-01,89970,84729,5241,5.8
37099,2020-12-01,19846,18711,1135,5.7
37101,2020-12-01,100534,95118,5416,5.4
37103,2020-12-01,4292,4061,231,5.4
37105,2020-12-01,26097,24374,1723,6.6
37107,2020-12-01,28093,26388,1705,6.1
37109,2020-12-01,43948,41622,2326,5.3
37111,2020-12-01,20509,19294,1215,5.9
37113,2020-12-01,15901,15046,855,5.4
37115,2020-12-01,9760,9215,545,5.6
37117,2020-12-01,9132,8527,605,6.6
37119,2020-12-01,625134,586006,39128,6.3
37121,2020-12-01,5845,5444,401,6.9
37123,2020-12-01,11529,10840,689,6
37125,2020-12-01,41361,38946,2415,5.8
37127,2020-12-01,43066,39928,3138,7.3
37129,2020-12-01,121735,114948,6787,5.6
37131,2020-12-01,7753,7178,575,7.4
37133,2020-12-01,65603,61399,4204,6.4
37135,2020-12-01,79080,75381,3699,4.7
37137,2020-12-01,5343,5056,287,5.4
37139,2020-12-01,16718,15564,1154,6.9
37141,2020-12-01,28457,26864,1593,5.6
37143,2020-12-01,4929,4623,306,6.2
37145,2020-12-01,18267,17152,1115,6.1
37147,2020-12-01,90471,84894,5577,6.2
37149,2020-12-01,9061,8559,502,5.5
37151,2020-12-01,64332,60435,3897,6.1
37153,2020-12-01,17122,15637,1485,8.7
37155,2020-12-01,50750,46329,4421,8.7
37157,2020-12-01,39160,36433,2727,7
37159,2020-12-01,65876,61685,4191,6.4
37161,2020-12-01,24951,22981,1970,7.9
37163,2020-12-01,28890,27281,1609,5.6
37165,2020-12-01,11517,10222,1295,11.2
37167,2020-12-01,30082,28454,1628,5.4
37169,2020-12-01,21339,20140,1199,5.6
37171,2020-12-01,32834,31026,1808,5.5
37173,2020-12-01,6736,6350,386,5.7
37175,2020-12-01,14138,13386,752,5.3
37177,2020-12-01,1322,1211,111,8.4
37179,2020-12-01,123643,117330,6313,5.1
37181,2020-12-01,17232,15607,1625,9.4
37183,2020-12-01,595264,564164,31100,5.2
37185,2020-12-01,6556,5962,594,9.1
37187,2020-12-01,4396,4051,345,7.8
37189,2020-12-01,29403,28003,1400,4.8
37191,2020-12-01,51521,48333,3188,6.2
37193,2020-12-01,28900,27234,1666,5.8
37195,2020-12-01,34889,32241,2648,7.6
37197,2020-12-01,17438,16483,955,5.5
37199,2020-12-01,8256,7805,451,5.5
38001,2020-12-01,962,925,37,3.8
38003,2020-12-01,5165,4983,182,3.5
38005,2020-12-01,2339,2206,133,5.7
38007,2020-12-01,365,350,15,4.1
38009,2020-12-01,2861,2704,157,5.5
38011,2020-12-01,1609,1557,52,3.2
38013,2020-12-01,1014,960,54,5.3
38015,2020-12-01,50253,48227,2026,4
38017,2020-12-01,104041,100106,3935,3.8
38019,2020-12-01,1868,1811,57,3.1
38021,2020-12-01,2275,2196,79,3.5
38023,2020-12-01,1364,1325,39,2.9
38025,2020-12-01,2828,2682,146,5.2
38027,2020-12-01,1194,1136,58,4.9
38029,2020-12-01,1471,1405,66,4.5
38031,2020-12-01,1533,1476,57,3.7
38033,2020-12-01,817,792,25,3.1
38035,2020-12-01,35986,34475,1511,4.2
38037,2020-12-01,1185,1136,49,4.1
38039,2020-12-01,985,949,36,3.7
38041,2020-12-01,1377,1322,55,4
38043,2020-12-01,1274,1198,76,6
38045,2020-12-01,2032,1974,58,2.9
38047,2020-12-01,855,827,28,3.3
38049,2020-12-01,3052,2897,155,5.1
38051,2020-12-01,1091,1042,49,4.5
38053,2020-12-01,8390,7693,697,8.3
38055,2020-12-01,4667,4455,212,4.5
38057,2020-12-01,3464,3249,215,6.2
38059,2020-12-01,16558,15806,752,4.5
38061,2020-12-01,6487,6135,352,5.4
38063,2020-12-01,1375,1300,75,5.5
38065,2020-12-01,864,824,40,4.6
38067,2020-12-01,3249,3103,146,4.5
38069,2020-12-01,1686,1625,61,3.6
38071,2020-12-01,5532,5304,228,4.1
38073,2020-12-01,2804,2725,79,2.8
38075,2020-12-01,1207,1155,52,4.3
38077,2020-12-01,8464,8189,275,3.2
38079,2020-12-01,4556,3995,561,12.3
38081,2020-12-01,2780,2684,96,3.5
38083,2020-12-01,681,635,46,6.8
38085,2020-12-01,1189,1147,42,3.5
38087,2020-12-01,373,363,10,2.7
38089,2020-12-01,17477,16280,1197,6.8
38091,2020-12-01,928,906,22,2.4
38093,2020-12-01,10352,9982,370,3.6
38095,2020-12-01,1116,1071,45,4
38097,2020-12-01,4474,4338,136,3
38099,2020-12-01,4990,4765,225,4.5
38101,2020-12-01,31187,29406,1781,5.7
38103,2020-12-01,1894,1804,90,4.8
38105,2020-12-01,20998,18968,2030,9.7
39001,2020-12-01,10771,10111,660,6.1
39003,2020-12-01,48626,46312,2314,4.8
39005,2020-12-01,26231,25082,1149,4.4
39007,2020-12-01,42345,39952,2393,5.7
39009,2020-12-01,28591,27298,1293,4.5
39011,2020-12-01,24324,23499,825,3.4
39013,2020-12-01,28082,26378,1704,6.1
39015,2020-12-01,19125,18103,1022,5.3
39017,2020-12-01,191401,183181,8220,4.3
39019,2020-12-01,12712,12013,699,5.5
39021,2020-12-01,19608,18843,765,3.9
39023,2020-12-01,62139,59141,2998,4.8
39025,2020-12-01,105007,100653,4354,4.1
39027,2020-12-01,17502,16595,907,5.2
39029,2020-12-01,45992,43347,2645,5.8
39031,2020-12-01,13641,12873,768,5.6
39033,2020-12-01,18261,17336,925,5.1
39035,2020-12-01,589456,540297,49159,8.3
39037,2020-12-01,25399,24414,985,3.9
39039,2020-12-01,17627,16835,792,4.5
39041,2020-12-01,111852,108106,3746,3.3
39043,2020-12-01,34122,31866,2256,6.6
39045,2020-12-01,78482,75316,3166,4
39047,2020-12-01,13896,13299,597,4.3
39049,2020-12-01,702319,669659,32660,4.7
39051,2020-12-01,21648,20658,990,4.6
39053,2020-12-01,11927,11289,638,5.3
39055,2020-12-01,46517,43933,2584,5.6
39057,2020-12-01,81865,78573,3292,4
39059,2020-12-01,17780,16750,1030,5.8
39061,2020-12-01,410248,390180,20068,4.9
39063,2020-12-01,41456,39878,1578,3.8
39065,2020-12-01,13992,13340,652,4.7
39067,2020-12-01,6493,6085,408,6.3
39069,2020-12-01,12801,12129,672,5.2
39071,2020-12-01,17331,16406,925,5.3
39073,2020-12-01,12933,12308,625,4.8
39075,2020-12-01,20977,20441,536,2.6
39077,2020-12-01,26609,24865,1744,6.6
39079,2020-12-01,12905,12163,742,5.7
39081,2020-12-01,26748,24998,1750,6.5
39083,2020-12-01,31067,29833,1234,4
39085,2020-12-01,120749,112650,8099,6.7
39087,2020-12-01,23453,22323,1130,4.8
39089,2020-12-01,90464,86923,3541,3.9
39091,2020-12-01,22332,21437,895,4
39093,2020-12-01,147811,136665,11146,7.5
39095,2020-12-01,203128,191435,11693,5.8
39097,2020-12-01,20885,20109,776,3.7
39099,2020-12-01,98413,92326,6087,6.2
39101,2020-12-01,27871,26565,1306,4.7
39103,2020-12-01,93034,87743,5291,5.7
39105,2020-12-01,8895,8347,548,6.2
39107,2020-12-01,23161,22505,656,2.8
39109,2020-12-01,53422,51199,2223,4.2
39111,2020-12-01,5524,5128,396,7.2
39113,2020-12-01,248402,235389,13013,5.2
39115,2020-12-01,6534,6130,404,6.2
39117,2020-12-01,16845,16084,761,4.5
39119,2020-12-01,40250,38170,2080,5.2
39121,2020-12-01,4518,4193,325,7.2
39123,2020-12-01,19349,18069,1280,6.6
39125,2020-12-01,8584,8227,357,4.2
39127,2020-12-01,15861,15004,857,5.4
39129,2020-12-01,26492,25364,1128,4.3
39131,2020-12-01,10689,10062,627,5.9
39133,2020-12-01,84802,80911,3891,4.6
39135,2020-12-01,20920,20084,836,4
39137,2020-12-01,18700,18110,590,3.2
39139,2020-12-01,51611,48812,2799,5.4
39141,2020-12-01,34942,33390,1552,4.4
39143,2020-12-01,29578,28185,1393,4.7
39145,2020-12-01,28930,27292,1638,5.7
39147,2020-12-01,26709,25479,1230,4.6
39149,2020-12-01,23717,22759,958,4
39151,2020-12-01,182195,173196,8999,4.9
39153,2020-12-01,266192,252407,13785,5.2
39155,2020-12-01,82708,77446,5262,6.4
39157,2020-12-01,43773,41732,2041,4.7
39159,2020-12-01,29377,28402,975,3.3
39161,2020-12-01,14479,13944,535,3.7
39163,2020-12-01,5500,5150,350,6.4
39165,2020-12-01,117721,113184,4537,3.9
39167,2020-12-01,26192,24723,1469,5.6
39169,2020-12-01,59546,57430,2116,3.6
39171,2020-12-01,18446,17640,806,4.4
39173,2020-12-01,68576,65833,2743,4
39175,2020-12-01,12878,12417,461,3.6
40001,2020-12-01,8420,8079,341,4
40003,2020-12-01,2726,2644,82,3
40005,2020-12-01,5265,4957,308,5.8
40007,2020-12-01,2533,2482,51,2
40009,2020-12-01,9896,9289,607,6.1
40011,2020-12-01,4256,4070,186,4.4
40013,2020-12-01,22999,22090,909,4
40015,2020-12-01,12042,11471,571,4.7
40017,2020-12-01,76347,73351,2996,3.9
40019,2020-12-01,21884,20818,1066,4.9
40021,2020-12-01,19723,18800,923,4.7
40023,2020-12-01,5558,5202,356,6.4
40025,2020-12-01,1439,1414,25,1.7
40027,2020-12-01,143779,138354,5425,3.8
40029,2020-12-01,2396,2256,140,5.8
40031,2020-12-01,48241,46069,2172,4.5
40033,2020-12-01,2706,2581,125,4.6
40035,2020-12-01,5811,5580,231,4
40037,2020-12-01,31342,29696,1646,5.3
40039,2020-12-01,15076,14429,647,4.3
40041,2020-12-01,18596,17843,753,4
40043,2020-12-01,2656,2540,116,4.4
40045,2020-12-01,2135,2041,94,4.4
40047,2020-12-01,26742,25567,1175,4.4
40049,2020-12-01,12948,12313,635,4.9
40051,2020-12-01,26830,25605,1225,4.6
40053,2020-12-01,2775,2690,85,3.1
40055,2020-12-01,1902,1777,125,6.6
40057,2020-12-01,1201,1164,37,3.1
40059,2020-12-01,1805,1746,59,3.3
40061,2020-12-01,4316,4037,279,6.5
40063,2020-12-01,5470,5118,352,6.4
40065,2020-12-01,11008,10669,339,3.1
40067,2020-12-01,2598,2456,142,5.5
40069,2020-12-01,3718,3512,206,5.5
40071,2020-12-01,18041,17101,940,5.2
40073,2020-12-01,8664,8345,319,3.7
40075,2020-12-01,3566,3423,143,4
40077,2020-12-01,3173,2886,287,9
40079,2020-12-01,19371,18304,1067,5.5
40081,2020-12-01,15756,15084,672,4.3
40083,2020-12-01,22453,21593,860,3.8
40085,2020-12-01,6578,6382,196,3
40087,2020-12-01,19981,19206,775,3.9
40089,2020-12-01,15261,14341,920,6
40091,2020-12-01,7114,6600,514,7.2
40093,2020-12-01,3701,3546,155,4.2
40095,2020-12-01,6874,6549,325,4.7
40097,2020-12-01,19659,18803,856,4.4
40099,2020-12-01,6010,5710,300,5
40101,2020-12-01,29782,28286,1496,5
40103,2020-12-01,5577,5414,163,2.9
40105,2020-12-01,4702,4487,215,4.6
40107,2020-12-01,4448,4190,258,5.8
40109,2020-12-01,388862,370754,18108,4.7
40111,2020-12-01,15643,14669,974,6.2
40113,2020-12-01,20507,19462,1045,5.1
40115,2020-12-01,14245,13676,569,4
40117,2020-12-01,7320,6922,398,5.4
40119,2020-12-01,38040,36591,1449,3.8
40121,2020-12-01,16601,15592,1009,6.1
40123,2020-12-01,19595,18814,781,4
40125,2020-12-01,32767,31188,1579,4.8
40127,2020-12-01,4482,4211,271,6
40129,2020-12-01,1845,1778,67,3.6
40131,2020-12-01,44947,42906,2041,4.5
40133,2020-12-01,9331,8750,581,6.2
40135,2020-12-01,16603,15819,784,4.7
40137,2020-12-01,18389,17280,1109,6
40139,2020-12-01,11432,11167,265,2.3
40141,2020-12-01,3048,2949,99,3.2
40143,2020-12-01,323031,307022,16009,5
40145,2020-12-01,38183,36434,1749,4.6
40147,2020-12-01,22376,21366,1010,4.5
40149,2020-12-01,5069,4778,291,5.7
40151,2020-12-01,4687,4569,118,2.5
40153,2020-12-01,8681,8189,492,5.7
41001,2020-12-01,7528,7050,478,6.3
41003,2020-12-01,47061,45034,2027,4.3
41005,2020-12-01,220603,207417,13186,6
41007,2020-12-01,19019,17626,1393,7.3
41009,2020-12-01,24353,22720,1633,6.7
41011,2020-12-01,27087,25397,1690,6.2
41013,2020-12-01,10585,9698,887,8.4
41015,2020-12-01,8938,8321,617,6.9
41017,2020-12-01,100536,93622,6914,6.9
41019,2020-12-01,48407,45325,3082,6.4
41021,2020-12-01,986,937,49,5
41023,2020-12-01,3230,2952,278,8.6
41025,2020-12-01,3850,3651,199,5.2
41027,2020-12-01,13767,13057,710,5.2
41029,2020-12-01,107621,101015,6606,6.1
41031,2020-12-01,10466,9639,827,7.9
41033,2020-12-01,37040,34528,2512,6.8
41035,2020-12-01,29823,27483,2340,7.8
41037,2020-12-01,3676,3495,181,4.9
41039,2020-12-01,179485,168264,11221,6.3
41041,2020-12-01,20082,18500,1582,7.9
41043,2020-12-01,59568,55772,3796,6.4
41045,2020-12-01,12790,12189,601,4.7
41047,2020-12-01,164863,155121,9742,5.9
41049,2020-12-01,5689,5406,283,5
41051,2020-12-01,461126,429501,31625,6.9
41053,2020-12-01,40886,38653,2233,5.5
41055,2020-12-01,994,949,45,4.5
41057,2020-12-01,11601,10896,705,6.1
41059,2020-12-01,37257,34957,2300,6.2
41061,2020-12-01,12288,11484,804,6.5
41063,2020-12-01,3493,3284,209,6
41065,2020-12-01,12667,11824,843,6.7
41067,2020-12-01,325139,308147,16992,5.2
41069,2020-12-01,700,669,31,4.4
41071,2020-12-01,54569,51533,3036,5.6
42001,2020-12-01,53784,51310,2474,4.6
42003,2020-12-01,619099,576533,42566,6.9
42005,2020-12-01,30797,28328,2469,8
42007,2020-12-01,80608,74212,6396,7.9
42009,2020-12-01,22987,21385,1602,7
42011,2020-12-01,206841,192636,14205,6.9
42013,2020-12-01,58249,54327,3922,6.7
42015,2020-12-01,27825,26195,1630,5.9
42017,2020-12-01,329897,311182,18715,5.7
42019,2020-12-01,95124,89281,5843,6.1
42021,2020-12-01,54823,50619,4204,7.7
42023,2020-12-01,2022,1854,168,8.3
42025,2020-12-01,31419,29193,2226,7.1
42027,2020-12-01,74160,70640,3520,4.7
42029,2020-12-01,275755,263488,12267,4.4
42031,2020-12-01,16703,15578,1125,6.7
42033,2020-12-01,35120,32504,2616,7.4
42035,2020-12-01,17514,16206,1308,7.5
42037,2020-12-01,32754,30705,2049,6.3
42039,2020-12-01,37761,35019,2742,7.3
42041,2020-12-01,129005,122707,6298,4.9
42043,2020-12-01,141986,132378,9608,6.8
42045,2020-12-01,289087,269667,19420,6.7
42047,2020-12-01,14485,13367,1118,7.7
42049,2020-12-01,124523,114279,10244,8.2
42051,2020-12-01,54819,49615,5204,9.5
42053,2020-12-01,1759,1604,155,8.8
42055,2020-12-01,76570,72462,4108,5.4
42057,2020-12-01,7606,7087,519,6.8
42059,2020-12-01,15718,14500,1218,7.7
42061,2020-12-01,19394,17744,1650,8.5
42063,2020-12-01,36958,34340,2618,7.1
42065,2020-12-01,19692,18290,1402,7.1
42067,2020-12-01,12575,11843,732,5.8
42069,2020-12-01,102244,94897,7347,7.2
42071,2020-12-01,277207,262871,14336,5.2
42073,2020-12-01,39305,35956,3349,8.5
42075,2020-12-01,70586,66415,4171,5.9
42077,2020-12-01,190479,177170,13309,7
42079,2020-12-01,155088,141717,13371,8.6
42081,2020-12-01,55021,51042,3979,7.2
42083,2020-12-01,16692,15434,1258,7.5
42085,2020-12-01,47308,43546,3762,8
42087,2020-12-01,21186,19619,1567,7.4
42089,2020-12-01,78942,72453,6489,8.2
42091,2020-12-01,437051,413502,23549,5.4
42093,2020-12-01,8976,8513,463,5.2
42095,2020-12-01,157798,148116,9682,6.1
42097,2020-12-01,41355,38301,3054,7.4
42099,2020-12-01,23850,22705,1145,4.8
42101,2020-12-01,695374,624715,70659,10.2
42103,2020-12-01,23939,22141,1798,7.5
42105,2020-12-01,7198,6655,543,7.5
42107,2020-12-01,65045,60457,4588,7.1
42109,2020-12-01,19585,18518,1067,5.4
42111,2020-12-01,32311,29790,2521,7.8
42113,2020-12-01,2618,2437,181,6.9
42115,2020-12-01,19613,18535,1078,5.5
42117,2020-12-01,18428,17080,1348,7.3
42119,2020-12-01,19105,18098,1007,5.3
42121,2020-12-01,21667,20023,1644,7.6
42123,2020-12-01,18691,17437,1254,6.7
42125,2020-12-01,102545,94938,7607,7.4
42127,2020-12-01,21793,20263,1530,7
42129,2020-12-01,172326,160154,12172,7.1
42131,2020-12-01,13165,12304,861,6.5
42133,2020-12-01,231907,218836,13071,5.6
44001,2020-12-01,25228,23299,1929,7.6
44003,2020-12-01,87816,81610,6206,7.1
44005,2020-12-01,42775,39546,3229,7.5
44007,2020-12-01,317323,291393,25930,8.2
44009,2020-12-01,66121,61451,4670,7.1
45001,2020-12-01,9916,9307,609,6.1
45003,2020-12-01,74556,70980,3576,4.8
45005,2020-12-01,2587,2302,285,11
45007,2020-12-01,89633,84703,4930,5.5
45009,2020-12-01,4686,4189,497,10.6
45011,2020-12-01,7879,7178,701,8.9
45013,2020-12-01,76292,72533,3759,4.9
45015,2020-12-01,103971,98353,5618,5.4
45017,2020-12-01,6473,6052,421,6.5
45019,2020-12-01,208943,197186,11757,5.6
45021,2020-12-01,24953,23065,1888,7.6
45023,2020-12-01,13474,12309,1165,8.6
45025,2020-12-01,21404,20029,1375,6.4
45027,2020-12-01,12415,11521,894,7.2
45029,2020-12-01,16421,15300,1121,6.8
45031,2020-12-01,30204,28206,1998,6.6
45033,2020-12-01,13037,12111,926,7.1
45035,2020-12-01,76864,72650,4214,5.5
45037,2020-12-01,10600,10097,503,4.7
45039,2020-12-01,9450,8714,736,7.8
45041,2020-12-01,66810,62862,3948,5.9
45043,2020-12-01,25232,23351,1881,7.5
45045,2020-12-01,252223,239274,12949,5.1
45047,2020-12-01,31121,29096,2025,6.5
45049,2020-12-01,8010,7574,436,5.4
45051,2020-12-01,141825,130909,10916,7.7
45053,2020-12-01,12722,12074,648,5.1
45055,2020-12-01,28978,27418,1560,5.4
45057,2020-12-01,41902,39271,2631,6.3
45059,2020-12-01,29708,27841,1867,6.3
45061,2020-12-01,6673,6165,508,7.6
45063,2020-12-01,148153,141470,6683,4.5
45065,2020-12-01,3299,3063,236,7.2
45067,2020-12-01,13193,11980,1213,9.2
45069,2020-12-01,9085,8198,887,9.8
45071,2020-12-01,18782,17844,938,5
45073,2020-12-01,34048,32347,1701,5
45075,2020-12-01,34394,31055,3339,9.7
45077,2020-12-01,56374,53616,2758,4.9
45079,2020-12-01,197370,185155,12215,6.2
45081,2020-12-01,8464,8074,390,4.6
45083,2020-12-01,156725,147824,8901,5.7
45085,2020-12-01,43850,40903,2947,6.7
45087,2020-12-01,11922,10898,1024,8.6
45089,2020-12-01,11557,10579,978,8.5
45091,2020-12-01,141859,134156,7703,5.4
46003,2020-12-01,1519,1481,38,2.5
46005,2020-12-01,9391,9090,301,3.2
46007,2020-12-01,1086,1038,48,4.4
46009,2020-12-01,2903,2799,104,3.6
46011,2020-12-01,18906,18148,758,4
46013,2020-12-01,20852,20166,686,3.3
46015,2020-12-01,2490,2413,77,3.1
46017,2020-12-01,741,708,33,4.5
46019,2020-12-01,5013,4804,209,4.2
46021,2020-12-01,814,794,20,2.5
46023,2020-12-01,3793,3621,172,4.5
46025,2020-12-01,2353,2281,72,3.1
46027,2020-12-01,7270,7002,268,3.7
46029,2020-12-01,15489,14928,561,3.6
46031,2020-12-01,1400,1341,59,4.2
46033,2020-12-01,4112,3906,206,5
46035,2020-12-01,11065,10699,366,3.3
46037,2020-12-01,2715,2582,133,4.9
46039,2020-12-01,2468,2367,101,4.1
46041,2020-12-01,2281,2168,113,5
46043,2020-12-01,1608,1560,48,3
46045,2020-12-01,2069,2001,68,3.3
46047,2020-12-01,2972,2811,161,5.4
46049,2020-12-01,1100,1068,32,2.9
46051,2020-12-01,4458,4295,163,3.7
46053,2020-12-01,2123,2045,78,3.7
46055,2020-12-01,1104,1078,26,2.4
46057,2020-12-01,3445,3337,108,3.1
46059,2020-12-01,1874,1830,44,2.3
46061,2020-12-01,1785,1705,80,4.5
46063,2020-12-01,745,725,20,2.7
46065,2020-12-01,10067,9800,267,2.7
46067,2020-12-01,3684,3547,137,3.7
46069,2020-12-01,700,683,17,2.4
46071,2020-12-01,1204,1145,59,4.9
46073,2020-12-01,1246,1214,32,2.6
46075,2020-12-01,494,479,15,3
46077,2020-12-01,2739,2656,83,3
46079,2020-12-01,6554,6325,229,3.5
46081,2020-12-01,13624,13110,514,3.8
46083,2020-12-01,36023,35068,955,2.7
46085,2020-12-01,1672,1604,68,4.1
46087,2020-12-01,3137,3042,95,3
46089,2020-12-01,1047,1003,44,4.2
46091,2020-12-01,2505,2410,95,3.8
46093,2020-12-01,13830,13352,478,3.5
46095,2020-12-01,730,698,32,4.4
46097,2020-12-01,1155,1099,56,4.8
46099,2020-12-01,113720,110018,3702,3.3
46101,2020-12-01,4022,3897,125,3.1
46102,2020-12-01,3786,3393,393,10.4
46103,2020-12-01,56598,54458,2140,3.8
46105,2020-12-01,1437,1378,59,4.1
46107,2020-12-01,1041,1008,33,3.2
46109,2020-12-01,4893,4622,271,5.5
46111,2020-12-01,1204,1157,47,3.9
46115,2020-12-01,3184,3077,107,3.4
46117,2020-12-01,1928,1872,56,2.9
46119,2020-12-01,818,801,17,2.1
46121,2020-12-01,3072,2905,167,5.4
46123,2020-12-01,3125,3047,78,2.5
46125,2020-12-01,4726,4587,139,2.9
46127,2020-12-01,8590,8243,347,4
46129,2020-12-01,2171,2050,121,5.6
46135,2020-12-01,11705,11292,413,3.5
46137,2020-12-01,983,938,45,4.6
47001,2020-12-01,34823,32990,1833,5.3
47003,2020-12-01,20742,19571,1171,5.6
47005,2020-12-01,6682,6223,459,6.9
47007,2020-12-01,4275,3923,352,8.2
47009,2020-12-01,64264,61119,3145,4.9
47011,2020-12-01,53397,50474,2923,5.5
47013,2020-12-01,14916,13971,945,6.3
47015,2020-12-01,6590,6280,310,4.7
47017,2020-12-01,12173,11443,730,6
47019,2020-12-01,24037,22597,1440,6
47021,2020-12-01,21646,20703,943,4.4
47023,2020-12-01,8606,8179,427,5
47025,2020-12-01,13113,12286,827,6.3
47027,2020-12-01,2786,2579,207,7.4
47029,2020-12-01,14380,13441,939,6.5
47031,2020-12-01,25597,24276,1321,5.2
47033,2020-12-01,6968,6612,356,5.1
47035,2020-12-01,22956,21312,1644,7.2
47037,2020-12-01,403329,382329,21000,5.2
47039,2020-12-01,4414,4065,349,7.9
47041,2020-12-01,7689,7197,492,6.4
47043,2020-12-01,26831,25633,1198,4.5
47045,2020-12-01,15940,14968,972,6.1
47047,2020-12-01,19455,18365,1090,5.6
47049,2020-12-01,7634,7133,501,6.6
47051,2020-12-01,19575,18597,978,5
47053,2020-12-01,22146,20842,1304,5.9
47055,2020-12-01,14570,13768,802,5.5
47057,2020-12-01,9579,9007,572,6
47059,2020-12-01,28873,26994,1879,6.5
47061,2020-12-01,5036,4682,354,7
47063,2020-12-01,28381,26917,1464,5.2
47065,2020-12-01,183518,173445,10073,5.5
47067,2020-12-01,2168,2016,152,7
47069,2020-12-01,9316,8580,736,7.9
47071,2020-12-01,10394,9739,655,6.3
47073,2020-12-01,23585,22174,1411,6
47075,2020-12-01,7824,7263,561,7.2
47077,2020-12-01,12103,11398,705,5.8
47079,2020-12-01,13522,12654,868,6.4
47081,2020-12-01,11289,10762,527,4.7
47083,2020-12-01,3213,2980,233,7.3
47085,2020-12-01,8691,8225,466,5.4
47087,2020-12-01,4920,4599,321,6.5
47089,2020-12-01,24952,23629,1323,5.3
47091,2020-12-01,7904,7462,442,5.6
47093,2020-12-01,246590,235039,11551,4.7
47095,2020-12-01,1717,1559,158,9.2
47097,2020-12-01,9883,9155,728,7.4
47099,2020-12-01,19295,18246,1049,5.4
47101,2020-12-01,5316,5015,301,5.7
47103,2020-12-01,16118,15157,961,6
47105,2020-12-01,23874,22663,1211,5.1
47107,2020-12-01,23442,22053,1389,5.9
47109,2020-12-01,8403,7739,664,7.9
47111,2020-12-01,11315,10702,613,5.4
47113,2020-12-01,49881,46949,2932,5.9
47115,2020-12-01,12448,11674,774,6.2
47117,2020-12-01,15210,14416,794,5.2
47119,2020-12-01,50023,47388,2635,5.3
47121,2020-12-01,5243,4904,339,6.5
47123,2020-12-01,20186,19133,1053,5.2
47125,2020-12-01,87623,82280,5343,6.1
47127,2020-12-01,3629,3482,147,4.1
47129,2020-12-01,7854,7366,488,6.2
47131,2020-12-01,12328,11493,835,6.8
47133,2020-12-01,9817,9325,492,5
47135,2020-12-01,3079,2822,257,8.3
47137,2020-12-01,2223,2095,128,5.8
47139,2020-12-01,7561,7119,442,5.8
47141,2020-12-01,35855,33954,1901,5.3
47143,2020-12-01,13169,12167,1002,7.6
47145,2020-12-01,23584,22146,1438,6.1
47147,2020-12-01,37874,36144,1730,4.6
47149,2020-12-01,185866,177773,8093,4.4
47151,2020-12-01,8196,7580,616,7.5
47153,2020-12-01,6157,5777,380,6.2
47155,2020-12-01,52905,50463,2442,4.6
47157,2020-12-01,454800,420199,34601,7.6
47159,2020-12-01,9364,8966,398,4.3
47161,2020-12-01,5523,5173,350,6.3
47163,2020-12-01,70030,65856,4174,6
47165,2020-12-01,103258,98554,4704,4.6
47167,2020-12-01,28195,26571,1624,5.8
47169,2020-12-01,5502,5218,284,5.2
47171,2020-12-01,7206,6663,543,7.5
47173,2020-12-01,7721,7264,457,5.9
47175,2020-12-01,2009,1866,143,7.1
47177,2020-12-01,17101,16092,1009,5.9
47179,2020-12-01,60828,57612,3216,5.3
47181,2020-12-01,6509,6109,400,6.1
47183,2020-12-01,15571,14778,793,5.1
47185,2020-12-01,12168,11526,642,5.3
47187,2020-12-01,129559,124684,4875,3.8
47189,2020-12-01,77684,74306,3378,4.3
48001,2020-12-01,23490,22154,1336,5.7
48003,2020-12-01,9015,8303,712,7.9
48005,2020-12-01,35595,33027,2568,7.2
48007,2020-12-01,9049,8307,742,8.2
48009,2020-12-01,3944,3742,202,5.1
48011,2020-12-01,927,888,39,4.2
48013,2020-12-01,22246,20543,1703,7.7
48015,2020-12-01,13737,12858,879,6.4
48017,2020-12-01,2438,2315,123,5
48019,2020-12-01,10052,9519,533,5.3
48021,2020-12-01,43425,41215,2210,5.1
48023,2020-12-01,1800,1741,59,3.3
48025,2020-12-01,9813,8861,952,9.7
48027,2020-12-01,146395,137091,9304,6.4
48029,2020-12-01,958124,898537,59587,6.2
48031,2020-12-01,6722,6493,229,3.4
48033,2020-12-01,475,461,14,2.9
48035,2020-12-01,8446,8006,440,5.2
48037,2020-12-01,39163,36711,2452,6.3
48039,2020-12-01,179075,164341,14734,8.2
48041,2020-12-01,117935,112362,5573,4.7
48043,2020-12-01,4114,3876,238,5.8
48045,2020-12-01,573,543,30,5.2
48047,2020-12-01,2537,2263,274,10.8
48049,2020-12-01,15341,14429,912,5.9
48051,2020-12-01,8275,7781,494,6
48053,2020-12-01,24020,22989,1031,4.3
48055,2020-12-01,19737,18644,1093,5.5
48057,2020-12-01,12460,11768,692,5.6
48059,2020-12-01,6045,5744,301,5
48061,2020-12-01,169862,153750,16112,9.5
48063,2020-12-01,5069,4698,371,7.3
48065,2020-12-01,2968,2851,117,3.9
48067,2020-12-01,12427,11417,1010,8.1
48069,2020-12-01,3327,3204,123,3.7
48071,2020-12-01,20110,18159,1951,9.7
48073,2020-12-01,21606,20026,1580,7.3
48075,2020-12-01,3107,2995,112,3.6
48077,2020-12-01,4857,4569,288,5.9
48079,2020-12-01,1072,1005,67,6.3
48081,2020-12-01,1360,1286,74,5.4
48083,2020-12-01,2910,2704,206,7.1
48085,2020-12-01,582281,552359,29922,5.1
48087,2020-12-01,1074,1027,47,4.4
48089,2020-12-01,9681,9130,551,5.7
48091,2020-12-01,76389,72468,3921,5.1
48093,2020-12-01,5750,5433,317,5.5
48095,2020-12-01,1293,1229,64,4.9
48097,2020-12-01,19316,18116,1200,6.2
48099,2020-12-01,24270,22834,1436,5.9
48101,2020-12-01,587,557,30,5.1
48103,2020-12-01,1619,1404,215,13.3
48105,2020-12-01,1510,1383,127,8.4
48107,2020-12-01,2410,2278,132,5.5
48109,2020-12-01,1162,1100,62,5.3
48111,2020-12-01,3740,3640,100,2.7
48113,2020-12-01,NA,NA,90035,6.5
48115,2020-12-01,4608,4200,408,8.9
48117,2020-12-01,8564,8213,351,4.1
48119,2020-12-01,2438,2318,120,4.9
48121,2020-12-01,514240,487005,27235,5.3
48123,2020-12-01,9105,8554,551,6.1
48125,2020-12-01,666,623,43,6.5
48127,2020-12-01,6135,5708,427,7
48129,2020-12-01,1441,1377,64,4.4
48131,2020-12-01,4780,4186,594,12.4
48133,2020-12-01,7492,6991,501,6.7
48135,2020-12-01,80798,71447,9351,11.6
48137,2020-12-01,1290,1233,57,4.4
48139,2020-12-01,95868,90802,5066,5.3
48141,2020-12-01,369671,342154,27517,7.4
48143,2020-12-01,20348,19267,1081,5.3
48145,2020-12-01,6653,6275,378,5.7
48147,2020-12-01,17142,16389,753,4.4
48149,2020-12-01,11752,11162,590,5
48151,2020-12-01,1601,1521,80,5
48153,2020-12-01,2497,2344,153,6.1
48155,2020-12-01,564,541,23,4.1
48157,2020-12-01,396512,368750,27762,7
48159,2020-12-01,4901,4632,269,5.5
48161,2020-12-01,6302,5801,501,7.9
48163,2020-12-01,9165,8619,546,6
48165,2020-12-01,9690,9114,576,5.9
48167,2020-12-01,164963,151960,13003,7.9
48169,2020-12-01,2004,1877,127,6.3
48171,2020-12-01,13617,13106,511,3.8
48173,2020-12-01,762,733,29,3.8
48175,2020-12-01,3202,2959,243,7.6
48177,2020-12-01,9608,9105,503,5.2
48179,2020-12-01,7708,7023,685,8.9
48181,2020-12-01,65603,62244,3359,5.1
48183,2020-12-01,56505,52201,4304,7.6
48185,2020-12-01,11091,10196,895,8.1
48187,2020-12-01,82196,78047,4149,5
48189,2020-12-01,11885,11092,793,6.7
48191,2020-12-01,1076,1017,59,5.5
48193,2020-12-01,3849,3674,175,4.5
48195,2020-12-01,2518,2428,90,3.6
48197,2020-12-01,1715,1626,89,5.2
48199,2020-12-01,25200,23082,2118,8.4
48201,2020-12-01,NA,NA,176678,7.7
48203,2020-12-01,29071,26834,2237,7.7
48205,2020-12-01,2637,2591,46,1.7
48207,2020-12-01,2639,2519,120,4.5
48209,2020-12-01,123233,117196,6037,4.9
48211,2020-12-01,1862,1776,86,4.6
48213,2020-12-01,37693,35480,2213,5.9
48215,2020-12-01,363869,324276,39593,10.9
48217,2020-12-01,16547,15575,972,5.9
48219,2020-12-01,10375,9573,802,7.7
48221,2020-12-01,28258,26528,1730,6.1
48223,2020-12-01,17744,16885,859,4.8
48225,2020-12-01,10079,9472,607,6
48227,2020-12-01,13417,12316,1101,8.2
48229,2020-12-01,1883,1724,159,8.4
48231,2020-12-01,44554,41962,2592,5.8
48233,2020-12-01,8600,8004,596,6.9
48235,2020-12-01,761,709,52,6.8
48237,2020-12-01,3339,3118,221,6.6
48239,2020-12-01,7236,6824,412,5.7
48241,2020-12-01,12923,11511,1412,10.9
48243,2020-12-01,969,919,50,5.2
48245,2020-12-01,105955,94294,11661,11
48247,2020-12-01,1910,1718,192,10.1
48249,2020-12-01,15603,13564,2039,13.1
48251,2020-12-01,84954,80053,4901,5.8
48253,2020-12-01,5816,5402,414,7.1
48255,2020-12-01,6809,6358,451,6.6
48257,2020-12-01,68963,64973,3990,5.8
48259,2020-12-01,22550,21578,972,4.3
48261,2020-12-01,165,155,10,6.1
48263,2020-12-01,426,415,11,2.6
48265,2020-12-01,21614,20553,1061,4.9
48267,2020-12-01,1829,1727,102,5.6
48269,2020-12-01,260,256,4,1.5
48271,2020-12-01,1298,1215,83,6.4
48273,2020-12-01,13587,12552,1035,7.6
48275,2020-12-01,1457,1377,80,5.5
48277,2020-12-01,23895,22430,1465,6.1
48279,2020-12-01,5208,4926,282,5.4
48281,2020-12-01,9190,8706,484,5.3
48283,2020-12-01,3489,3264,225,6.4
48285,2020-12-01,8453,8003,450,5.3
48287,2020-12-01,9014,8592,422,4.7
48289,2020-12-01,6271,5735,536,8.5
48291,2020-12-01,34129,30337,3792,11.1
48293,2020-12-01,8326,7712,614,7.4
48295,2020-12-01,1522,1455,67,4.4
48297,2020-12-01,5110,4692,418,8.2
48299,2020-12-01,8540,8056,484,5.7
48301,2020-12-01,281,278,3,1.1
48303,2020-12-01,159248,151060,8188,5.1
48305,2020-12-01,2751,2612,139,5.1
48307,2020-12-01,3304,3039,265,8
48309,2020-12-01,122783,115969,6814,5.5
48311,2020-12-01,684,665,19,2.8
48313,2020-12-01,4521,4179,342,7.6
48315,2020-12-01,4274,3949,325,7.6
48317,2020-12-01,2480,2330,150,6
48319,2020-12-01,1698,1596,102,6
48321,2020-12-01,16275,14629,1646,10.1
48323,2020-12-01,25027,21180,3847,15.4
48325,2020-12-01,21905,20673,1232,5.6
48327,2020-12-01,875,829,46,5.3
48329,2020-12-01,96272,88475,7797,8.1
48331,2020-12-01,9844,9185,659,6.7
48333,2020-12-01,1913,1823,90,4.7
48335,2020-12-01,2406,2205,201,8.4
48337,2020-12-01,8984,8425,559,6.2
48339,2020-12-01,286502,266590,19912,7
48341,2020-12-01,10711,10307,404,3.8
48343,2020-12-01,4742,4109,633,13.3
48345,2020-12-01,415,398,17,4.1
48347,2020-12-01,28435,26663,1772,6.2
48349,2020-12-01,23218,21906,1312,5.7
48351,2020-12-01,5082,4552,530,10.4
48353,2020-12-01,7261,6847,414,5.7
48355,2020-12-01,162984,149655,13329,8.2
48357,2020-12-01,3956,3724,232,5.9
48359,2020-12-01,909,866,43,4.7
48361,2020-12-01,36256,32694,3562,9.8
48363,2020-12-01,13208,12287,921,7
48365,2020-12-01,9325,8537,788,8.5
48367,2020-12-01,69801,66149,3652,5.2
48369,2020-12-01,5097,4952,145,2.8
48371,2020-12-01,6731,6162,569,8.5
48373,2020-12-01,18751,17094,1657,8.8
48375,2020-12-01,55132,52394,2738,5
48377,2020-12-01,3152,2727,425,13.5
48379,2020-12-01,6228,5969,259,4.2
48381,2020-12-01,73646,70729,2917,4
48383,2020-12-01,1726,1543,183,10.6
48385,2020-12-01,1096,1022,74,6.8
48387,2020-12-01,5261,4929,332,6.3
48389,2020-12-01,8168,7495,673,8.2
48391,2020-12-01,3078,2823,255,8.3
48393,2020-12-01,413,396,17,4.1
48395,2020-12-01,7454,6971,483,6.5
48397,2020-12-01,54367,51654,2713,5
48399,2020-12-01,4513,4310,203,4.5
48401,2020-12-01,22258,20612,1646,7.4
48403,2020-12-01,4030,3590,440,10.9
48405,2020-12-01,2994,2693,301,10.1
48407,2020-12-01,11887,10893,994,8.4
48409,2020-12-01,29174,26265,2909,10
48411,2020-12-01,2170,2058,112,5.2
48413,2020-12-01,1199,1107,92,7.7
48415,2020-12-01,6158,5645,513,8.3
48417,2020-12-01,1747,1654,93,5.3
48419,2020-12-01,11284,10552,732,6.5
48421,2020-12-01,1308,1261,47,3.6
48423,2020-12-01,110435,103888,6547,5.9
48425,2020-12-01,4440,4178,262,5.9
48427,2020-12-01,26202,21635,4567,17.4
48429,2020-12-01,4079,3831,248,6.1
48431,2020-12-01,557,515,42,7.5
48433,2020-12-01,573,541,32,5.6
48435,2020-12-01,1205,1073,132,11
48437,2020-12-01,2540,2407,133,5.2
48439,2020-12-01,NA,NA,68309,6.2
48441,2020-12-01,66893,63632,3261,4.9
48443,2020-12-01,406,390,16,3.9
48445,2020-12-01,4762,4413,349,7.3
48447,2020-12-01,625,591,34,5.4
48449,2020-12-01,13491,12643,848,6.3
48451,2020-12-01,54047,50885,3162,5.9
48453,2020-12-01,753258,716218,37040,4.9
48455,2020-12-01,5331,4891,440,8.3
48457,2020-12-01,7406,6664,742,10
48459,2020-12-01,17501,16185,1316,7.5
48461,2020-12-01,1806,1706,100,5.5
48463,2020-12-01,11225,10492,733,6.5
48465,2020-12-01,23322,21752,1570,6.7
48467,2020-12-01,26380,24918,1462,5.5
48469,2020-12-01,41530,38408,3122,7.5
48471,2020-12-01,24201,22488,1713,7.1
48473,2020-12-01,23983,22174,1809,7.5
48475,2020-12-01,5777,5197,580,10
48477,2020-12-01,15583,14701,882,5.7
48479,2020-12-01,116211,107314,8897,7.7
48481,2020-12-01,21299,19883,1416,6.6
48483,2020-12-01,2273,2101,172,7.6
48485,2020-12-01,56024,52369,3655,6.5
48487,2020-12-01,5024,4677,347,6.9
48489,2020-12-01,6549,5803,746,11.4
48491,2020-12-01,324666,309343,15323,4.7
48493,2020-12-01,25028,23766,1262,5
48495,2020-12-01,3959,3574,385,9.7
48497,2020-12-01,32819,30961,1858,5.7
48499,2020-12-01,18175,17069,1106,6.1
48501,2020-12-01,3346,2985,361,10.8
48503,2020-12-01,7818,7420,398,5.1
48505,2020-12-01,4332,3700,632,14.6
48507,2020-12-01,3498,3001,497,14.2
49001,2020-12-01,2782,2696,86,3.1
49003,2020-12-01,26352,25703,649,2.5
49005,2020-12-01,66203,64859,1344,2
49007,2020-12-01,8423,8079,344,4.1
49009,2020-12-01,361,341,20,5.5
49011,2020-12-01,176098,171448,4650,2.6
49013,2020-12-01,7380,6944,436,5.9
49015,2020-12-01,4305,4141,164,3.8
49017,2020-12-01,2247,2005,242,10.8
49019,2020-12-01,5464,5034,430,7.9
49021,2020-12-01,25377,24577,800,3.2
49023,2020-12-01,5959,5840,119,2
49025,2020-12-01,3501,3362,139,4
49027,2020-12-01,5802,5660,142,2.4
49029,2020-12-01,5588,5457,131,2.3
49031,2020-12-01,466,439,27,5.8
49033,2020-12-01,1002,973,29,2.9
49035,2020-12-01,639334,619320,20014,3.1
49037,2020-12-01,5071,4637,434,8.6
49039,2020-12-01,12522,12164,358,2.9
49041,2020-12-01,9674,9348,326,3.4
49043,2020-12-01,24175,23362,813,3.4
49045,2020-12-01,35132,34029,1103,3.1
49047,2020-12-01,12823,11951,872,6.8
49049,2020-12-01,316587,308554,8033,2.5
49051,2020-12-01,15926,15400,526,3.3
49053,2020-12-01,79799,77093,2706,3.4
49055,2020-12-01,1287,1203,84,6.5
49057,2020-12-01,130018,125930,4088,3.1
50001,2020-12-01,19407,18870,537,2.8
50003,2020-12-01,15880,15230,650,4.1
50005,2020-12-01,13551,13094,457,3.4
50007,2020-12-01,88582,86076,2506,2.8
50009,2020-12-01,2430,2336,94,3.9
50011,2020-12-01,24816,23957,859,3.5
50013,2020-12-01,3793,3656,137,3.6
50015,2020-12-01,12304,11774,530,4.3
50017,2020-12-01,14670,14240,430,2.9
50019,2020-12-01,11964,11408,556,4.6
50021,2020-12-01,27784,26708,1076,3.9
50023,2020-12-01,31387,30482,905,2.9
50025,2020-12-01,20009,19237,772,3.9
50027,2020-12-01,26594,25822,772,2.9
51001,2020-12-01,15878,14898,980,6.2
51003,2020-12-01,54163,51515,2648,4.9
51005,2020-12-01,6615,6255,360,5.4
51007,2020-12-01,6080,5757,323,5.3
51009,2020-12-01,14330,13569,761,5.3
51011,2020-12-01,6931,6511,420,6.1
51013,2020-12-01,147651,140753,6898,4.7
51015,2020-12-01,36864,35295,1569,4.3
51017,2020-12-01,2196,2056,140,6.4
51019,2020-12-01,36831,34986,1845,5
51021,2020-12-01,2785,2656,129,4.6
51023,2020-12-01,16832,16137,695,4.1
51025,2020-12-01,5864,5371,493,8.4
51027,2020-12-01,6320,5700,620,9.8
51029,2020-12-01,6208,5732,476,7.7
51031,2020-12-01,24841,23437,1404,5.7
51033,2020-12-01,14576,13666,910,6.2
51035,2020-12-01,12959,12169,790,6.1
51036,2020-12-01,3541,3321,220,6.2
51037,2020-12-01,5125,4858,267,5.2
51041,2020-12-01,180246,170621,9625,5.3
51043,2020-12-01,7380,7060,320,4.3
51045,2020-12-01,2238,2142,96,4.3
51047,2020-12-01,23938,22865,1073,4.5
51049,2020-12-01,4465,4210,255,5.7
51051,2020-12-01,4675,4316,359,7.7
51053,2020-12-01,13197,12322,875,6.6
51057,2020-12-01,5472,5100,372,6.8
51059,2020-12-01,610804,577514,33290,5.5
51061,2020-12-01,36060,34535,1525,4.2
51063,2020-12-01,7986,7625,361,4.5
51065,2020-12-01,13297,12651,646,4.9
51067,2020-12-01,25603,24285,1318,5.1
51069,2020-12-01,47886,45979,1907,4
51071,2020-12-01,7528,7149,379,5
51073,2020-12-01,18842,17925,917,4.9
51075,2020-12-01,10864,10371,493,4.5
51077,2020-12-01,8347,7964,383,4.6
51079,2020-12-01,9865,9428,437,4.4
51081,2020-12-01,4228,3930,298,7
51083,2020-12-01,14912,13951,961,6.4
51085,2020-12-01,56252,53810,2442,4.3
51087,2020-12-01,174446,164189,10257,5.9
51089,2020-12-01,23820,22261,1559,6.5
51091,2020-12-01,1315,1263,52,4
51093,2020-12-01,18775,17850,925,4.9
51095,2020-12-01,35445,33407,2038,5.7
51097,2020-12-01,3887,3691,196,5
51099,2020-12-01,13666,13076,590,4.3
51101,2020-12-01,8845,8393,452,5.1
51103,2020-12-01,5342,5015,327,6.1
51105,2020-12-01,8170,7680,490,6
51107,2020-12-01,216648,206280,10368,4.8
51109,2020-12-01,19623,18707,916,4.7
51111,2020-12-01,5279,4982,297,5.6
51113,2020-12-01,7298,7038,260,3.6
51115,2020-12-01,3987,3786,201,5
51117,2020-12-01,12696,11893,803,6.3
51119,2020-12-01,5029,4792,237,4.7
51121,2020-12-01,47457,45465,1992,4.2
51125,2020-12-01,7142,6785,357,5
51127,2020-12-01,12155,11651,504,4.1
51131,2020-12-01,5520,5113,407,7.4
51133,2020-12-01,5747,5419,328,5.7
51135,2020-12-01,6996,6615,381,5.4
51137,2020-12-01,16860,15984,876,5.2
51139,2020-12-01,11856,11057,799,6.7
51141,2020-12-01,7113,6698,415,5.8
51143,2020-12-01,29939,28284,1655,5.5
51145,2020-12-01,13540,12975,565,4.2
51147,2020-12-01,9940,9304,636,6.4
51149,2020-12-01,14540,13582,958,6.6
51153,2020-12-01,238345,224276,14069,5.9
51155,2020-12-01,15513,14544,969,6.2
51157,2020-12-01,3633,3480,153,4.2
51159,2020-12-01,4071,3862,209,5.1
51161,2020-12-01,47633,45451,2182,4.6
51163,2020-12-01,10408,9814,594,5.7
51165,2020-12-01,41120,39464,1656,4
51167,2020-12-01,11063,10369,694,6.3
51169,2020-12-01,8826,8396,430,4.9
51171,2020-12-01,22042,20976,1066,4.8
51173,2020-12-01,13208,12459,749,5.7
51175,2020-12-01,9137,8700,437,4.8
51177,2020-12-01,65204,61696,3508,5.4
51179,2020-12-01,70307,66565,3742,5.3
51181,2020-12-01,3518,3320,198,5.6
51183,2020-12-01,3773,3457,316,8.4
51185,2020-12-01,15470,14361,1109,7.2
51187,2020-12-01,19696,18659,1037,5.3
51191,2020-12-01,25435,24162,1273,5
51193,2020-12-01,9476,8892,584,6.2
51195,2020-12-01,12770,11805,965,7.6
51197,2020-12-01,13687,12873,814,5.9
51199,2020-12-01,31488,29989,1499,4.8
51510,2020-12-01,97608,91850,5758,5.9
51520,2020-12-01,7145,6650,495,6.9
51530,2020-12-01,3114,2946,168,5.4
51540,2020-12-01,24452,23120,1332,5.4
51550,2020-12-01,119079,112346,6733,5.7
51570,2020-12-01,8238,7673,565,6.9
51580,2020-12-01,2321,2139,182,7.8
51590,2020-12-01,19261,17568,1693,8.8
51595,2020-12-01,2349,2099,250,10.6
51600,2020-12-01,12630,12004,626,5
51610,2020-12-01,8096,7774,322,4
51620,2020-12-01,3659,3321,338,9.2
51630,2020-12-01,13584,12687,897,6.6
51640,2020-12-01,2825,2668,157,5.6
51650,2020-12-01,62978,57929,5049,8
51660,2020-12-01,23757,22466,1291,5.4
51670,2020-12-01,9565,8528,1037,10.8
51678,2020-12-01,2027,1874,153,7.5
51680,2020-12-01,34979,32571,2408,6.9
51683,2020-12-01,20966,19777,1189,5.7
51685,2020-12-01,9180,8622,558,6.1
51690,2020-12-01,5685,5105,580,10.2
51700,2020-12-01,87105,80285,6820,7.8
51710,2020-12-01,109109,100018,9091,8.3
51720,2020-12-01,1614,1506,108,6.7
51730,2020-12-01,13216,11279,1937,14.7
51735,2020-12-01,6134,5904,230,3.7
51740,2020-12-01,43874,39617,4257,9.7
51750,2020-12-01,8236,7760,476,5.8
51760,2020-12-01,115901,106540,9361,8.1
51770,2020-12-01,47927,44606,3321,6.9
51775,2020-12-01,12353,11726,627,5.1
51790,2020-12-01,12037,11399,638,5.3
51800,2020-12-01,43676,40854,2822,6.5
51810,2020-12-01,223694,211774,11920,5.3
51820,2020-12-01,10520,9918,602,5.7
51830,2020-12-01,6463,6029,434,6.7
51840,2020-12-01,14667,13963,704,4.8
53001,2020-12-01,8871,8245,626,7.1
53003,2020-12-01,10308,9885,423,4.1
53005,2020-12-01,99763,93239,6524,6.5
53007,2020-12-01,41795,38886,2909,7
53009,2020-12-01,29069,26847,2222,7.6
53011,2020-12-01,232788,217441,15347,6.6
53013,2020-12-01,1662,1564,98,5.9
53015,2020-12-01,47003,43521,3482,7.4
53017,2020-12-01,20112,18654,1458,7.2
53019,2020-12-01,2450,2217,233,9.5
53021,2020-12-01,40547,37277,3270,8.1
53023,2020-12-01,797,741,56,7
53025,2020-12-01,46489,42754,3735,8
53027,2020-12-01,28850,26170,2680,9.3
53029,2020-12-01,35698,33378,2320,6.5
53031,2020-12-01,12942,12028,914,7.1
53033,2020-12-01,NA,NA,74283,5.8
53035,2020-12-01,124890,117241,7649,6.1
53037,2020-12-01,20876,19276,1600,7.7
53039,2020-12-01,9496,8835,661,7
53041,2020-12-01,34188,31800,2388,7
53043,2020-12-01,4511,4258,253,5.6
53045,2020-12-01,25502,23519,1983,7.8
53047,2020-12-01,19242,17823,1419,7.4
53049,2020-12-01,9010,8231,779,8.6
53051,2020-12-01,4778,4356,422,8.8
53053,2020-12-01,430375,399332,31043,7.2
53055,2020-12-01,8567,8037,530,6.2
53057,2020-12-01,59838,55287,4551,7.6
53059,2020-12-01,5343,4918,425,8
53061,2020-12-01,439210,409996,29214,6.7
53063,2020-12-01,246807,229937,16870,6.8
53065,2020-12-01,17875,16501,1374,7.7
53067,2020-12-01,140386,131694,8692,6.2
53069,2020-12-01,1457,1356,101,6.9
53071,2020-12-01,29436,27604,1832,6.2
53073,2020-12-01,110457,102611,7846,7.1
53075,2020-12-01,21028,19959,1069,5.1
53077,2020-12-01,124169,113813,10356,8.3
54001,2020-12-01,7510,6948,562,7.5
54003,2020-12-01,59334,56358,2976,5
54005,2020-12-01,7388,6726,662,9
54007,2020-12-01,5068,4571,497,9.8
54009,2020-12-01,9942,9110,832,8.4
54011,2020-12-01,42334,39496,2838,6.7
54013,2020-12-01,2496,2084,412,16.5
54015,2020-12-01,3107,2773,334,10.7
54017,2020-12-01,3754,3528,226,6
54019,2020-12-01,16212,14783,1429,8.8
54021,2020-12-01,2439,2188,251,10.3
54023,2020-12-01,5965,5549,416,7
54025,2020-12-01,15735,14710,1025,6.5
54027,2020-12-01,11041,10462,579,5.2
54029,2020-12-01,13057,11954,1103,8.4
54031,2020-12-01,5855,5433,422,7.2
54033,2020-12-01,33985,31661,2324,6.8
54035,2020-12-01,12526,11554,972,7.8
54037,2020-12-01,30213,28744,1469,4.9
54039,2020-12-01,81949,75905,6044,7.4
54041,2020-12-01,6180,5580,600,9.7
54043,2020-12-01,7368,6716,652,8.8
54045,2020-12-01,10880,9796,1084,10
54047,2020-12-01,4459,3897,562,12.6
54049,2020-12-01,25385,23559,1826,7.2
54051,2020-12-01,13602,12451,1151,8.5
54053,2020-12-01,10406,9645,761,7.3
54055,2020-12-01,20916,19164,1752,8.4
54057,2020-12-01,12388,11492,896,7.2
54059,2020-12-01,6655,5854,801,12
54061,2020-12-01,55139,52232,2907,5.3
54063,2020-12-01,6091,5735,356,5.8
54065,2020-12-01,8479,8061,418,4.9
54067,2020-12-01,9615,8826,789,8.2
54069,2020-12-01,20480,19010,1470,7.2
54071,2020-12-01,3736,3571,165,4.4
54073,2020-12-01,2697,2436,261,9.7
54075,2020-12-01,4109,3824,285,6.9
54077,2020-12-01,15657,14646,1011,6.5
54079,2020-12-01,27231,25653,1578,5.8
54081,2020-12-01,30346,28083,2263,7.5
54083,2020-12-01,12257,11272,985,8
54085,2020-12-01,4332,3983,349,8.1
54087,2020-12-01,5096,4491,605,11.9
54089,2020-12-01,4277,3973,304,7.1
54091,2020-12-01,7852,7368,484,6.2
54093,2020-12-01,3260,3028,232,7.1
54095,2020-12-01,3213,2894,319,9.9
54097,2020-12-01,9334,8534,800,8.6
54099,2020-12-01,15994,14849,1145,7.2
54101,2020-12-01,3329,3063,266,8
54103,2020-12-01,6950,6301,649,9.3
54105,2020-12-01,2310,2055,255,11
54107,2020-12-01,36315,33569,2746,7.6
54109,2020-12-01,6320,5696,624,9.9
55001,2020-12-01,7855,7272,583,7.4
55003,2020-12-01,7512,7048,464,6.2
55005,2020-12-01,23921,22777,1144,4.8
55007,2020-12-01,7264,6758,506,7
55009,2020-12-01,139376,134457,4919,3.5
55011,2020-12-01,6287,5990,297,4.7
55013,2020-12-01,7046,6590,456,6.5
55015,2020-12-01,27158,26386,772,2.8
55017,2020-12-01,33649,32104,1545,4.6
55019,2020-12-01,17687,17074,613,3.5
55021,2020-12-01,31147,29972,1175,3.8
55023,2020-12-01,7525,7158,367,4.9
55025,2020-12-01,318968,309248,9720,3
55027,2020-12-01,46960,45376,1584,3.4
55029,2020-12-01,13968,13162,806,5.8
55031,2020-12-01,22026,20891,1135,5.2
55033,2020-12-01,24048,23103,945,3.9
55035,2020-12-01,59126,57067,2059,3.5
55037,2020-12-01,2184,2059,125,5.7
55039,2020-12-01,56617,54716,1901,3.4
55041,2020-12-01,3727,3453,274,7.4
55043,2020-12-01,27637,26821,816,3
55045,2020-12-01,20628,19981,647,3.1
55047,2020-12-01,9077,8660,417,4.6
55049,2020-12-01,13446,12980,466,3.5
55051,2020-12-01,2516,2320,196,7.8
55053,2020-12-01,9508,8922,586,6.2
55055,2020-12-01,45346,43732,1614,3.6
55057,2020-12-01,13210,12562,648,4.9
55059,2020-12-01,86743,82882,3861,4.5
55061,2020-12-01,10751,10424,327,3
55063,2020-12-01,65534,63369,2165,3.3
55065,2020-12-01,9887,9624,263,2.7
55067,2020-12-01,9266,8851,415,4.5
55069,2020-12-01,14670,14068,602,4.1
55071,2020-12-01,40004,38499,1505,3.8
55073,2020-12-01,72186,69913,2273,3.1
55075,2020-12-01,19410,18473,937,4.8
55077,2020-12-01,7674,7286,388,5.1
55078,2020-12-01,1563,1429,134,8.6
55079,2020-12-01,453165,427911,25254,5.6
55081,2020-12-01,23140,22292,848,3.7
55083,2020-12-01,20222,19399,823,4.1
55085,2020-12-01,17436,16495,941,5.4
55087,2020-12-01,102365,99021,3344,3.3
55089,2020-12-01,47329,45789,1540,3.3
55091,2020-12-01,4011,3848,163,4.1
55093,2020-12-01,23949,22977,972,4.1
55095,2020-12-01,24200,22840,1360,5.6
55097,2020-12-01,37613,36219,1394,3.7
55099,2020-12-01,6235,5956,279,4.5
55101,2020-12-01,96354,91680,4674,4.9
55103,2020-12-01,9102,8788,314,3.4
55105,2020-12-01,83725,80284,3441,4.1
55107,2020-12-01,6618,6279,339,5.1
55109,2020-12-01,48075,45994,2081,4.3
55111,2020-12-01,33558,32051,1507,4.5
55113,2020-12-01,7691,7213,478,6.2
55115,2020-12-01,20806,20009,797,3.8
55117,2020-12-01,61114,59168,1946,3.2
55119,2020-12-01,11051,10572,479,4.3
55121,2020-12-01,15464,14793,671,4.3
55123,2020-12-01,15051,14517,534,3.5
55125,2020-12-01,9901,9332,569,5.7
55127,2020-12-01,55935,53781,2154,3.9
55129,2020-12-01,7670,7295,375,4.9
55131,2020-12-01,74375,71929,2446,3.3
55133,2020-12-01,217026,209597,7429,3.4
55135,2020-12-01,25342,24373,969,3.8
55137,2020-12-01,11173,10695,478,4.3
55139,2020-12-01,91152,88142,3010,3.3
55141,2020-12-01,34318,32666,1652,4.8
56001,2020-12-01,19212,18471,741,3.9
56003,2020-12-01,5280,5031,249,4.7
56005,2020-12-01,22955,21540,1415,6.2
56007,2020-12-01,8077,7712,365,4.5
56009,2020-12-01,7778,7310,468,6
56011,2020-12-01,3814,3680,134,3.5
56013,2020-12-01,19187,18141,1046,5.5
56015,2020-12-01,6625,6348,277,4.2
56017,2020-12-01,2247,2148,99,4.4
56019,2020-12-01,4063,3864,199,4.9
56021,2020-12-01,50684,48397,2287,4.5
56023,2020-12-01,9327,8931,396,4.2
56025,2020-12-01,40551,37603,2948,7.3
56027,2020-12-01,1246,1198,48,3.9
56029,2020-12-01,14697,13941,756,5.1
56031,2020-12-01,4595,4376,219,4.8
56033,2020-12-01,16119,15361,758,4.7
56035,2020-12-01,3890,3628,262,6.7
56037,2020-12-01,20645,19248,1397,6.8
56039,2020-12-01,14654,14033,621,4.2
56041,2020-12-01,9332,8819,513,5.5
56043,2020-12-01,4012,3827,185,4.6
56045,2020-12-01,3818,3687,131,3.4
72001,2020-12-01,4071,3443,628,15.4
72003,2020-12-01,11371,10153,1218,10.7
72005,2020-12-01,13950,12259,1691,12.1
72007,2020-12-01,6173,5454,719,11.6
72009,2020-12-01,6009,5333,676,11.2
72011,2020-12-01,8478,7652,826,9.7
72013,2020-12-01,23000,20519,2481,10.8
72015,2020-12-01,4491,3952,539,12
72017,2020-12-01,5531,4859,672,12.1
72019,2020-12-01,6903,6107,796,11.5
72021,2020-12-01,62524,55908,6616,10.6
72023,2020-12-01,13364,12049,1315,9.8
72025,2020-12-01,45315,40934,4381,9.7
72027,2020-12-01,9088,8232,856,9.4
72029,2020-12-01,15489,13889,1600,10.3
72031,2020-12-01,59029,52872,6157,10.4
72033,2020-12-01,7521,6659,862,11.5
72035,2020-12-01,15087,13810,1277,8.5
72037,2020-12-01,3446,3046,400,11.6
72039,2020-12-01,3551,3014,537,15.1
72041,2020-12-01,14376,13292,1084,7.5
72043,2020-12-01,9528,8404,1124,11.8
72045,2020-12-01,4688,4090,598,12.8
72047,2020-12-01,8660,7411,1249,14.4
72049,2020-12-01,839,757,82,9.8
72051,2020-12-01,12658,11563,1095,8.7
72053,2020-12-01,10235,8963,1272,12.4
72054,2020-12-01,3130,2705,425,13.6
72055,2020-12-01,3832,3279,553,14.4
72057,2020-12-01,10447,9450,997,9.5
72059,2020-12-01,4560,3959,601,13.2
72061,2020-12-01,35647,33269,2378,6.7
72063,2020-12-01,17243,15962,1281,7.4
72065,2020-12-01,12715,11415,1300,10.2
72067,2020-12-01,5203,4645,558,10.7
72069,2020-12-01,16184,14488,1696,10.5
72071,2020-12-01,11236,10075,1161,10.3
72073,2020-12-01,4233,3701,532,12.6
72075,2020-12-01,14745,13347,1398,9.5
72077,2020-12-01,11730,10421,1309,11.2
72079,2020-12-01,5085,4400,685,13.5
72081,2020-12-01,6620,5746,874,13.2
72083,2020-12-01,2620,2326,294,11.2
72085,2020-12-01,10698,9583,1115,10.4
72087,2020-12-01,8079,7089,990,12.3
72089,2020-12-01,5935,5184,751,12.7
72091,2020-12-01,10937,9829,1108,10.1
72093,2020-12-01,1869,1682,187,10
72095,2020-12-01,2610,2282,328,12.6
72097,2020-12-01,20634,18408,2226,10.8
72099,2020-12-01,9966,8824,1142,11.5
72101,2020-12-01,7668,6691,977,12.7
72103,2020-12-01,7682,6944,738,9.6
72105,2020-12-01,6906,5912,994,14.4
72107,2020-12-01,4697,4009,688,14.6
72109,2020-12-01,4072,3521,551,13.5
72111,2020-12-01,5424,4702,722,13.3
72113,2020-12-01,42798,38316,4482,10.5
72115,2020-12-01,5834,5113,721,12.4
72117,2020-12-01,4435,3882,553,12.5
72119,2020-12-01,16339,14425,1914,11.7
72121,2020-12-01,5783,5127,656,11.3
72123,2020-12-01,6677,5805,872,13.1
72125,2020-12-01,9367,8306,1061,11.3
72127,2020-12-01,128700,116218,12482,9.7
72129,2020-12-01,10927,9791,1136,10.4
72131,2020-12-01,9679,8386,1293,13.4
72133,2020-12-01,8100,7262,838,10.3
72135,2020-12-01,26047,23743,2304,8.8
72137,2020-12-01,27763,25109,2654,9.6
72139,2020-12-01,25662,23621,2041,8
72141,2020-12-01,6216,5540,676,10.9
72143,2020-12-01,9412,8221,1191,12.7
72145,2020-12-01,12638,10919,1719,13.6
72147,2020-12-01,2452,2115,337,13.7
72149,2020-12-01,6824,5855,969,14.2
72151,2020-12-01,8118,7092,1026,12.6
72153,2020-12-01,9322,7956,1366,14.7
01001,2021-01-01,25730,24878,852,3.3
01003,2021-01-01,95635,92248,3387,3.5
01005,2021-01-01,8483,7918,565,6.7
01007,2021-01-01,8608,8256,352,4.1
01009,2021-01-01,24754,24153,601,2.4
01011,2021-01-01,4815,4588,227,4.7
01013,2021-01-01,8906,8317,589,6.6
01015,2021-01-01,46147,44058,2089,4.5
01017,2021-01-01,15933,15191,742,4.7
01019,2021-01-01,11523,11205,318,2.8
01021,2021-01-01,19611,18992,619,3.2
01023,2021-01-01,4618,4394,224,4.9
01025,2021-01-01,7702,7183,519,6.7
01027,2021-01-01,6113,5926,187,3.1
01029,2021-01-01,5639,5486,153,2.7
01031,2021-01-01,21357,20741,616,2.9
01033,2021-01-01,23284,22329,955,4.1
01035,2021-01-01,4443,4210,233,5.2
01037,2021-01-01,4336,4178,158,3.6
01039,2021-01-01,15082,14586,496,3.3
01041,2021-01-01,6077,5853,224,3.7
01043,2021-01-01,38555,37610,945,2.5
01045,2021-01-01,20768,19998,770,3.7
01047,2021-01-01,14298,13064,1234,8.6
01049,2021-01-01,30394,29555,839,2.8
01051,2021-01-01,36499,35313,1186,3.2
01053,2021-01-01,14284,13617,667,4.7
01055,2021-01-01,39751,37916,1835,4.6
01057,2021-01-01,6539,6321,218,3.3
01059,2021-01-01,14325,13956,369,2.6
01061,2021-01-01,10762,10450,312,2.9
01063,2021-01-01,2947,2700,247,8.4
01065,2021-01-01,5938,5510,428,7.2
01067,2021-01-01,6815,6565,250,3.7
01069,2021-01-01,46442,44571,1871,4
01071,2021-01-01,22705,22011,694,3.1
01073,2021-01-01,318213,303888,14325,4.5
01075,2021-01-01,5718,5531,187,3.3
01077,2021-01-01,41583,40201,1382,3.3
01079,2021-01-01,14386,13938,448,3.1
01081,2021-01-01,75918,73473,2445,3.2
01083,2021-01-01,45083,43944,1139,2.5
01085,2021-01-01,3635,3197,438,12
01087,2021-01-01,7966,7357,609,7.6
01089,2021-01-01,189784,184040,5744,3
01091,2021-01-01,7732,7346,386,5
01093,2021-01-01,13114,12693,421,3.2
01095,2021-01-01,44476,43302,1174,2.6
01097,2021-01-01,189440,178038,11402,6
01099,2021-01-01,7476,6966,510,6.8
01101,2021-01-01,106810,100074,6736,6.3
01103,2021-01-01,59305,57579,1726,2.9
01105,2021-01-01,3349,3035,314,9.4
01107,2021-01-01,7581,7235,346,4.6
01109,2021-01-01,15680,15102,578,3.7
01111,2021-01-01,9244,8991,253,2.7
01113,2021-01-01,23191,22399,792,3.4
01115,2021-01-01,40276,39087,1189,3
01117,2021-01-01,115062,112449,2613,2.3
01119,2021-01-01,4700,4460,240,5.1
01121,2021-01-01,36007,34401,1606,4.5
01123,2021-01-01,17570,16666,904,5.1
01125,2021-01-01,101529,97187,4342,4.3
01127,2021-01-01,24981,24002,979,3.9
01129,2021-01-01,6609,6254,355,5.4
01131,2021-01-01,2822,2474,348,12.3
01133,2021-01-01,9851,9536,315,3.2
02013,2021-01-01,2518,2450,68,2.7
02016,2021-01-01,4572,4352,220,4.8
02020,2021-01-01,149486,140034,9452,6.3
02050,2021-01-01,8090,7287,803,9.9
02060,2021-01-01,243,213,30,12.3
02068,2021-01-01,582,490,92,15.8
02070,2021-01-01,1806,1680,126,7
02090,2021-01-01,44019,41553,2466,5.6
02100,2021-01-01,919,785,134,14.6
02105,2021-01-01,983,863,120,12.2
02110,2021-01-01,16577,15676,901,5.4
02122,2021-01-01,26703,24445,2258,8.5
02130,2021-01-01,6335,5811,524,8.3
02150,2021-01-01,5780,5332,448,7.8
02158,2021-01-01,2523,2092,431,17.1
02164,2021-01-01,614,557,57,9.3
02170,2021-01-01,48188,44692,3496,7.3
02180,2021-01-01,3951,3627,324,8.2
02185,2021-01-01,2904,2720,184,6.3
02188,2021-01-01,3038,2733,305,10
02195,2021-01-01,1356,1231,125,9.2
02198,2021-01-01,2686,2464,222,8.3
02220,2021-01-01,3916,3645,271,6.9
02230,2021-01-01,543,427,116,21.4
02240,2021-01-01,2931,2714,217,7.4
02261,2021-01-01,4328,3958,370,8.5
02275,2021-01-01,979,904,75,7.7
02282,2021-01-01,239,214,25,10.5
02290,2021-01-01,2289,2049,240,10.5
04001,2021-01-01,19887,17560,2327,11.7
04003,2021-01-01,51637,48591,3046,5.9
04005,2021-01-01,73803,67301,6502,8.8
04007,2021-01-01,20792,19333,1459,7
04009,2021-01-01,16146,15157,989,6.1
04011,2021-01-01,4449,4189,260,5.8
04012,2021-01-01,9164,8606,558,6.1
04013,2021-01-01,NA,NA,154168,6.6
04015,2021-01-01,87431,80773,6658,7.6
04017,2021-01-01,39577,35984,3593,9.1
04019,2021-01-01,495480,460119,35361,7.1
04021,2021-01-01,192801,179893,12908,6.7
04023,2021-01-01,19649,17600,2049,10.4
04025,2021-01-01,107130,100724,6406,6
04027,2021-01-01,94563,83943,10620,11.2
05001,2021-01-01,9377,9013,364,3.9
05003,2021-01-01,7120,6463,657,9.2
05005,2021-01-01,16427,15632,795,4.8
05007,2021-01-01,141059,136006,5053,3.6
05009,2021-01-01,15604,14992,612,3.9
05011,2021-01-01,4376,4136,240,5.5
05013,2021-01-01,2436,2323,113,4.6
05015,2021-01-01,12265,11607,658,5.4
05017,2021-01-01,3239,2879,360,11.1
05019,2021-01-01,9212,8730,482,5.2
05021,2021-01-01,5461,5172,289,5.3
05023,2021-01-01,8966,8395,571,6.4
05025,2021-01-01,3207,3037,170,5.3
05027,2021-01-01,9112,8455,657,7.2
05029,2021-01-01,8424,7994,430,5.1
05031,2021-01-01,55588,53260,2328,4.2
05033,2021-01-01,26403,25224,1179,4.5
05035,2021-01-01,20977,19597,1380,6.6
05037,2021-01-01,7187,6788,399,5.6
05039,2021-01-01,2873,2748,125,4.4
05041,2021-01-01,5222,4876,346,6.6
05043,2021-01-01,7739,7240,499,6.4
05045,2021-01-01,61370,58615,2755,4.5
05047,2021-01-01,7442,7106,336,4.5
05049,2021-01-01,4871,4623,248,5.1
05051,2021-01-01,41242,38549,2693,6.5
05053,2021-01-01,8186,7847,339,4.1
05055,2021-01-01,19119,18237,882,4.6
05057,2021-01-01,9432,9041,391,4.1
05059,2021-01-01,14146,13468,678,4.8
05061,2021-01-01,5536,5311,225,4.1
05063,2021-01-01,16613,15789,824,5
05065,2021-01-01,4433,4112,321,7.2
05067,2021-01-01,5890,5495,395,6.7
05069,2021-01-01,27526,25400,2126,7.7
05071,2021-01-01,10206,9642,564,5.5
05073,2021-01-01,2431,2243,188,7.7
05075,2021-01-01,6820,6467,353,5.2
05077,2021-01-01,2792,2599,193,6.9
05079,2021-01-01,3844,3641,203,5.3
05081,2021-01-01,5386,5071,315,5.8
05083,2021-01-01,8669,8228,441,5.1
05085,2021-01-01,33339,31887,1452,4.4
05087,2021-01-01,7537,7258,279,3.7
05089,2021-01-01,6024,5665,359,6
05091,2021-01-01,19297,18155,1142,5.9
05093,2021-01-01,16796,15441,1355,8.1
05095,2021-01-01,2737,2557,180,6.6
05097,2021-01-01,2966,2789,177,6
05099,2021-01-01,3474,3315,159,4.6
05101,2021-01-01,3230,3099,131,4.1
05103,2021-01-01,9759,9297,462,4.7
05105,2021-01-01,4183,3977,206,4.9
05107,2021-01-01,6439,5877,562,8.7
05109,2021-01-01,4293,4072,221,5.1
05111,2021-01-01,9969,9475,494,5
05113,2021-01-01,7962,7510,452,5.7
05115,2021-01-01,27376,25982,1394,5.1
05117,2021-01-01,3629,3454,175,4.8
05119,2021-01-01,187374,175744,11630,6.2
05121,2021-01-01,7538,7145,393,5.2
05123,2021-01-01,7904,7314,590,7.5
05125,2021-01-01,57834,55510,2324,4
05127,2021-01-01,4393,4206,187,4.3
05129,2021-01-01,2762,2608,154,5.6
05131,2021-01-01,55955,53249,2706,4.8
05133,2021-01-01,5469,5158,311,5.7
05135,2021-01-01,5664,5294,370,6.5
05137,2021-01-01,4539,4216,323,7.1
05139,2021-01-01,15392,14282,1110,7.2
05141,2021-01-01,5746,5356,390,6.8
05143,2021-01-01,126992,122317,4675,3.7
05145,2021-01-01,33889,32082,1807,5.3
05147,2021-01-01,2839,2662,177,6.2
05149,2021-01-01,7970,7575,395,5
06001,2021-01-01,802211,744238,57973,7.2
06003,2021-01-01,626,583,43,6.9
06005,2021-01-01,14326,13136,1190,8.3
06007,2021-01-01,91283,83900,7383,8.1
06009,2021-01-01,21155,19683,1472,7
06011,2021-01-01,10263,8624,1639,16
06013,2021-01-01,534726,494599,40127,7.5
06015,2021-01-01,9308,8471,837,9
06017,2021-01-01,90588,84312,6276,6.9
06019,2021-01-01,441770,397030,44740,10.1
06021,2021-01-01,12247,11266,981,8
06023,2021-01-01,58781,54438,4343,7.4
06025,2021-01-01,65235,54477,10758,16.5
06027,2021-01-01,8273,7702,571,6.9
06029,2021-01-01,380003,338811,41192,10.8
06031,2021-01-01,55165,49166,5999,10.9
06033,2021-01-01,28655,26096,2559,8.9
06035,2021-01-01,9453,8795,658,7
06037,2021-01-01,NA,NA,625882,12.7
06039,2021-01-01,62645,56537,6108,9.8
06041,2021-01-01,128702,121734,6968,5.4
06043,2021-01-01,6764,5950,814,12
06045,2021-01-01,36212,33411,2801,7.7
06047,2021-01-01,113923,100741,13182,11.6
06049,2021-01-01,3122,2828,294,9.4
06051,2021-01-01,8580,7811,769,9
06053,2021-01-01,203073,179754,23319,11.5
06055,2021-01-01,66891,60978,5913,8.8
06057,2021-01-01,46758,43622,3136,6.7
06059,2021-01-01,NA,NA,111317,7.3
06061,2021-01-01,184451,173448,11003,6
06063,2021-01-01,7093,6242,851,12
06065,2021-01-01,NA,NA,94804,8.6
06067,2021-01-01,706871,649341,57530,8.1
06069,2021-01-01,30872,28115,2757,8.9
06071,2021-01-01,969831,886440,83391,8.6
06073,2021-01-01,NA,NA,121725,8
06075,2021-01-01,536339,503122,33217,6.2
06077,2021-01-01,329776,296796,32980,10
06079,2021-01-01,130694,121816,8878,6.8
06081,2021-01-01,420868,396999,23869,5.7
06083,2021-01-01,210930,194568,16362,7.8
06085,2021-01-01,NA,946970,57033,5.7
06087,2021-01-01,128453,117233,11220,8.7
06089,2021-01-01,73402,67599,5803,7.9
06091,2021-01-01,1262,1166,96,7.6
06093,2021-01-01,16500,14869,1631,9.9
06095,2021-01-01,201154,183825,17329,8.6
06097,2021-01-01,235834,219047,16787,7.1
06099,2021-01-01,237319,214973,22346,9.4
06101,2021-01-01,43156,38657,4499,10.4
06103,2021-01-01,25224,23187,2037,8.1
06105,2021-01-01,4404,4060,344,7.8
06107,2021-01-01,195456,173069,22387,11.5
06109,2021-01-01,19807,17981,1826,9.2
06111,2021-01-01,402587,372634,29953,7.4
06113,2021-01-01,104977,97610,7367,7
06115,2021-01-01,28990,26064,2926,10.1
08001,2021-01-01,278740,257013,21727,7.8
08003,2021-01-01,8458,7857,601,7.1
08005,2021-01-01,370610,343940,26670,7.2
08007,2021-01-01,7207,6730,477,6.6
08009,2021-01-01,2279,2213,66,2.9
08011,2021-01-01,1976,1825,151,7.6
08013,2021-01-01,193636,182085,11551,6
08014,2021-01-01,40674,38213,2461,6.1
08015,2021-01-01,9944,9388,556,5.6
08017,2021-01-01,1144,1111,33,2.9
08019,2021-01-01,6170,5732,438,7.1
08021,2021-01-01,4126,3862,264,6.4
08023,2021-01-01,1851,1704,147,7.9
08025,2021-01-01,1561,1463,98,6.3
08027,2021-01-01,2124,2011,113,5.3
08029,2021-01-01,14528,13502,1026,7.1
08031,2021-01-01,428764,395824,32940,7.7
08033,2021-01-01,1142,1074,68,6
08035,2021-01-01,197324,186663,10661,5.4
08037,2021-01-01,37760,35623,2137,5.7
08039,2021-01-01,15265,14567,698,4.6
08041,2021-01-01,348668,323686,24982,7.2
08043,2021-01-01,15699,14418,1281,8.2
08045,2021-01-01,33461,31392,2069,6.2
08047,2021-01-01,3945,3625,320,8.1
08049,2021-01-01,10028,9477,551,5.5
08051,2021-01-01,11619,11057,562,4.8
08053,2021-01-01,385,364,21,5.5
08055,2021-01-01,2741,2466,275,10
08057,2021-01-01,912,876,36,3.9
08059,2021-01-01,338083,315613,22470,6.6
08061,2021-01-01,1024,988,36,3.5
08063,2021-01-01,4438,4302,136,3.1
08065,2021-01-01,5154,4864,290,5.6
08067,2021-01-01,32076,29606,2470,7.7
08069,2021-01-01,207051,193868,13183,6.4
08071,2021-01-01,6643,6120,523,7.9
08073,2021-01-01,2461,2333,128,5.2
08075,2021-01-01,11300,10681,619,5.5
08077,2021-01-01,76403,70278,6125,8
08079,2021-01-01,548,525,23,4.2
08081,2021-01-01,7557,7090,467,6.2
08083,2021-01-01,12706,11721,985,7.8
08085,2021-01-01,21996,20552,1444,6.6
08087,2021-01-01,16708,15731,977,5.8
08089,2021-01-01,8456,7849,607,7.2
08091,2021-01-01,2499,2336,163,6.5
08093,2021-01-01,11249,10686,563,5
08095,2021-01-01,2544,2456,88,3.5
08097,2021-01-01,11452,10676,776,6.8
08099,2021-01-01,6342,5993,349,5.5
08101,2021-01-01,78782,71476,7306,9.3
08103,2021-01-01,3003,2798,205,6.8
08105,2021-01-01,5592,5168,424,7.6
08107,2021-01-01,17377,16483,894,5.1
08109,2021-01-01,3476,3213,263,7.6
08111,2021-01-01,464,438,26,5.6
08113,2021-01-01,5619,5272,347,6.2
08115,2021-01-01,1185,1143,42,3.5
08117,2021-01-01,25307,24028,1279,5.1
08119,2021-01-01,13055,12194,861,6.6
08121,2021-01-01,3073,2969,104,3.4
08123,2021-01-01,169322,157205,12117,7.2
08125,2021-01-01,5735,5548,187,3.3
09001,2021-01-01,451971,413574,38397,8.5
09003,2021-01-01,463577,423586,39991,8.6
09005,2021-01-01,100178,92219,7959,7.9
09007,2021-01-01,90228,83737,6491,7.2
09009,2021-01-01,446678,408167,38511,8.6
09011,2021-01-01,126956,115047,11909,9.4
09013,2021-01-01,82639,76918,5721,6.9
09015,2021-01-01,60753,55569,5184,8.5
10001,2021-01-01,79997,74319,5678,7.1
10003,2021-01-01,300912,281896,19016,6.3
10005,2021-01-01,106666,100069,6597,6.2
11001,2021-01-01,407077,374869,32208,7.9
12001,2021-01-01,137195,132046,5149,3.8
12003,2021-01-01,11922,11521,401,3.4
12005,2021-01-01,82699,79208,3491,4.2
12007,2021-01-01,10928,10502,426,3.9
12009,2021-01-01,284096,271695,12401,4.4
12011,2021-01-01,NA,953521,59226,5.8
12013,2021-01-01,4827,4650,177,3.7
12015,2021-01-01,71603,68489,3114,4.3
12017,2021-01-01,46413,43821,2592,5.6
12019,2021-01-01,106604,102984,3620,3.4
12021,2021-01-01,185331,178440,6891,3.7
12023,2021-01-01,30023,28717,1306,4.3
12027,2021-01-01,15248,14731,517,3.4
12029,2021-01-01,6104,5854,250,4.1
12031,2021-01-01,488696,466527,22169,4.5
12033,2021-01-01,146037,139509,6528,4.5
12035,2021-01-01,46652,44378,2274,4.9
12037,2021-01-01,4772,4592,180,3.8
12039,2021-01-01,18748,17716,1032,5.5
12041,2021-01-01,7157,6894,263,3.7
12043,2021-01-01,5419,5228,191,3.5
12045,2021-01-01,5026,4815,211,4.2
12047,2021-01-01,4150,3900,250,6
12049,2021-01-01,8866,8478,388,4.4
12051,2021-01-01,16543,15722,821,5
12053,2021-01-01,71664,67978,3686,5.1
12055,2021-01-01,35197,33124,2073,5.9
12057,2021-01-01,759892,725631,34261,4.5
12059,2021-01-01,6868,6618,250,3.6
12061,2021-01-01,64602,61590,3012,4.7
12063,2021-01-01,17462,16706,756,4.3
12065,2021-01-01,5411,5196,215,4
12067,2021-01-01,2836,2740,96,3.4
12069,2021-01-01,147516,139722,7794,5.3
12071,2021-01-01,346109,330897,15212,4.4
12073,2021-01-01,152355,145768,6587,4.3
12075,2021-01-01,16953,16240,713,4.2
12077,2021-01-01,2615,2522,93,3.6
12079,2021-01-01,7727,7362,365,4.7
12081,2021-01-01,178178,171011,7167,4
12083,2021-01-01,140660,133988,6672,4.7
12085,2021-01-01,72674,70028,2646,3.6
12086,2021-01-01,NA,NA,104836,8.1
12087,2021-01-01,45555,43864,1691,3.7
12089,2021-01-01,41675,40192,1483,3.6
12091,2021-01-01,96417,93077,3340,3.5
12093,2021-01-01,17528,16855,673,3.8
12095,2021-01-01,703261,654809,48452,6.9
12097,2021-01-01,174235,159553,14682,8.4
12099,2021-01-01,725399,690565,34834,4.8
12101,2021-01-01,239225,228280,10945,4.6
12103,2021-01-01,486094,465113,20981,4.3
12105,2021-01-01,317588,299723,17865,5.6
12107,2021-01-01,26705,25177,1528,5.7
12109,2021-01-01,134923,130705,4218,3.1
12111,2021-01-01,145511,138023,7488,5.1
12113,2021-01-01,83630,80847,2783,3.3
12115,2021-01-01,186119,178536,7583,4.1
12117,2021-01-01,230338,219499,10839,4.7
12119,2021-01-01,31661,30092,1569,5
12121,2021-01-01,17703,16984,719,4.1
12123,2021-01-01,8110,7689,421,5.2
12125,2021-01-01,4543,4388,155,3.4
12127,2021-01-01,250117,237834,12283,4.9
12129,2021-01-01,15066,14616,450,3
12131,2021-01-01,32123,30966,1157,3.6
12133,2021-01-01,9488,9091,397,4.2
13001,2021-01-01,9522,9131,391,4.1
13003,2021-01-01,4766,4616,150,3.1
13005,2021-01-01,4797,4600,197,4.1
13007,2021-01-01,1221,1156,65,5.3
13009,2021-01-01,17669,16569,1100,6.2
13011,2021-01-01,10208,9904,304,3
13013,2021-01-01,40352,38893,1459,3.6
13015,2021-01-01,50077,47693,2384,4.8
13017,2021-01-01,5507,5116,391,7.1
13019,2021-01-01,7723,7388,335,4.3
13021,2021-01-01,68138,63654,4484,6.6
13023,2021-01-01,4565,4295,270,5.9
13025,2021-01-01,7188,6876,312,4.3
13027,2021-01-01,7207,6880,327,4.5
13029,2021-01-01,19112,18428,684,3.6
13031,2021-01-01,37767,35797,1970,5.2
13033,2021-01-01,9302,8701,601,6.5
13035,2021-01-01,10891,10313,578,5.3
13037,2021-01-01,2430,2324,106,4.4
13039,2021-01-01,21536,20730,806,3.7
13043,2021-01-01,5810,5577,233,4
13045,2021-01-01,54830,52166,2664,4.9
13047,2021-01-01,32720,31767,953,2.9
13049,2021-01-01,4995,4828,167,3.3
13051,2021-01-01,142969,134898,8071,5.6
13053,2021-01-01,2014,1907,107,5.3
13055,2021-01-01,9754,9104,650,6.7
13057,2021-01-01,133490,129132,4358,3.3
13059,2021-01-01,58473,55613,2860,4.9
13061,2021-01-01,929,824,105,11.3
13063,2021-01-01,140129,128049,12080,8.6
13065,2021-01-01,3087,2992,95,3.1
13067,2021-01-01,415354,397755,17599,4.2
13069,2021-01-01,19296,18297,999,5.2
13071,2021-01-01,22978,22100,878,3.8
13073,2021-01-01,75401,73117,2284,3
13075,2021-01-01,8346,8004,342,4.1
13077,2021-01-01,74037,70901,3136,4.2
13079,2021-01-01,5621,5369,252,4.5
13081,2021-01-01,9758,9006,752,7.7
13083,2021-01-01,7920,7673,247,3.1
13085,2021-01-01,12414,12007,407,3.3
13087,2021-01-01,11709,11201,508,4.3
13089,2021-01-01,395587,371499,24088,6.1
13091,2021-01-01,7000,6640,360,5.1
13093,2021-01-01,5057,4732,325,6.4
13095,2021-01-01,37590,34583,3007,8
13097,2021-01-01,72347,68274,4073,5.6
13099,2021-01-01,4589,4323,266,5.8
13101,2021-01-01,2035,1973,62,3
13103,2021-01-01,32213,31011,1202,3.7
13105,2021-01-01,8032,7565,467,5.8
13107,2021-01-01,8800,8215,585,6.6
13109,2021-01-01,5180,4947,233,4.5
13111,2021-01-01,11252,10874,378,3.4
13113,2021-01-01,56541,54499,2042,3.6
13115,2021-01-01,43876,41793,2083,4.7
13117,2021-01-01,121470,117840,3630,3
13119,2021-01-01,10088,9656,432,4.3
13121,2021-01-01,557307,523240,34067,6.1
13123,2021-01-01,12052,11619,433,3.6
13125,2021-01-01,1271,1237,34,2.7
13127,2021-01-01,38474,36595,1879,4.9
13129,2021-01-01,28983,27779,1204,4.2
13131,2021-01-01,11075,10670,405,3.7
13133,2021-01-01,7080,6727,353,5
13135,2021-01-01,481408,459938,21470,4.5
13137,2021-01-01,18646,17797,849,4.6
13139,2021-01-01,103127,99730,3397,3.3
13141,2021-01-01,2623,2411,212,8.1
13143,2021-01-01,12302,11761,541,4.4
13145,2021-01-01,16573,16008,565,3.4
13147,2021-01-01,11691,11164,527,4.5
13149,2021-01-01,5185,4921,264,5.1
13151,2021-01-01,115507,109118,6389,5.5
13153,2021-01-01,71242,68230,3012,4.2
13155,2021-01-01,3619,3441,178,4.9
13157,2021-01-01,41423,40191,1232,3
13159,2021-01-01,6893,6597,296,4.3
13161,2021-01-01,6276,5980,296,4.7
13163,2021-01-01,6811,6402,409,6
13165,2021-01-01,3280,3096,184,5.6
13167,2021-01-01,4204,4025,179,4.3
13169,2021-01-01,13561,13059,502,3.7
13171,2021-01-01,8049,7623,426,5.3
13173,2021-01-01,3815,3648,167,4.4
13175,2021-01-01,20032,18968,1064,5.3
13177,2021-01-01,14685,14144,541,3.7
13179,2021-01-01,26053,24720,1333,5.1
13181,2021-01-01,3626,3454,172,4.7
13183,2021-01-01,8348,8064,284,3.4
13185,2021-01-01,52620,49905,2715,5.2
13187,2021-01-01,16424,15856,568,3.5
13189,2021-01-01,8823,8241,582,6.6
13191,2021-01-01,6128,5860,268,4.4
13193,2021-01-01,4830,4506,324,6.7
13195,2021-01-01,13065,12572,493,3.8
13197,2021-01-01,3224,3082,142,4.4
13199,2021-01-01,8906,8276,630,7.1
13201,2021-01-01,2888,2785,103,3.6
13205,2021-01-01,8538,8019,519,6.1
13207,2021-01-01,12877,12352,525,4.1
13209,2021-01-01,4036,3840,196,4.9
13211,2021-01-01,9310,8921,389,4.2
13213,2021-01-01,15605,14691,914,5.9
13215,2021-01-01,77058,71951,5107,6.6
13217,2021-01-01,52204,49286,2918,5.6
13219,2021-01-01,19395,18891,504,2.6
13221,2021-01-01,6927,6681,246,3.6
13223,2021-01-01,85802,82481,3321,3.9
13225,2021-01-01,12153,11444,709,5.8
13227,2021-01-01,15034,14505,529,3.5
13229,2021-01-01,8718,8398,320,3.7
13231,2021-01-01,8777,8470,307,3.5
13233,2021-01-01,18534,17668,866,4.7
13235,2021-01-01,4103,3930,173,4.2
13237,2021-01-01,8254,7816,438,5.3
13239,2021-01-01,811,765,46,5.7
13241,2021-01-01,7089,6796,293,4.1
13243,2021-01-01,2563,2417,146,5.7
13245,2021-01-01,86188,80709,5479,6.4
13247,2021-01-01,44125,41490,2635,6
13249,2021-01-01,2178,2083,95,4.4
13251,2021-01-01,5191,4822,369,7.1
13253,2021-01-01,3173,3036,137,4.3
13255,2021-01-01,28612,26737,1875,6.6
13257,2021-01-01,10382,9850,532,5.1
13259,2021-01-01,2588,2464,124,4.8
13261,2021-01-01,12754,11820,934,7.3
13263,2021-01-01,2783,2617,166,6
13265,2021-01-01,535,500,35,6.5
13267,2021-01-01,9954,9567,387,3.9
13269,2021-01-01,2775,2591,184,6.6
13271,2021-01-01,3871,3527,344,8.9
13273,2021-01-01,3536,3266,270,7.6
13275,2021-01-01,17116,16189,927,5.4
13277,2021-01-01,21359,20441,918,4.3
13279,2021-01-01,12448,11755,693,5.6
13281,2021-01-01,3726,3545,181,4.9
13283,2021-01-01,2831,2697,134,4.7
13285,2021-01-01,38002,35795,2207,5.8
13287,2021-01-01,3423,3178,245,7.2
13289,2021-01-01,2829,2650,179,6.3
13291,2021-01-01,10617,10277,340,3.2
13293,2021-01-01,11470,10858,612,5.3
13295,2021-01-01,30823,29717,1106,3.6
13297,2021-01-01,45185,43409,1776,3.9
13299,2021-01-01,15627,14912,715,4.6
13301,2021-01-01,2738,2564,174,6.4
13303,2021-01-01,6950,6532,418,6
13305,2021-01-01,11781,11221,560,4.8
13307,2021-01-01,1038,980,58,5.6
13309,2021-01-01,1671,1562,109,6.5
13311,2021-01-01,16396,15843,553,3.4
13313,2021-01-01,43782,41402,2380,5.4
13315,2021-01-01,2870,2713,157,5.5
13317,2021-01-01,3787,3554,233,6.2
13319,2021-01-01,3879,3678,201,5.2
13321,2021-01-01,8954,8510,444,5
15001,2021-01-01,89537,80908,8629,9.6
15003,2021-01-01,450631,410660,39971,8.9
15007,2021-01-01,33736,28794,4942,14.6
15009,2021-01-01,81659,70372,11287,13.8
16001,2021-01-01,260474,250201,10273,3.9
16003,2021-01-01,1716,1574,142,8.3
16005,2021-01-01,43223,41394,1829,4.2
16007,2021-01-01,3068,2947,121,3.9
16009,2021-01-01,4128,3857,271,6.6
16011,2021-01-01,23453,22564,889,3.8
16013,2021-01-01,12844,12302,542,4.2
16015,2021-01-01,3643,3403,240,6.6
16017,2021-01-01,21586,20251,1335,6.2
16019,2021-01-01,59553,57443,2110,3.5
16021,2021-01-01,5417,5091,326,6
16023,2021-01-01,1406,1347,59,4.2
16025,2021-01-01,683,653,30,4.4
16027,2021-01-01,106743,101371,5372,5
16029,2021-01-01,4060,3896,164,4
16031,2021-01-01,12286,11862,424,3.5
16033,2021-01-01,353,340,13,3.7
16035,2021-01-01,2985,2770,215,7.2
16037,2021-01-01,2063,1918,145,7
16039,2021-01-01,12009,11474,535,4.5
16041,2021-01-01,6965,6741,224,3.2
16043,2021-01-01,7936,7631,305,3.8
16045,2021-01-01,8466,8017,449,5.3
16047,2021-01-01,8305,7957,348,4.2
16049,2021-01-01,6648,6240,408,6.1
16051,2021-01-01,14314,13834,480,3.4
16053,2021-01-01,12170,11658,512,4.2
16055,2021-01-01,81383,76757,4626,5.7
16057,2021-01-01,20303,19501,802,4
16059,2021-01-01,3536,3300,236,6.7
16061,2021-01-01,1599,1484,115,7.2
16063,2021-01-01,2741,2574,167,6.1
16065,2021-01-01,22936,22338,598,2.6
16067,2021-01-01,11548,11076,472,4.1
16069,2021-01-01,20706,19863,843,4.1
16071,2021-01-01,2310,2227,83,3.6
16073,2021-01-01,5260,4943,317,6
16075,2021-01-01,11914,11316,598,5
16077,2021-01-01,3948,3739,209,5.3
16079,2021-01-01,5698,5257,441,7.7
16081,2021-01-01,6338,6088,250,3.9
16083,2021-01-01,41128,39349,1779,4.3
16085,2021-01-01,5833,5470,363,6.2
16087,2021-01-01,4748,4518,230,4.8
17001,2021-01-01,30648,28988,1660,5.4
17003,2021-01-01,1903,1720,183,9.6
17005,2021-01-01,7293,6858,435,6
17007,2021-01-01,24946,21974,2972,11.9
17009,2021-01-01,2914,2822,92,3.2
17011,2021-01-01,15684,14541,1143,7.3
17013,2021-01-01,2169,2028,141,6.5
17015,2021-01-01,6986,6541,445,6.4
17017,2021-01-01,5607,5253,354,6.3
17019,2021-01-01,104881,98189,6692,6.4
17021,2021-01-01,13133,12165,968,7.4
17023,2021-01-01,7077,6581,496,7
17025,2021-01-01,5802,5380,422,7.3
17027,2021-01-01,19328,18433,895,4.6
17029,2021-01-01,22889,21393,1496,6.5
17031,2021-01-01,NA,NA,243157,9.8
17033,2021-01-01,8337,7784,553,6.6
17035,2021-01-01,5837,5515,322,5.5
17037,2021-01-01,51402,47492,3910,7.6
17039,2021-01-01,6913,6429,484,7
17041,2021-01-01,9688,9221,467,4.8
17043,2021-01-01,473451,441328,32123,6.8
17045,2021-01-01,8513,8087,426,5
17047,2021-01-01,2599,2440,159,6.1
17049,2021-01-01,19230,18232,998,5.2
17051,2021-01-01,9566,8887,679,7.1
17053,2021-01-01,5880,5507,373,6.3
17055,2021-01-01,15291,14088,1203,7.9
17057,2021-01-01,14024,12892,1132,8.1
17059,2021-01-01,1911,1765,146,7.6
17061,2021-01-01,5730,5373,357,6.2
17063,2021-01-01,23840,21855,1985,8.3
17065,2021-01-01,4085,3860,225,5.5
17067,2021-01-01,7649,7174,475,6.2
17069,2021-01-01,1286,1183,103,8
17071,2021-01-01,3390,3189,201,5.9
17073,2021-01-01,23275,21656,1619,7
17075,2021-01-01,12798,11946,852,6.7
17077,2021-01-01,26317,24501,1816,6.9
17079,2021-01-01,4611,4343,268,5.8
17081,2021-01-01,16554,15320,1234,7.5
17083,2021-01-01,10431,9810,621,6
17085,2021-01-01,9945,9265,680,6.8
17087,2021-01-01,4017,3707,310,7.7
17089,2021-01-01,253636,232624,21012,8.3
17091,2021-01-01,51920,47416,4504,8.7
17093,2021-01-01,64816,60190,4626,7.1
17095,2021-01-01,20323,18541,1782,8.8
17097,2021-01-01,356816,329722,27094,7.6
17099,2021-01-01,51666,47263,4403,8.5
17101,2021-01-01,5739,5305,434,7.6
17103,2021-01-01,16840,15787,1053,6.3
17105,2021-01-01,15192,14168,1024,6.7
17107,2021-01-01,11862,11101,761,6.4
17109,2021-01-01,12471,11636,835,6.7
17111,2021-01-01,155039,143567,11472,7.4
17113,2021-01-01,82635,77487,5148,6.2
17115,2021-01-01,46075,41481,4594,10
17117,2021-01-01,21707,20365,1342,6.2
17119,2021-01-01,129089,120933,8156,6.3
17121,2021-01-01,16501,15319,1182,7.2
17123,2021-01-01,4928,4528,400,8.1
17125,2021-01-01,5664,5231,433,7.6
17127,2021-01-01,5290,4860,430,8.1
17129,2021-01-01,5912,5554,358,6.1
17131,2021-01-01,7447,6900,547,7.3
17133,2021-01-01,18036,17285,751,4.2
17135,2021-01-01,11001,10173,828,7.5
17137,2021-01-01,15433,14384,1049,6.8
17139,2021-01-01,7170,6814,356,5
17141,2021-01-01,23497,21617,1880,8
17143,2021-01-01,80966,73247,7719,9.5
17145,2021-01-01,7761,7234,527,6.8
17147,2021-01-01,8100,7647,453,5.6
17149,2021-01-01,6379,6028,351,5.5
17151,2021-01-01,1628,1518,110,6.8
17153,2021-01-01,1735,1533,202,11.6
17155,2021-01-01,2904,2696,208,7.2
17157,2021-01-01,13436,12679,757,5.6
17159,2021-01-01,7104,6717,387,5.4
17161,2021-01-01,67149,61871,5278,7.9
17163,2021-01-01,122972,113589,9383,7.6
17165,2021-01-01,9203,8466,737,8
17167,2021-01-01,94337,87073,7264,7.7
17169,2021-01-01,2965,2795,170,5.7
17171,2021-01-01,2275,2100,175,7.7
17173,2021-01-01,9869,9311,558,5.7
17175,2021-01-01,2274,2095,179,7.9
17177,2021-01-01,20368,18828,1540,7.6
17179,2021-01-01,59629,55454,4175,7
17181,2021-01-01,6890,6365,525,7.6
17183,2021-01-01,31977,29417,2560,8
17185,2021-01-01,5434,5116,318,5.9
17187,2021-01-01,7729,7254,475,6.1
17189,2021-01-01,9522,9139,383,4
17191,2021-01-01,6362,5985,377,5.9
17193,2021-01-01,5863,5528,335,5.7
17195,2021-01-01,27093,25329,1764,6.5
17197,2021-01-01,337072,308600,28472,8.4
17199,2021-01-01,30197,28111,2086,6.9
17201,2021-01-01,131044,116656,14388,11
17203,2021-01-01,17404,16420,984,5.7
18001,2021-01-01,17038,16581,457,2.7
18003,2021-01-01,187806,179055,8751,4.7
18005,2021-01-01,44088,42427,1661,3.8
18007,2021-01-01,4389,4218,171,3.9
18009,2021-01-01,4843,4620,223,4.6
18011,2021-01-01,36304,35292,1012,2.8
18013,2021-01-01,7691,7332,359,4.7
18015,2021-01-01,9791,9437,354,3.6
18017,2021-01-01,17504,16728,776,4.4
18019,2021-01-01,61093,58470,2623,4.3
18021,2021-01-01,11505,10884,621,5.4
18023,2021-01-01,17127,16482,645,3.8
18025,2021-01-01,4905,4638,267,5.4
18027,2021-01-01,16947,16450,497,2.9
18029,2021-01-01,25159,24084,1075,4.3
18031,2021-01-01,15097,14534,563,3.7
18033,2021-01-01,22215,21448,767,3.5
18035,2021-01-01,53296,50630,2666,5
18037,2021-01-01,22893,22058,835,3.6
18039,2021-01-01,114363,110311,4052,3.5
18041,2021-01-01,8369,7883,486,5.8
18043,2021-01-01,41189,39608,1581,3.8
18045,2021-01-01,7789,7486,303,3.9
18047,2021-01-01,11375,10965,410,3.6
18049,2021-01-01,9606,9148,458,4.8
18051,2021-01-01,19861,19222,639,3.2
18053,2021-01-01,30683,29253,1430,4.7
18055,2021-01-01,13433,12786,647,4.8
18057,2021-01-01,185657,180327,5330,2.9
18059,2021-01-01,40820,39408,1412,3.5
18061,2021-01-01,19931,19219,712,3.6
18063,2021-01-01,90687,87693,2994,3.3
18065,2021-01-01,21905,20932,973,4.4
18067,2021-01-01,35080,32945,2135,6.1
18069,2021-01-01,18127,17484,643,3.5
18071,2021-01-01,23697,22824,873,3.7
18073,2021-01-01,15534,14811,723,4.7
18075,2021-01-01,8764,8443,321,3.7
18077,2021-01-01,15342,14692,650,4.2
18079,2021-01-01,13729,13034,695,5.1
18081,2021-01-01,83223,80352,2871,3.4
18083,2021-01-01,18414,17709,705,3.8
18085,2021-01-01,41176,39692,1484,3.6
18087,2021-01-01,19422,18908,514,2.6
18089,2021-01-01,222089,205495,16594,7.5
18091,2021-01-01,47429,44182,3247,6.8
18093,2021-01-01,20523,19551,972,4.7
18095,2021-01-01,59274,56005,3269,5.5
18097,2021-01-01,501505,471358,30147,6
18099,2021-01-01,22680,21817,863,3.8
18101,2021-01-01,5577,5388,189,3.4
18103,2021-01-01,14795,14058,737,5
18105,2021-01-01,67435,64700,2735,4.1
18107,2021-01-01,18585,17910,675,3.6
18109,2021-01-01,36253,34886,1367,3.8
18111,2021-01-01,6614,6296,318,4.8
18113,2021-01-01,22476,21517,959,4.3
18115,2021-01-01,3113,2997,116,3.7
18117,2021-01-01,8592,8086,506,5.9
18119,2021-01-01,9000,8525,475,5.3
18121,2021-01-01,6844,6571,273,4
18123,2021-01-01,9236,8811,425,4.6
18125,2021-01-01,6393,6100,293,4.6
18127,2021-01-01,82763,78597,4166,5
18129,2021-01-01,12826,12396,430,3.4
18131,2021-01-01,6482,6228,254,3.9
18133,2021-01-01,16613,15867,746,4.5
18135,2021-01-01,11129,10639,490,4.4
18137,2021-01-01,13831,13333,498,3.6
18139,2021-01-01,8821,8481,340,3.9
18141,2021-01-01,132904,125445,7459,5.6
18143,2021-01-01,10407,9901,506,4.9
18145,2021-01-01,23102,22195,907,3.9
18147,2021-01-01,10049,9615,434,4.3
18149,2021-01-01,9725,9159,566,5.8
18151,2021-01-01,19968,19256,712,3.6
18153,2021-01-01,7878,7494,384,4.9
18155,2021-01-01,4696,4457,239,5.1
18157,2021-01-01,95050,91036,4014,4.2
18159,2021-01-01,9062,8775,287,3.2
18161,2021-01-01,3457,3345,112,3.2
18163,2021-01-01,90277,85962,4315,4.8
18165,2021-01-01,6572,6216,356,5.4
18167,2021-01-01,45430,42866,2564,5.6
18169,2021-01-01,14414,13868,546,3.8
18171,2021-01-01,4034,3901,133,3.3
18173,2021-01-01,31438,30309,1129,3.6
18175,2021-01-01,13586,12998,588,4.3
18177,2021-01-01,29963,28591,1372,4.6
18179,2021-01-01,14369,13887,482,3.4
18181,2021-01-01,13401,12944,457,3.4
18183,2021-01-01,17534,16932,602,3.4
19001,2021-01-01,4220,4070,150,3.6
19003,2021-01-01,2018,1948,70,3.5
19005,2021-01-01,7109,6658,451,6.3
19007,2021-01-01,5970,5683,287,4.8
19009,2021-01-01,3094,2988,106,3.4
19011,2021-01-01,12724,12079,645,5.1
19013,2021-01-01,64215,60826,3389,5.3
19015,2021-01-01,14018,13483,535,3.8
19017,2021-01-01,13111,12641,470,3.6
19019,2021-01-01,10933,10447,486,4.4
19021,2021-01-01,11729,11326,403,3.4
19023,2021-01-01,7629,7270,359,4.7
19025,2021-01-01,4125,3958,167,4
19027,2021-01-01,10496,10155,341,3.2
19029,2021-01-01,6789,6490,299,4.4
19031,2021-01-01,10261,9773,488,4.8
19033,2021-01-01,22544,21512,1032,4.6
19035,2021-01-01,6286,6060,226,3.6
19037,2021-01-01,6274,6010,264,4.2
19039,2021-01-01,4827,4564,263,5.4
19041,2021-01-01,8228,7902,326,4
19043,2021-01-01,9635,8929,706,7.3
19045,2021-01-01,21274,20011,1263,5.9
19047,2021-01-01,8004,7502,502,6.3
19049,2021-01-01,48524,46974,1550,3.2
19051,2021-01-01,4112,3953,159,3.9
19053,2021-01-01,4342,4202,140,3.2
19055,2021-01-01,10420,9993,427,4.1
19057,2021-01-01,17911,16734,1177,6.6
19059,2021-01-01,9093,8575,518,5.7
19061,2021-01-01,53475,50676,2799,5.2
19063,2021-01-01,4906,4674,232,4.7
19065,2021-01-01,10378,9762,616,5.9
19067,2021-01-01,8235,7825,410,5
19069,2021-01-01,5618,5383,235,4.2
19071,2021-01-01,3722,3612,110,3
19073,2021-01-01,5352,5181,171,3.2
19075,2021-01-01,6202,5944,258,4.2
19077,2021-01-01,5467,5191,276,5
19079,2021-01-01,6666,6362,304,4.6
19081,2021-01-01,5744,5538,206,3.6
19083,2021-01-01,7751,7350,401,5.2
19085,2021-01-01,7093,6794,299,4.2
19087,2021-01-01,9518,9090,428,4.5
19089,2021-01-01,5101,4839,262,5.1
19091,2021-01-01,4904,4718,186,3.8
19093,2021-01-01,3995,3835,160,4
19095,2021-01-01,9839,9405,434,4.4
19097,2021-01-01,10420,9742,678,6.5
19099,2021-01-01,18695,17783,912,4.9
19101,2021-01-01,9363,8930,433,4.6
19103,2021-01-01,80361,77138,3223,4
19105,2021-01-01,10157,9578,579,5.7
19107,2021-01-01,5158,4897,261,5.1
19109,2021-01-01,8072,7791,281,3.5
19111,2021-01-01,15305,14327,978,6.4
19113,2021-01-01,114281,108036,6245,5.5
19115,2021-01-01,5996,5674,322,5.4
19117,2021-01-01,4721,4555,166,3.5
19119,2021-01-01,6906,6720,186,2.7
19121,2021-01-01,8285,7814,471,5.7
19123,2021-01-01,11619,11146,473,4.1
19125,2021-01-01,17536,16893,643,3.7
19127,2021-01-01,17368,15876,1492,8.6
19129,2021-01-01,7095,6846,249,3.5
19131,2021-01-01,5942,5751,191,3.2
19133,2021-01-01,4380,4147,233,5.3
19135,2021-01-01,3914,3728,186,4.8
19137,2021-01-01,4848,4649,199,4.1
19139,2021-01-01,20257,19004,1253,6.2
19141,2021-01-01,8028,7763,265,3.3
19143,2021-01-01,3582,3485,97,2.7
19145,2021-01-01,6165,5912,253,4.1
19147,2021-01-01,4448,4277,171,3.8
19149,2021-01-01,14114,13645,469,3.3
19151,2021-01-01,4108,3968,140,3.4
19153,2021-01-01,257810,244665,13145,5.1
19155,2021-01-01,46309,44194,2115,4.6
19157,2021-01-01,9219,8755,464,5
19159,2021-01-01,2430,2339,91,3.7
19161,2021-01-01,5210,5012,198,3.8
19163,2021-01-01,83618,78441,5177,6.2
19165,2021-01-01,6231,6016,215,3.5
19167,2021-01-01,21130,20493,637,3
19169,2021-01-01,52839,51153,1686,3.2
19171,2021-01-01,9146,8590,556,6.1
19173,2021-01-01,3088,2985,103,3.3
19175,2021-01-01,6123,5783,340,5.6
19177,2021-01-01,3650,3479,171,4.7
19179,2021-01-01,17039,16113,926,5.4
19181,2021-01-01,27070,25905,1165,4.3
19183,2021-01-01,11368,10824,544,4.8
19185,2021-01-01,2842,2721,121,4.3
19187,2021-01-01,18103,17220,883,4.9
19189,2021-01-01,4890,4681,209,4.3
19191,2021-01-01,10880,10253,627,5.8
19193,2021-01-01,52805,50248,2557,4.8
19195,2021-01-01,4026,3835,191,4.7
19197,2021-01-01,6859,6569,290,4.2
20001,2021-01-01,6382,6099,283,4.4
20003,2021-01-01,4292,4160,132,3.1
20005,2021-01-01,6868,6448,420,6.1
20007,2021-01-01,2380,2263,117,4.9
20009,2021-01-01,13538,12945,593,4.4
20011,2021-01-01,6786,6454,332,4.9
20013,2021-01-01,5265,5048,217,4.1
20015,2021-01-01,32829,30908,1921,5.9
20017,2021-01-01,1431,1368,63,4.4
20019,2021-01-01,1499,1421,78,5.2
20021,2021-01-01,10039,9718,321,3.2
20023,2021-01-01,1359,1329,30,2.2
20025,2021-01-01,1196,1167,29,2.4
20027,2021-01-01,3884,3706,178,4.6
20029,2021-01-01,3988,3784,204,5.1
20031,2021-01-01,3870,3706,164,4.2
20033,2021-01-01,857,824,33,3.9
20035,2021-01-01,16491,15734,757,4.6
20037,2021-01-01,19060,18189,871,4.6
20039,2021-01-01,1247,1193,54,4.3
20041,2021-01-01,8902,8481,421,4.7
20043,2021-01-01,4153,4019,134,3.2
20045,2021-01-01,64498,60571,3927,6.1
20047,2021-01-01,1589,1494,95,6
20049,2021-01-01,1174,1133,41,3.5
20051,2021-01-01,16989,16369,620,3.6
20053,2021-01-01,2808,2711,97,3.5
20055,2021-01-01,21375,20517,858,4
20057,2021-01-01,17411,16671,740,4.3
20059,2021-01-01,14535,13765,770,5.3
20061,2021-01-01,11418,10880,538,4.7
20063,2021-01-01,1500,1460,40,2.7
20065,2021-01-01,1072,1022,50,4.7
20067,2021-01-01,3001,2877,124,4.1
20069,2021-01-01,3342,3262,80,2.4
20071,2021-01-01,837,822,15,1.8
20073,2021-01-01,3122,2983,139,4.5
20075,2021-01-01,1673,1641,32,1.9
20077,2021-01-01,2969,2765,204,6.9
20079,2021-01-01,17064,16298,766,4.5
20081,2021-01-01,2288,2244,44,1.9
20083,2021-01-01,1008,983,25,2.5
20085,2021-01-01,7298,6999,299,4.1
20087,2021-01-01,10414,9969,445,4.3
20089,2021-01-01,1264,1228,36,2.8
20091,2021-01-01,352565,335205,17360,4.9
20093,2021-01-01,2063,1999,64,3.1
20095,2021-01-01,3407,3219,188,5.5
20097,2021-01-01,1270,1224,46,3.6
20099,2021-01-01,9589,9133,456,4.8
20101,2021-01-01,758,730,28,3.7
20103,2021-01-01,37418,35726,1692,4.5
20105,2021-01-01,1825,1750,75,4.1
20107,2021-01-01,4430,4205,225,5.1
20109,2021-01-01,1638,1598,40,2.4
20111,2021-01-01,16905,15962,943,5.6
20113,2021-01-01,17539,16867,672,3.8
20115,2021-01-01,5831,5590,241,4.1
20117,2021-01-01,5601,5352,249,4.4
20119,2021-01-01,2150,2088,62,2.9
20121,2021-01-01,18087,17338,749,4.1
20123,2021-01-01,3570,3402,168,4.7
20125,2021-01-01,14369,13658,711,4.9
20127,2021-01-01,3161,3048,113,3.6
20129,2021-01-01,1143,1096,47,4.1
20131,2021-01-01,5723,5480,243,4.2
20133,2021-01-01,6341,5962,379,6
20135,2021-01-01,1332,1288,44,3.3
20137,2021-01-01,2668,2572,96,3.6
20139,2021-01-01,8167,7811,356,4.4
20141,2021-01-01,1984,1907,77,3.9
20143,2021-01-01,3013,2898,115,3.8
20145,2021-01-01,2899,2756,143,4.9
20147,2021-01-01,2691,2598,93,3.5
20149,2021-01-01,11694,11173,521,4.5
20151,2021-01-01,5004,4791,213,4.3
20153,2021-01-01,1586,1540,46,2.9
20155,2021-01-01,29372,27957,1415,4.8
20157,2021-01-01,2284,2201,83,3.6
20159,2021-01-01,5117,4905,212,4.1
20161,2021-01-01,33581,31460,2121,6.3
20163,2021-01-01,2544,2418,126,5
20165,2021-01-01,1545,1489,56,3.6
20167,2021-01-01,3333,3210,123,3.7
20169,2021-01-01,29503,28158,1345,4.6
20171,2021-01-01,2888,2769,119,4.1
20173,2021-01-01,256701,238727,17974,7
20175,2021-01-01,10081,9508,573,5.7
20177,2021-01-01,94603,88243,6360,6.7
20179,2021-01-01,1489,1454,35,2.4
20181,2021-01-01,2942,2832,110,3.7
20183,2021-01-01,2048,1996,52,2.5
20185,2021-01-01,2079,2006,73,3.5
20187,2021-01-01,1143,1095,48,4.2
20189,2021-01-01,2853,2767,86,3
20191,2021-01-01,10939,10283,656,6
20193,2021-01-01,4334,4163,171,3.9
20195,2021-01-01,1490,1437,53,3.6
20197,2021-01-01,3735,3604,131,3.5
20199,2021-01-01,824,801,23,2.8
20201,2021-01-01,3138,3045,93,3
20203,2021-01-01,1243,1210,33,2.7
20205,2021-01-01,3871,3660,211,5.5
20207,2021-01-01,1512,1438,74,4.9
20209,2021-01-01,79241,74628,4613,5.8
21001,2021-01-01,6733,6364,369,5.5
21003,2021-01-01,8662,8300,362,4.2
21005,2021-01-01,11275,10754,521,4.6
21007,2021-01-01,3234,3061,173,5.3
21009,2021-01-01,17783,16735,1048,5.9
21011,2021-01-01,4466,4176,290,6.5
21013,2021-01-01,8148,7663,485,6
21015,2021-01-01,68025,65027,2998,4.4
21017,2021-01-01,9472,9086,386,4.1
21019,2021-01-01,17126,15946,1180,6.9
21021,2021-01-01,12421,11710,711,5.7
21023,2021-01-01,3702,3486,216,5.8
21025,2021-01-01,3181,2933,248,7.8
21027,2021-01-01,7687,7225,462,6
21029,2021-01-01,41361,38921,2440,5.9
21031,2021-01-01,4895,4647,248,5.1
21033,2021-01-01,5513,5237,276,5
21035,2021-01-01,16942,16053,889,5.2
21037,2021-01-01,48395,46047,2348,4.9
21039,2021-01-01,2120,2026,94,4.4
21041,2021-01-01,5054,4815,239,4.7
21043,2021-01-01,9419,8601,818,8.7
21045,2021-01-01,6633,6321,312,4.7
21047,2021-01-01,24068,22736,1332,5.5
21049,2021-01-01,16532,15709,823,5
21051,2021-01-01,5077,4700,377,7.4
21053,2021-01-01,3973,3810,163,4.1
21055,2021-01-01,3557,3389,168,4.7
21057,2021-01-01,3187,3057,130,4.1
21059,2021-01-01,44401,42201,2200,5
21061,2021-01-01,4476,4225,251,5.6
21063,2021-01-01,1924,1742,182,9.5
21065,2021-01-01,4928,4636,292,5.9
21067,2021-01-01,167438,160029,7409,4.4
21069,2021-01-01,5920,5590,330,5.6
21071,2021-01-01,10277,9508,769,7.5
21073,2021-01-01,23838,22549,1289,5.4
21075,2021-01-01,1929,1833,96,5
21077,2021-01-01,3931,3731,200,5.1
21079,2021-01-01,7339,6986,353,4.8
21081,2021-01-01,11149,10554,595,5.3
21083,2021-01-01,15347,14549,798,5.2
21085,2021-01-01,10448,9793,655,6.3
21087,2021-01-01,4989,4790,199,4
21089,2021-01-01,12952,11969,983,7.6
21091,2021-01-01,3700,3514,186,5
21093,2021-01-01,45588,43185,2403,5.3
21095,2021-01-01,6252,5634,618,9.9
21097,2021-01-01,8481,8112,369,4.4
21099,2021-01-01,7540,7176,364,4.8
21101,2021-01-01,20209,19176,1033,5.1
21103,2021-01-01,7967,7610,357,4.5
21105,2021-01-01,1692,1613,79,4.7
21107,2021-01-01,17904,16955,949,5.3
21109,2021-01-01,3874,3601,273,7
21111,2021-01-01,381756,360065,21691,5.7
21113,2021-01-01,25551,24390,1161,4.5
21115,2021-01-01,6379,5859,520,8.2
21117,2021-01-01,83707,79529,4178,5
21119,2021-01-01,4289,3962,327,7.6
21121,2021-01-01,9833,9178,655,6.7
21123,2021-01-01,5696,5378,318,5.6
21125,2021-01-01,24429,23210,1219,5
21127,2021-01-01,5012,4634,378,7.5
21129,2021-01-01,1962,1852,110,5.6
21131,2021-01-01,2569,2339,230,9
21133,2021-01-01,5912,5429,483,8.2
21135,2021-01-01,4604,4190,414,9
21137,2021-01-01,9241,8644,597,6.5
21139,2021-01-01,3420,3159,261,7.6
21141,2021-01-01,11818,11385,433,3.7
21143,2021-01-01,3024,2866,158,5.2
21145,2021-01-01,27258,25603,1655,6.1
21147,2021-01-01,4829,4539,290,6
21149,2021-01-01,3963,3768,195,4.9
21151,2021-01-01,44239,42219,2020,4.6
21153,2021-01-01,3153,2700,453,14.4
21155,2021-01-01,9073,8638,435,4.8
21157,2021-01-01,14194,13406,788,5.6
21159,2021-01-01,2363,2150,213,9
21161,2021-01-01,6824,6408,416,6.1
21163,2021-01-01,11370,10681,689,6.1
21165,2021-01-01,2213,2016,197,8.9
21167,2021-01-01,9521,9041,480,5
21169,2021-01-01,3965,3735,230,5.8
21171,2021-01-01,4462,4277,185,4.1
21173,2021-01-01,10961,10280,681,6.2
21175,2021-01-01,4236,3946,290,6.8
21177,2021-01-01,9541,8841,700,7.3
21179,2021-01-01,22256,21130,1126,5.1
21181,2021-01-01,3203,3055,148,4.6
21183,2021-01-01,8943,8371,572,6.4
21185,2021-01-01,31830,30627,1203,3.8
21187,2021-01-01,4953,4723,230,4.6
21189,2021-01-01,1045,969,76,7.3
21191,2021-01-01,6690,6382,308,4.6
21193,2021-01-01,7968,7417,551,6.9
21195,2021-01-01,18485,17191,1294,7
21197,2021-01-01,4889,4618,271,5.5
21199,2021-01-01,25007,23629,1378,5.5
21201,2021-01-01,780,742,38,4.9
21203,2021-01-01,6199,5854,345,5.6
21205,2021-01-01,9189,8653,536,5.8
21207,2021-01-01,5959,5609,350,5.9
21209,2021-01-01,28267,27130,1137,4
21211,2021-01-01,24842,23720,1122,4.5
21213,2021-01-01,8582,8206,376,4.4
21215,2021-01-01,10103,9590,513,5.1
21217,2021-01-01,12375,11869,506,4.1
21219,2021-01-01,5299,5112,187,3.5
21221,2021-01-01,5978,5649,329,5.5
21223,2021-01-01,3722,3521,201,5.4
21225,2021-01-01,5946,5696,250,4.2
21227,2021-01-01,61307,58527,2780,4.5
21229,2021-01-01,6016,5782,234,3.9
21231,2021-01-01,7338,6952,386,5.3
21233,2021-01-01,5247,4992,255,4.9
21235,2021-01-01,13551,12798,753,5.6
21237,2021-01-01,2054,1916,138,6.7
21239,2021-01-01,14829,14275,554,3.7
22001,2021-01-01,23110,21589,1521,6.6
22003,2021-01-01,8124,7513,611,7.5
22005,2021-01-01,64045,60394,3651,5.7
22007,2021-01-01,8731,7908,823,9.4
22009,2021-01-01,14780,13767,1013,6.9
22011,2021-01-01,13862,13102,760,5.5
22013,2021-01-01,5388,4976,412,7.6
22015,2021-01-01,55662,52704,2958,5.3
22017,2021-01-01,101236,92573,8663,8.6
22019,2021-01-01,92052,84476,7576,8.2
22021,2021-01-01,3600,3382,218,6.1
22023,2021-01-01,3304,3145,159,4.8
22025,2021-01-01,3475,3235,240,6.9
22027,2021-01-01,5668,5323,345,6.1
22029,2021-01-01,6834,6332,502,7.3
22031,2021-01-01,10468,9785,683,6.5
22033,2021-01-01,229655,213237,16418,7.1
22035,2021-01-01,1833,1604,229,12.5
22037,2021-01-01,7783,7311,472,6.1
22039,2021-01-01,11688,10863,825,7.1
22041,2021-01-01,7292,6762,530,7.3
22043,2021-01-01,8132,7704,428,5.3
22045,2021-01-01,27668,25022,2646,9.6
22047,2021-01-01,14115,12758,1357,9.6
22049,2021-01-01,6637,6328,309,4.7
22051,2021-01-01,208156,190350,17806,8.6
22053,2021-01-01,12409,11625,784,6.3
22055,2021-01-01,111455,104451,7004,6.3
22057,2021-01-01,40947,38550,2397,5.9
22059,2021-01-01,6914,6631,283,4.1
22061,2021-01-01,20373,19236,1137,5.6
22063,2021-01-01,67925,64477,3448,5.1
22065,2021-01-01,3559,3280,279,7.8
22067,2021-01-01,10069,9125,944,9.4
22069,2021-01-01,15711,14754,957,6.1
22071,2021-01-01,180774,158325,22449,12.4
22073,2021-01-01,69346,64721,4625,6.7
22075,2021-01-01,9479,8937,542,5.7
22077,2021-01-01,9709,8993,716,7.4
22079,2021-01-01,55125,52246,2879,5.2
22081,2021-01-01,3564,3349,215,6
22083,2021-01-01,7982,7449,533,6.7
22085,2021-01-01,9127,8710,417,4.6
22087,2021-01-01,19775,17834,1941,9.8
22089,2021-01-01,24210,22533,1677,6.9
22091,2021-01-01,4374,3844,530,12.1
22093,2021-01-01,9015,8130,885,9.8
22095,2021-01-01,19365,17164,2201,11.4
22097,2021-01-01,32183,29521,2662,8.3
22099,2021-01-01,21758,20091,1667,7.7
22101,2021-01-01,18855,17150,1705,9
22103,2021-01-01,113525,107602,5923,5.2
22105,2021-01-01,56135,51270,4865,8.7
22107,2021-01-01,1328,1229,99,7.5
22109,2021-01-01,45872,42475,3397,7.4
22111,2021-01-01,8931,8370,561,6.3
22113,2021-01-01,23369,21735,1634,7
22115,2021-01-01,15692,14746,946,6
22117,2021-01-01,16622,15346,1276,7.7
22119,2021-01-01,13858,12875,983,7.1
22121,2021-01-01,13554,12652,902,6.7
22123,2021-01-01,3497,3207,290,8.3
22125,2021-01-01,5303,5044,259,4.9
22127,2021-01-01,4605,4313,292,6.3
23001,2021-01-01,53892,50618,3274,6.1
23003,2021-01-01,29201,27201,2000,6.8
23005,2021-01-01,156960,148394,8566,5.5
23007,2021-01-01,14058,13143,915,6.5
23009,2021-01-01,25625,23494,2131,8.3
23011,2021-01-01,60781,57345,3436,5.7
23013,2021-01-01,18761,17575,1186,6.3
23015,2021-01-01,15641,14613,1028,6.6
23017,2021-01-01,26058,24051,2007,7.7
23019,2021-01-01,73511,68900,4611,6.3
23021,2021-01-01,7145,6672,473,6.6
23023,2021-01-01,18834,17871,963,5.1
23025,2021-01-01,21875,20088,1787,8.2
23027,2021-01-01,19434,18147,1287,6.6
23029,2021-01-01,13354,12229,1125,8.4
23031,2021-01-01,109235,101740,7495,6.9
24001,2021-01-01,29754,27519,2235,7.5
24003,2021-01-01,302302,286450,15852,5.2
24005,2021-01-01,434586,406910,27676,6.4
24009,2021-01-01,46757,44519,2238,4.8
24011,2021-01-01,16966,16000,966,5.7
24013,2021-01-01,90796,86728,4068,4.5
24015,2021-01-01,51065,48235,2830,5.5
24017,2021-01-01,82858,77741,5117,6.2
24019,2021-01-01,14794,13722,1072,7.2
24021,2021-01-01,128070,121205,6865,5.4
24023,2021-01-01,14648,13674,974,6.6
24025,2021-01-01,134766,127827,6939,5.1
24027,2021-01-01,179889,171361,8528,4.7
24029,2021-01-01,9664,8999,665,6.9
24031,2021-01-01,527768,496867,30901,5.9
24033,2021-01-01,486500,447977,38523,7.9
24035,2021-01-01,26616,25308,1308,4.9
24037,2021-01-01,56408,53898,2510,4.4
24039,2021-01-01,8589,7845,744,8.7
24041,2021-01-01,17871,16716,1155,6.5
24043,2021-01-01,70511,66224,4287,6.1
24045,2021-01-01,47890,44384,3506,7.3
24047,2021-01-01,24648,21638,3010,12.2
24510,2021-01-01,275212,251358,23854,8.7
25001,2021-01-01,107222,96394,10828,10.1
25003,2021-01-01,61799,56376,5423,8.8
25005,2021-01-01,296954,271516,25438,8.6
25007,2021-01-01,8354,7403,951,11.4
25009,2021-01-01,421396,386520,34876,8.3
25011,2021-01-01,39546,36848,2698,6.8
25013,2021-01-01,220748,199818,20930,9.5
25015,2021-01-01,86027,80425,5602,6.5
25017,2021-01-01,895577,841336,54241,6.1
25019,2021-01-01,6294,5226,1068,17
25021,2021-01-01,382523,357740,24783,6.5
25023,2021-01-01,279353,257099,22254,8
25025,2021-01-01,448806,414221,34585,7.7
25027,2021-01-01,439300,406301,32999,7.5
26001,2021-01-01,3784,3463,321,8.5
26003,2021-01-01,3039,2691,348,11.5
26005,2021-01-01,60969,57461,3508,5.8
26007,2021-01-01,13160,12260,900,6.8
26009,2021-01-01,9855,8895,960,9.7
26011,2021-01-01,5609,5000,609,10.9
26013,2021-01-01,3120,2823,297,9.5
26015,2021-01-01,30749,29003,1746,5.7
26017,2021-01-01,48808,45018,3790,7.8
26019,2021-01-01,8305,7588,717,8.6
26021,2021-01-01,71150,66022,5128,7.2
26023,2021-01-01,19387,18232,1155,6
26025,2021-01-01,60702,56026,4676,7.7
26027,2021-01-01,23847,22381,1466,6.1
26029,2021-01-01,12212,11213,999,8.2
26031,2021-01-01,9724,8206,1518,15.6
26033,2021-01-01,15891,14450,1441,9.1
26035,2021-01-01,11614,10458,1156,10
26037,2021-01-01,38759,36887,1872,4.8
26039,2021-01-01,5510,5037,473,8.6
26041,2021-01-01,17101,15795,1306,7.6
26043,2021-01-01,12241,11510,731,6
26045,2021-01-01,54335,51255,3080,5.7
26047,2021-01-01,16488,14901,1587,9.6
26049,2021-01-01,177361,162283,15078,8.5
26051,2021-01-01,9563,8717,846,8.8
26053,2021-01-01,5910,5535,375,6.3
26055,2021-01-01,46929,43529,3400,7.2
26057,2021-01-01,17467,16367,1100,6.3
26059,2021-01-01,19584,18350,1234,6.3
26061,2021-01-01,15702,14766,936,6
26063,2021-01-01,14991,13993,998,6.7
26065,2021-01-01,143187,134623,8564,6
26067,2021-01-01,29984,28332,1652,5.5
26069,2021-01-01,9814,8889,925,9.4
26071,2021-01-01,4878,4498,380,7.8
26073,2021-01-01,32565,30501,2064,6.3
26075,2021-01-01,72333,67263,5070,7
26077,2021-01-01,128940,121386,7554,5.9
26079,2021-01-01,7593,6822,771,10.2
26081,2021-01-01,351363,331393,19970,5.7
26083,2021-01-01,875,797,78,8.9
26085,2021-01-01,3854,3467,387,10
26087,2021-01-01,38472,36207,2265,5.9
26089,2021-01-01,9820,9096,724,7.4
26091,2021-01-01,44496,41622,2874,6.5
26093,2021-01-01,97517,93810,3707,3.8
26095,2021-01-01,2164,1977,187,8.6
26097,2021-01-01,4054,3265,789,19.5
26099,2021-01-01,422380,400910,21470,5.1
26101,2021-01-01,10035,9081,954,9.5
26103,2021-01-01,31985,29834,2151,6.7
26105,2021-01-01,12991,11904,1087,8.4
26107,2021-01-01,17929,16490,1439,8
26109,2021-01-01,10653,10115,538,5.1
26111,2021-01-01,39268,36893,2375,6
26113,2021-01-01,6711,6212,499,7.4
26115,2021-01-01,72423,67644,4779,6.6
26117,2021-01-01,27468,25558,1910,7
26119,2021-01-01,2900,2543,357,12.3
26121,2021-01-01,75318,68610,6708,8.9
26123,2021-01-01,22767,21179,1588,7
26125,2021-01-01,634692,608956,25736,4.1
26127,2021-01-01,11491,10370,1121,9.8
26129,2021-01-01,7915,7058,857,10.8
26131,2021-01-01,2013,1839,174,8.6
26133,2021-01-01,11491,10699,792,6.9
26135,2021-01-01,2798,2500,298,10.7
26137,2021-01-01,11266,10275,991,8.8
26139,2021-01-01,155818,148292,7526,4.8
26141,2021-01-01,4820,4300,520,10.8
26143,2021-01-01,7615,6704,911,12
26145,2021-01-01,84073,77243,6830,8.1
26147,2021-01-01,71090,67174,3916,5.5
26149,2021-01-01,28538,26870,1668,5.8
26151,2021-01-01,19108,17632,1476,7.7
26153,2021-01-01,3212,2885,327,10.2
26155,2021-01-01,31993,29859,2134,6.7
26157,2021-01-01,23316,21528,1788,7.7
26159,2021-01-01,34140,31400,2740,8
26161,2021-01-01,189554,180509,9045,4.8
26163,2021-01-01,764842,713657,51185,6.7
26165,2021-01-01,14606,13497,1109,7.6
27001,2021-01-01,7395,6783,612,8.3
27003,2021-01-01,191013,181585,9428,4.9
27005,2021-01-01,18195,17082,1113,6.1
27007,2021-01-01,24211,22872,1339,5.5
27009,2021-01-01,21624,20150,1474,6.8
27011,2021-01-01,2398,2243,155,6.5
27013,2021-01-01,39558,37817,1741,4.4
27015,2021-01-01,13734,13009,725,5.3
27017,2021-01-01,17211,16230,981,5.7
27019,2021-01-01,56564,54269,2295,4.1
27021,2021-01-01,12657,11439,1218,9.6
27023,2021-01-01,6579,6260,319,4.8
27025,2021-01-01,29243,27428,1815,6.2
27027,2021-01-01,35942,34507,1435,4
27029,2021-01-01,4392,3953,439,10
27031,2021-01-01,2569,2345,224,8.7
27033,2021-01-01,6374,6095,279,4.4
27035,2021-01-01,31183,28928,2255,7.2
27037,2021-01-01,232987,222347,10640,4.6
27039,2021-01-01,11676,11076,600,5.1
27041,2021-01-01,20858,19882,976,4.7
27043,2021-01-01,6710,6291,419,6.2
27045,2021-01-01,11259,10675,584,5.2
27047,2021-01-01,15895,15100,795,5
27049,2021-01-01,25843,24526,1317,5.1
27051,2021-01-01,3236,3040,196,6.1
27053,2021-01-01,679745,649110,30635,4.5
27055,2021-01-01,10173,9709,464,4.6
27057,2021-01-01,9321,8639,682,7.3
27059,2021-01-01,20917,19504,1413,6.8
27061,2021-01-01,21305,19882,1423,6.7
27063,2021-01-01,5600,5319,281,5
27065,2021-01-01,9104,8220,884,9.7
27067,2021-01-01,24001,22741,1260,5.2
27069,2021-01-01,2307,2215,92,4
27071,2021-01-01,5477,5138,339,6.2
27073,2021-01-01,3376,3202,174,5.2
27075,2021-01-01,4919,4597,322,6.5
27077,2021-01-01,2481,2375,106,4.3
27079,2021-01-01,15895,14666,1229,7.7
27081,2021-01-01,2945,2771,174,5.9
27083,2021-01-01,13589,12974,615,4.5
27085,2021-01-01,18701,17649,1052,5.6
27087,2021-01-01,2049,1854,195,9.5
27089,2021-01-01,5255,4866,389,7.4
27091,2021-01-01,9511,9066,445,4.7
27093,2021-01-01,12914,12143,771,6
27095,2021-01-01,12718,11549,1169,9.2
27097,2021-01-01,17613,16180,1433,8.1
27099,2021-01-01,20523,19582,941,4.6
27101,2021-01-01,4645,4297,348,7.5
27103,2021-01-01,20360,19518,842,4.1
27105,2021-01-01,11346,10905,441,3.9
27107,2021-01-01,3125,2937,188,6
27109,2021-01-01,88036,84377,3659,4.2
27111,2021-01-01,30314,28438,1876,6.2
27113,2021-01-01,8546,8023,523,6.1
27115,2021-01-01,14142,12897,1245,8.8
27117,2021-01-01,4376,4128,248,5.7
27119,2021-01-01,15824,15001,823,5.2
27121,2021-01-01,6287,5965,322,5.1
27123,2021-01-01,278054,264125,13929,5
27125,2021-01-01,2190,2048,142,6.5
27127,2021-01-01,7442,7054,388,5.2
27129,2021-01-01,8281,7797,484,5.8
27131,2021-01-01,36203,34490,1713,4.7
27133,2021-01-01,5730,5569,161,2.8
27135,2021-01-01,7647,7319,328,4.3
27137,2021-01-01,98209,92794,5415,5.5
27139,2021-01-01,80766,77175,3591,4.4
27141,2021-01-01,51099,48113,2986,5.8
27143,2021-01-01,8031,7584,447,5.6
27145,2021-01-01,88311,83693,4618,5.2
27147,2021-01-01,19301,18382,919,4.8
27149,2021-01-01,5166,4967,199,3.9
27151,2021-01-01,4625,4338,287,6.2
27153,2021-01-01,13452,12672,780,5.8
27155,2021-01-01,1677,1592,85,5.1
27157,2021-01-01,11997,11386,611,5.1
27159,2021-01-01,5902,5442,460,7.8
27161,2021-01-01,8628,8095,533,6.2
27163,2021-01-01,138342,132456,5886,4.3
27165,2021-01-01,6558,6265,293,4.5
27167,2021-01-01,3290,3147,143,4.3
27169,2021-01-01,27243,26151,1092,4
27171,2021-01-01,73494,69806,3688,5
27173,2021-01-01,5130,4853,277,5.4
28001,2021-01-01,10435,9359,1076,10.3
28003,2021-01-01,15392,14634,758,4.9
28005,2021-01-01,4494,4147,347,7.7
28007,2021-01-01,6882,6420,462,6.7
28009,2021-01-01,3005,2813,192,6.4
28011,2021-01-01,11419,10501,918,8
28013,2021-01-01,5418,5105,313,5.8
28015,2021-01-01,3409,3191,218,6.4
28017,2021-01-01,6892,6405,487,7.1
28019,2021-01-01,3538,3346,192,5.4
28021,2021-01-01,3060,2646,414,13.5
28023,2021-01-01,5843,5446,397,6.8
28025,2021-01-01,7857,7148,709,9
28027,2021-01-01,8109,7224,885,10.9
28029,2021-01-01,10815,10040,775,7.2
28031,2021-01-01,8512,7985,527,6.2
28033,2021-01-01,91145,87144,4001,4.4
28035,2021-01-01,33964,31740,2224,6.5
28037,2021-01-01,2768,2562,206,7.4
28039,2021-01-01,9041,8352,689,7.6
28041,2021-01-01,4397,4034,363,8.3
28043,2021-01-01,9367,8824,543,5.8
28045,2021-01-01,18941,17674,1267,6.7
28047,2021-01-01,87679,82203,5476,6.2
28049,2021-01-01,104225,96689,7536,7.2
28051,2021-01-01,5163,4487,676,13.1
28053,2021-01-01,2159,1864,295,13.7
28055,2021-01-01,327,289,38,11.6
28057,2021-01-01,10363,9889,474,4.6
28059,2021-01-01,58969,55017,3952,6.7
28061,2021-01-01,6027,5524,503,8.3
28063,2021-01-01,1976,1639,337,17.1
28065,2021-01-01,4022,3666,356,8.9
28067,2021-01-01,25265,23739,1526,6
28069,2021-01-01,3378,3134,244,7.2
28071,2021-01-01,26261,25079,1182,4.5
28073,2021-01-01,31493,30086,1407,4.5
28075,2021-01-01,29842,28070,1772,5.9
28077,2021-01-01,4707,4339,368,7.8
28079,2021-01-01,7992,7533,459,5.7
28081,2021-01-01,41358,39186,2172,5.3
28083,2021-01-01,9840,8842,998,10.1
28085,2021-01-01,14696,13840,856,5.8
28087,2021-01-01,25275,23659,1616,6.4
28089,2021-01-01,52325,49941,2384,4.6
28091,2021-01-01,10468,9836,632,6
28093,2021-01-01,14235,13340,895,6.3
28095,2021-01-01,15532,14620,912,5.9
28097,2021-01-01,3919,3632,287,7.3
28099,2021-01-01,9988,9405,583,5.8
28101,2021-01-01,7843,7391,452,5.8
28103,2021-01-01,3931,3550,381,9.7
28105,2021-01-01,22426,21140,1286,5.7
28107,2021-01-01,12633,11590,1043,8.3
28109,2021-01-01,23393,21889,1504,6.4
28111,2021-01-01,4333,4041,292,6.7
28113,2021-01-01,14807,13655,1152,7.8
28115,2021-01-01,14811,14123,688,4.6
28117,2021-01-01,11149,10609,540,4.8
28119,2021-01-01,2314,2082,232,10
28121,2021-01-01,74738,71955,2783,3.7
28123,2021-01-01,13002,12379,623,4.8
28125,2021-01-01,1447,1283,164,11.3
28127,2021-01-01,10510,9899,611,5.8
28129,2021-01-01,6694,6383,311,4.6
28131,2021-01-01,7061,6665,396,5.6
28133,2021-01-01,7401,6582,819,11.1
28135,2021-01-01,5111,4759,352,6.9
28137,2021-01-01,12018,11292,726,6
28139,2021-01-01,9489,9030,459,4.8
28141,2021-01-01,8262,7877,385,4.7
28143,2021-01-01,4448,3978,470,10.6
28145,2021-01-01,13979,13390,589,4.2
28147,2021-01-01,5010,4614,396,7.9
28149,2021-01-01,19862,18433,1429,7.2
28151,2021-01-01,16009,14415,1594,10
28153,2021-01-01,7359,6777,582,7.9
28155,2021-01-01,3910,3677,233,6
28157,2021-01-01,2854,2466,388,13.6
28159,2021-01-01,7115,6615,500,7
28161,2021-01-01,4906,4592,314,6.4
28163,2021-01-01,9781,9008,773,7.9
29001,2021-01-01,10038,9537,501,5
29003,2021-01-01,9710,9340,370,3.8
29005,2021-01-01,2736,2636,100,3.7
29007,2021-01-01,10241,9798,443,4.3
29009,2021-01-01,15710,14753,957,6.1
29011,2021-01-01,5289,5082,207,3.9
29013,2021-01-01,7783,7387,396,5.1
29015,2021-01-01,7306,6787,519,7.1
29017,2021-01-01,5408,5143,265,4.9
29019,2021-01-01,95125,91551,3574,3.8
29021,2021-01-01,43443,41468,1975,4.5
29023,2021-01-01,18266,17230,1036,5.7
29025,2021-01-01,4325,4123,202,4.7
29027,2021-01-01,21564,20692,872,4
29029,2021-01-01,18115,16754,1361,7.5
29031,2021-01-01,40145,38427,1718,4.3
29033,2021-01-01,4791,4539,252,5.3
29035,2021-01-01,2518,2344,174,6.9
29037,2021-01-01,54592,52054,2538,4.6
29039,2021-01-01,5856,5593,263,4.5
29041,2021-01-01,3870,3701,169,4.4
29043,2021-01-01,45757,43892,1865,4.1
29045,2021-01-01,3155,2988,167,5.3
29047,2021-01-01,136187,130210,5977,4.4
29049,2021-01-01,10600,10093,507,4.8
29051,2021-01-01,39474,37962,1512,3.8
29053,2021-01-01,7135,6805,330,4.6
29055,2021-01-01,10834,10209,625,5.8
29057,2021-01-01,3595,3445,150,4.2
29059,2021-01-01,7113,6752,361,5.1
29061,2021-01-01,4144,3967,177,4.3
29063,2021-01-01,4770,4571,199,4.2
29065,2021-01-01,6435,6119,316,4.9
29067,2021-01-01,5219,4938,281,5.4
29069,2021-01-01,11656,10837,819,7
29071,2021-01-01,52217,49592,2625,5
29073,2021-01-01,7502,7150,352,4.7
29075,2021-01-01,3416,3308,108,3.2
29077,2021-01-01,151750,145419,6331,4.2
29079,2021-01-01,4366,4181,185,4.2
29081,2021-01-01,3843,3676,167,4.3
29083,2021-01-01,9752,9255,497,5.1
29085,2021-01-01,3848,3652,196,5.1
29087,2021-01-01,2564,2478,86,3.4
29089,2021-01-01,4882,4686,196,4
29091,2021-01-01,16184,15223,961,5.9
29093,2021-01-01,3527,3282,245,6.9
29095,2021-01-01,361026,339936,21090,5.8
29097,2021-01-01,57037,54432,2605,4.6
29099,2021-01-01,116034,110136,5898,5.1
29101,2021-01-01,23074,21952,1122,4.9
29103,2021-01-01,1750,1681,69,3.9
29105,2021-01-01,16495,15564,931,5.6
29107,2021-01-01,16736,15955,781,4.7
29109,2021-01-01,17629,16630,999,5.7
29111,2021-01-01,4951,4738,213,4.3
29113,2021-01-01,28430,27027,1403,4.9
29115,2021-01-01,5217,4838,379,7.3
29117,2021-01-01,7436,7145,291,3.9
29119,2021-01-01,10739,10292,447,4.2
29121,2021-01-01,7526,7166,360,4.8
29123,2021-01-01,5477,5184,293,5.3
29125,2021-01-01,3975,3791,184,4.6
29127,2021-01-01,14164,13565,599,4.2
29129,2021-01-01,1917,1841,76,4
29131,2021-01-01,12235,11537,698,5.7
29133,2021-01-01,5736,5418,318,5.5
29135,2021-01-01,7444,7149,295,4
29137,2021-01-01,3734,3517,217,5.8
29139,2021-01-01,5724,5493,231,4
29141,2021-01-01,8285,7731,554,6.7
29143,2021-01-01,8677,8221,456,5.3
29145,2021-01-01,27104,25868,1236,4.6
29147,2021-01-01,10510,10103,407,3.9
29149,2021-01-01,3995,3731,264,6.6
29151,2021-01-01,7155,6929,226,3.2
29153,2021-01-01,3398,3163,235,6.9
29155,2021-01-01,6232,5759,473,7.6
29157,2021-01-01,9866,9470,396,4
29159,2021-01-01,20408,19279,1129,5.5
29161,2021-01-01,19972,19053,919,4.6
29163,2021-01-01,7441,7100,341,4.6
29165,2021-01-01,58470,56136,2334,4
29167,2021-01-01,14603,13977,626,4.3
29169,2021-01-01,14555,13772,783,5.4
29171,2021-01-01,2288,2190,98,4.3
29173,2021-01-01,5605,5362,243,4.3
29175,2021-01-01,10091,9557,534,5.3
29177,2021-01-01,10888,10378,510,4.7
29179,2021-01-01,2847,2701,146,5.1
29181,2021-01-01,4940,4607,333,6.7
29183,2021-01-01,222154,213337,8817,4
29185,2021-01-01,3842,3637,205,5.3
29186,2021-01-01,9271,8867,404,4.4
29187,2021-01-01,26230,24705,1525,5.8
29189,2021-01-01,520361,493749,26612,5.1
29195,2021-01-01,10715,10260,455,4.2
29197,2021-01-01,1956,1853,103,5.3
29199,2021-01-01,2425,2345,80,3.3
29201,2021-01-01,19945,18975,970,4.9
29203,2021-01-01,3371,3141,230,6.8
29205,2021-01-01,3086,2936,150,4.9
29207,2021-01-01,13321,12612,709,5.3
29209,2021-01-01,12284,10939,1345,10.9
29211,2021-01-01,2882,2721,161,5.6
29213,2021-01-01,23979,20960,3019,12.6
29215,2021-01-01,9110,8631,479,5.3
29217,2021-01-01,9617,9222,395,4.1
29219,2021-01-01,18056,17220,836,4.6
29221,2021-01-01,10150,9489,661,6.5
29223,2021-01-01,5048,4754,294,5.8
29225,2021-01-01,17449,16728,721,4.1
29227,2021-01-01,1172,1134,38,3.2
29229,2021-01-01,7332,6947,385,5.3
29510,2021-01-01,150319,139793,10526,7
30001,2021-01-01,4981,4781,200,4
30003,2021-01-01,4841,4396,445,9.2
30005,2021-01-01,2258,2137,121,5.4
30007,2021-01-01,2543,2389,154,6.1
30009,2021-01-01,5379,5094,285,5.3
30011,2021-01-01,658,637,21,3.2
30013,2021-01-01,36768,34984,1784,4.9
30015,2021-01-01,2440,2345,95,3.9
30017,2021-01-01,6125,5821,304,5
30019,2021-01-01,900,878,22,2.4
30021,2021-01-01,4614,4388,226,4.9
30023,2021-01-01,4942,4703,239,4.8
30025,2021-01-01,1629,1564,65,4
30027,2021-01-01,5754,5474,280,4.9
30029,2021-01-01,47725,44563,3162,6.6
30031,2021-01-01,69217,66834,2383,3.4
30033,2021-01-01,755,731,24,3.2
30035,2021-01-01,5087,4566,521,10.2
30037,2021-01-01,354,342,12,3.4
30039,2021-01-01,1612,1502,110,6.8
30041,2021-01-01,7402,7106,296,4
30043,2021-01-01,5719,5475,244,4.3
30045,2021-01-01,982,949,33,3.4
30047,2021-01-01,13305,12562,743,5.6
30049,2021-01-01,36087,34463,1624,4.5
30051,2021-01-01,994,966,28,2.8
30053,2021-01-01,7685,6970,715,9.3
30055,2021-01-01,971,949,22,2.3
30057,2021-01-01,5147,4928,219,4.3
30059,2021-01-01,1019,980,39,3.8
30061,2021-01-01,1641,1510,131,8
30063,2021-01-01,61416,58207,3209,5.2
30065,2021-01-01,2285,2149,136,6
30067,2021-01-01,8435,7928,507,6
30069,2021-01-01,267,259,8,3
30071,2021-01-01,1896,1787,109,5.7
30073,2021-01-01,2686,2558,128,4.8
30075,2021-01-01,999,963,36,3.6
30077,2021-01-01,2837,2727,110,3.9
30079,2021-01-01,461,434,27,5.9
30081,2021-01-01,20368,19199,1169,5.7
30083,2021-01-01,5770,5465,305,5.3
30085,2021-01-01,4412,4158,254,5.8
30087,2021-01-01,3576,3395,181,5.1
30089,2021-01-01,4958,4561,397,8
30091,2021-01-01,1788,1688,100,5.6
30093,2021-01-01,16906,15961,945,5.6
30095,2021-01-01,5243,5024,219,4.2
30097,2021-01-01,1839,1781,58,3.2
30099,2021-01-01,2733,2610,123,4.5
30101,2021-01-01,2104,2027,77,3.7
30103,2021-01-01,344,330,14,4.1
30105,2021-01-01,4000,3814,186,4.7
30107,2021-01-01,755,692,63,8.3
30109,2021-01-01,448,425,23,5.1
30111,2021-01-01,79719,76159,3560,4.5
31001,2021-01-01,16441,15984,457,2.8
31003,2021-01-01,3929,3849,80,2
31005,2021-01-01,239,233,6,2.5
31007,2021-01-01,387,381,6,1.6
31009,2021-01-01,264,253,11,4.2
31011,2021-01-01,2949,2892,57,1.9
31013,2021-01-01,5351,5171,180,3.4
31015,2021-01-01,1069,1045,24,2.2
31017,2021-01-01,1407,1376,31,2.2
31019,2021-01-01,26872,26185,687,2.6
31021,2021-01-01,3545,3439,106,3
31023,2021-01-01,4589,4459,130,2.8
31025,2021-01-01,13164,12722,442,3.4
31027,2021-01-01,4460,4355,105,2.4
31029,2021-01-01,2335,2296,39,1.7
31031,2021-01-01,3307,3246,61,1.8
31033,2021-01-01,4109,3962,147,3.6
31035,2021-01-01,3232,3151,81,2.5
31037,2021-01-01,5583,5463,120,2.1
31039,2021-01-01,4790,4704,86,1.8
31041,2021-01-01,6357,6241,116,1.8
31043,2021-01-01,10235,9818,417,4.1
31045,2021-01-01,4838,4734,104,2.1
31047,2021-01-01,13210,12869,341,2.6
31049,2021-01-01,954,931,23,2.4
31051,2021-01-01,2918,2833,85,2.9
31053,2021-01-01,20224,19650,574,2.8
31055,2021-01-01,291799,280649,11150,3.8
31057,2021-01-01,1176,1157,19,1.6
31059,2021-01-01,3125,3055,70,2.2
31061,2021-01-01,1492,1450,42,2.8
31063,2021-01-01,1525,1493,32,2.1
31065,2021-01-01,2607,2546,61,2.3
31067,2021-01-01,10633,10286,347,3.3
31069,2021-01-01,1059,1034,25,2.4
31071,2021-01-01,1165,1142,23,2
31073,2021-01-01,1075,1057,18,1.7
31075,2021-01-01,425,420,5,1.2
31077,2021-01-01,1234,1211,23,1.9
31079,2021-01-01,31101,29887,1214,3.9
31081,2021-01-01,4718,4597,121,2.6
31083,2021-01-01,1697,1657,40,2.4
31085,2021-01-01,638,629,9,1.4
31087,2021-01-01,1283,1253,30,2.3
31089,2021-01-01,5788,5678,110,1.9
31091,2021-01-01,375,369,6,1.6
31093,2021-01-01,3291,3196,95,2.9
31095,2021-01-01,4199,4108,91,2.2
31097,2021-01-01,2051,1974,77,3.8
31099,2021-01-01,3722,3644,78,2.1
31101,2021-01-01,4472,4347,125,2.8
31103,2021-01-01,631,621,10,1.6
31105,2021-01-01,1942,1891,51,2.6
31107,2021-01-01,4695,4563,132,2.8
31109,2021-01-01,171482,165861,5621,3.3
31111,2021-01-01,17867,17386,481,2.7
31113,2021-01-01,475,469,6,1.3
31115,2021-01-01,425,415,10,2.4
31117,2021-01-01,443,434,9,2
31119,2021-01-01,19251,18554,697,3.6
31121,2021-01-01,3968,3854,114,2.9
31123,2021-01-01,2596,2516,80,3.1
31125,2021-01-01,1932,1888,44,2.3
31127,2021-01-01,3496,3408,88,2.5
31129,2021-01-01,2492,2432,60,2.4
31131,2021-01-01,8280,8040,240,2.9
31133,2021-01-01,1501,1470,31,2.1
31135,2021-01-01,1846,1823,23,1.2
31137,2021-01-01,4919,4824,95,1.9
31139,2021-01-01,4089,3935,154,3.8
31141,2021-01-01,17491,17069,422,2.4
31143,2021-01-01,2922,2859,63,2.2
31145,2021-01-01,5842,5695,147,2.5
31147,2021-01-01,4089,3975,114,2.8
31149,2021-01-01,898,886,12,1.3
31151,2021-01-01,7200,6980,220,3.1
31153,2021-01-01,94099,91419,2680,2.8
31155,2021-01-01,11010,10692,318,2.9
31157,2021-01-01,17797,17187,610,3.4
31159,2021-01-01,8709,8420,289,3.3
31161,2021-01-01,2727,2672,55,2
31163,2021-01-01,1670,1634,36,2.2
31165,2021-01-01,759,746,13,1.7
31167,2021-01-01,3509,3395,114,3.2
31169,2021-01-01,2806,2760,46,1.6
31171,2021-01-01,432,414,18,4.2
31173,2021-01-01,3009,2915,94,3.1
31175,2021-01-01,2114,2064,50,2.4
31177,2021-01-01,10921,10622,299,2.7
31179,2021-01-01,5534,5421,113,2
31181,2021-01-01,1667,1627,40,2.4
31183,2021-01-01,576,571,5,0.9
31185,2021-01-01,7137,6981,156,2.2
32001,2021-01-01,11611,11182,429,3.7
32003,2021-01-01,NA,998567,108184,9.8
32005,2021-01-01,22675,21439,1236,5.5
32007,2021-01-01,27897,26880,1017,3.6
32009,2021-01-01,426,410,16,3.8
32011,2021-01-01,1142,1108,34,3
32013,2021-01-01,8357,8045,312,3.7
32015,2021-01-01,3297,3166,131,4
32017,2021-01-01,2119,2028,91,4.3
32019,2021-01-01,23740,22339,1401,5.9
32021,2021-01-01,2104,2016,88,4.2
32023,2021-01-01,18083,16903,1180,6.5
32027,2021-01-01,2636,2539,97,3.7
32029,2021-01-01,2140,2022,118,5.5
32031,2021-01-01,264918,252201,12717,4.8
32033,2021-01-01,4677,4528,149,3.2
32510,2021-01-01,26782,25302,1480,5.5
33001,2021-01-01,31107,29711,1396,4.5
33003,2021-01-01,22836,21828,1008,4.4
33005,2021-01-01,39587,37945,1642,4.1
33007,2021-01-01,14366,13592,774,5.4
33009,2021-01-01,47737,46018,1719,3.6
33011,2021-01-01,238708,228656,10052,4.2
33013,2021-01-01,82379,79325,3054,3.7
33015,2021-01-01,183579,176227,7352,4
33017,2021-01-01,72097,69343,2754,3.8
33019,2021-01-01,23099,22263,836,3.6
34001,2021-01-01,115264,100818,14446,12.5
34003,2021-01-01,461832,426689,35143,7.6
34005,2021-01-01,225798,210793,15005,6.6
34007,2021-01-01,250086,229350,20736,8.3
34009,2021-01-01,44278,38576,5702,12.9
34011,2021-01-01,64393,58093,6300,9.8
34013,2021-01-01,362159,326073,36086,10
34015,2021-01-01,147630,136446,11184,7.6
34017,2021-01-01,348573,318103,30470,8.7
34019,2021-01-01,61533,57877,3656,5.9
34021,2021-01-01,202497,189546,12951,6.4
34023,2021-01-01,427728,397584,30144,7
34025,2021-01-01,320553,298322,22231,6.9
34027,2021-01-01,245532,229966,15566,6.3
34029,2021-01-01,272212,251751,20461,7.5
34031,2021-01-01,236153,211431,24722,10.5
34033,2021-01-01,29176,26656,2520,8.6
34035,2021-01-01,163193,152820,10373,6.4
34037,2021-01-01,71464,65985,5479,7.7
34039,2021-01-01,267828,245626,22202,8.3
34041,2021-01-01,55369,51426,3943,7.1
35001,2021-01-01,334119,305784,28335,8.5
35003,2021-01-01,1190,1091,99,8.3
35005,2021-01-01,29034,26446,2588,8.9
35006,2021-01-01,9717,8544,1173,12.1
35007,2021-01-01,5393,4984,409,7.6
35009,2021-01-01,23059,21598,1461,6.3
35011,2021-01-01,731,687,44,6
35013,2021-01-01,97634,89171,8463,8.7
35015,2021-01-01,33299,30504,2795,8.4
35017,2021-01-01,11748,10636,1112,9.5
35019,2021-01-01,1606,1467,139,8.7
35021,2021-01-01,285,272,13,4.6
35023,2021-01-01,1977,1855,122,6.2
35025,2021-01-01,28949,25149,3800,13.1
35027,2021-01-01,9321,8377,944,10.1
35028,2021-01-01,10287,9918,369,3.6
35029,2021-01-01,10122,8299,1823,18
35031,2021-01-01,24892,21859,3033,12.2
35033,2021-01-01,2065,1895,170,8.2
35035,2021-01-01,25959,23810,2149,8.3
35037,2021-01-01,3179,2902,277,8.7
35039,2021-01-01,17234,15665,1569,9.1
35041,2021-01-01,8114,7555,559,6.9
35043,2021-01-01,67218,61050,6168,9.2
35045,2021-01-01,50363,44842,5521,11
35047,2021-01-01,10673,9671,1002,9.4
35049,2021-01-01,70527,64444,6083,8.6
35051,2021-01-01,4283,3850,433,10.1
35053,2021-01-01,6401,5899,502,7.8
35055,2021-01-01,15086,13278,1808,12
35057,2021-01-01,5444,4904,540,9.9
35059,2021-01-01,1627,1545,82,5
35061,2021-01-01,30594,27844,2750,9
36001,2021-01-01,156911,147444,9467,6
36003,2021-01-01,19532,18123,1409,7.2
36005,2021-01-01,585733,482248,103485,17.7
36007,2021-01-01,81210,75079,6131,7.5
36009,2021-01-01,33766,31212,2554,7.6
36011,2021-01-01,35601,33127,2474,6.9
36013,2021-01-01,53216,48105,5111,9.6
36015,2021-01-01,35055,32506,2549,7.3
36017,2021-01-01,22013,20616,1397,6.3
36019,2021-01-01,35730,33109,2621,7.3
36021,2021-01-01,30054,28378,1676,5.6
36023,2021-01-01,22537,20868,1669,7.4
36025,2021-01-01,18689,17456,1233,6.6
36027,2021-01-01,140796,132207,8589,6.1
36029,2021-01-01,438292,403905,34387,7.8
36031,2021-01-01,16912,15761,1151,6.8
36033,2021-01-01,19421,18157,1264,6.5
36035,2021-01-01,22488,20799,1689,7.5
36037,2021-01-01,29026,27216,1810,6.2
36039,2021-01-01,20746,19356,1390,6.7
36041,2021-01-01,2046,1905,141,6.9
36043,2021-01-01,27636,25286,2350,8.5
36045,2021-01-01,42980,39892,3088,7.2
36047,2021-01-01,NA,980992,152500,13.5
36049,2021-01-01,11759,10863,896,7.6
36051,2021-01-01,30266,28377,1889,6.2
36053,2021-01-01,32197,30032,2165,6.7
36055,2021-01-01,361025,334717,26308,7.3
36057,2021-01-01,21932,20211,1721,7.8
36059,2021-01-01,686842,643640,43202,6.3
36061,2021-01-01,842359,757513,84846,10.1
36063,2021-01-01,97216,89395,7821,8
36065,2021-01-01,99871,92532,7339,7.3
36067,2021-01-01,217297,201971,15326,7.1
36069,2021-01-01,54824,51485,3339,6.1
36071,2021-01-01,181771,169799,11972,6.6
36073,2021-01-01,17404,16138,1266,7.3
36075,2021-01-01,51698,47581,4117,8
36077,2021-01-01,26141,24396,1745,6.7
36079,2021-01-01,49441,46605,2836,5.7
36081,2021-01-01,NA,936737,137876,12.8
36083,2021-01-01,80660,75890,4770,5.9
36085,2021-01-01,207451,183885,23566,11.4
36087,2021-01-01,150923,141710,9213,6.1
36089,2021-01-01,42899,39878,3021,7
36091,2021-01-01,118427,112109,6318,5.3
36093,2021-01-01,76583,71405,5178,6.8
36095,2021-01-01,14558,13604,954,6.6
36097,2021-01-01,7927,7333,594,7.5
36099,2021-01-01,15189,14141,1048,6.9
36101,2021-01-01,42230,39284,2946,7
36103,2021-01-01,752396,704093,48303,6.4
36105,2021-01-01,35548,33070,2478,7
36107,2021-01-01,21903,20525,1378,6.3
36109,2021-01-01,47751,45227,2524,5.3
36111,2021-01-01,85160,79458,5702,6.7
36113,2021-01-01,30988,28748,2240,7.2
36115,2021-01-01,27610,25872,1738,6.3
36117,2021-01-01,43408,40716,2692,6.2
36119,2021-01-01,472502,441114,31388,6.6
36121,2021-01-01,18003,16770,1233,6.8
36123,2021-01-01,11766,11113,653,5.5
37001,2021-01-01,81119,76343,4776,5.9
37003,2021-01-01,17818,16902,916,5.1
37005,2021-01-01,4123,3869,254,6.2
37007,2021-01-01,10578,9762,816,7.7
37009,2021-01-01,12683,12002,681,5.4
37011,2021-01-01,7479,7081,398,5.3
37013,2021-01-01,19652,18480,1172,6
37015,2021-01-01,7707,7219,488,6.3
37017,2021-01-01,14733,13723,1010,6.9
37019,2021-01-01,51398,47416,3982,7.7
37021,2021-01-01,135909,128259,7650,5.6
37023,2021-01-01,40521,38203,2318,5.7
37025,2021-01-01,108947,102925,6022,5.5
37027,2021-01-01,36247,33984,2263,6.2
37029,2021-01-01,4588,4366,222,4.8
37031,2021-01-01,31175,29506,1669,5.4
37033,2021-01-01,9669,9046,623,6.4
37035,2021-01-01,78483,73925,4558,5.8
37037,2021-01-01,35569,34019,1550,4.4
37039,2021-01-01,10617,9952,665,6.3
37041,2021-01-01,5574,5233,341,6.1
37043,2021-01-01,4038,3799,239,5.9
37045,2021-01-01,48317,45171,3146,6.5
37047,2021-01-01,22262,20476,1786,8
37049,2021-01-01,41060,38631,2429,5.9
37051,2021-01-01,125728,115317,10411,8.3
37053,2021-01-01,13945,13165,780,5.6
37055,2021-01-01,18337,16449,1888,10.3
37057,2021-01-01,79274,74711,4563,5.8
37059,2021-01-01,20084,19067,1017,5.1
37061,2021-01-01,24896,23581,1315,5.3
37063,2021-01-01,171397,162428,8969,5.2
37065,2021-01-01,21034,18983,2051,9.8
37067,2021-01-01,184811,173677,11134,6
37069,2021-01-01,31549,29703,1846,5.9
37071,2021-01-01,109835,102788,7047,6.4
37073,2021-01-01,5107,4849,258,5.1
37075,2021-01-01,2970,2696,274,9.2
37077,2021-01-01,29777,28349,1428,4.8
37079,2021-01-01,9724,9248,476,4.9
37081,2021-01-01,256961,239412,17549,6.8
37083,2021-01-01,20177,18411,1766,8.8
37085,2021-01-01,53229,49802,3427,6.4
37087,2021-01-01,28779,27168,1611,5.6
37089,2021-01-01,52825,50068,2757,5.2
37091,2021-01-01,8975,8358,617,6.9
37093,2021-01-01,19742,18206,1536,7.8
37095,2021-01-01,1724,1558,166,9.6
37097,2021-01-01,89080,84016,5064,5.7
37099,2021-01-01,18535,17442,1093,5.9
37101,2021-01-01,99787,94593,5194,5.2
37103,2021-01-01,4240,4018,222,5.2
37105,2021-01-01,26114,24452,1662,6.4
37107,2021-01-01,27700,26063,1637,5.9
37109,2021-01-01,43439,41243,2196,5.1
37111,2021-01-01,20345,19168,1177,5.8
37113,2021-01-01,15539,14666,873,5.6
37115,2021-01-01,9685,9150,535,5.5
37117,2021-01-01,9113,8499,614,6.7
37119,2021-01-01,618721,581192,37529,6.1
37121,2021-01-01,5750,5356,394,6.9
37123,2021-01-01,11504,10864,640,5.6
37125,2021-01-01,40765,38536,2229,5.5
37127,2021-01-01,42693,39570,3123,7.3
37129,2021-01-01,121122,114519,6603,5.5
37131,2021-01-01,7621,7051,570,7.5
37133,2021-01-01,64473,60441,4032,6.3
37135,2021-01-01,78484,75100,3384,4.3
37137,2021-01-01,5280,5015,265,5
37139,2021-01-01,16593,15449,1144,6.9
37141,2021-01-01,28277,26735,1542,5.5
37143,2021-01-01,4885,4573,312,6.4
37145,2021-01-01,18204,17100,1104,6.1
37147,2021-01-01,90229,84921,5308,5.9
37149,2021-01-01,8961,8466,495,5.5
37151,2021-01-01,64153,60412,3741,5.8
37153,2021-01-01,16808,15360,1448,8.6
37155,2021-01-01,50518,46038,4480,8.9
37157,2021-01-01,39125,36412,2713,6.9
37159,2021-01-01,65147,61140,4007,6.2
37161,2021-01-01,24705,22748,1957,7.9
37163,2021-01-01,28744,27190,1554,5.4
37165,2021-01-01,11494,10185,1309,11.4
37167,2021-01-01,29853,28289,1564,5.2
37169,2021-01-01,21173,20016,1157,5.5
37171,2021-01-01,32458,30675,1783,5.5
37173,2021-01-01,6599,6173,426,6.5
37175,2021-01-01,13982,13271,711,5.1
37177,2021-01-01,1284,1168,116,9
37179,2021-01-01,122137,116272,5865,4.8
37181,2021-01-01,16976,15409,1567,9.2
37183,2021-01-01,590765,561476,29289,5
37185,2021-01-01,6506,5911,595,9.1
37187,2021-01-01,4472,4088,384,8.6
37189,2021-01-01,28219,26924,1295,4.6
37191,2021-01-01,50694,47524,3170,6.3
37193,2021-01-01,28269,26666,1603,5.7
37195,2021-01-01,34299,31701,2598,7.6
37197,2021-01-01,17292,16387,905,5.2
37199,2021-01-01,8226,7770,456,5.5
38001,2021-01-01,957,919,38,4
38003,2021-01-01,5135,4931,204,4
38005,2021-01-01,2333,2183,150,6.4
38007,2021-01-01,374,359,15,4
38009,2021-01-01,2888,2676,212,7.3
38011,2021-01-01,1585,1534,51,3.2
38013,2021-01-01,1006,947,59,5.9
38015,2021-01-01,50773,48561,2212,4.4
38017,2021-01-01,104243,100098,4145,4
38019,2021-01-01,1870,1798,72,3.9
38021,2021-01-01,2260,2183,77,3.4
38023,2021-01-01,1351,1309,42,3.1
38025,2021-01-01,2795,2654,141,5
38027,2021-01-01,1170,1099,71,6.1
38029,2021-01-01,1494,1392,102,6.8
38031,2021-01-01,1527,1468,59,3.9
38033,2021-01-01,829,803,26,3.1
38035,2021-01-01,35952,34395,1557,4.3
38037,2021-01-01,1190,1140,50,4.2
38039,2021-01-01,994,955,39,3.9
38041,2021-01-01,1359,1289,70,5.2
38043,2021-01-01,1298,1199,99,7.6
38045,2021-01-01,1986,1930,56,2.8
38047,2021-01-01,851,817,34,4
38049,2021-01-01,3022,2829,193,6.4
38051,2021-01-01,1082,1031,51,4.7
38053,2021-01-01,8273,7607,666,8.1
38055,2021-01-01,4652,4397,255,5.5
38057,2021-01-01,3440,3205,235,6.8
38059,2021-01-01,16831,15936,895,5.3
38061,2021-01-01,6400,6089,311,4.9
38063,2021-01-01,1365,1294,71,5.2
38065,2021-01-01,875,829,46,5.3
38067,2021-01-01,3274,3067,207,6.3
38069,2021-01-01,1695,1612,83,4.9
38071,2021-01-01,5533,5291,242,4.4
38073,2021-01-01,2817,2727,90,3.2
38075,2021-01-01,1211,1149,62,5.1
38077,2021-01-01,8389,8091,298,3.6
38079,2021-01-01,4554,3961,593,13
38081,2021-01-01,2788,2709,79,2.8
38083,2021-01-01,665,609,56,8.4
38085,2021-01-01,1192,1152,40,3.4
38087,2021-01-01,379,364,15,4
38089,2021-01-01,17433,16257,1176,6.7
38091,2021-01-01,910,882,28,3.1
38093,2021-01-01,10373,9951,422,4.1
38095,2021-01-01,1115,1067,48,4.3
38097,2021-01-01,4447,4302,145,3.3
38099,2021-01-01,5012,4721,291,5.8
38101,2021-01-01,30966,29109,1857,6
38103,2021-01-01,1895,1780,115,6.1
38105,2021-01-01,20572,18752,1820,8.8
39001,2021-01-01,10686,9850,836,7.8
39003,2021-01-01,48416,45596,2820,5.8
39005,2021-01-01,26338,24956,1382,5.2
39007,2021-01-01,42317,39416,2901,6.9
39009,2021-01-01,26712,25061,1651,6.2
39011,2021-01-01,24176,23214,962,4
39013,2021-01-01,28211,26117,2094,7.4
39015,2021-01-01,19121,17891,1230,6.4
39017,2021-01-01,191340,181372,9968,5.2
39019,2021-01-01,12753,11898,855,6.7
39021,2021-01-01,19425,18514,911,4.7
39023,2021-01-01,62325,58734,3591,5.8
39025,2021-01-01,105010,99646,5364,5.1
39027,2021-01-01,17427,16306,1121,6.4
39029,2021-01-01,45869,42830,3039,6.6
39031,2021-01-01,13452,12550,902,6.7
39033,2021-01-01,18107,16971,1136,6.3
39035,2021-01-01,595414,548274,47140,7.9
39037,2021-01-01,25291,24113,1178,4.7
39039,2021-01-01,17412,16513,899,5.2
39041,2021-01-01,111908,107310,4598,4.1
39043,2021-01-01,34079,31323,2756,8.1
39045,2021-01-01,78582,74689,3893,5
39047,2021-01-01,13634,12858,776,5.7
39049,2021-01-01,704606,665034,39572,5.6
39051,2021-01-01,21505,20308,1197,5.6
39053,2021-01-01,11956,11178,778,6.5
39055,2021-01-01,46992,44507,2485,5.3
39057,2021-01-01,82072,78160,3912,4.8
39059,2021-01-01,17630,16365,1265,7.2
39061,2021-01-01,410419,386454,23965,5.8
39063,2021-01-01,41010,39199,1811,4.4
39065,2021-01-01,13783,13005,778,5.6
39067,2021-01-01,6415,5938,477,7.4
39069,2021-01-01,12677,11878,799,6.3
39071,2021-01-01,17159,16043,1116,6.5
39073,2021-01-01,12975,12220,755,5.8
39075,2021-01-01,20601,19964,637,3.1
39077,2021-01-01,26463,24366,2097,7.9
39079,2021-01-01,12889,11961,928,7.2
39081,2021-01-01,26855,24842,2013,7.5
39083,2021-01-01,30441,28975,1466,4.8
39085,2021-01-01,122049,114253,7796,6.4
39087,2021-01-01,23367,22111,1256,5.4
39089,2021-01-01,90532,86201,4331,4.8
39091,2021-01-01,22160,21065,1095,4.9
39093,2021-01-01,149429,138550,10879,7.3
39095,2021-01-01,203273,188918,14355,7.1
39097,2021-01-01,20820,19881,939,4.5
39099,2021-01-01,98878,91597,7281,7.4
39101,2021-01-01,27691,26177,1514,5.5
39103,2021-01-01,94046,88943,5103,5.4
39105,2021-01-01,8738,8036,702,8
39107,2021-01-01,22853,22075,778,3.4
39109,2021-01-01,53563,50920,2643,4.9
39111,2021-01-01,5475,5014,461,8.4
39113,2021-01-01,250108,234407,15701,6.3
39115,2021-01-01,6514,5987,527,8.1
39117,2021-01-01,16855,15942,913,5.4
39119,2021-01-01,39784,37235,2549,6.4
39121,2021-01-01,4516,4133,383,8.5
39123,2021-01-01,19160,17548,1612,8.4
39125,2021-01-01,8548,8120,428,5
39127,2021-01-01,15946,14870,1076,6.7
39129,2021-01-01,26496,25125,1371,5.2
39131,2021-01-01,10629,9828,801,7.5
39133,2021-01-01,84605,79904,4701,5.6
39135,2021-01-01,20841,19862,979,4.7
39137,2021-01-01,18380,17683,697,3.8
39139,2021-01-01,51909,48611,3298,6.4
39141,2021-01-01,34603,32625,1978,5.7
39143,2021-01-01,29400,27698,1702,5.8
39145,2021-01-01,28577,26546,2031,7.1
39147,2021-01-01,26486,25038,1448,5.5
39149,2021-01-01,23580,22410,1170,5
39151,2021-01-01,182808,171947,10861,5.9
39153,2021-01-01,266064,249360,16704,6.3
39155,2021-01-01,83162,76846,6316,7.6
39157,2021-01-01,43328,40889,2439,5.6
39159,2021-01-01,29228,28099,1129,3.9
39161,2021-01-01,14466,13805,661,4.6
39163,2021-01-01,5494,5078,416,7.6
39165,2021-01-01,117482,112058,5424,4.6
39167,2021-01-01,26022,24334,1688,6.5
39169,2021-01-01,58602,56062,2540,4.3
39171,2021-01-01,18398,17496,902,4.9
39173,2021-01-01,68216,64918,3298,4.8
39175,2021-01-01,12743,12211,532,4.2
40001,2021-01-01,8530,8129,401,4.7
40003,2021-01-01,2820,2728,92,3.3
40005,2021-01-01,5363,5019,344,6.4
40007,2021-01-01,2555,2497,58,2.3
40009,2021-01-01,10025,9375,650,6.5
40011,2021-01-01,4264,4064,200,4.7
40013,2021-01-01,23283,22281,1002,4.3
40015,2021-01-01,12247,11642,605,4.9
40017,2021-01-01,76224,72949,3275,4.3
40019,2021-01-01,21966,20761,1205,5.5
40021,2021-01-01,20345,19336,1009,5
40023,2021-01-01,5748,5332,416,7.2
40025,2021-01-01,1497,1469,28,1.9
40027,2021-01-01,143411,137441,5970,4.2
40029,2021-01-01,2459,2304,155,6.3
40031,2021-01-01,48550,46147,2403,4.9
40033,2021-01-01,2746,2610,136,5
40035,2021-01-01,5835,5569,266,4.6
40037,2021-01-01,31608,29793,1815,5.7
40039,2021-01-01,15058,14354,704,4.7
40041,2021-01-01,18728,17869,859,4.6
40043,2021-01-01,2706,2584,122,4.5
40045,2021-01-01,2188,2096,92,4.2
40047,2021-01-01,26914,25605,1309,4.9
40049,2021-01-01,13087,12404,683,5.2
40051,2021-01-01,26887,25559,1328,4.9
40053,2021-01-01,2825,2730,95,3.4
40055,2021-01-01,1935,1799,136,7
40057,2021-01-01,1215,1177,38,3.1
40059,2021-01-01,1850,1790,60,3.2
40061,2021-01-01,4422,4106,316,7.1
40063,2021-01-01,5507,5132,375,6.8
40065,2021-01-01,11061,10676,385,3.5
40067,2021-01-01,2641,2506,135,5.1
40069,2021-01-01,3660,3436,224,6.1
40071,2021-01-01,18178,17144,1034,5.7
40073,2021-01-01,8822,8478,344,3.9
40075,2021-01-01,3674,3516,158,4.3
40077,2021-01-01,3163,2868,295,9.3
40079,2021-01-01,19634,18457,1177,6
40081,2021-01-01,15822,15074,748,4.7
40083,2021-01-01,22491,21518,973,4.3
40085,2021-01-01,6695,6482,213,3.2
40087,2021-01-01,20061,19208,853,4.3
40089,2021-01-01,15695,14700,995,6.3
40091,2021-01-01,7243,6658,585,8.1
40093,2021-01-01,3782,3616,166,4.4
40095,2021-01-01,6943,6573,370,5.3
40097,2021-01-01,19878,18883,995,5
40099,2021-01-01,6071,5723,348,5.7
40101,2021-01-01,29949,28255,1694,5.7
40103,2021-01-01,5634,5447,187,3.3
40105,2021-01-01,4739,4507,232,4.9
40107,2021-01-01,4544,4242,302,6.6
40109,2021-01-01,388607,368567,20040,5.2
40111,2021-01-01,15823,14731,1092,6.9
40113,2021-01-01,20684,19525,1159,5.6
40115,2021-01-01,14383,13762,621,4.3
40117,2021-01-01,7397,6969,428,5.8
40119,2021-01-01,38142,36475,1667,4.4
40121,2021-01-01,16801,15684,1117,6.6
40123,2021-01-01,19842,18984,858,4.3
40125,2021-01-01,32781,31072,1709,5.2
40127,2021-01-01,4640,4334,306,6.6
40129,2021-01-01,1872,1801,71,3.8
40131,2021-01-01,45254,42944,2310,5.1
40133,2021-01-01,9384,8753,631,6.7
40135,2021-01-01,16894,15965,929,5.5
40137,2021-01-01,18679,17517,1162,6.2
40139,2021-01-01,11714,11415,299,2.6
40141,2021-01-01,3111,2985,126,4.1
40143,2021-01-01,325382,307709,17673,5.4
40145,2021-01-01,38438,36513,1925,5
40147,2021-01-01,22498,21376,1122,5
40149,2021-01-01,5136,4834,302,5.9
40151,2021-01-01,4687,4550,137,2.9
40153,2021-01-01,8807,8251,556,6.3
41001,2021-01-01,7392,6842,550,7.4
41003,2021-01-01,46841,44414,2427,5.2
41005,2021-01-01,219978,205401,14577,6.6
41007,2021-01-01,19168,17402,1766,9.2
41009,2021-01-01,24345,22502,1843,7.6
41011,2021-01-01,27427,25311,2116,7.7
41013,2021-01-01,10628,9587,1041,9.8
41015,2021-01-01,9063,8252,811,8.9
41017,2021-01-01,100731,92727,8004,7.9
41019,2021-01-01,48356,45020,3336,6.9
41021,2021-01-01,1012,953,59,5.8
41023,2021-01-01,3218,2879,339,10.5
41025,2021-01-01,3735,3461,274,7.3
41027,2021-01-01,13457,12613,844,6.3
41029,2021-01-01,107594,99803,7791,7.2
41031,2021-01-01,10597,9611,986,9.3
41033,2021-01-01,37287,34315,2972,8
41035,2021-01-01,29703,26996,2707,9.1
41037,2021-01-01,3658,3414,244,6.7
41039,2021-01-01,179497,166328,13169,7.3
41041,2021-01-01,20550,18617,1933,9.4
41043,2021-01-01,59576,55056,4520,7.6
41045,2021-01-01,12748,12032,716,5.6
41047,2021-01-01,164960,153691,11269,6.8
41049,2021-01-01,5793,5431,362,6.2
41051,2021-01-01,459430,425025,34405,7.5
41053,2021-01-01,40866,38260,2606,6.4
41055,2021-01-01,978,926,52,5.3
41057,2021-01-01,11742,10782,960,8.2
41059,2021-01-01,37472,34728,2744,7.3
41061,2021-01-01,12184,11231,953,7.8
41063,2021-01-01,3514,3254,260,7.4
41065,2021-01-01,12674,11673,1001,7.9
41067,2021-01-01,323630,304636,18994,5.9
41069,2021-01-01,706,671,35,5
41071,2021-01-01,54600,51121,3479,6.4
42001,2021-01-01,53482,50450,3032,5.7
42003,2021-01-01,619205,570186,49019,7.9
42005,2021-01-01,30895,27926,2969,9.6
42007,2021-01-01,80759,73356,7403,9.2
42009,2021-01-01,22817,20966,1851,8.1
42011,2021-01-01,205830,189237,16593,8.1
42013,2021-01-01,58669,54035,4634,7.9
42015,2021-01-01,27738,25808,1930,7
42017,2021-01-01,330068,308472,21596,6.5
42019,2021-01-01,94987,88146,6841,7.2
42021,2021-01-01,54470,49603,4867,8.9
42023,2021-01-01,2044,1840,204,10
42025,2021-01-01,31355,28622,2733,8.7
42027,2021-01-01,71412,67111,4301,6
42029,2021-01-01,273841,259776,14065,5.1
42031,2021-01-01,16501,15182,1319,8
42033,2021-01-01,35309,32080,3229,9.1
42035,2021-01-01,17406,15903,1503,8.6
42037,2021-01-01,32891,30358,2533,7.7
42039,2021-01-01,37730,34459,3271,8.7
42041,2021-01-01,128283,121133,7150,5.6
42043,2021-01-01,142177,130913,11264,7.9
42045,2021-01-01,287935,265867,22068,7.7
42047,2021-01-01,14626,13341,1285,8.8
42049,2021-01-01,124871,112744,12127,9.7
42051,2021-01-01,55238,48981,6257,11.3
42053,2021-01-01,1777,1595,182,10.2
42055,2021-01-01,75560,70751,4809,6.4
42057,2021-01-01,7592,6973,619,8.2
42059,2021-01-01,15732,14337,1395,8.9
42061,2021-01-01,19134,17102,2032,10.6
42063,2021-01-01,36250,33092,3158,8.7
42065,2021-01-01,19683,18059,1624,8.3
42067,2021-01-01,12531,11689,842,6.7
42069,2021-01-01,101538,92648,8890,8.8
42071,2021-01-01,274689,257452,17237,6.3
42073,2021-01-01,39623,35557,4066,10.3
42075,2021-01-01,70330,65389,4941,7
42077,2021-01-01,189354,173809,15545,8.2
42079,2021-01-01,154248,138339,15909,10.3
42081,2021-01-01,55063,50354,4709,8.6
42083,2021-01-01,16736,15320,1416,8.5
42085,2021-01-01,47270,42834,4436,9.4
42087,2021-01-01,20988,19316,1672,8
42089,2021-01-01,79538,72186,7352,9.2
42091,2021-01-01,437130,410198,26932,6.2
42093,2021-01-01,8941,8418,523,5.8
42095,2021-01-01,156619,145308,11311,7.2
42097,2021-01-01,41093,37466,3627,8.8
42099,2021-01-01,23697,22299,1398,5.9
42101,2021-01-01,698987,620400,78587,11.2
42103,2021-01-01,23791,21670,2121,8.9
42105,2021-01-01,7147,6488,659,9.2
42107,2021-01-01,65020,59537,5483,8.4
42109,2021-01-01,18929,17615,1314,6.9
42111,2021-01-01,33006,30054,2952,8.9
42113,2021-01-01,2613,2380,233,8.9
42115,2021-01-01,19509,18161,1348,6.9
42117,2021-01-01,18467,16856,1611,8.7
42119,2021-01-01,18667,17479,1188,6.4
42121,2021-01-01,21636,19725,1911,8.8
42123,2021-01-01,18375,16843,1532,8.3
42125,2021-01-01,102743,93778,8965,8.7
42127,2021-01-01,21955,20001,1954,8.9
42129,2021-01-01,172498,158168,14330,8.3
42131,2021-01-01,13065,11955,1110,8.5
42133,2021-01-01,230647,215218,15429,6.7
44001,2021-01-01,25332,23205,2127,8.4
44003,2021-01-01,88346,81280,7066,8
44005,2021-01-01,43155,39386,3769,8.7
44007,2021-01-01,318097,290213,27884,8.8
44009,2021-01-01,66095,61001,5094,7.7
45001,2021-01-01,9957,9397,560,5.6
45003,2021-01-01,74668,71374,3294,4.4
45005,2021-01-01,2563,2337,226,8.8
45007,2021-01-01,89441,84911,4530,5.1
45009,2021-01-01,4713,4259,454,9.6
45011,2021-01-01,7836,7246,590,7.5
45013,2021-01-01,75766,72318,3448,4.6
45015,2021-01-01,103774,98734,5040,4.9
45017,2021-01-01,6371,6017,354,5.6
45019,2021-01-01,208849,198153,10696,5.1
45021,2021-01-01,24849,23118,1731,7
45023,2021-01-01,13402,12358,1044,7.8
45025,2021-01-01,21527,20165,1362,6.3
45027,2021-01-01,12494,11664,830,6.6
45029,2021-01-01,16438,15455,983,6
45031,2021-01-01,30094,28278,1816,6
45033,2021-01-01,13272,12357,915,6.9
45035,2021-01-01,76784,72941,3843,5
45037,2021-01-01,10636,10156,480,4.5
45039,2021-01-01,9335,8656,679,7.3
45041,2021-01-01,66590,63082,3508,5.3
45043,2021-01-01,25301,23600,1701,6.7
45045,2021-01-01,251580,239859,11721,4.7
45047,2021-01-01,31200,29349,1851,5.9
45049,2021-01-01,8009,7624,385,4.8
45051,2021-01-01,141453,131218,10235,7.2
45053,2021-01-01,12694,12081,613,4.8
45055,2021-01-01,28653,27241,1412,4.9
45057,2021-01-01,42038,39455,2583,6.1
45059,2021-01-01,29654,27920,1734,5.8
45061,2021-01-01,6691,6215,476,7.1
45063,2021-01-01,146555,140575,5980,4.1
45065,2021-01-01,3331,3105,226,6.8
45067,2021-01-01,13194,12139,1055,8
45069,2021-01-01,9250,8377,873,9.4
45071,2021-01-01,18872,18017,855,4.5
45073,2021-01-01,34253,32701,1552,4.5
45075,2021-01-01,34306,31344,2962,8.6
45077,2021-01-01,56265,53770,2495,4.4
45079,2021-01-01,194730,183868,10862,5.6
45081,2021-01-01,8372,8024,348,4.2
45083,2021-01-01,155733,147640,8093,5.2
45085,2021-01-01,43813,41130,2683,6.1
45087,2021-01-01,11814,10888,926,7.8
45089,2021-01-01,11633,10778,855,7.3
45091,2021-01-01,142294,134812,7482,5.3
46003,2021-01-01,1467,1433,34,2.3
46005,2021-01-01,9264,8991,273,2.9
46007,2021-01-01,1056,1015,41,3.9
46009,2021-01-01,2821,2730,91,3.2
46011,2021-01-01,18102,17494,608,3.4
46013,2021-01-01,20573,19947,626,3
46015,2021-01-01,2393,2328,65,2.7
46017,2021-01-01,721,698,23,3.2
46019,2021-01-01,4923,4748,175,3.6
46021,2021-01-01,777,755,22,2.8
46023,2021-01-01,3684,3531,153,4.2
46025,2021-01-01,2368,2277,91,3.8
46027,2021-01-01,7292,7077,215,2.9
46029,2021-01-01,15304,14799,505,3.3
46031,2021-01-01,1346,1300,46,3.4
46033,2021-01-01,4016,3844,172,4.3
46035,2021-01-01,10942,10628,314,2.9
46037,2021-01-01,2668,2526,142,5.3
46039,2021-01-01,2403,2291,112,4.7
46041,2021-01-01,2209,2116,93,4.2
46043,2021-01-01,1548,1508,40,2.6
46045,2021-01-01,2019,1956,63,3.1
46047,2021-01-01,2936,2790,146,5
46049,2021-01-01,1024,999,25,2.4
46051,2021-01-01,4366,4182,184,4.2
46053,2021-01-01,1978,1914,64,3.2
46055,2021-01-01,1087,1057,30,2.8
46057,2021-01-01,3319,3225,94,2.8
46059,2021-01-01,1783,1742,41,2.3
46061,2021-01-01,1758,1679,79,4.5
46063,2021-01-01,705,687,18,2.6
46065,2021-01-01,10001,9730,271,2.7
46067,2021-01-01,3642,3512,130,3.6
46069,2021-01-01,683,667,16,2.3
46071,2021-01-01,1113,1053,60,5.4
46073,2021-01-01,1210,1184,26,2.1
46075,2021-01-01,461,449,12,2.6
46077,2021-01-01,2657,2579,78,2.9
46079,2021-01-01,6393,6203,190,3
46081,2021-01-01,13400,12980,420,3.1
46083,2021-01-01,35956,35054,902,2.5
46085,2021-01-01,1584,1514,70,4.4
46087,2021-01-01,3099,3008,91,2.9
46089,2021-01-01,1012,967,45,4.4
46091,2021-01-01,2403,2308,95,4
46093,2021-01-01,13699,13279,420,3.1
46095,2021-01-01,706,679,27,3.8
46097,2021-01-01,1108,1068,40,3.6
46099,2021-01-01,113655,110060,3595,3.2
46101,2021-01-01,3924,3811,113,2.9
46102,2021-01-01,3732,3396,336,9
46103,2021-01-01,56185,54288,1897,3.4
46105,2021-01-01,1374,1328,46,3.3
46107,2021-01-01,974,947,27,2.8
46109,2021-01-01,4744,4488,256,5.4
46111,2021-01-01,1170,1129,41,3.5
46115,2021-01-01,3068,2968,100,3.3
46117,2021-01-01,1908,1844,64,3.4
46119,2021-01-01,791,775,16,2
46121,2021-01-01,3013,2875,138,4.6
46123,2021-01-01,2997,2925,72,2.4
46125,2021-01-01,4657,4529,128,2.7
46127,2021-01-01,8458,8140,318,3.8
46129,2021-01-01,2102,1979,123,5.9
46135,2021-01-01,11610,11287,323,2.8
46137,2021-01-01,946,915,31,3.3
47001,2021-01-01,34757,33023,1734,5
47003,2021-01-01,20836,19722,1114,5.3
47005,2021-01-01,6706,6269,437,6.5
47007,2021-01-01,4276,3953,323,7.6
47009,2021-01-01,64170,61209,2961,4.6
47011,2021-01-01,52782,50042,2740,5.2
47013,2021-01-01,14935,13996,939,6.3
47015,2021-01-01,6568,6287,281,4.3
47017,2021-01-01,12161,11412,749,6.2
47019,2021-01-01,23559,22245,1314,5.6
47021,2021-01-01,21581,20742,839,3.9
47023,2021-01-01,8489,8105,384,4.5
47025,2021-01-01,12970,12251,719,5.5
47027,2021-01-01,2764,2570,194,7
47029,2021-01-01,14574,13328,1246,8.5
47031,2021-01-01,25575,24369,1206,4.7
47033,2021-01-01,6905,6572,333,4.8
47035,2021-01-01,22782,21177,1605,7
47037,2021-01-01,402073,382483,19590,4.9
47039,2021-01-01,4399,4089,310,7
47041,2021-01-01,7665,7250,415,5.4
47043,2021-01-01,26730,25648,1082,4
47045,2021-01-01,15777,14811,966,6.1
47047,2021-01-01,19184,18193,991,5.2
47049,2021-01-01,7589,7174,415,5.5
47051,2021-01-01,19462,18549,913,4.7
47053,2021-01-01,21943,20756,1187,5.4
47055,2021-01-01,14580,13823,757,5.2
47057,2021-01-01,9614,9034,580,6
47059,2021-01-01,28724,26969,1755,6.1
47061,2021-01-01,5066,4718,348,6.9
47063,2021-01-01,28025,26629,1396,5
47065,2021-01-01,182586,173288,9298,5.1
47067,2021-01-01,2148,2015,133,6.2
47069,2021-01-01,9314,8586,728,7.8
47071,2021-01-01,10336,9716,620,6
47073,2021-01-01,23574,22182,1392,5.9
47075,2021-01-01,7824,7269,555,7.1
47077,2021-01-01,12088,11371,717,5.9
47079,2021-01-01,13437,12623,814,6.1
47081,2021-01-01,11257,10785,472,4.2
47083,2021-01-01,3253,3006,247,7.6
47085,2021-01-01,8737,8281,456,5.2
47087,2021-01-01,4866,4583,283,5.8
47089,2021-01-01,24758,23377,1381,5.6
47091,2021-01-01,7929,7499,430,5.4
47093,2021-01-01,245620,235269,10351,4.2
47095,2021-01-01,1714,1571,143,8.3
47097,2021-01-01,9848,9173,675,6.9
47099,2021-01-01,19236,18228,1008,5.2
47101,2021-01-01,5330,5047,283,5.3
47103,2021-01-01,16021,15175,846,5.3
47105,2021-01-01,23741,22714,1027,4.3
47107,2021-01-01,23289,22083,1206,5.2
47109,2021-01-01,8405,7764,641,7.6
47111,2021-01-01,11323,10741,582,5.1
47113,2021-01-01,49147,46479,2668,5.4
47115,2021-01-01,12362,11668,694,5.6
47117,2021-01-01,15231,14478,753,4.9
47119,2021-01-01,50211,47419,2792,5.6
47121,2021-01-01,5265,4907,358,6.8
47123,2021-01-01,20293,19276,1017,5
47125,2021-01-01,86909,81932,4977,5.7
47127,2021-01-01,3519,3386,133,3.8
47129,2021-01-01,7866,7375,491,6.2
47131,2021-01-01,12364,11552,812,6.6
47133,2021-01-01,9852,9350,502,5.1
47135,2021-01-01,3063,2820,243,7.9
47137,2021-01-01,2211,2095,116,5.2
47139,2021-01-01,7454,7064,390,5.2
47141,2021-01-01,35403,33672,1731,4.9
47143,2021-01-01,13143,12198,945,7.2
47145,2021-01-01,23515,22170,1345,5.7
47147,2021-01-01,37735,36191,1544,4.1
47149,2021-01-01,185473,177784,7689,4.1
47151,2021-01-01,8226,7695,531,6.5
47153,2021-01-01,6144,5781,363,5.9
47155,2021-01-01,52578,48778,3800,7.2
47157,2021-01-01,449849,415120,34729,7.7
47159,2021-01-01,9359,8981,378,4
47161,2021-01-01,5495,5174,321,5.8
47163,2021-01-01,69790,65886,3904,5.6
47165,2021-01-01,102898,98630,4268,4.1
47167,2021-01-01,27711,26269,1442,5.2
47169,2021-01-01,5486,5224,262,4.8
47171,2021-01-01,7104,6568,536,7.5
47173,2021-01-01,7688,7281,407,5.3
47175,2021-01-01,2011,1882,129,6.4
47177,2021-01-01,17088,16076,1012,5.9
47179,2021-01-01,59451,56633,2818,4.7
47181,2021-01-01,6502,6120,382,5.9
47183,2021-01-01,15549,14813,736,4.7
47185,2021-01-01,12086,11512,574,4.7
47187,2021-01-01,128912,124831,4081,3.2
47189,2021-01-01,77423,74350,3073,4
48001,2021-01-01,23221,21769,1452,6.3
48003,2021-01-01,9023,8287,736,8.2
48005,2021-01-01,35301,32400,2901,8.2
48007,2021-01-01,9017,8202,815,9
48009,2021-01-01,3909,3693,216,5.5
48011,2021-01-01,926,882,44,4.8
48013,2021-01-01,22031,20287,1744,7.9
48015,2021-01-01,13630,12684,946,6.9
48017,2021-01-01,2474,2328,146,5.9
48019,2021-01-01,9996,9401,595,6
48021,2021-01-01,43294,40797,2497,5.8
48023,2021-01-01,1828,1761,67,3.7
48025,2021-01-01,9835,8824,1011,10.3
48027,2021-01-01,145180,134873,10307,7.1
48029,2021-01-01,949485,884947,64538,6.8
48031,2021-01-01,6700,6440,260,3.9
48033,2021-01-01,492,478,14,2.8
48035,2021-01-01,8473,7989,484,5.7
48037,2021-01-01,38877,36140,2737,7
48039,2021-01-01,177433,161638,15795,8.9
48041,2021-01-01,116551,110283,6268,5.4
48043,2021-01-01,4127,3880,247,6
48045,2021-01-01,571,541,30,5.3
48047,2021-01-01,2656,2342,314,11.8
48049,2021-01-01,15338,14324,1014,6.6
48051,2021-01-01,8203,7658,545,6.6
48053,2021-01-01,24087,22956,1131,4.7
48055,2021-01-01,19680,18451,1229,6.2
48057,2021-01-01,12515,11755,760,6.1
48059,2021-01-01,6016,5668,348,5.8
48061,2021-01-01,169824,151983,17841,10.5
48063,2021-01-01,5071,4662,409,8.1
48065,2021-01-01,2969,2833,136,4.6
48067,2021-01-01,12325,11261,1064,8.6
48069,2021-01-01,3351,3206,145,4.3
48071,2021-01-01,19979,17853,2126,10.6
48073,2021-01-01,21458,19736,1722,8
48075,2021-01-01,3073,2931,142,4.6
48077,2021-01-01,4831,4516,315,6.5
48079,2021-01-01,1118,1043,75,6.7
48081,2021-01-01,1335,1251,84,6.3
48083,2021-01-01,2928,2696,232,7.9
48085,2021-01-01,576608,543696,32912,5.7
48087,2021-01-01,1056,998,58,5.5
48089,2021-01-01,9655,9061,594,6.2
48091,2021-01-01,75766,71401,4365,5.8
48093,2021-01-01,5705,5366,339,5.9
48095,2021-01-01,1329,1261,68,5.1
48097,2021-01-01,19114,17836,1278,6.7
48099,2021-01-01,24096,22470,1626,6.7
48101,2021-01-01,583,545,38,6.5
48103,2021-01-01,1577,1364,213,13.5
48105,2021-01-01,1490,1355,135,9.1
48107,2021-01-01,2452,2286,166,6.8
48109,2021-01-01,1199,1132,67,5.6
48111,2021-01-01,3679,3560,119,3.2
48113,2021-01-01,NA,NA,97050,7.1
48115,2021-01-01,4649,4214,435,9.4
48117,2021-01-01,8657,8278,379,4.4
48119,2021-01-01,2437,2298,139,5.7
48121,2021-01-01,508704,479352,29352,5.8
48123,2021-01-01,9127,8532,595,6.5
48125,2021-01-01,668,625,43,6.4
48127,2021-01-01,6106,5676,430,7
48129,2021-01-01,1456,1378,78,5.4
48131,2021-01-01,4796,4189,607,12.7
48133,2021-01-01,7220,6679,541,7.5
48135,2021-01-01,79820,70458,9362,11.7
48137,2021-01-01,1382,1318,64,4.6
48139,2021-01-01,94961,89414,5547,5.8
48141,2021-01-01,366877,337445,29432,8
48143,2021-01-01,19845,18616,1229,6.2
48145,2021-01-01,6628,6233,395,6
48147,2021-01-01,16981,16151,830,4.9
48149,2021-01-01,11723,11092,631,5.4
48151,2021-01-01,1624,1535,89,5.5
48153,2021-01-01,2538,2348,190,7.5
48155,2021-01-01,584,558,26,4.5
48157,2021-01-01,392731,362629,30102,7.7
48159,2021-01-01,4950,4660,290,5.9
48161,2021-01-01,6296,5738,558,8.9
48163,2021-01-01,9270,8682,588,6.3
48165,2021-01-01,9839,9201,638,6.5
48167,2021-01-01,163698,149489,14209,8.7
48169,2021-01-01,2011,1875,136,6.8
48171,2021-01-01,13285,12704,581,4.4
48173,2021-01-01,783,756,27,3.4
48175,2021-01-01,3189,2909,280,8.8
48177,2021-01-01,9757,9213,544,5.6
48179,2021-01-01,7612,6923,689,9.1
48181,2021-01-01,64839,61149,3690,5.7
48183,2021-01-01,56418,51820,4598,8.1
48185,2021-01-01,11083,10116,967,8.7
48187,2021-01-01,81476,76896,4580,5.6
48189,2021-01-01,11897,10998,899,7.6
48191,2021-01-01,1081,1010,71,6.6
48193,2021-01-01,3869,3673,196,5.1
48195,2021-01-01,2473,2369,104,4.2
48197,2021-01-01,1739,1648,91,5.2
48199,2021-01-01,25129,22747,2382,9.5
48201,2021-01-01,NA,NA,187163,8.3
48203,2021-01-01,28821,26440,2381,8.3
48205,2021-01-01,2592,2531,61,2.4
48207,2021-01-01,2667,2535,132,4.9
48209,2021-01-01,122597,115891,6706,5.5
48211,2021-01-01,1711,1620,91,5.3
48213,2021-01-01,37587,35155,2432,6.5
48215,2021-01-01,364306,321080,43226,11.9
48217,2021-01-01,16187,15130,1057,6.5
48219,2021-01-01,10454,9613,841,8
48221,2021-01-01,28044,26115,1929,6.9
48223,2021-01-01,17716,16766,950,5.4
48225,2021-01-01,9836,9180,656,6.7
48227,2021-01-01,13420,12284,1136,8.5
48229,2021-01-01,1875,1723,152,8.1
48231,2021-01-01,44219,41337,2882,6.5
48233,2021-01-01,8490,7814,676,8
48235,2021-01-01,757,706,51,6.7
48237,2021-01-01,3269,3029,240,7.3
48239,2021-01-01,7246,6804,442,6.1
48241,2021-01-01,12859,11271,1588,12.3
48243,2021-01-01,981,928,53,5.4
48245,2021-01-01,105875,92938,12937,12.2
48247,2021-01-01,1909,1693,216,11.3
48249,2021-01-01,15635,13533,2102,13.4
48251,2021-01-01,84052,78698,5354,6.4
48253,2021-01-01,5797,5352,445,7.7
48255,2021-01-01,6930,6456,474,6.8
48257,2021-01-01,68306,63962,4344,6.4
48259,2021-01-01,22395,21321,1074,4.8
48261,2021-01-01,179,165,14,7.8
48263,2021-01-01,448,432,16,3.6
48265,2021-01-01,21254,20040,1214,5.7
48267,2021-01-01,1795,1686,109,6.1
48269,2021-01-01,261,257,4,1.5
48271,2021-01-01,1325,1228,97,7.3
48273,2021-01-01,13475,12322,1153,8.6
48275,2021-01-01,1477,1388,89,6
48277,2021-01-01,23818,22160,1658,7
48279,2021-01-01,5365,5044,321,6
48281,2021-01-01,9121,8583,538,5.9
48283,2021-01-01,3501,3275,226,6.5
48285,2021-01-01,8431,7944,487,5.8
48287,2021-01-01,8839,8342,497,5.6
48289,2021-01-01,6234,5656,578,9.3
48291,2021-01-01,34069,29870,4199,12.3
48293,2021-01-01,8410,7725,685,8.1
48295,2021-01-01,1557,1486,71,4.6
48297,2021-01-01,5098,4653,445,8.7
48299,2021-01-01,8501,7954,547,6.4
48301,2021-01-01,267,264,3,1.1
48303,2021-01-01,158208,149126,9082,5.7
48305,2021-01-01,2768,2616,152,5.5
48307,2021-01-01,3286,3018,268,8.2
48309,2021-01-01,122123,114643,7480,6.1
48311,2021-01-01,673,655,18,2.7
48313,2021-01-01,4497,4116,381,8.5
48315,2021-01-01,4274,3915,359,8.4
48317,2021-01-01,2478,2315,163,6.6
48319,2021-01-01,1723,1615,108,6.3
48321,2021-01-01,16270,14479,1791,11
48323,2021-01-01,25478,21154,4324,17
48325,2021-01-01,21787,20422,1365,6.3
48327,2021-01-01,872,825,47,5.4
48329,2021-01-01,94877,87012,7865,8.3
48331,2021-01-01,9898,9127,771,7.8
48333,2021-01-01,1942,1841,101,5.2
48335,2021-01-01,2395,2181,214,8.9
48337,2021-01-01,8984,8379,605,6.7
48339,2021-01-01,283518,262247,21271,7.5
48341,2021-01-01,10745,10269,476,4.4
48343,2021-01-01,4739,4090,649,13.7
48345,2021-01-01,431,407,24,5.6
48347,2021-01-01,28496,26522,1974,6.9
48349,2021-01-01,23012,21533,1479,6.4
48351,2021-01-01,5101,4494,607,11.9
48353,2021-01-01,7316,6866,450,6.2
48355,2021-01-01,161861,147478,14383,8.9
48357,2021-01-01,3965,3714,251,6.3
48359,2021-01-01,909,864,45,5
48361,2021-01-01,36188,32211,3977,11
48363,2021-01-01,13095,12085,1010,7.7
48365,2021-01-01,9191,8349,842,9.2
48367,2021-01-01,69103,65072,4031,5.8
48369,2021-01-01,5104,4934,170,3.3
48371,2021-01-01,6769,6178,591,8.7
48373,2021-01-01,18833,17018,1815,9.6
48375,2021-01-01,54654,51648,3006,5.5
48377,2021-01-01,3168,2721,447,14.1
48379,2021-01-01,6211,5928,283,4.6
48381,2021-01-01,73093,69773,3320,4.5
48383,2021-01-01,1727,1538,189,10.9
48385,2021-01-01,1129,1047,82,7.3
48387,2021-01-01,5295,4904,391,7.4
48389,2021-01-01,8220,7554,666,8.1
48391,2021-01-01,3072,2796,276,9
48393,2021-01-01,408,390,18,4.4
48395,2021-01-01,7376,6873,503,6.8
48397,2021-01-01,53841,50851,2990,5.6
48399,2021-01-01,4533,4299,234,5.2
48401,2021-01-01,22257,20486,1771,8
48403,2021-01-01,4109,3618,491,11.9
48405,2021-01-01,2978,2664,314,10.5
48407,2021-01-01,11822,10721,1101,9.3
48409,2021-01-01,29092,25914,3178,10.9
48411,2021-01-01,2173,2042,131,6
48413,2021-01-01,1172,1083,89,7.6
48415,2021-01-01,6088,5547,541,8.9
48417,2021-01-01,1739,1640,99,5.7
48419,2021-01-01,11348,10530,818,7.2
48421,2021-01-01,1322,1269,53,4
48423,2021-01-01,109448,102182,7266,6.6
48425,2021-01-01,4398,4107,291,6.6
48427,2021-01-01,27044,21938,5106,18.9
48429,2021-01-01,4089,3816,273,6.7
48431,2021-01-01,563,519,44,7.8
48433,2021-01-01,577,543,34,5.9
48435,2021-01-01,1190,1064,126,10.6
48437,2021-01-01,2575,2410,165,6.4
48439,2021-01-01,NA,NA,73992,6.8
48441,2021-01-01,66350,62705,3645,5.5
48443,2021-01-01,408,392,16,3.9
48445,2021-01-01,4777,4402,375,7.9
48447,2021-01-01,631,594,37,5.9
48449,2021-01-01,13511,12618,893,6.6
48451,2021-01-01,53631,50225,3406,6.4
48453,2021-01-01,748301,708078,40223,5.4
48455,2021-01-01,5365,4899,466,8.7
48457,2021-01-01,7521,6721,800,10.6
48459,2021-01-01,17481,16085,1396,8
48461,2021-01-01,1908,1799,109,5.7
48463,2021-01-01,11184,10391,793,7.1
48465,2021-01-01,22988,21285,1703,7.4
48467,2021-01-01,26386,24767,1619,6.1
48469,2021-01-01,41036,37644,3392,8.3
48471,2021-01-01,24135,22269,1866,7.7
48473,2021-01-01,23854,21857,1997,8.4
48475,2021-01-01,5836,5255,581,10
48477,2021-01-01,15511,14491,1020,6.6
48479,2021-01-01,115840,106175,9665,8.3
48481,2021-01-01,21217,19666,1551,7.3
48483,2021-01-01,2308,2126,182,7.9
48485,2021-01-01,55310,51449,3861,7
48487,2021-01-01,5082,4696,386,7.6
48489,2021-01-01,6620,5775,845,12.8
48491,2021-01-01,322604,305830,16774,5.2
48493,2021-01-01,24837,23439,1398,5.6
48495,2021-01-01,3975,3579,396,10
48497,2021-01-01,32498,30480,2018,6.2
48499,2021-01-01,18187,16954,1233,6.8
48501,2021-01-01,3360,2988,372,11.1
48503,2021-01-01,7680,7233,447,5.8
48505,2021-01-01,4353,3692,661,15.2
48507,2021-01-01,3558,3010,548,15.4
49001,2021-01-01,2701,2609,92,3.4
49003,2021-01-01,26356,25551,805,3.1
49005,2021-01-01,65376,63737,1639,2.5
49007,2021-01-01,8544,8113,431,5
49009,2021-01-01,328,305,23,7
49011,2021-01-01,177275,171948,5327,3
49013,2021-01-01,7498,6970,528,7
49015,2021-01-01,4306,4092,214,5
49017,2021-01-01,2181,1882,299,13.7
49019,2021-01-01,5407,4802,605,11.2
49021,2021-01-01,25281,24377,904,3.6
49023,2021-01-01,6035,5874,161,2.7
49025,2021-01-01,3503,3336,167,4.8
49027,2021-01-01,5617,5441,176,3.1
49029,2021-01-01,5620,5463,157,2.8
49031,2021-01-01,458,428,30,6.6
49033,2021-01-01,937,894,43,4.6
49035,2021-01-01,644036,621424,22612,3.5
49037,2021-01-01,5011,4537,474,9.5
49039,2021-01-01,12625,12170,455,3.6
49041,2021-01-01,9623,9220,403,4.2
49043,2021-01-01,25442,24577,865,3.4
49045,2021-01-01,35387,34082,1305,3.7
49047,2021-01-01,12808,11805,1003,7.8
49049,2021-01-01,320257,310891,9366,2.9
49051,2021-01-01,16237,15668,569,3.5
49053,2021-01-01,80374,77207,3167,3.9
49055,2021-01-01,1258,1148,110,8.7
49057,2021-01-01,130827,126018,4809,3.7
50001,2021-01-01,19208,18621,587,3.1
50003,2021-01-01,16000,15270,730,4.6
50005,2021-01-01,13558,13029,529,3.9
50007,2021-01-01,87188,84481,2707,3.1
50009,2021-01-01,2466,2338,128,5.2
50011,2021-01-01,24414,23523,891,3.6
50013,2021-01-01,3744,3589,155,4.1
50015,2021-01-01,12300,11758,542,4.4
50017,2021-01-01,14704,14170,534,3.6
50019,2021-01-01,11946,11371,575,4.8
50021,2021-01-01,27650,26445,1205,4.4
50023,2021-01-01,31422,30471,951,3
50025,2021-01-01,20122,19183,939,4.7
50027,2021-01-01,27001,26006,995,3.7
51001,2021-01-01,15686,14610,1076,6.9
51003,2021-01-01,53779,51188,2591,4.8
51005,2021-01-01,6699,6302,397,5.9
51007,2021-01-01,6012,5668,344,5.7
51009,2021-01-01,14242,13476,766,5.4
51011,2021-01-01,6863,6453,410,6
51013,2021-01-01,147000,140625,6375,4.3
51015,2021-01-01,36680,35095,1585,4.3
51017,2021-01-01,2248,2078,170,7.6
51019,2021-01-01,36599,34749,1850,5.1
51021,2021-01-01,2802,2652,150,5.4
51023,2021-01-01,16730,16024,706,4.2
51025,2021-01-01,5809,5343,466,8
51027,2021-01-01,6317,5686,631,10
51029,2021-01-01,6164,5679,485,7.9
51031,2021-01-01,24697,23301,1396,5.7
51033,2021-01-01,14434,13542,892,6.2
51035,2021-01-01,12841,12048,793,6.2
51036,2021-01-01,3486,3275,211,6.1
51037,2021-01-01,5063,4789,274,5.4
51041,2021-01-01,178708,169350,9358,5.2
51043,2021-01-01,7294,6991,303,4.2
51045,2021-01-01,2225,2124,101,4.5
51047,2021-01-01,23832,22709,1123,4.7
51049,2021-01-01,4485,4203,282,6.3
51051,2021-01-01,4692,4329,363,7.7
51053,2021-01-01,13002,12173,829,6.4
51057,2021-01-01,5446,5080,366,6.7
51059,2021-01-01,607686,576587,31099,5.1
51061,2021-01-01,35786,34263,1523,4.3
51063,2021-01-01,7814,7444,370,4.7
51065,2021-01-01,13262,12596,666,5
51067,2021-01-01,25422,24056,1366,5.4
51069,2021-01-01,47567,45599,1968,4.1
51071,2021-01-01,7423,7043,380,5.1
51073,2021-01-01,18733,17796,937,5
51075,2021-01-01,10738,10252,486,4.5
51077,2021-01-01,8400,7994,406,4.8
51079,2021-01-01,9789,9368,421,4.3
51081,2021-01-01,4186,3892,294,7
51083,2021-01-01,14914,13950,964,6.5
51085,2021-01-01,55704,53348,2356,4.2
51087,2021-01-01,172995,163053,9942,5.7
51089,2021-01-01,23791,22188,1603,6.7
51091,2021-01-01,1237,1181,56,4.5
51093,2021-01-01,18622,17710,912,4.9
51095,2021-01-01,35323,33240,2083,5.9
51097,2021-01-01,3817,3633,184,4.8
51099,2021-01-01,13803,13213,590,4.3
51101,2021-01-01,8737,8296,441,5
51103,2021-01-01,5366,4920,446,8.3
51105,2021-01-01,8150,7680,470,5.8
51107,2021-01-01,215898,205964,9934,4.6
51109,2021-01-01,19589,18650,939,4.8
51111,2021-01-01,5284,4997,287,5.4
51113,2021-01-01,7207,6948,259,3.6
51115,2021-01-01,3946,3764,182,4.6
51117,2021-01-01,12647,11834,813,6.4
51119,2021-01-01,4991,4747,244,4.9
51121,2021-01-01,46910,44954,1956,4.2
51125,2021-01-01,7053,6690,363,5.1
51127,2021-01-01,12056,11542,514,4.3
51131,2021-01-01,5380,4931,449,8.3
51133,2021-01-01,5589,5130,459,8.2
51135,2021-01-01,7034,6649,385,5.5
51137,2021-01-01,16823,15928,895,5.3
51139,2021-01-01,11810,10917,893,7.6
51141,2021-01-01,7025,6588,437,6.2
51143,2021-01-01,29834,28112,1722,5.8
51145,2021-01-01,13446,12859,587,4.4
51147,2021-01-01,10171,9515,656,6.4
51149,2021-01-01,14412,13476,936,6.5
51153,2021-01-01,237850,224076,13774,5.8
51155,2021-01-01,15310,14373,937,6.1
51157,2021-01-01,3577,3433,144,4
51159,2021-01-01,4047,3823,224,5.5
51161,2021-01-01,47417,45233,2184,4.6
51163,2021-01-01,10409,9819,590,5.7
51165,2021-01-01,40292,38530,1762,4.4
51167,2021-01-01,11078,10376,702,6.3
51169,2021-01-01,8720,8313,407,4.7
51171,2021-01-01,22121,20973,1148,5.2
51173,2021-01-01,13148,12379,769,5.8
51175,2021-01-01,9010,8577,433,4.8
51177,2021-01-01,65107,61576,3531,5.4
51179,2021-01-01,70258,66538,3720,5.3
51181,2021-01-01,3495,3295,200,5.7
51183,2021-01-01,3675,3368,307,8.4
51185,2021-01-01,15563,14415,1148,7.4
51187,2021-01-01,19632,18591,1041,5.3
51191,2021-01-01,25242,23954,1288,5.1
51193,2021-01-01,9337,8734,603,6.5
51195,2021-01-01,12795,11858,937,7.3
51197,2021-01-01,13564,12743,821,6.1
51199,2021-01-01,31371,29884,1487,4.7
51510,2021-01-01,97112,91752,5360,5.5
51520,2021-01-01,7075,6597,478,6.8
51530,2021-01-01,3381,3202,179,5.3
51540,2021-01-01,24418,23052,1366,5.6
51550,2021-01-01,118530,111956,6574,5.5
51570,2021-01-01,8169,7618,551,6.7
51580,2021-01-01,2355,2152,203,8.6
51590,2021-01-01,19136,17470,1666,8.7
51595,2021-01-01,2322,2071,251,10.8
51600,2021-01-01,12579,11984,595,4.7
51610,2021-01-01,8074,7762,312,3.9
51620,2021-01-01,3650,3310,340,9.3
51630,2021-01-01,13579,12687,892,6.6
51640,2021-01-01,2822,2656,166,5.9
51650,2021-01-01,62674,57744,4930,7.9
51660,2021-01-01,23388,22064,1324,5.7
51670,2021-01-01,9470,8473,997,10.5
51678,2021-01-01,2062,1915,147,7.1
51680,2021-01-01,34892,32431,2461,7.1
51683,2021-01-01,20958,19756,1202,5.7
51685,2021-01-01,9138,8604,534,5.8
51690,2021-01-01,5599,5037,562,10
51700,2021-01-01,86935,80063,6872,7.9
51710,2021-01-01,108829,99745,9084,8.3
51720,2021-01-01,1624,1512,112,6.9
51730,2021-01-01,13122,11202,1920,14.6
51735,2021-01-01,6083,5857,226,3.7
51740,2021-01-01,43743,39500,4243,9.7
51750,2021-01-01,8184,7685,499,6.1
51760,2021-01-01,114958,105747,9211,8
51770,2021-01-01,47704,44402,3302,6.9
51775,2021-01-01,12294,11683,611,5
51790,2021-01-01,12042,11389,653,5.4
51800,2021-01-01,43457,40709,2748,6.3
51810,2021-01-01,222946,210996,11950,5.4
51820,2021-01-01,10532,9922,610,5.8
51830,2021-01-01,6460,6009,451,7
51840,2021-01-01,14533,13815,718,4.9
53001,2021-01-01,9461,8806,655,6.9
53003,2021-01-01,10149,9747,402,4
53005,2021-01-01,99866,93386,6480,6.5
53007,2021-01-01,41125,38295,2830,6.9
53009,2021-01-01,28920,26756,2164,7.5
53011,2021-01-01,230492,215839,14653,6.4
53013,2021-01-01,1671,1564,107,6.4
53015,2021-01-01,46408,43045,3363,7.2
53017,2021-01-01,20473,19008,1465,7.2
53019,2021-01-01,2411,2177,234,9.7
53021,2021-01-01,41934,38635,3299,7.9
53023,2021-01-01,796,742,54,6.8
53025,2021-01-01,46821,43066,3755,8
53027,2021-01-01,28833,26220,2613,9.1
53029,2021-01-01,35628,33416,2212,6.2
53031,2021-01-01,12654,11747,907,7.2
53033,2021-01-01,NA,NA,82170,6.3
53035,2021-01-01,123276,116019,7257,5.9
53037,2021-01-01,21389,19752,1637,7.7
53039,2021-01-01,9718,9028,690,7.1
53041,2021-01-01,34649,32261,2388,6.9
53043,2021-01-01,4602,4350,252,5.5
53045,2021-01-01,24815,22881,1934,7.8
53047,2021-01-01,19043,17525,1518,8
53049,2021-01-01,8802,7983,819,9.3
53051,2021-01-01,4776,4336,440,9.2
53053,2021-01-01,426036,395998,30038,7.1
53055,2021-01-01,8367,7837,530,6.3
53057,2021-01-01,59501,55114,4387,7.4
53059,2021-01-01,5312,4876,436,8.2
53061,2021-01-01,445431,412654,32777,7.4
53063,2021-01-01,245813,229267,16546,6.7
53065,2021-01-01,17897,16456,1441,8.1
53067,2021-01-01,139754,131342,8412,6
53069,2021-01-01,1416,1321,95,6.7
53071,2021-01-01,29393,27623,1770,6
53073,2021-01-01,109745,101958,7787,7.1
53075,2021-01-01,22755,21784,971,4.3
53077,2021-01-01,126849,116092,10757,8.5
54001,2021-01-01,7384,6847,537,7.3
54003,2021-01-01,57850,54990,2860,4.9
54005,2021-01-01,7300,6687,613,8.4
54007,2021-01-01,5047,4527,520,10.3
54009,2021-01-01,9873,9042,831,8.4
54011,2021-01-01,41762,39099,2663,6.4
54013,2021-01-01,2487,2055,432,17.4
54015,2021-01-01,3101,2752,349,11.3
54017,2021-01-01,3694,3468,226,6.1
54019,2021-01-01,16036,14606,1430,8.9
54021,2021-01-01,2315,2063,252,10.9
54023,2021-01-01,5960,5559,401,6.7
54025,2021-01-01,15394,14321,1073,7
54027,2021-01-01,10895,10364,531,4.9
54029,2021-01-01,12999,11874,1125,8.7
54031,2021-01-01,5895,5473,422,7.2
54033,2021-01-01,33411,31187,2224,6.7
54035,2021-01-01,12573,11589,984,7.8
54037,2021-01-01,29824,28490,1334,4.5
54039,2021-01-01,81315,75442,5873,7.2
54041,2021-01-01,6132,5487,645,10.5
54043,2021-01-01,7316,6646,670,9.2
54045,2021-01-01,10839,9819,1020,9.4
54047,2021-01-01,4380,3894,486,11.1
54049,2021-01-01,25207,23432,1775,7
54051,2021-01-01,13526,12321,1205,8.9
54053,2021-01-01,10377,9567,810,7.8
54055,2021-01-01,20648,18963,1685,8.2
54057,2021-01-01,12076,11288,788,6.5
54059,2021-01-01,6586,5841,745,11.3
54061,2021-01-01,54210,51460,2750,5.1
54063,2021-01-01,5973,5628,345,5.8
54065,2021-01-01,8416,7996,420,5
54067,2021-01-01,9570,8798,772,8.1
54069,2021-01-01,20261,18814,1447,7.1
54071,2021-01-01,3680,3521,159,4.3
54073,2021-01-01,2694,2411,283,10.5
54075,2021-01-01,4187,3912,275,6.6
54077,2021-01-01,15368,14397,971,6.3
54079,2021-01-01,26955,25402,1553,5.8
54081,2021-01-01,29964,27765,2199,7.3
54083,2021-01-01,12095,11088,1007,8.3
54085,2021-01-01,4320,3973,347,8
54087,2021-01-01,5101,4470,631,12.4
54089,2021-01-01,4265,3948,317,7.4
54091,2021-01-01,7756,7269,487,6.3
54093,2021-01-01,3303,3021,282,8.5
54095,2021-01-01,3227,2871,356,11
54097,2021-01-01,9345,8544,801,8.6
54099,2021-01-01,15831,14704,1127,7.1
54101,2021-01-01,3287,3025,262,8
54103,2021-01-01,6836,6186,650,9.5
54105,2021-01-01,2286,2034,252,11
54107,2021-01-01,36009,33237,2772,7.7
54109,2021-01-01,6315,5738,577,9.1
55001,2021-01-01,7817,7187,630,8.1
55003,2021-01-01,7332,6881,451,6.2
55005,2021-01-01,23874,22658,1216,5.1
55007,2021-01-01,7188,6613,575,8
55009,2021-01-01,139401,133930,5471,3.9
55011,2021-01-01,6330,5977,353,5.6
55013,2021-01-01,7000,6501,499,7.1
55015,2021-01-01,27283,26411,872,3.2
55017,2021-01-01,33693,31902,1791,5.3
55019,2021-01-01,17809,17062,747,4.2
55021,2021-01-01,31045,29668,1377,4.4
55023,2021-01-01,7528,7083,445,5.9
55025,2021-01-01,315599,305044,10555,3.3
55027,2021-01-01,47104,45221,1883,4
55029,2021-01-01,13775,12804,971,7
55031,2021-01-01,22170,21003,1167,5.3
55033,2021-01-01,23679,22603,1076,4.5
55035,2021-01-01,58845,56523,2322,3.9
55037,2021-01-01,2183,2064,119,5.5
55039,2021-01-01,56988,54808,2180,3.8
55041,2021-01-01,3801,3489,312,8.2
55043,2021-01-01,27372,26381,991,3.6
55045,2021-01-01,20648,19854,794,3.8
55047,2021-01-01,9093,8583,510,5.6
55049,2021-01-01,13532,12943,589,4.4
55051,2021-01-01,2525,2327,198,7.8
55053,2021-01-01,9598,8935,663,6.9
55055,2021-01-01,45295,43425,1870,4.1
55057,2021-01-01,13160,12408,752,5.7
55059,2021-01-01,86118,81876,4242,4.9
55061,2021-01-01,10883,10484,399,3.7
55063,2021-01-01,64927,62442,2485,3.8
55065,2021-01-01,9954,9622,332,3.3
55067,2021-01-01,9368,8862,506,5.4
55069,2021-01-01,14624,13929,695,4.8
55071,2021-01-01,40212,38476,1736,4.3
55073,2021-01-01,72398,69870,2528,3.5
55075,2021-01-01,19475,18430,1045,5.4
55077,2021-01-01,7696,7227,469,6.1
55078,2021-01-01,1566,1435,131,8.4
55079,2021-01-01,451611,424940,26671,5.9
55081,2021-01-01,23281,22337,944,4.1
55083,2021-01-01,20387,19398,989,4.9
55085,2021-01-01,17252,16231,1021,5.9
55087,2021-01-01,102577,98786,3791,3.7
55089,2021-01-01,47207,45524,1683,3.6
55091,2021-01-01,4049,3846,203,5
55093,2021-01-01,24266,23185,1081,4.5
55095,2021-01-01,24227,22810,1417,5.8
55097,2021-01-01,37184,35587,1597,4.3
55099,2021-01-01,6141,5841,300,4.9
55101,2021-01-01,95542,90275,5267,5.5
55103,2021-01-01,9115,8714,401,4.4
55105,2021-01-01,84149,79962,4187,5
55107,2021-01-01,6722,6359,363,5.4
55109,2021-01-01,48454,46308,2146,4.4
55111,2021-01-01,33556,31836,1720,5.1
55113,2021-01-01,7671,7156,515,6.7
55115,2021-01-01,21014,20065,949,4.5
55117,2021-01-01,61474,59295,2179,3.5
55119,2021-01-01,11418,10873,545,4.8
55121,2021-01-01,15565,14793,772,5
55123,2021-01-01,15066,14408,658,4.4
55125,2021-01-01,9937,9321,616,6.2
55127,2021-01-01,55338,52808,2530,4.6
55129,2021-01-01,7732,7254,478,6.2
55131,2021-01-01,74302,71531,2771,3.7
55133,2021-01-01,216132,208136,7996,3.7
55135,2021-01-01,25624,24519,1105,4.3
55137,2021-01-01,11271,10658,613,5.4
55139,2021-01-01,91282,87939,3343,3.7
55141,2021-01-01,34191,32335,1856,5.4
56001,2021-01-01,19384,18506,878,4.5
56003,2021-01-01,5295,4961,334,6.3
56005,2021-01-01,23183,21546,1637,7.1
56007,2021-01-01,8109,7664,445,5.5
56009,2021-01-01,7858,7320,538,6.8
56011,2021-01-01,3881,3726,155,4
56013,2021-01-01,19239,17989,1250,6.5
56015,2021-01-01,6662,6340,322,4.8
56017,2021-01-01,2248,2120,128,5.7
56019,2021-01-01,4084,3841,243,6
56021,2021-01-01,50766,47999,2767,5.5
56023,2021-01-01,9436,8936,500,5.3
56025,2021-01-01,40676,37279,3397,8.4
56027,2021-01-01,1284,1216,68,5.3
56029,2021-01-01,14784,13866,918,6.2
56031,2021-01-01,4713,4449,264,5.6
56033,2021-01-01,16183,15260,923,5.7
56035,2021-01-01,3946,3616,330,8.4
56037,2021-01-01,20521,18928,1593,7.8
56039,2021-01-01,14899,14263,636,4.3
56041,2021-01-01,9168,8574,594,6.5
56043,2021-01-01,4043,3818,225,5.6
56045,2021-01-01,3838,3689,149,3.9
72001,2021-01-01,4053,3475,578,14.3
72003,2021-01-01,11382,10292,1090,9.6
72005,2021-01-01,13827,12424,1403,10.1
72007,2021-01-01,6147,5520,627,10.2
72009,2021-01-01,6014,5409,605,10.1
72011,2021-01-01,8486,7765,721,8.5
72013,2021-01-01,22905,20785,2120,9.3
72015,2021-01-01,4470,4003,467,10.4
72017,2021-01-01,5516,4925,591,10.7
72019,2021-01-01,6860,6189,671,9.8
72021,2021-01-01,62106,56607,5499,8.9
72023,2021-01-01,13276,12098,1178,8.9
72025,2021-01-01,45110,41447,3663,8.1
72027,2021-01-01,9131,8391,740,8.1
72029,2021-01-01,15396,14056,1340,8.7
72031,2021-01-01,58579,53527,5052,8.6
72033,2021-01-01,7449,6744,705,9.5
72035,2021-01-01,15065,13987,1078,7.2
72037,2021-01-01,3422,3086,336,9.8
72039,2021-01-01,3514,3057,457,13
72041,2021-01-01,14368,13454,914,6.4
72043,2021-01-01,9472,8468,1004,10.6
72045,2021-01-01,4645,4148,497,10.7
72047,2021-01-01,8513,7503,1010,11.9
72049,2021-01-01,839,770,69,8.2
72051,2021-01-01,12611,11706,905,7.2
72053,2021-01-01,10154,9078,1076,10.6
72054,2021-01-01,3105,2740,365,11.8
72055,2021-01-01,3926,3414,512,13
72057,2021-01-01,10462,9582,880,8.4
72059,2021-01-01,4487,3948,539,12
72061,2021-01-01,35699,33696,2003,5.6
72063,2021-01-01,17219,16158,1061,6.2
72065,2021-01-01,12738,11604,1134,8.9
72067,2021-01-01,5129,4658,471,9.2
72069,2021-01-01,16179,14715,1464,9
72071,2021-01-01,11196,10203,993,8.9
72073,2021-01-01,4261,3742,519,12.2
72075,2021-01-01,14615,13413,1202,8.2
72077,2021-01-01,11622,10538,1084,9.3
72079,2021-01-01,5040,4430,610,12.1
72081,2021-01-01,6617,5814,803,12.1
72083,2021-01-01,2534,2297,237,9.4
72085,2021-01-01,10675,9720,955,8.9
72087,2021-01-01,8007,7176,831,10.4
72089,2021-01-01,5877,5255,622,10.6
72091,2021-01-01,10677,9725,952,8.9
72093,2021-01-01,1892,1713,179,9.5
72095,2021-01-01,2626,2307,319,12.1
72097,2021-01-01,20437,18459,1978,9.7
72099,2021-01-01,9945,8961,984,9.9
72101,2021-01-01,7587,6775,812,10.7
72103,2021-01-01,7673,7016,657,8.6
72105,2021-01-01,6805,5988,817,12
72107,2021-01-01,4656,4053,603,13
72109,2021-01-01,4045,3570,475,11.7
72111,2021-01-01,5371,4713,658,12.3
72113,2021-01-01,42432,38436,3996,9.4
72115,2021-01-01,5800,5186,614,10.6
72117,2021-01-01,4405,3954,451,10.2
72119,2021-01-01,16207,14600,1607,9.9
72121,2021-01-01,5738,5153,585,10.2
72123,2021-01-01,6583,5856,727,11
72125,2021-01-01,9273,8343,930,10
72127,2021-01-01,128017,117744,10273,8
72129,2021-01-01,10896,9922,974,8.9
72131,2021-01-01,9688,8572,1116,11.5
72133,2021-01-01,9658,8934,724,7.5
72135,2021-01-01,25969,24041,1928,7.4
72137,2021-01-01,27658,25414,2244,8.1
72139,2021-01-01,25615,23920,1695,6.6
72141,2021-01-01,6242,5631,611,9.8
72143,2021-01-01,9321,8320,1001,10.7
72145,2021-01-01,12682,11244,1438,11.3
72147,2021-01-01,2462,2132,330,13.4
72149,2021-01-01,6875,5880,995,14.5
72151,2021-01-01,8271,7188,1083,13.1
72153,2021-01-01,9001,7775,1226,13.6
01001,2021-02-01,25586,24804,782,3.1
01003,2021-02-01,95654,92529,3125,3.3
01005,2021-02-01,8455,7935,520,6.2
01007,2021-02-01,8592,8282,310,3.6
01009,2021-02-01,24756,24213,543,2.2
01011,2021-02-01,4818,4605,213,4.4
01013,2021-02-01,8925,8358,567,6.4
01015,2021-02-01,46012,44088,1924,4.2
01017,2021-02-01,15926,15258,668,4.2
01019,2021-02-01,11518,11232,286,2.5
01021,2021-02-01,19628,19059,569,2.9
01023,2021-02-01,4613,4401,212,4.6
01025,2021-02-01,7687,7192,495,6.4
01027,2021-02-01,6121,5950,171,2.8
01029,2021-02-01,5602,5462,140,2.5
01031,2021-02-01,21456,20889,567,2.6
01033,2021-02-01,23513,22606,907,3.9
01035,2021-02-01,4443,4219,224,5
01037,2021-02-01,4335,4197,138,3.2
01039,2021-02-01,15080,14615,465,3.1
01041,2021-02-01,6131,5920,211,3.4
01043,2021-02-01,38676,37831,845,2.2
01045,2021-02-01,20786,20084,702,3.4
01047,2021-02-01,14271,13107,1164,8.2
01049,2021-02-01,30559,29797,762,2.5
01051,2021-02-01,36297,35199,1098,3
01053,2021-02-01,14299,13677,622,4.3
01055,2021-02-01,39634,37934,1700,4.3
01057,2021-02-01,6580,6373,207,3.1
01059,2021-02-01,14399,14069,330,2.3
01061,2021-02-01,10781,10484,297,2.8
01063,2021-02-01,2943,2716,227,7.7
01065,2021-02-01,5963,5565,398,6.7
01067,2021-02-01,6798,6576,222,3.3
01069,2021-02-01,46382,44672,1710,3.7
01071,2021-02-01,22750,22069,681,3
01073,2021-02-01,317905,304690,13215,4.2
01075,2021-02-01,5707,5537,170,3
01077,2021-02-01,41893,40653,1240,3
01079,2021-02-01,14362,13953,409,2.8
01081,2021-02-01,76305,74076,2229,2.9
01083,2021-02-01,45188,44140,1048,2.3
01085,2021-02-01,3613,3195,418,11.6
01087,2021-02-01,7957,7393,564,7.1
01089,2021-02-01,190079,184803,5276,2.8
01091,2021-02-01,7732,7365,367,4.7
01093,2021-02-01,13161,12776,385,2.9
01095,2021-02-01,44575,43499,1076,2.4
01097,2021-02-01,188422,177658,10764,5.7
01099,2021-02-01,7462,7001,461,6.2
01101,2021-02-01,106162,99822,6340,6
01103,2021-02-01,59196,57645,1551,2.6
01105,2021-02-01,3355,3052,303,9
01107,2021-02-01,7610,7292,318,4.2
01109,2021-02-01,15750,15226,524,3.3
01111,2021-02-01,9257,9022,235,2.5
01113,2021-02-01,23087,22381,706,3.1
01115,2021-02-01,40264,39180,1084,2.7
01117,2021-02-01,115123,112729,2394,2.1
01119,2021-02-01,4701,4484,217,4.6
01121,2021-02-01,35967,34441,1526,4.2
01123,2021-02-01,17614,16782,832,4.7
01125,2021-02-01,101836,97865,3971,3.9
01127,2021-02-01,24959,24043,916,3.7
01129,2021-02-01,6609,6287,322,4.9
01131,2021-02-01,2821,2490,331,11.7
01133,2021-02-01,9861,9585,276,2.8
02013,2021-02-01,2903,2844,59,2
02016,2021-02-01,4600,4496,104,2.3
02020,2021-02-01,149534,139821,9713,6.5
02050,2021-02-01,6717,5850,867,12.9
02060,2021-02-01,216,189,27,12.5
02068,2021-02-01,613,515,98,16
02070,2021-02-01,1539,1407,132,8.6
02090,2021-02-01,43567,41443,2124,4.9
02100,2021-02-01,928,783,145,15.6
02105,2021-02-01,963,834,129,13.4
02110,2021-02-01,16429,15490,939,5.7
02122,2021-02-01,25534,23286,2248,8.8
02130,2021-02-01,6287,5749,538,8.6
02150,2021-02-01,6157,5778,379,6.2
02158,2021-02-01,2187,1722,465,21.3
02164,2021-02-01,529,468,61,11.5
02170,2021-02-01,48233,44661,3572,7.4
02180,2021-02-01,4078,3722,356,8.7
02185,2021-02-01,2982,2791,191,6.4
02188,2021-02-01,3128,2803,325,10.4
02195,2021-02-01,1369,1252,117,8.5
02198,2021-02-01,2660,2409,251,9.4
02220,2021-02-01,3933,3683,250,6.4
02230,2021-02-01,547,432,115,21
02240,2021-02-01,3004,2793,211,7
02261,2021-02-01,3972,3582,390,9.8
02275,2021-02-01,972,897,75,7.7
02282,2021-02-01,250,227,23,9.2
02290,2021-02-01,2748,2126,622,22.6
04001,2021-02-01,19940,17555,2385,12
04003,2021-02-01,51754,48408,3346,6.5
04005,2021-02-01,73888,67304,6584,8.9
04007,2021-02-01,20802,19292,1510,7.3
04009,2021-02-01,16731,15742,989,5.9
04011,2021-02-01,4470,4206,264,5.9
04012,2021-02-01,9045,8425,620,6.9
04013,2021-02-01,NA,NA,156212,6.6
04015,2021-02-01,87879,81065,6814,7.8
04017,2021-02-01,39537,35796,3741,9.5
04019,2021-02-01,495938,460046,35892,7.2
04021,2021-02-01,193450,180111,13339,6.9
04023,2021-02-01,19599,17479,2120,10.8
04025,2021-02-01,107969,101438,6531,6
04027,2021-02-01,93264,82253,11011,11.8
05001,2021-02-01,9383,8973,410,4.4
05003,2021-02-01,7102,6433,669,9.4
05005,2021-02-01,16496,15652,844,5.1
05007,2021-02-01,142240,136921,5319,3.7
05009,2021-02-01,15714,15046,668,4.3
05011,2021-02-01,4347,4102,245,5.6
05013,2021-02-01,2430,2313,117,4.8
05015,2021-02-01,12293,11602,691,5.6
05017,2021-02-01,3207,2848,359,11.2
05019,2021-02-01,9320,8827,493,5.3
05021,2021-02-01,5456,5124,332,6.1
05023,2021-02-01,9023,8415,608,6.7
05025,2021-02-01,3192,3021,171,5.4
05027,2021-02-01,9075,8452,623,6.9
05029,2021-02-01,8432,7973,459,5.4
05031,2021-02-01,55722,53292,2430,4.4
05033,2021-02-01,26376,25109,1267,4.8
05035,2021-02-01,20995,19586,1409,6.7
05037,2021-02-01,7193,6764,429,6
05039,2021-02-01,2866,2732,134,4.7
05041,2021-02-01,5197,4829,368,7.1
05043,2021-02-01,7665,7173,492,6.4
05045,2021-02-01,61274,58466,2808,4.6
05047,2021-02-01,7424,7065,359,4.8
05049,2021-02-01,4870,4601,269,5.5
05051,2021-02-01,41424,38616,2808,6.8
05053,2021-02-01,8157,7820,337,4.1
05055,2021-02-01,19188,18225,963,5
05057,2021-02-01,9425,9005,420,4.5
05059,2021-02-01,14166,13466,700,4.9
05061,2021-02-01,5525,5295,230,4.2
05063,2021-02-01,16661,15794,867,5.2
05065,2021-02-01,4399,4085,314,7.1
05067,2021-02-01,5891,5475,416,7.1
05069,2021-02-01,27553,25361,2192,8
05071,2021-02-01,10214,9627,587,5.7
05073,2021-02-01,2420,2227,193,8
05075,2021-02-01,6809,6427,382,5.6
05077,2021-02-01,2760,2567,193,7
05079,2021-02-01,3844,3619,225,5.9
05081,2021-02-01,5400,5070,330,6.1
05083,2021-02-01,8672,8185,487,5.6
05085,2021-02-01,33275,31767,1508,4.5
05087,2021-02-01,7588,7266,322,4.2
05089,2021-02-01,6032,5651,381,6.3
05091,2021-02-01,19351,18145,1206,6.2
05093,2021-02-01,16808,15371,1437,8.5
05095,2021-02-01,2714,2537,177,6.5
05097,2021-02-01,2942,2766,176,6
05099,2021-02-01,3473,3308,165,4.8
05101,2021-02-01,3250,3100,150,4.6
05103,2021-02-01,9777,9291,486,5
05105,2021-02-01,4177,3961,216,5.2
05107,2021-02-01,6451,5848,603,9.3
05109,2021-02-01,4295,4041,254,5.9
05111,2021-02-01,9977,9450,527,5.3
05113,2021-02-01,7959,7479,480,6
05115,2021-02-01,27557,26139,1418,5.1
05117,2021-02-01,3617,3425,192,5.3
05119,2021-02-01,187237,175371,11866,6.3
05121,2021-02-01,7567,7153,414,5.5
05123,2021-02-01,7913,7274,639,8.1
05125,2021-02-01,57819,55390,2429,4.2
05127,2021-02-01,4358,4169,189,4.3
05129,2021-02-01,2781,2616,165,5.9
05131,2021-02-01,55865,53042,2823,5.1
05133,2021-02-01,5480,5145,335,6.1
05135,2021-02-01,5670,5276,394,6.9
05137,2021-02-01,4521,4183,338,7.5
05139,2021-02-01,15386,14233,1153,7.5
05141,2021-02-01,5722,5313,409,7.1
05143,2021-02-01,128073,123135,4938,3.9
05145,2021-02-01,33927,32077,1850,5.5
05147,2021-02-01,2823,2629,194,6.9
05149,2021-02-01,8000,7587,413,5.2
06001,2021-02-01,809704,754875,54829,6.8
06003,2021-02-01,633,587,46,7.3
06005,2021-02-01,14530,13385,1145,7.9
06007,2021-02-01,92449,85300,7149,7.7
06009,2021-02-01,21395,19984,1411,6.6
06011,2021-02-01,10564,8885,1679,15.9
06013,2021-02-01,539881,501594,38287,7.1
06015,2021-02-01,9328,8529,799,8.6
06017,2021-02-01,91758,85710,6048,6.6
06019,2021-02-01,444289,400086,44203,9.9
06021,2021-02-01,12503,11555,948,7.6
06023,2021-02-01,59800,55628,4172,7
06025,2021-02-01,66225,55707,10518,15.9
06027,2021-02-01,8348,7796,552,6.6
06029,2021-02-01,380745,339664,41081,10.8
06031,2021-02-01,55364,49415,5949,10.7
06033,2021-02-01,29122,26713,2409,8.3
06035,2021-02-01,9534,8877,657,6.9
06037,2021-02-01,NA,NA,556617,10.9
06039,2021-02-01,63323,57317,6006,9.5
06041,2021-02-01,131059,124471,6588,5
06043,2021-02-01,6718,6040,678,10.1
06045,2021-02-01,36765,34069,2696,7.3
06047,2021-02-01,115470,102222,13248,11.5
06049,2021-02-01,3150,2856,294,9.3
06051,2021-02-01,8425,7758,667,7.9
06053,2021-02-01,205496,183037,22459,10.9
06055,2021-02-01,68680,63790,4890,7.1
06057,2021-02-01,47098,44110,2988,6.3
06059,2021-02-01,NA,NA,104518,6.8
06061,2021-02-01,186993,176379,10614,5.7
06063,2021-02-01,7190,6316,874,12.2
06065,2021-02-01,NA,NA,90138,8
06067,2021-02-01,715339,660450,54889,7.7
06069,2021-02-01,31328,28666,2662,8.5
06071,2021-02-01,986044,905703,80341,8.1
06073,2021-02-01,NA,NA,112129,7.2
06075,2021-02-01,541149,510163,30986,5.7
06077,2021-02-01,333995,302198,31797,9.5
06079,2021-02-01,131000,122807,8193,6.3
06081,2021-02-01,424977,402498,22479,5.3
06083,2021-02-01,214597,199306,15291,7.1
06085,2021-02-01,NA,963250,54379,5.3
06087,2021-02-01,130371,119445,10926,8.4
06089,2021-02-01,73684,67929,5755,7.8
06091,2021-02-01,1297,1200,97,7.5
06093,2021-02-01,16639,15023,1616,9.7
06095,2021-02-01,203531,186978,16553,8.1
06097,2021-02-01,239584,224275,15309,6.4
06099,2021-02-01,241151,219459,21692,9
06101,2021-02-01,43991,39474,4517,10.3
06103,2021-02-01,25550,23495,2055,8
06105,2021-02-01,4449,4113,336,7.6
06107,2021-02-01,197795,175341,22454,11.4
06109,2021-02-01,19908,18176,1732,8.7
06111,2021-02-01,409716,381988,27728,6.8
06113,2021-02-01,106638,99379,7259,6.8
06115,2021-02-01,29452,26544,2908,9.9
08001,2021-02-01,280980,259510,21470,7.6
08003,2021-02-01,8350,7739,611,7.3
08005,2021-02-01,374309,347875,26434,7.1
08007,2021-02-01,7066,6588,478,6.8
08009,2021-02-01,2140,2076,64,3
08011,2021-02-01,1871,1749,122,6.5
08013,2021-02-01,196017,184750,11267,5.7
08014,2021-02-01,41112,38639,2473,6
08015,2021-02-01,9844,9275,569,5.8
08017,2021-02-01,1079,1047,32,3
08019,2021-02-01,6208,5791,417,6.7
08021,2021-02-01,4012,3752,260,6.5
08023,2021-02-01,1800,1650,150,8.3
08025,2021-02-01,1524,1425,99,6.5
08027,2021-02-01,2091,1975,116,5.5
08029,2021-02-01,14097,13073,1024,7.3
08031,2021-02-01,432463,400314,32149,7.4
08033,2021-02-01,1094,1018,76,6.9
08035,2021-02-01,199485,188741,10744,5.4
08037,2021-02-01,36792,34727,2065,5.6
08039,2021-02-01,15275,14566,709,4.6
08041,2021-02-01,350218,325127,25091,7.2
08043,2021-02-01,15559,14203,1356,8.7
08045,2021-02-01,32988,30913,2075,6.3
08047,2021-02-01,3991,3666,325,8.1
08049,2021-02-01,9871,9314,557,5.6
08051,2021-02-01,11732,11164,568,4.8
08053,2021-02-01,388,366,22,5.7
08055,2021-02-01,2702,2417,285,10.5
08057,2021-02-01,880,830,50,5.7
08059,2021-02-01,341202,319141,22061,6.5
08061,2021-02-01,967,924,43,4.4
08063,2021-02-01,4212,4062,150,3.6
08065,2021-02-01,5080,4790,290,5.7
08067,2021-02-01,31676,29295,2381,7.5
08069,2021-02-01,208485,195583,12902,6.2
08071,2021-02-01,6530,5993,537,8.2
08073,2021-02-01,2393,2255,138,5.8
08075,2021-02-01,11052,10424,628,5.7
08077,2021-02-01,76002,70052,5950,7.8
08079,2021-02-01,519,492,27,5.2
08081,2021-02-01,7446,6930,516,6.9
08083,2021-02-01,12565,11461,1104,8.8
08085,2021-02-01,21516,20061,1455,6.8
08087,2021-02-01,16115,15157,958,5.9
08089,2021-02-01,8213,7589,624,7.6
08091,2021-02-01,2432,2278,154,6.3
08093,2021-02-01,11372,10779,593,5.2
08095,2021-02-01,2354,2260,94,4
08097,2021-02-01,11269,10549,720,6.4
08099,2021-02-01,6154,5811,343,5.6
08101,2021-02-01,79095,71773,7322,9.3
08103,2021-02-01,2970,2745,225,7.6
08105,2021-02-01,5366,4925,441,8.2
08107,2021-02-01,17063,16214,849,5
08109,2021-02-01,3325,3059,266,8
08111,2021-02-01,470,439,31,6.6
08113,2021-02-01,5604,5261,343,6.1
08115,2021-02-01,1122,1076,46,4.1
08117,2021-02-01,24958,23766,1192,4.8
08119,2021-02-01,13147,12273,874,6.6
08121,2021-02-01,2907,2802,105,3.6
08123,2021-02-01,169265,157119,12146,7.2
08125,2021-02-01,5360,5164,196,3.7
09001,2021-02-01,417063,381761,35302,8.5
09003,2021-02-01,429741,392578,37163,8.6
09005,2021-02-01,91887,84431,7456,8.1
09007,2021-02-01,83621,77657,5964,7.1
09009,2021-02-01,415974,380226,35748,8.6
09011,2021-02-01,117900,106734,11166,9.5
09013,2021-02-01,76767,71275,5492,7.2
09015,2021-02-01,55997,51169,4828,8.6
10001,2021-02-01,79678,73668,6010,7.5
10003,2021-02-01,303376,283627,19749,6.5
10005,2021-02-01,106601,99682,6919,6.5
11001,2021-02-01,407673,376724,30949,7.6
12001,2021-02-01,139347,134820,4527,3.2
12003,2021-02-01,11953,11601,352,2.9
12005,2021-02-01,84440,81327,3113,3.7
12007,2021-02-01,11031,10657,374,3.4
12009,2021-02-01,285796,273817,11979,4.2
12011,2021-02-01,NA,967756,57632,5.6
12013,2021-02-01,4881,4717,164,3.4
12015,2021-02-01,72460,69513,2947,4.1
12017,2021-02-01,47238,44824,2414,5.1
12019,2021-02-01,106784,103622,3162,3
12021,2021-02-01,186411,180147,6264,3.4
12023,2021-02-01,30207,29011,1196,4
12027,2021-02-01,15441,15001,440,2.8
12029,2021-02-01,6171,5953,218,3.5
12031,2021-02-01,490191,469524,20667,4.2
12033,2021-02-01,147893,142001,5892,4
12035,2021-02-01,46985,44881,2104,4.5
12037,2021-02-01,4822,4644,178,3.7
12039,2021-02-01,18957,18016,941,5
12041,2021-02-01,7256,7031,225,3.1
12043,2021-02-01,5468,5299,169,3.1
12045,2021-02-01,5144,4943,201,3.9
12047,2021-02-01,4148,3931,217,5.2
12049,2021-02-01,8872,8552,320,3.6
12051,2021-02-01,16521,15785,736,4.5
12053,2021-02-01,72658,69129,3529,4.9
12055,2021-02-01,35323,33533,1790,5.1
12057,2021-02-01,769860,737360,32500,4.2
12059,2021-02-01,6947,6716,231,3.3
12061,2021-02-01,65229,62391,2838,4.4
12063,2021-02-01,17632,16970,662,3.8
12065,2021-02-01,5487,5285,202,3.7
12067,2021-02-01,2867,2788,79,2.8
12069,2021-02-01,149772,142125,7647,5.1
12071,2021-02-01,349112,334798,14314,4.1
12073,2021-02-01,154115,148277,5838,3.8
12075,2021-02-01,17175,16523,652,3.8
12077,2021-02-01,2643,2560,83,3.1
12079,2021-02-01,7701,7388,313,4.1
12081,2021-02-01,180445,173782,6663,3.7
12083,2021-02-01,141717,135432,6285,4.4
12085,2021-02-01,73543,71074,2469,3.4
12086,2021-02-01,NA,NA,103447,7.9
12087,2021-02-01,46173,44546,1627,3.5
12089,2021-02-01,41804,40451,1353,3.2
12091,2021-02-01,97071,94146,2925,3
12093,2021-02-01,17632,17054,578,3.3
12095,2021-02-01,715118,666042,49076,6.9
12097,2021-02-01,177907,162311,15596,8.8
12099,2021-02-01,727766,694879,32887,4.5
12101,2021-02-01,242199,231995,10204,4.2
12103,2021-02-01,492611,472727,19884,4
12105,2021-02-01,321713,304139,17574,5.5
12107,2021-02-01,26881,25414,1467,5.5
12109,2021-02-01,135322,131584,3738,2.8
12111,2021-02-01,147143,140096,7047,4.8
12113,2021-02-01,84715,82276,2439,2.9
12115,2021-02-01,188442,181458,6984,3.7
12117,2021-02-01,233676,223342,10334,4.4
12119,2021-02-01,32014,30565,1449,4.5
12121,2021-02-01,17808,17149,659,3.7
12123,2021-02-01,8094,7735,359,4.4
12125,2021-02-01,4567,4426,141,3.1
12127,2021-02-01,252358,240566,11792,4.7
12129,2021-02-01,15348,14952,396,2.6
12131,2021-02-01,32417,31355,1062,3.3
12133,2021-02-01,9627,9276,351,3.6
13001,2021-02-01,9374,9024,350,3.7
13003,2021-02-01,4721,4578,143,3
13005,2021-02-01,4701,4533,168,3.6
13007,2021-02-01,1177,1117,60,5.1
13009,2021-02-01,17852,16895,957,5.4
13011,2021-02-01,10155,9872,283,2.8
13013,2021-02-01,40886,39493,1393,3.4
13015,2021-02-01,50470,48375,2095,4.2
13017,2021-02-01,5470,5146,324,5.9
13019,2021-02-01,7676,7389,287,3.7
13021,2021-02-01,69017,65133,3884,5.6
13023,2021-02-01,4607,4362,245,5.3
13025,2021-02-01,7194,6903,291,4
13027,2021-02-01,7097,6808,289,4.1
13029,2021-02-01,19419,18789,630,3.2
13031,2021-02-01,37911,36186,1725,4.6
13033,2021-02-01,9318,8778,540,5.8
13035,2021-02-01,10936,10459,477,4.4
13037,2021-02-01,2318,2213,105,4.5
13039,2021-02-01,21804,21033,771,3.5
13043,2021-02-01,5786,5575,211,3.6
13045,2021-02-01,55223,52868,2355,4.3
13047,2021-02-01,33093,32227,866,2.6
13049,2021-02-01,5013,4840,173,3.5
13051,2021-02-01,144932,137767,7165,4.9
13053,2021-02-01,2013,1921,92,4.6
13055,2021-02-01,9696,9185,511,5.3
13057,2021-02-01,135058,131133,3925,2.9
13059,2021-02-01,58876,56322,2554,4.3
13061,2021-02-01,902,808,94,10.4
13063,2021-02-01,140682,130117,10565,7.5
13065,2021-02-01,3113,3017,96,3.1
13067,2021-02-01,419887,404069,15818,3.8
13069,2021-02-01,19310,18399,911,4.7
13071,2021-02-01,22574,21776,798,3.5
13073,2021-02-01,76481,74346,2135,2.8
13075,2021-02-01,8284,7983,301,3.6
13077,2021-02-01,74874,71996,2878,3.8
13079,2021-02-01,5663,5449,214,3.8
13081,2021-02-01,9626,9026,600,6.2
13083,2021-02-01,7947,7735,212,2.7
13085,2021-02-01,12518,12139,379,3
13087,2021-02-01,11608,11143,465,4
13089,2021-02-01,398863,377639,21224,5.3
13091,2021-02-01,7076,6763,313,4.4
13093,2021-02-01,4911,4632,279,5.7
13095,2021-02-01,37833,35180,2653,7
13097,2021-02-01,73036,69384,3652,5
13099,2021-02-01,4551,4314,237,5.2
13101,2021-02-01,1981,1929,52,2.6
13103,2021-02-01,32735,31667,1068,3.3
13105,2021-02-01,8104,7667,437,5.4
13107,2021-02-01,8707,8195,512,5.9
13109,2021-02-01,5181,4964,217,4.2
13111,2021-02-01,11336,10984,352,3.1
13113,2021-02-01,57267,55389,1878,3.3
13115,2021-02-01,44462,42634,1828,4.1
13117,2021-02-01,122965,119625,3340,2.7
13119,2021-02-01,10102,9696,406,4
13121,2021-02-01,561515,531525,29990,5.3
13123,2021-02-01,12143,11735,408,3.4
13125,2021-02-01,1296,1260,36,2.8
13127,2021-02-01,39028,37325,1703,4.4
13129,2021-02-01,29624,28568,1056,3.6
13131,2021-02-01,11025,10649,376,3.4
13133,2021-02-01,7119,6809,310,4.4
13135,2021-02-01,486617,467089,19528,4
13137,2021-02-01,18684,17933,751,4
13139,2021-02-01,103672,100535,3137,3
13141,2021-02-01,2579,2399,180,7
13143,2021-02-01,12434,11932,502,4
13145,2021-02-01,16694,16179,515,3.1
13147,2021-02-01,11676,11183,493,4.2
13149,2021-02-01,5215,4977,238,4.6
13151,2021-02-01,116619,110983,5636,4.8
13153,2021-02-01,72234,69553,2681,3.7
13155,2021-02-01,3606,3433,173,4.8
13157,2021-02-01,41695,40568,1127,2.7
13159,2021-02-01,6916,6661,255,3.7
13161,2021-02-01,6272,5990,282,4.5
13163,2021-02-01,6784,6413,371,5.5
13165,2021-02-01,3279,3110,169,5.2
13167,2021-02-01,4205,4035,170,4
13169,2021-02-01,13747,13300,447,3.3
13171,2021-02-01,8113,7736,377,4.6
13173,2021-02-01,3842,3696,146,3.8
13175,2021-02-01,20047,19125,922,4.6
13177,2021-02-01,14857,14371,486,3.3
13179,2021-02-01,26237,25067,1170,4.5
13181,2021-02-01,3614,3462,152,4.2
13183,2021-02-01,8357,8084,273,3.3
13185,2021-02-01,53242,50871,2371,4.5
13187,2021-02-01,16586,16080,506,3.1
13189,2021-02-01,8879,8377,502,5.7
13191,2021-02-01,6136,5895,241,3.9
13193,2021-02-01,4704,4433,271,5.8
13195,2021-02-01,13142,12698,444,3.4
13197,2021-02-01,3232,3106,126,3.9
13199,2021-02-01,8918,8354,564,6.3
13201,2021-02-01,2848,2756,92,3.2
13205,2021-02-01,8410,7935,475,5.6
13207,2021-02-01,13040,12567,473,3.6
13209,2021-02-01,4054,3877,177,4.4
13211,2021-02-01,9299,8952,347,3.7
13213,2021-02-01,15692,14961,731,4.7
13215,2021-02-01,77560,73049,4511,5.8
13217,2021-02-01,52614,50015,2599,4.9
13219,2021-02-01,19542,19083,459,2.3
13221,2021-02-01,6923,6700,223,3.2
13223,2021-02-01,86755,83775,2980,3.4
13225,2021-02-01,12144,11543,601,4.9
13227,2021-02-01,15198,14736,462,3
13229,2021-02-01,8686,8384,302,3.5
13231,2021-02-01,8856,8569,287,3.2
13233,2021-02-01,18607,17862,745,4
13235,2021-02-01,4105,3955,150,3.7
13237,2021-02-01,8214,7827,387,4.7
13239,2021-02-01,805,766,39,4.8
13241,2021-02-01,7139,6883,256,3.6
13243,2021-02-01,2521,2390,131,5.2
13245,2021-02-01,87058,82220,4838,5.6
13247,2021-02-01,44459,42152,2307,5.2
13249,2021-02-01,2178,2099,79,3.6
13251,2021-02-01,5151,4817,334,6.5
13253,2021-02-01,3168,3040,128,4
13255,2021-02-01,28739,27130,1609,5.6
13257,2021-02-01,10422,9932,490,4.7
13259,2021-02-01,2574,2466,108,4.2
13261,2021-02-01,12702,11900,802,6.3
13263,2021-02-01,2787,2641,146,5.2
13265,2021-02-01,534,504,30,5.6
13267,2021-02-01,9804,9453,351,3.6
13269,2021-02-01,2785,2630,155,5.6
13271,2021-02-01,3802,3509,293,7.7
13273,2021-02-01,3548,3305,243,6.8
13275,2021-02-01,17174,16339,835,4.9
13277,2021-02-01,21353,20543,810,3.8
13279,2021-02-01,12445,11860,585,4.7
13281,2021-02-01,3767,3609,158,4.2
13283,2021-02-01,2844,2725,119,4.2
13285,2021-02-01,38143,36254,1889,5
13287,2021-02-01,3345,3143,202,6
13289,2021-02-01,2881,2710,171,5.9
13291,2021-02-01,10563,10263,300,2.8
13293,2021-02-01,11523,10993,530,4.6
13295,2021-02-01,31080,30087,993,3.2
13297,2021-02-01,45743,44079,1664,3.6
13299,2021-02-01,15568,14919,649,4.2
13301,2021-02-01,2734,2589,145,5.3
13303,2021-02-01,6996,6604,392,5.6
13305,2021-02-01,11879,11372,507,4.3
13307,2021-02-01,1033,980,53,5.1
13309,2021-02-01,1638,1538,100,6.1
13311,2021-02-01,16609,16137,472,2.8
13313,2021-02-01,44179,42307,1872,4.2
13315,2021-02-01,2795,2657,138,4.9
13317,2021-02-01,3758,3552,206,5.5
13319,2021-02-01,3836,3666,170,4.4
13321,2021-02-01,8965,8570,395,4.4
15001,2021-02-01,89733,82252,7481,8.3
15003,2021-02-01,453606,419223,34383,7.6
15007,2021-02-01,33545,29222,4323,12.9
15009,2021-02-01,81151,71178,9973,12.3
16001,2021-02-01,259841,249757,10084,3.9
16003,2021-02-01,1678,1549,129,7.7
16005,2021-02-01,43880,42068,1812,4.1
16007,2021-02-01,3072,2942,130,4.2
16009,2021-02-01,4065,3791,274,6.7
16011,2021-02-01,23394,22481,913,3.9
16013,2021-02-01,12606,12043,563,4.5
16015,2021-02-01,3636,3395,241,6.6
16017,2021-02-01,21294,19959,1335,6.3
16019,2021-02-01,59342,57167,2175,3.7
16021,2021-02-01,5366,5025,341,6.4
16023,2021-02-01,1417,1340,77,5.4
16025,2021-02-01,682,645,37,5.4
16027,2021-02-01,106369,101307,5062,4.8
16029,2021-02-01,4059,3910,149,3.7
16031,2021-02-01,12196,11757,439,3.6
16033,2021-02-01,356,338,18,5.1
16035,2021-02-01,2962,2737,225,7.6
16037,2021-02-01,2040,1899,141,6.9
16039,2021-02-01,11919,11372,547,4.6
16041,2021-02-01,6958,6748,210,3
16043,2021-02-01,7966,7663,303,3.8
16045,2021-02-01,8446,8010,436,5.2
16047,2021-02-01,8220,7893,327,4
16049,2021-02-01,6612,6198,414,6.3
16051,2021-02-01,14268,13773,495,3.5
16053,2021-02-01,12182,11670,512,4.2
16055,2021-02-01,81222,76701,4521,5.6
16057,2021-02-01,20209,19421,788,3.9
16059,2021-02-01,3502,3253,249,7.1
16061,2021-02-01,1599,1478,121,7.6
16063,2021-02-01,2697,2524,173,6.4
16065,2021-02-01,23064,22451,613,2.7
16067,2021-02-01,11479,11016,463,4
16069,2021-02-01,20616,19802,814,3.9
16071,2021-02-01,2293,2213,80,3.5
16073,2021-02-01,5260,4953,307,5.8
16075,2021-02-01,11912,11306,606,5.1
16077,2021-02-01,3952,3758,194,4.9
16079,2021-02-01,5600,5158,442,7.9
16081,2021-02-01,6221,5986,235,3.8
16083,2021-02-01,41150,39374,1776,4.3
16085,2021-02-01,5774,5400,374,6.5
16087,2021-02-01,4755,4486,269,5.7
17001,2021-02-01,30292,28909,1383,4.6
17003,2021-02-01,1896,1744,152,8
17005,2021-02-01,7175,6792,383,5.3
17007,2021-02-01,24464,21855,2609,10.7
17009,2021-02-01,2891,2815,76,2.6
17011,2021-02-01,15415,14440,975,6.3
17013,2021-02-01,2146,2015,131,6.1
17015,2021-02-01,6891,6500,391,5.7
17017,2021-02-01,5524,5209,315,5.7
17019,2021-02-01,109180,103627,5553,5.1
17021,2021-02-01,13021,12195,826,6.3
17023,2021-02-01,6889,6454,435,6.3
17025,2021-02-01,5640,5272,368,6.5
17027,2021-02-01,19108,18304,804,4.2
17029,2021-02-01,22706,21449,1257,5.5
17031,2021-02-01,NA,NA,237479,9.5
17033,2021-02-01,8316,7854,462,5.6
17035,2021-02-01,5812,5510,302,5.2
17037,2021-02-01,51076,47611,3465,6.8
17039,2021-02-01,6856,6458,398,5.8
17041,2021-02-01,9758,9365,393,4
17043,2021-02-01,477164,446980,30184,6.3
17045,2021-02-01,8378,8003,375,4.5
17047,2021-02-01,2566,2425,141,5.5
17049,2021-02-01,19132,18232,900,4.7
17051,2021-02-01,9487,8874,613,6.5
17053,2021-02-01,6066,5750,316,5.2
17055,2021-02-01,15179,14140,1039,6.8
17057,2021-02-01,13907,12938,969,7
17059,2021-02-01,1873,1745,128,6.8
17061,2021-02-01,5663,5362,301,5.3
17063,2021-02-01,24116,22102,2014,8.4
17065,2021-02-01,4051,3854,197,4.9
17067,2021-02-01,7558,7143,415,5.5
17069,2021-02-01,1272,1183,89,7
17071,2021-02-01,3325,3149,176,5.3
17073,2021-02-01,22934,21552,1382,6
17075,2021-02-01,12647,11911,736,5.8
17077,2021-02-01,26619,25049,1570,5.9
17079,2021-02-01,4533,4276,257,5.7
17081,2021-02-01,16392,15353,1039,6.3
17083,2021-02-01,10291,9771,520,5.1
17085,2021-02-01,9805,9203,602,6.1
17087,2021-02-01,4063,3791,272,6.7
17089,2021-02-01,250876,233319,17557,7
17091,2021-02-01,51434,47583,3851,7.5
17093,2021-02-01,65341,60794,4547,7
17095,2021-02-01,19968,18513,1455,7.3
17097,2021-02-01,351010,328769,22241,6.3
17099,2021-02-01,50376,46669,3707,7.4
17101,2021-02-01,5677,5308,369,6.5
17103,2021-02-01,16478,15602,876,5.3
17105,2021-02-01,15037,14136,901,6
17107,2021-02-01,11785,11161,624,5.3
17109,2021-02-01,12484,11803,681,5.5
17111,2021-02-01,156410,145344,11066,7.1
17113,2021-02-01,82210,78034,4176,5.1
17115,2021-02-01,45213,41420,3793,8.4
17117,2021-02-01,21365,20243,1122,5.3
17119,2021-02-01,127138,120407,6731,5.3
17121,2021-02-01,16230,15232,998,6.1
17123,2021-02-01,4837,4491,346,7.2
17125,2021-02-01,5557,5189,368,6.6
17127,2021-02-01,5178,4837,341,6.6
17129,2021-02-01,5919,5608,311,5.3
17131,2021-02-01,7349,6856,493,6.7
17133,2021-02-01,17844,17192,652,3.7
17135,2021-02-01,10919,10210,709,6.5
17137,2021-02-01,15338,14486,852,5.6
17139,2021-02-01,7125,6830,295,4.1
17141,2021-02-01,23414,21773,1641,7
17143,2021-02-01,79257,72781,6476,8.2
17145,2021-02-01,7712,7259,453,5.9
17147,2021-02-01,8395,8028,367,4.4
17149,2021-02-01,6290,5984,306,4.9
17151,2021-02-01,1612,1520,92,5.7
17153,2021-02-01,1697,1531,166,9.8
17155,2021-02-01,2855,2670,185,6.5
17157,2021-02-01,13291,12655,636,4.8
17159,2021-02-01,7056,6726,330,4.7
17161,2021-02-01,66156,61784,4372,6.6
17163,2021-02-01,121152,113154,7998,6.6
17165,2021-02-01,9170,8533,637,6.9
17167,2021-02-01,93982,88133,5849,6.2
17169,2021-02-01,2906,2763,143,4.9
17171,2021-02-01,2239,2094,145,6.5
17173,2021-02-01,9768,9280,488,5
17175,2021-02-01,2212,2066,146,6.6
17177,2021-02-01,20028,18714,1314,6.6
17179,2021-02-01,58563,55039,3524,6
17181,2021-02-01,6928,6472,456,6.6
17183,2021-02-01,31805,29611,2194,6.9
17185,2021-02-01,5403,5130,273,5.1
17187,2021-02-01,7692,7294,398,5.2
17189,2021-02-01,9342,9042,300,3.2
17191,2021-02-01,6353,6016,337,5.3
17193,2021-02-01,5811,5499,312,5.4
17195,2021-02-01,26697,25212,1485,5.6
17197,2021-02-01,340198,311897,28301,8.3
17199,2021-02-01,30577,28754,1823,6
17201,2021-02-01,128392,116182,12210,9.5
17203,2021-02-01,17118,16291,827,4.8
18001,2021-02-01,16714,16226,488,2.9
18003,2021-02-01,186454,177925,8529,4.6
18005,2021-02-01,43454,41747,1707,3.9
18007,2021-02-01,4299,4130,169,3.9
18009,2021-02-01,4740,4501,239,5
18011,2021-02-01,35726,34633,1093,3.1
18013,2021-02-01,7557,7196,361,4.8
18015,2021-02-01,9749,9342,407,4.2
18017,2021-02-01,17408,16516,892,5.1
18019,2021-02-01,60725,58154,2571,4.2
18021,2021-02-01,11254,10679,575,5.1
18023,2021-02-01,16882,16253,629,3.7
18025,2021-02-01,4841,4576,265,5.5
18027,2021-02-01,16581,16049,532,3.2
18029,2021-02-01,24896,23829,1067,4.3
18031,2021-02-01,14821,14236,585,3.9
18033,2021-02-01,21923,21116,807,3.7
18035,2021-02-01,52439,49719,2720,5.2
18037,2021-02-01,22355,21547,808,3.6
18039,2021-02-01,113176,109226,3950,3.5
18041,2021-02-01,8280,7782,498,6
18043,2021-02-01,40921,39371,1550,3.8
18045,2021-02-01,7635,7320,315,4.1
18047,2021-02-01,11212,10759,453,4
18049,2021-02-01,9361,8886,475,5.1
18051,2021-02-01,19582,18922,660,3.4
18053,2021-02-01,31926,30416,1510,4.7
18055,2021-02-01,13310,12649,661,5
18057,2021-02-01,183330,177725,5605,3.1
18059,2021-02-01,40237,38748,1489,3.7
18061,2021-02-01,19814,19076,738,3.7
18063,2021-02-01,89547,86483,3064,3.4
18065,2021-02-01,21601,20607,994,4.6
18067,2021-02-01,35894,32827,3067,8.5
18069,2021-02-01,18211,17382,829,4.6
18071,2021-02-01,23418,22441,977,4.2
18073,2021-02-01,15269,14481,788,5.2
18075,2021-02-01,8513,8195,318,3.7
18077,2021-02-01,15086,14438,648,4.3
18079,2021-02-01,13588,12839,749,5.5
18081,2021-02-01,82011,79099,2912,3.6
18083,2021-02-01,18252,17542,710,3.9
18085,2021-02-01,40668,39148,1520,3.7
18087,2021-02-01,19014,18463,551,2.9
18089,2021-02-01,219732,203505,16227,7.4
18091,2021-02-01,46900,43672,3228,6.9
18093,2021-02-01,20611,19571,1040,5
18095,2021-02-01,58341,55074,3267,5.6
18097,2021-02-01,492159,465023,27136,5.5
18099,2021-02-01,22257,21385,872,3.9
18101,2021-02-01,5451,5258,193,3.5
18103,2021-02-01,14752,13794,958,6.5
18105,2021-02-01,68578,65757,2821,4.1
18107,2021-02-01,18273,17607,666,3.6
18109,2021-02-01,35767,34295,1472,4.1
18111,2021-02-01,6475,6131,344,5.3
18113,2021-02-01,22056,21115,941,4.3
18115,2021-02-01,3092,2973,119,3.8
18117,2021-02-01,8486,7991,495,5.8
18119,2021-02-01,9075,8594,481,5.3
18121,2021-02-01,6649,6362,287,4.3
18123,2021-02-01,9116,8703,413,4.5
18125,2021-02-01,6274,5980,294,4.7
18127,2021-02-01,82112,77787,4325,5.3
18129,2021-02-01,12747,12264,483,3.8
18131,2021-02-01,6305,6039,266,4.2
18133,2021-02-01,16257,15558,699,4.3
18135,2021-02-01,10912,10404,508,4.7
18137,2021-02-01,13659,13108,551,4
18139,2021-02-01,8573,8222,351,4.1
18141,2021-02-01,131651,124525,7126,5.4
18143,2021-02-01,10344,9838,506,4.9
18145,2021-02-01,22748,21805,943,4.1
18147,2021-02-01,9881,9438,443,4.5
18149,2021-02-01,9556,8975,581,6.1
18151,2021-02-01,19753,19050,703,3.6
18153,2021-02-01,7712,7315,397,5.1
18155,2021-02-01,4599,4365,234,5.1
18157,2021-02-01,95996,91989,4007,4.2
18159,2021-02-01,9002,8578,424,4.7
18161,2021-02-01,3405,3286,119,3.5
18163,2021-02-01,90076,85827,4249,4.7
18165,2021-02-01,6452,6072,380,5.9
18167,2021-02-01,44810,42276,2534,5.7
18169,2021-02-01,14389,13777,612,4.3
18171,2021-02-01,3967,3820,147,3.7
18173,2021-02-01,31411,30221,1190,3.8
18175,2021-02-01,13344,12729,615,4.6
18177,2021-02-01,29777,28372,1405,4.7
18179,2021-02-01,14165,13670,495,3.5
18181,2021-02-01,13159,12702,457,3.5
18183,2021-02-01,17370,16765,605,3.5
19001,2021-02-01,4251,4067,184,4.3
19003,2021-02-01,2027,1955,72,3.6
19005,2021-02-01,7142,6681,461,6.5
19007,2021-02-01,6001,5743,258,4.3
19009,2021-02-01,3077,2968,109,3.5
19011,2021-02-01,12832,12202,630,4.9
19013,2021-02-01,65628,62484,3144,4.8
19015,2021-02-01,14222,13674,548,3.9
19017,2021-02-01,13378,12920,458,3.4
19019,2021-02-01,11079,10561,518,4.7
19021,2021-02-01,11808,11454,354,3
19023,2021-02-01,7678,7327,351,4.6
19025,2021-02-01,4110,3952,158,3.8
19027,2021-02-01,10510,10170,340,3.2
19029,2021-02-01,6831,6529,302,4.4
19031,2021-02-01,10307,9843,464,4.5
19033,2021-02-01,22677,21692,985,4.3
19035,2021-02-01,6297,6061,236,3.7
19037,2021-02-01,6283,6013,270,4.3
19039,2021-02-01,4861,4603,258,5.3
19041,2021-02-01,8204,7878,326,4
19043,2021-02-01,9618,8933,685,7.1
19045,2021-02-01,21621,20416,1205,5.6
19047,2021-02-01,7948,7472,476,6
19049,2021-02-01,48967,47494,1473,3
19051,2021-02-01,4127,3974,153,3.7
19053,2021-02-01,4429,4279,150,3.4
19055,2021-02-01,10486,10033,453,4.3
19057,2021-02-01,18003,16883,1120,6.2
19059,2021-02-01,9215,8737,478,5.2
19061,2021-02-01,53973,51243,2730,5.1
19063,2021-02-01,4906,4699,207,4.2
19065,2021-02-01,10501,9927,574,5.5
19067,2021-02-01,8256,7855,401,4.9
19069,2021-02-01,5629,5392,237,4.2
19071,2021-02-01,3726,3621,105,2.8
19073,2021-02-01,5358,5178,180,3.4
19075,2021-02-01,6312,6039,273,4.3
19077,2021-02-01,5488,5210,278,5.1
19079,2021-02-01,6707,6421,286,4.3
19081,2021-02-01,5742,5541,201,3.5
19083,2021-02-01,7798,7410,388,5
19085,2021-02-01,7116,6814,302,4.2
19087,2021-02-01,9707,9313,394,4.1
19089,2021-02-01,5097,4830,267,5.2
19091,2021-02-01,4903,4718,185,3.8
19093,2021-02-01,3989,3829,160,4
19095,2021-02-01,9897,9462,435,4.4
19097,2021-02-01,10528,9874,654,6.2
19099,2021-02-01,18834,17932,902,4.8
19101,2021-02-01,9524,9102,422,4.4
19103,2021-02-01,81321,78363,2958,3.6
19105,2021-02-01,10256,9661,595,5.8
19107,2021-02-01,5172,4898,274,5.3
19109,2021-02-01,8073,7804,269,3.3
19111,2021-02-01,15432,14523,909,5.9
19113,2021-02-01,115761,109725,6036,5.2
19115,2021-02-01,6021,5716,305,5.1
19117,2021-02-01,4751,4583,168,3.5
19119,2021-02-01,6887,6705,182,2.6
19121,2021-02-01,8371,7884,487,5.8
19123,2021-02-01,11767,11309,458,3.9
19125,2021-02-01,17959,17325,634,3.5
19127,2021-02-01,17480,16046,1434,8.2
19129,2021-02-01,7135,6878,257,3.6
19131,2021-02-01,5952,5745,207,3.5
19133,2021-02-01,4400,4174,226,5.1
19135,2021-02-01,3935,3767,168,4.3
19137,2021-02-01,4876,4665,211,4.3
19139,2021-02-01,20464,19353,1111,5.4
19141,2021-02-01,8052,7800,252,3.1
19143,2021-02-01,3540,3445,95,2.7
19145,2021-02-01,6205,5962,243,3.9
19147,2021-02-01,4431,4263,168,3.8
19149,2021-02-01,14182,13745,437,3.1
19151,2021-02-01,4102,3964,138,3.4
19153,2021-02-01,260408,247680,12728,4.9
19155,2021-02-01,46683,44551,2132,4.6
19157,2021-02-01,9981,9519,462,4.6
19159,2021-02-01,2431,2342,89,3.7
19161,2021-02-01,5237,5031,206,3.9
19163,2021-02-01,84510,79714,4796,5.7
19165,2021-02-01,6270,6049,221,3.5
19167,2021-02-01,21176,20563,613,2.9
19169,2021-02-01,54109,52510,1599,3
19171,2021-02-01,9193,8664,529,5.8
19173,2021-02-01,3108,3003,105,3.4
19175,2021-02-01,6180,5856,324,5.2
19177,2021-02-01,3645,3477,168,4.6
19179,2021-02-01,17210,16350,860,5
19181,2021-02-01,27389,26223,1166,4.3
19183,2021-02-01,11482,10934,548,4.8
19185,2021-02-01,2858,2745,113,4
19187,2021-02-01,18235,17388,847,4.6
19189,2021-02-01,4911,4708,203,4.1
19191,2021-02-01,11389,10751,638,5.6
19193,2021-02-01,53263,50880,2383,4.5
19195,2021-02-01,4035,3838,197,4.9
19197,2021-02-01,6875,6583,292,4.2
20001,2021-02-01,6529,6247,282,4.3
20003,2021-02-01,4385,4221,164,3.7
20005,2021-02-01,6924,6512,412,6
20007,2021-02-01,2326,2262,64,2.8
20009,2021-02-01,13711,13141,570,4.2
20011,2021-02-01,6883,6512,371,5.4
20013,2021-02-01,5252,5073,179,3.4
20015,2021-02-01,32612,30984,1628,5
20017,2021-02-01,1434,1388,46,3.2
20019,2021-02-01,1513,1425,88,5.8
20021,2021-02-01,10187,9772,415,4.1
20023,2021-02-01,1346,1321,25,1.9
20025,2021-02-01,1176,1152,24,2
20027,2021-02-01,3862,3719,143,3.7
20029,2021-02-01,3963,3818,145,3.7
20031,2021-02-01,3855,3695,160,4.2
20033,2021-02-01,850,826,24,2.8
20035,2021-02-01,16797,16001,796,4.7
20037,2021-02-01,19261,18405,856,4.4
20039,2021-02-01,1214,1179,35,2.9
20041,2021-02-01,8874,8533,341,3.8
20043,2021-02-01,4240,4049,191,4.5
20045,2021-02-01,64871,61967,2904,4.5
20047,2021-02-01,1522,1480,42,2.8
20049,2021-02-01,1172,1126,46,3.9
20051,2021-02-01,17053,16597,456,2.7
20053,2021-02-01,2791,2697,94,3.4
20055,2021-02-01,21280,20713,567,2.7
20057,2021-02-01,17388,16858,530,3
20059,2021-02-01,14626,13917,709,4.8
20061,2021-02-01,11768,11127,641,5.4
20063,2021-02-01,1489,1450,39,2.6
20065,2021-02-01,1088,1029,59,5.4
20067,2021-02-01,3005,2877,128,4.3
20069,2021-02-01,3336,3269,67,2
20071,2021-02-01,831,819,12,1.4
20073,2021-02-01,3114,2984,130,4.2
20075,2021-02-01,1653,1628,25,1.5
20077,2021-02-01,2881,2770,111,3.9
20079,2021-02-01,17012,16332,680,4
20081,2021-02-01,2291,2242,49,2.1
20083,2021-02-01,1002,977,25,2.5
20085,2021-02-01,7337,7045,292,4
20087,2021-02-01,10507,10028,479,4.6
20089,2021-02-01,1250,1216,34,2.7
20091,2021-02-01,347264,334321,12943,3.7
20093,2021-02-01,2060,2018,42,2
20095,2021-02-01,3354,3214,140,4.2
20097,2021-02-01,1240,1210,30,2.4
20099,2021-02-01,9719,9236,483,5
20101,2021-02-01,737,720,17,2.3
20103,2021-02-01,37479,35630,1849,4.9
20105,2021-02-01,1776,1717,59,3.3
20107,2021-02-01,4526,4187,339,7.5
20109,2021-02-01,1632,1598,34,2.1
20111,2021-02-01,16962,16257,705,4.2
20113,2021-02-01,17513,17029,484,2.8
20115,2021-02-01,5809,5620,189,3.3
20117,2021-02-01,5526,5374,152,2.8
20119,2021-02-01,2146,2085,61,2.8
20121,2021-02-01,18094,17289,805,4.4
20123,2021-02-01,3476,3397,79,2.3
20125,2021-02-01,14624,13819,805,5.5
20127,2021-02-01,3163,3053,110,3.5
20129,2021-02-01,1141,1107,34,3
20131,2021-02-01,5610,5482,128,2.3
20133,2021-02-01,6400,6019,381,6
20135,2021-02-01,1319,1279,40,3
20137,2021-02-01,2630,2569,61,2.3
20139,2021-02-01,8237,7854,383,4.6
20141,2021-02-01,1957,1915,42,2.1
20143,2021-02-01,3023,2908,115,3.8
20145,2021-02-01,2820,2734,86,3
20147,2021-02-01,2673,2602,71,2.7
20149,2021-02-01,12059,11641,418,3.5
20151,2021-02-01,4965,4825,140,2.8
20153,2021-02-01,1555,1521,34,2.2
20155,2021-02-01,29645,28347,1298,4.4
20157,2021-02-01,2270,2194,76,3.3
20159,2021-02-01,5113,4946,167,3.3
20161,2021-02-01,34233,32885,1348,3.9
20163,2021-02-01,2497,2419,78,3.1
20165,2021-02-01,1556,1504,52,3.3
20167,2021-02-01,3327,3214,113,3.4
20169,2021-02-01,29652,28444,1208,4.1
20171,2021-02-01,2824,2765,59,2.1
20173,2021-02-01,256842,239444,17398,6.8
20175,2021-02-01,10014,9631,383,3.8
20177,2021-02-01,93086,88918,4168,4.5
20179,2021-02-01,1481,1449,32,2.2
20181,2021-02-01,2940,2840,100,3.4
20183,2021-02-01,2033,1991,42,2.1
20185,2021-02-01,2064,2008,56,2.7
20187,2021-02-01,1119,1090,29,2.6
20189,2021-02-01,2857,2774,83,2.9
20191,2021-02-01,10996,10297,699,6.4
20193,2021-02-01,4300,4192,108,2.5
20195,2021-02-01,1484,1447,37,2.5
20197,2021-02-01,3760,3617,143,3.8
20199,2021-02-01,818,799,19,2.3
20201,2021-02-01,3109,3040,69,2.2
20203,2021-02-01,1240,1213,27,2.2
20205,2021-02-01,3921,3686,235,6
20207,2021-02-01,1537,1463,74,4.8
20209,2021-02-01,79758,74437,5321,6.7
21001,2021-02-01,6799,6430,369,5.4
21003,2021-02-01,8624,8266,358,4.2
21005,2021-02-01,11463,10948,515,4.5
21007,2021-02-01,3219,3048,171,5.3
21009,2021-02-01,17815,16738,1077,6
21011,2021-02-01,4414,4115,299,6.8
21013,2021-02-01,8146,7681,465,5.7
21015,2021-02-01,68534,65661,2873,4.2
21017,2021-02-01,9175,8796,379,4.1
21019,2021-02-01,17231,16053,1178,6.8
21021,2021-02-01,12403,11748,655,5.3
21023,2021-02-01,3706,3485,221,6
21025,2021-02-01,3172,2932,240,7.6
21027,2021-02-01,7586,7130,456,6
21029,2021-02-01,41016,39349,1667,4.1
21031,2021-02-01,4940,4691,249,5
21033,2021-02-01,5462,5193,269,4.9
21035,2021-02-01,17142,16255,887,5.2
21037,2021-02-01,48715,46523,2192,4.5
21039,2021-02-01,2098,2010,88,4.2
21041,2021-02-01,5044,4802,242,4.8
21043,2021-02-01,9475,8628,847,8.9
21045,2021-02-01,6536,6245,291,4.5
21047,2021-02-01,24089,22773,1316,5.5
21049,2021-02-01,16532,15750,782,4.7
21051,2021-02-01,5084,4700,384,7.6
21053,2021-02-01,3938,3773,165,4.2
21055,2021-02-01,3525,3365,160,4.5
21057,2021-02-01,3122,3003,119,3.8
21059,2021-02-01,44444,42295,2149,4.8
21061,2021-02-01,4550,4283,267,5.9
21063,2021-02-01,1910,1733,177,9.3
21065,2021-02-01,4961,4677,284,5.7
21067,2021-02-01,168029,160717,7312,4.4
21069,2021-02-01,5816,5478,338,5.8
21071,2021-02-01,10370,9594,776,7.5
21073,2021-02-01,24201,22953,1248,5.2
21075,2021-02-01,1918,1815,103,5.4
21077,2021-02-01,3928,3727,201,5.1
21079,2021-02-01,7354,7020,334,4.5
21081,2021-02-01,11222,10615,607,5.4
21083,2021-02-01,15169,14391,778,5.1
21085,2021-02-01,10452,9801,651,6.2
21087,2021-02-01,4965,4781,184,3.7
21089,2021-02-01,12961,12022,939,7.2
21091,2021-02-01,3706,3520,186,5
21093,2021-02-01,45856,43646,2210,4.8
21095,2021-02-01,6304,5709,595,9.4
21097,2021-02-01,8471,8122,349,4.1
21099,2021-02-01,7445,7092,353,4.7
21101,2021-02-01,20351,19356,995,4.9
21103,2021-02-01,7913,7585,328,4.1
21105,2021-02-01,1612,1538,74,4.6
21107,2021-02-01,17911,16958,953,5.3
21109,2021-02-01,3903,3637,266,6.8
21111,2021-02-01,383433,364229,19204,5
21113,2021-02-01,25640,24510,1130,4.4
21115,2021-02-01,6408,5888,520,8.1
21117,2021-02-01,84378,80347,4031,4.8
21119,2021-02-01,4293,3973,320,7.5
21121,2021-02-01,9946,9284,662,6.7
21123,2021-02-01,5666,5384,282,5
21125,2021-02-01,24673,23492,1181,4.8
21127,2021-02-01,5029,4653,376,7.5
21129,2021-02-01,1982,1872,110,5.5
21131,2021-02-01,2568,2346,222,8.6
21133,2021-02-01,5981,5510,471,7.9
21135,2021-02-01,4565,4144,421,9.2
21137,2021-02-01,9224,8659,565,6.1
21139,2021-02-01,3449,3167,282,8.2
21141,2021-02-01,11778,11355,423,3.6
21143,2021-02-01,3050,2899,151,5
21145,2021-02-01,27350,25735,1615,5.9
21147,2021-02-01,4822,4527,295,6.1
21149,2021-02-01,3909,3723,186,4.8
21151,2021-02-01,44718,42744,1974,4.4
21153,2021-02-01,3207,2721,486,15.2
21155,2021-02-01,9006,8595,411,4.6
21157,2021-02-01,14329,13527,802,5.6
21159,2021-02-01,2381,2167,214,9
21161,2021-02-01,6777,6366,411,6.1
21163,2021-02-01,11356,10758,598,5.3
21165,2021-02-01,2232,2019,213,9.5
21167,2021-02-01,9579,9082,497,5.2
21169,2021-02-01,3908,3680,228,5.8
21171,2021-02-01,4386,4206,180,4.1
21173,2021-02-01,10967,10292,675,6.2
21175,2021-02-01,4261,3963,298,7
21177,2021-02-01,9635,8948,687,7.1
21179,2021-02-01,22168,21207,961,4.3
21181,2021-02-01,3161,3021,140,4.4
21183,2021-02-01,8890,8327,563,6.3
21185,2021-02-01,31986,30882,1104,3.5
21187,2021-02-01,4938,4707,231,4.7
21189,2021-02-01,1038,961,77,7.4
21191,2021-02-01,6717,6409,308,4.6
21193,2021-02-01,7993,7467,526,6.6
21195,2021-02-01,18665,17390,1275,6.8
21197,2021-02-01,4873,4609,264,5.4
21199,2021-02-01,25032,23686,1346,5.4
21201,2021-02-01,759,724,35,4.6
21203,2021-02-01,6251,5922,329,5.3
21205,2021-02-01,9445,8885,560,5.9
21207,2021-02-01,5938,5589,349,5.9
21209,2021-02-01,28345,27218,1127,4
21211,2021-02-01,24669,23757,912,3.7
21213,2021-02-01,8508,8138,370,4.3
21215,2021-02-01,10060,9675,385,3.8
21217,2021-02-01,12578,12077,501,4
21219,2021-02-01,5215,5032,183,3.5
21221,2021-02-01,5925,5606,319,5.4
21223,2021-02-01,3710,3524,186,5
21225,2021-02-01,5842,5600,242,4.1
21227,2021-02-01,62831,59591,3240,5.2
21229,2021-02-01,5941,5719,222,3.7
21231,2021-02-01,7199,6838,361,5
21233,2021-02-01,5254,5009,245,4.7
21235,2021-02-01,13719,12973,746,5.4
21237,2021-02-01,2081,1941,140,6.7
21239,2021-02-01,14426,13896,530,3.7
22001,2021-02-01,22991,21589,1402,6.1
22003,2021-02-01,8055,7505,550,6.8
22005,2021-02-01,64116,60713,3403,5.3
22007,2021-02-01,8690,7889,801,9.2
22009,2021-02-01,14651,13745,906,6.2
22011,2021-02-01,13823,13176,647,4.7
22013,2021-02-01,5333,4958,375,7
22015,2021-02-01,55434,52722,2712,4.9
22017,2021-02-01,100639,92628,8011,8
22019,2021-02-01,92239,85382,6857,7.4
22021,2021-02-01,3547,3360,187,5.3
22023,2021-02-01,3321,3177,144,4.3
22025,2021-02-01,3438,3226,212,6.2
22027,2021-02-01,5613,5293,320,5.7
22029,2021-02-01,6759,6294,465,6.9
22031,2021-02-01,10414,9782,632,6.1
22033,2021-02-01,229506,214377,15129,6.6
22035,2021-02-01,1794,1583,211,11.8
22037,2021-02-01,7797,7352,445,5.7
22039,2021-02-01,11631,10868,763,6.6
22041,2021-02-01,7277,6773,504,6.9
22043,2021-02-01,8030,7665,365,4.5
22045,2021-02-01,27549,25064,2485,9
22047,2021-02-01,14104,12810,1294,9.2
22049,2021-02-01,6564,6282,282,4.3
22051,2021-02-01,207809,190920,16889,8.1
22053,2021-02-01,12374,11644,730,5.9
22055,2021-02-01,111134,104640,6494,5.8
22057,2021-02-01,40759,38558,2201,5.4
22059,2021-02-01,6855,6604,251,3.7
22061,2021-02-01,20176,19151,1025,5.1
22063,2021-02-01,67997,64837,3160,4.6
22065,2021-02-01,3538,3273,265,7.5
22067,2021-02-01,9957,9090,867,8.7
22069,2021-02-01,15650,14801,849,5.4
22071,2021-02-01,180024,158868,21156,11.8
22073,2021-02-01,68496,64202,4294,6.3
22075,2021-02-01,9446,8949,497,5.3
22077,2021-02-01,9712,9037,675,7
22079,2021-02-01,54535,51933,2602,4.8
22081,2021-02-01,3525,3328,197,5.6
22083,2021-02-01,7890,7407,483,6.1
22085,2021-02-01,9058,8678,380,4.2
22087,2021-02-01,19735,17899,1836,9.3
22089,2021-02-01,24161,22596,1565,6.5
22091,2021-02-01,4367,3865,502,11.5
22093,2021-02-01,8988,8142,846,9.4
22095,2021-02-01,19264,17204,2060,10.7
22097,2021-02-01,31972,29495,2477,7.7
22099,2021-02-01,21666,20084,1582,7.3
22101,2021-02-01,18666,17015,1651,8.8
22103,2021-02-01,113453,108003,5450,4.8
22105,2021-02-01,55893,51431,4462,8
22107,2021-02-01,1320,1226,94,7.1
22109,2021-02-01,45608,42445,3163,6.9
22111,2021-02-01,8825,8295,530,6
22113,2021-02-01,23321,21790,1531,6.6
22115,2021-02-01,15423,14661,762,4.9
22117,2021-02-01,16539,15334,1205,7.3
22119,2021-02-01,13772,12877,895,6.5
22121,2021-02-01,13574,12720,854,6.3
22123,2021-02-01,3452,3194,258,7.5
22125,2021-02-01,5304,5070,234,4.4
22127,2021-02-01,4552,4283,269,5.9
23001,2021-02-01,53565,50684,2881,5.4
23003,2021-02-01,29230,27465,1765,6
23005,2021-02-01,157284,149952,7332,4.7
23007,2021-02-01,14361,13529,832,5.8
23009,2021-02-01,26026,24047,1979,7.6
23011,2021-02-01,60544,57622,2922,4.8
23013,2021-02-01,18804,17716,1088,5.8
23015,2021-02-01,15727,14775,952,6.1
23017,2021-02-01,25986,24144,1842,7.1
23019,2021-02-01,74214,70254,3960,5.3
23021,2021-02-01,7152,6725,427,6
23023,2021-02-01,18886,18055,831,4.4
23025,2021-02-01,21999,20357,1642,7.5
23027,2021-02-01,19527,18395,1132,5.8
23029,2021-02-01,13569,12490,1079,8
23031,2021-02-01,110052,103283,6769,6.2
24001,2021-02-01,29980,27832,2148,7.2
24003,2021-02-01,302639,287289,15350,5.1
24005,2021-02-01,434449,408104,26345,6.1
24009,2021-02-01,47070,44842,2228,4.7
24011,2021-02-01,16975,16082,893,5.3
24013,2021-02-01,90931,86960,3971,4.4
24015,2021-02-01,51301,48500,2801,5.5
24017,2021-02-01,83213,78297,4916,5.9
24019,2021-02-01,14780,13803,977,6.6
24021,2021-02-01,128388,121763,6625,5.2
24023,2021-02-01,14720,13766,954,6.5
24025,2021-02-01,135018,128178,6840,5.1
24027,2021-02-01,180083,171872,8211,4.6
24029,2021-02-01,9627,9032,595,6.2
24031,2021-02-01,529713,499449,30264,5.7
24033,2021-02-01,487705,451208,36497,7.5
24035,2021-02-01,26635,25368,1267,4.8
24037,2021-02-01,56662,54157,2505,4.4
24039,2021-02-01,8578,7901,677,7.9
24041,2021-02-01,17877,16812,1065,6
24043,2021-02-01,69386,65323,4063,5.9
24045,2021-02-01,48113,44797,3316,6.9
24047,2021-02-01,24532,21837,2695,11
24510,2021-02-01,273956,252078,21878,8
25001,2021-02-01,108013,97073,10940,10.1
25003,2021-02-01,62406,57018,5388,8.6
25005,2021-02-01,297818,272821,24997,8.4
25007,2021-02-01,8439,7451,988,11.7
25009,2021-02-01,423018,389035,33983,8
25011,2021-02-01,39765,37159,2606,6.6
25013,2021-02-01,221542,201018,20524,9.3
25015,2021-02-01,86211,80924,5287,6.1
25017,2021-02-01,898390,846923,51467,5.7
25019,2021-02-01,6462,5344,1118,17.3
25021,2021-02-01,384667,360410,24257,6.3
25023,2021-02-01,280420,258390,22030,7.9
25025,2021-02-01,449853,417394,32459,7.2
25027,2021-02-01,438739,406608,32131,7.3
26001,2021-02-01,3743,3459,284,7.6
26003,2021-02-01,2963,2699,264,8.9
26005,2021-02-01,60056,56973,3083,5.1
26007,2021-02-01,13193,12423,770,5.8
26009,2021-02-01,9860,9049,811,8.2
26011,2021-02-01,5622,5079,543,9.7
26013,2021-02-01,3057,2791,266,8.7
26015,2021-02-01,30760,29228,1532,5
26017,2021-02-01,48319,45145,3174,6.6
26019,2021-02-01,8336,7738,598,7.2
26021,2021-02-01,70407,66181,4226,6
26023,2021-02-01,19129,18195,934,4.9
26025,2021-02-01,59916,56041,3875,6.5
26027,2021-02-01,23465,22160,1305,5.6
26029,2021-02-01,12202,11340,862,7.1
26031,2021-02-01,9369,8070,1299,13.9
26033,2021-02-01,15570,14407,1163,7.5
26035,2021-02-01,11445,10468,977,8.5
26037,2021-02-01,38829,37241,1588,4.1
26039,2021-02-01,5443,5039,404,7.4
26041,2021-02-01,16758,15627,1131,6.7
26043,2021-02-01,11973,11359,614,5.1
26045,2021-02-01,54277,51705,2572,4.7
26047,2021-02-01,16401,15103,1298,7.9
26049,2021-02-01,175355,162479,12876,7.3
26051,2021-02-01,9433,8706,727,7.7
26053,2021-02-01,5805,5484,321,5.5
26055,2021-02-01,47106,44370,2736,5.8
26057,2021-02-01,17335,16356,979,5.6
26059,2021-02-01,19567,18504,1063,5.4
26061,2021-02-01,15796,14967,829,5.2
26063,2021-02-01,14749,13906,843,5.7
26065,2021-02-01,143138,135746,7392,5.2
26067,2021-02-01,29815,28396,1419,4.8
26069,2021-02-01,9924,9171,753,7.6
26071,2021-02-01,4817,4494,323,6.7
26073,2021-02-01,32694,30950,1744,5.3
26075,2021-02-01,71547,67146,4401,6.2
26077,2021-02-01,127700,121260,6440,5
26079,2021-02-01,7582,6947,635,8.4
26081,2021-02-01,350351,333370,16981,4.8
26083,2021-02-01,869,812,57,6.6
26085,2021-02-01,3805,3467,338,8.9
26087,2021-02-01,37569,35759,1810,4.8
26089,2021-02-01,9888,9289,599,6.1
26091,2021-02-01,44104,41659,2445,5.5
26093,2021-02-01,95631,92671,2960,3.1
26095,2021-02-01,2062,1905,157,7.6
26097,2021-02-01,3862,3187,675,17.5
26099,2021-02-01,412021,395443,16578,4
26101,2021-02-01,9930,9153,777,7.8
26103,2021-02-01,31599,29718,1881,6
26105,2021-02-01,12896,11974,922,7.1
26107,2021-02-01,17696,16448,1248,7.1
26109,2021-02-01,10556,10087,469,4.4
26111,2021-02-01,38588,36559,2029,5.3
26113,2021-02-01,6724,6288,436,6.5
26115,2021-02-01,71717,67464,4253,5.9
26117,2021-02-01,27343,25714,1629,6
26119,2021-02-01,2881,2587,294,10.2
26121,2021-02-01,74424,68778,5646,7.6
26123,2021-02-01,22582,21195,1387,6.1
26125,2021-02-01,621502,601339,20163,3.2
26127,2021-02-01,11355,10397,958,8.4
26129,2021-02-01,7849,7158,691,8.8
26131,2021-02-01,1992,1844,148,7.4
26133,2021-02-01,11343,10681,662,5.8
26135,2021-02-01,2782,2540,242,8.7
26137,2021-02-01,11242,10410,832,7.4
26139,2021-02-01,155724,149176,6548,4.2
26141,2021-02-01,4793,4332,461,9.6
26143,2021-02-01,7462,6694,768,10.3
26145,2021-02-01,82941,77154,5787,7
26147,2021-02-01,69350,66353,2997,4.3
26149,2021-02-01,27846,26407,1439,5.2
26151,2021-02-01,18818,17572,1246,6.6
26153,2021-02-01,3152,2870,282,8.9
26155,2021-02-01,31580,29709,1871,5.9
26157,2021-02-01,22970,21443,1527,6.6
26159,2021-02-01,33669,31382,2287,6.8
26161,2021-02-01,189856,181885,7971,4.2
26163,2021-02-01,742803,702571,40232,5.4
26165,2021-02-01,14580,13655,925,6.3
27001,2021-02-01,7370,6825,545,7.4
27003,2021-02-01,191966,183243,8723,4.5
27005,2021-02-01,18122,17138,984,5.4
27007,2021-02-01,24308,23083,1225,5
27009,2021-02-01,21823,20424,1399,6.4
27011,2021-02-01,2359,2223,136,5.8
27013,2021-02-01,39576,37985,1591,4
27015,2021-02-01,13686,12999,687,5
27017,2021-02-01,17570,16578,992,5.6
27019,2021-02-01,56817,54719,2098,3.7
27021,2021-02-01,12553,11473,1080,8.6
27023,2021-02-01,6455,6172,283,4.4
27025,2021-02-01,29425,27669,1756,6
27027,2021-02-01,36270,34849,1421,3.9
27029,2021-02-01,4357,3963,394,9
27031,2021-02-01,2552,2361,191,7.5
27033,2021-02-01,6336,6083,253,4
27035,2021-02-01,31008,29025,1983,6.4
27037,2021-02-01,234131,224375,9756,4.2
27039,2021-02-01,11801,11185,616,5.2
27041,2021-02-01,20925,20031,894,4.3
27043,2021-02-01,6622,6244,378,5.7
27045,2021-02-01,11327,10744,583,5.1
27047,2021-02-01,15781,15093,688,4.4
27049,2021-02-01,25869,24582,1287,5
27051,2021-02-01,3210,3031,179,5.6
27053,2021-02-01,683469,655370,28099,4.1
27055,2021-02-01,10338,9842,496,4.8
27057,2021-02-01,9269,8670,599,6.5
27059,2021-02-01,21095,19671,1424,6.8
27061,2021-02-01,21307,19952,1355,6.4
27063,2021-02-01,5518,5296,222,4
27065,2021-02-01,9121,8267,854,9.4
27067,2021-02-01,23822,22660,1162,4.9
27069,2021-02-01,2284,2198,86,3.8
27071,2021-02-01,5450,5153,297,5.4
27073,2021-02-01,3369,3209,160,4.7
27075,2021-02-01,4939,4666,273,5.5
27077,2021-02-01,2471,2367,104,4.2
27079,2021-02-01,15912,14763,1149,7.2
27081,2021-02-01,2912,2753,159,5.5
27083,2021-02-01,13547,12979,568,4.2
27085,2021-02-01,18597,17612,985,5.3
27087,2021-02-01,2023,1854,169,8.4
27089,2021-02-01,5204,4842,362,7
27091,2021-02-01,9424,9045,379,4
27093,2021-02-01,12877,12156,721,5.6
27095,2021-02-01,12745,11643,1102,8.6
27097,2021-02-01,17611,16262,1349,7.7
27099,2021-02-01,20514,19640,874,4.3
27101,2021-02-01,4577,4264,313,6.8
27103,2021-02-01,20364,19595,769,3.8
27105,2021-02-01,11252,10853,399,3.5
27107,2021-02-01,3090,2913,177,5.7
27109,2021-02-01,89009,85579,3430,3.9
27111,2021-02-01,30192,28499,1693,5.6
27113,2021-02-01,8457,7972,485,5.7
27115,2021-02-01,14168,12978,1190,8.4
27117,2021-02-01,4304,4082,222,5.2
27119,2021-02-01,15964,15193,771,4.8
27121,2021-02-01,6263,5971,292,4.7
27123,2021-02-01,279385,266611,12774,4.6
27125,2021-02-01,2167,2043,124,5.7
27127,2021-02-01,7418,7034,384,5.2
27129,2021-02-01,8160,7704,456,5.6
27131,2021-02-01,36314,34719,1595,4.4
27133,2021-02-01,5665,5517,148,2.6
27135,2021-02-01,7634,7329,305,4
27137,2021-02-01,99935,94830,5105,5.1
27139,2021-02-01,81232,77879,3353,4.1
27141,2021-02-01,51328,48528,2800,5.5
27143,2021-02-01,8033,7581,452,5.6
27145,2021-02-01,89094,84763,4331,4.9
27147,2021-02-01,19245,18355,890,4.6
27149,2021-02-01,5207,5012,195,3.7
27151,2021-02-01,4590,4331,259,5.6
27153,2021-02-01,13452,12726,726,5.4
27155,2021-02-01,1642,1559,83,5.1
27157,2021-02-01,12029,11473,556,4.6
27159,2021-02-01,5906,5482,424,7.2
27161,2021-02-01,8609,8092,517,6
27163,2021-02-01,139116,133630,5486,3.9
27165,2021-02-01,6469,6176,293,4.5
27167,2021-02-01,3269,3139,130,4
27169,2021-02-01,27417,26413,1004,3.7
27171,2021-02-01,73988,70409,3579,4.8
27173,2021-02-01,5065,4820,245,4.8
28001,2021-02-01,10447,9390,1057,10.1
28003,2021-02-01,15501,14707,794,5.1
28005,2021-02-01,4549,4199,350,7.7
28007,2021-02-01,6900,6444,456,6.6
28009,2021-02-01,3035,2830,205,6.8
28011,2021-02-01,11644,10750,894,7.7
28013,2021-02-01,5509,5194,315,5.7
28015,2021-02-01,3479,3241,238,6.8
28017,2021-02-01,6943,6487,456,6.6
28019,2021-02-01,3601,3412,189,5.2
28021,2021-02-01,3056,2675,381,12.5
28023,2021-02-01,5894,5505,389,6.6
28025,2021-02-01,7780,7160,620,8
28027,2021-02-01,8149,7336,813,10
28029,2021-02-01,10870,10125,745,6.9
28031,2021-02-01,8545,8025,520,6.1
28033,2021-02-01,91772,87648,4124,4.5
28035,2021-02-01,34004,31893,2111,6.2
28037,2021-02-01,2786,2584,202,7.3
28039,2021-02-01,9152,8481,671,7.3
28041,2021-02-01,4427,4089,338,7.6
28043,2021-02-01,9356,8815,541,5.8
28045,2021-02-01,19060,17738,1322,6.9
28047,2021-02-01,87943,82384,5559,6.3
28049,2021-02-01,104388,97244,7144,6.8
28051,2021-02-01,5189,4552,637,12.3
28053,2021-02-01,2214,1902,312,14.1
28055,2021-02-01,332,299,33,9.9
28057,2021-02-01,10469,9973,496,4.7
28059,2021-02-01,59080,55109,3971,6.7
28061,2021-02-01,6023,5553,470,7.8
28063,2021-02-01,1930,1630,300,15.5
28065,2021-02-01,4056,3719,337,8.3
28067,2021-02-01,25384,23829,1555,6.1
28069,2021-02-01,3430,3178,252,7.3
28071,2021-02-01,27071,25903,1168,4.3
28073,2021-02-01,31607,30213,1394,4.4
28075,2021-02-01,30059,28294,1765,5.9
28077,2021-02-01,4721,4364,357,7.6
28079,2021-02-01,8084,7590,494,6.1
28081,2021-02-01,41537,39436,2101,5.1
28083,2021-02-01,9901,8964,937,9.5
28085,2021-02-01,14706,13868,838,5.7
28087,2021-02-01,25337,23730,1607,6.3
28089,2021-02-01,52683,50244,2439,4.6
28091,2021-02-01,10306,9696,610,5.9
28093,2021-02-01,14318,13433,885,6.2
28095,2021-02-01,15624,14718,906,5.8
28097,2021-02-01,3942,3677,265,6.7
28099,2021-02-01,10070,9488,582,5.8
28101,2021-02-01,7915,7465,450,5.7
28103,2021-02-01,3951,3598,353,8.9
28105,2021-02-01,22754,21500,1254,5.5
28107,2021-02-01,12673,11668,1005,7.9
28109,2021-02-01,23652,22083,1569,6.6
28111,2021-02-01,4385,4068,317,7.2
28113,2021-02-01,14922,13771,1151,7.7
28115,2021-02-01,14926,14238,688,4.6
28117,2021-02-01,11191,10650,541,4.8
28119,2021-02-01,2324,2101,223,9.6
28121,2021-02-01,75300,72371,2929,3.9
28123,2021-02-01,13030,12400,630,4.8
28125,2021-02-01,1461,1314,147,10.1
28127,2021-02-01,10601,9980,621,5.9
28129,2021-02-01,6815,6498,317,4.7
28131,2021-02-01,7173,6761,412,5.7
28133,2021-02-01,7473,6680,793,10.6
28135,2021-02-01,5125,4779,346,6.8
28137,2021-02-01,12122,11386,736,6.1
28139,2021-02-01,9579,9097,482,5
28141,2021-02-01,8326,7934,392,4.7
28143,2021-02-01,4465,4021,444,9.9
28145,2021-02-01,14052,13429,623,4.4
28147,2021-02-01,5018,4621,397,7.9
28149,2021-02-01,19920,18598,1322,6.6
28151,2021-02-01,15985,14474,1511,9.5
28153,2021-02-01,7407,6877,530,7.2
28155,2021-02-01,3973,3737,236,5.9
28157,2021-02-01,2909,2523,386,13.3
28159,2021-02-01,7151,6662,489,6.8
28161,2021-02-01,5001,4675,326,6.5
28163,2021-02-01,9890,9116,774,7.8
29001,2021-02-01,10081,9601,480,4.8
29003,2021-02-01,9744,9365,379,3.9
29005,2021-02-01,2673,2586,87,3.3
29007,2021-02-01,10178,9707,471,4.6
29009,2021-02-01,15521,14673,848,5.5
29011,2021-02-01,5182,4988,194,3.7
29013,2021-02-01,7681,7261,420,5.5
29015,2021-02-01,7271,6746,525,7.2
29017,2021-02-01,5471,5178,293,5.4
29019,2021-02-01,97573,94334,3239,3.3
29021,2021-02-01,43814,41911,1903,4.3
29023,2021-02-01,18387,17409,978,5.3
29025,2021-02-01,4300,4043,257,6
29027,2021-02-01,21476,20595,881,4.1
29029,2021-02-01,18155,16832,1323,7.3
29031,2021-02-01,40838,39248,1590,3.9
29033,2021-02-01,4664,4420,244,5.2
29035,2021-02-01,2491,2313,178,7.1
29037,2021-02-01,54322,51887,2435,4.5
29039,2021-02-01,5750,5521,229,4
29041,2021-02-01,3804,3637,167,4.4
29043,2021-02-01,46170,44374,1796,3.9
29045,2021-02-01,3096,2934,162,5.2
29047,2021-02-01,136741,130180,6561,4.8
29049,2021-02-01,10620,10013,607,5.7
29051,2021-02-01,39346,37880,1466,3.7
29053,2021-02-01,7168,6835,333,4.6
29055,2021-02-01,10899,10227,672,6.2
29057,2021-02-01,3542,3408,134,3.8
29059,2021-02-01,7106,6747,359,5.1
29061,2021-02-01,4059,3862,197,4.9
29063,2021-02-01,4759,4552,207,4.3
29065,2021-02-01,6403,6109,294,4.6
29067,2021-02-01,5200,4932,268,5.2
29069,2021-02-01,11464,10658,806,7
29071,2021-02-01,52610,49874,2736,5.2
29073,2021-02-01,7524,7118,406,5.4
29075,2021-02-01,3307,3213,94,2.8
29077,2021-02-01,153148,147315,5833,3.8
29079,2021-02-01,4304,4134,170,3.9
29081,2021-02-01,3740,3572,168,4.5
29083,2021-02-01,9789,9283,506,5.2
29085,2021-02-01,3832,3637,195,5.1
29087,2021-02-01,2512,2422,90,3.6
29089,2021-02-01,4898,4695,203,4.1
29091,2021-02-01,16099,15210,889,5.5
29093,2021-02-01,3533,3296,237,6.7
29095,2021-02-01,360746,339915,20831,5.8
29097,2021-02-01,57144,54782,2362,4.1
29099,2021-02-01,116992,110997,5995,5.1
29101,2021-02-01,23285,22079,1206,5.2
29103,2021-02-01,1681,1605,76,4.5
29105,2021-02-01,16462,15601,861,5.2
29107,2021-02-01,16674,15810,864,5.2
29109,2021-02-01,17455,16534,921,5.3
29111,2021-02-01,4880,4683,197,4
29113,2021-02-01,28679,27144,1535,5.4
29115,2021-02-01,5218,4811,407,7.8
29117,2021-02-01,7393,7074,319,4.3
29119,2021-02-01,10785,10357,428,4
29121,2021-02-01,7441,7082,359,4.8
29123,2021-02-01,5458,5170,288,5.3
29125,2021-02-01,3956,3765,191,4.8
29127,2021-02-01,14135,13521,614,4.3
29129,2021-02-01,1826,1748,78,4.3
29131,2021-02-01,12288,11566,722,5.9
29133,2021-02-01,5608,5331,277,4.9
29135,2021-02-01,7360,7033,327,4.4
29137,2021-02-01,3714,3495,219,5.9
29139,2021-02-01,5683,5436,247,4.3
29141,2021-02-01,8238,7691,547,6.6
29143,2021-02-01,8518,8107,411,4.8
29145,2021-02-01,27069,25920,1149,4.2
29147,2021-02-01,10498,10155,343,3.3
29149,2021-02-01,3931,3686,245,6.2
29151,2021-02-01,7061,6833,228,3.2
29153,2021-02-01,3367,3132,235,7
29155,2021-02-01,6215,5725,490,7.9
29157,2021-02-01,9792,9401,391,4
29159,2021-02-01,20489,19209,1280,6.2
29161,2021-02-01,20126,19249,877,4.4
29163,2021-02-01,7554,7188,366,4.8
29165,2021-02-01,58541,56106,2435,4.2
29167,2021-02-01,14514,13957,557,3.8
29169,2021-02-01,14701,13977,724,4.9
29171,2021-02-01,2210,2115,95,4.3
29173,2021-02-01,5590,5316,274,4.9
29175,2021-02-01,10266,9770,496,4.8
29177,2021-02-01,11015,10336,679,6.2
29179,2021-02-01,2833,2693,140,4.9
29181,2021-02-01,4893,4583,310,6.3
29183,2021-02-01,223530,215098,8432,3.8
29185,2021-02-01,3756,3545,211,5.6
29186,2021-02-01,9259,8861,398,4.3
29187,2021-02-01,26388,24825,1563,5.9
29189,2021-02-01,523315,497709,25606,4.9
29195,2021-02-01,10613,10176,437,4.1
29197,2021-02-01,1930,1816,114,5.9
29199,2021-02-01,2343,2262,81,3.5
29201,2021-02-01,19883,18984,899,4.5
29203,2021-02-01,3296,3063,233,7.1
29205,2021-02-01,3022,2872,150,5
29207,2021-02-01,13212,12491,721,5.5
29209,2021-02-01,12090,10657,1433,11.9
29211,2021-02-01,2828,2668,160,5.7
29213,2021-02-01,23686,20498,3188,13.5
29215,2021-02-01,8986,8505,481,5.4
29217,2021-02-01,9462,9094,368,3.9
29219,2021-02-01,18181,17294,887,4.9
29221,2021-02-01,10222,9514,708,6.9
29223,2021-02-01,5005,4720,285,5.7
29225,2021-02-01,17455,16766,689,3.9
29227,2021-02-01,1122,1089,33,2.9
29229,2021-02-01,7180,6809,371,5.2
29510,2021-02-01,151199,140999,10200,6.7
30001,2021-02-01,4991,4804,187,3.7
30003,2021-02-01,4837,4395,442,9.1
30005,2021-02-01,2265,2153,112,4.9
30007,2021-02-01,2581,2420,161,6.2
30009,2021-02-01,5389,5113,276,5.1
30011,2021-02-01,645,626,19,2.9
30013,2021-02-01,36806,35021,1785,4.8
30015,2021-02-01,2450,2358,92,3.8
30017,2021-02-01,6162,5876,286,4.6
30019,2021-02-01,894,872,22,2.5
30021,2021-02-01,4590,4399,191,4.2
30023,2021-02-01,4956,4728,228,4.6
30025,2021-02-01,1629,1567,62,3.8
30027,2021-02-01,5796,5503,293,5.1
30029,2021-02-01,47963,44942,3021,6.3
30031,2021-02-01,69999,67618,2381,3.4
30033,2021-02-01,744,721,23,3.1
30035,2021-02-01,5070,4570,500,9.9
30037,2021-02-01,361,341,20,5.5
30039,2021-02-01,1590,1503,87,5.5
30041,2021-02-01,7480,7186,294,3.9
30043,2021-02-01,5776,5515,261,4.5
30045,2021-02-01,971,934,37,3.8
30047,2021-02-01,13429,12701,728,5.4
30049,2021-02-01,36343,34760,1583,4.4
30051,2021-02-01,989,959,30,3
30053,2021-02-01,7680,7003,677,8.8
30055,2021-02-01,968,945,23,2.4
30057,2021-02-01,5135,4927,208,4.1
30059,2021-02-01,1017,976,41,4
30061,2021-02-01,1653,1527,126,7.6
30063,2021-02-01,62065,59044,3021,4.9
30065,2021-02-01,2309,2168,141,6.1
30067,2021-02-01,8446,8006,440,5.2
30069,2021-02-01,266,258,8,3
30071,2021-02-01,1880,1780,100,5.3
30073,2021-02-01,2686,2569,117,4.4
30075,2021-02-01,995,956,39,3.9
30077,2021-02-01,2861,2757,104,3.6
30079,2021-02-01,461,436,25,5.4
30081,2021-02-01,20488,19403,1085,5.3
30083,2021-02-01,5745,5447,298,5.2
30085,2021-02-01,4403,4169,234,5.3
30087,2021-02-01,3597,3419,178,4.9
30089,2021-02-01,4976,4604,372,7.5
30091,2021-02-01,1782,1698,84,4.7
30093,2021-02-01,16945,16045,900,5.3
30095,2021-02-01,5273,5054,219,4.2
30097,2021-02-01,1850,1793,57,3.1
30099,2021-02-01,2748,2620,128,4.7
30101,2021-02-01,2100,2025,75,3.6
30103,2021-02-01,343,329,14,4.1
30105,2021-02-01,3999,3820,179,4.5
30107,2021-02-01,765,691,74,9.7
30109,2021-02-01,444,424,20,4.5
30111,2021-02-01,80281,76579,3702,4.6
31001,2021-02-01,16552,16023,529,3.2
31003,2021-02-01,3818,3730,88,2.3
31005,2021-02-01,228,220,8,3.5
31007,2021-02-01,374,367,7,1.9
31009,2021-02-01,250,239,11,4.4
31011,2021-02-01,2869,2804,65,2.3
31013,2021-02-01,5332,5170,162,3
31015,2021-02-01,1040,1013,27,2.6
31017,2021-02-01,1377,1340,37,2.7
31019,2021-02-01,27036,26318,718,2.7
31021,2021-02-01,3530,3407,123,3.5
31023,2021-02-01,4525,4387,138,3
31025,2021-02-01,13200,12698,502,3.8
31027,2021-02-01,4389,4271,118,2.7
31029,2021-02-01,2296,2255,41,1.8
31031,2021-02-01,3174,3112,62,2
31033,2021-02-01,4096,3931,165,4
31035,2021-02-01,3186,3089,97,3
31037,2021-02-01,5579,5446,133,2.4
31039,2021-02-01,4726,4621,105,2.2
31041,2021-02-01,6242,6122,120,1.9
31043,2021-02-01,10296,9857,439,4.3
31045,2021-02-01,4879,4767,112,2.3
31047,2021-02-01,13166,12782,384,2.9
31049,2021-02-01,952,927,25,2.6
31051,2021-02-01,2883,2786,97,3.4
31053,2021-02-01,20397,19716,681,3.3
31055,2021-02-01,293457,281281,12176,4.1
31057,2021-02-01,1146,1121,25,2.2
31059,2021-02-01,3065,2984,81,2.6
31061,2021-02-01,1457,1414,43,3
31063,2021-02-01,1492,1450,42,2.8
31065,2021-02-01,2550,2490,60,2.4
31067,2021-02-01,10666,10276,390,3.7
31069,2021-02-01,1033,1006,27,2.6
31071,2021-02-01,1156,1131,25,2.2
31073,2021-02-01,1073,1050,23,2.1
31075,2021-02-01,407,401,6,1.5
31077,2021-02-01,1203,1177,26,2.2
31079,2021-02-01,31450,30129,1321,4.2
31081,2021-02-01,4709,4570,139,3
31083,2021-02-01,1686,1642,44,2.6
31085,2021-02-01,618,609,9,1.5
31087,2021-02-01,1275,1241,34,2.7
31089,2021-02-01,5676,5550,126,2.2
31091,2021-02-01,369,362,7,1.9
31093,2021-02-01,3283,3179,104,3.2
31095,2021-02-01,4166,4066,100,2.4
31097,2021-02-01,2049,1964,85,4.1
31099,2021-02-01,3694,3613,81,2.2
31101,2021-02-01,4408,4275,133,3
31103,2021-02-01,602,590,12,2
31105,2021-02-01,1942,1886,56,2.9
31107,2021-02-01,4606,4473,133,2.9
31109,2021-02-01,174943,168728,6215,3.6
31111,2021-02-01,17934,17423,511,2.8
31113,2021-02-01,464,456,8,1.7
31115,2021-02-01,405,398,7,1.7
31117,2021-02-01,434,426,8,1.8
31119,2021-02-01,19467,18712,755,3.9
31121,2021-02-01,3957,3829,128,3.2
31123,2021-02-01,2553,2472,81,3.2
31125,2021-02-01,1892,1846,46,2.4
31127,2021-02-01,3550,3455,95,2.7
31129,2021-02-01,2458,2400,58,2.4
31131,2021-02-01,8273,8002,271,3.3
31133,2021-02-01,1492,1453,39,2.6
31135,2021-02-01,1803,1776,27,1.5
31137,2021-02-01,4854,4750,104,2.1
31139,2021-02-01,4059,3897,162,4
31141,2021-02-01,17544,17071,473,2.7
31143,2021-02-01,2865,2795,70,2.4
31145,2021-02-01,5847,5707,140,2.4
31147,2021-02-01,4128,3977,151,3.7
31149,2021-02-01,867,855,12,1.4
31151,2021-02-01,7241,6995,246,3.4
31153,2021-02-01,94592,91621,2971,3.1
31155,2021-02-01,10994,10645,349,3.2
31157,2021-02-01,17904,17265,639,3.6
31159,2021-02-01,8779,8456,323,3.7
31161,2021-02-01,2669,2613,56,2.1
31163,2021-02-01,1652,1608,44,2.7
31165,2021-02-01,730,715,15,2.1
31167,2021-02-01,3515,3387,128,3.6
31169,2021-02-01,2746,2698,48,1.7
31171,2021-02-01,417,403,14,3.4
31173,2021-02-01,2989,2894,95,3.2
31175,2021-02-01,2089,2032,57,2.7
31177,2021-02-01,10928,10586,342,3.1
31179,2021-02-01,5655,5529,126,2.2
31181,2021-02-01,1626,1589,37,2.3
31183,2021-02-01,544,538,6,1.1
31185,2021-02-01,7091,6908,183,2.6
32001,2021-02-01,11893,11436,457,3.8
32003,2021-02-01,NA,NA,104268,9.3
32005,2021-02-01,23149,21941,1208,5.2
32007,2021-02-01,28654,27521,1133,4
32009,2021-02-01,444,425,19,4.3
32011,2021-02-01,1188,1156,32,2.7
32013,2021-02-01,8530,8199,331,3.9
32015,2021-02-01,3371,3239,132,3.9
32017,2021-02-01,2173,2081,92,4.2
32019,2021-02-01,24286,22825,1461,6
32021,2021-02-01,2152,2052,100,4.6
32023,2021-02-01,18371,17190,1181,6.4
32027,2021-02-01,2722,2613,109,4
32029,2021-02-01,2188,2065,123,5.6
32031,2021-02-01,270765,257570,13195,4.9
32033,2021-02-01,4759,4595,164,3.4
32510,2021-02-01,27620,26117,1503,5.4
33001,2021-02-01,31022,29886,1136,3.7
33003,2021-02-01,22698,21849,849,3.7
33005,2021-02-01,40176,38848,1328,3.3
33007,2021-02-01,14203,13595,608,4.3
33009,2021-02-01,48586,47167,1419,2.9
33011,2021-02-01,236373,228297,8076,3.4
33013,2021-02-01,82662,80191,2471,3
33015,2021-02-01,181690,175755,5935,3.3
33017,2021-02-01,73263,71023,2240,3.1
33019,2021-02-01,23128,22478,650,2.8
34001,2021-02-01,116595,102321,14274,12.2
34003,2021-02-01,464739,428726,36013,7.7
34005,2021-02-01,227607,212019,15588,6.8
34007,2021-02-01,252029,230712,21317,8.5
34009,2021-02-01,44540,38693,5847,13.1
34011,2021-02-01,64529,58083,6446,10
34013,2021-02-01,363684,327543,36141,9.9
34015,2021-02-01,148923,137240,11683,7.8
34017,2021-02-01,349934,319566,30368,8.7
34019,2021-02-01,61985,58118,3867,6.2
34021,2021-02-01,202801,189699,13102,6.5
34023,2021-02-01,429924,398604,31320,7.3
34025,2021-02-01,322481,299243,23238,7.2
34027,2021-02-01,247207,230998,16209,6.6
34029,2021-02-01,274259,252560,21699,7.9
34031,2021-02-01,237107,212374,24733,10.4
34033,2021-02-01,29340,26714,2626,9
34035,2021-02-01,164360,153477,10883,6.6
34037,2021-02-01,72083,66276,5807,8.1
34039,2021-02-01,269187,246684,22503,8.4
34041,2021-02-01,55677,51504,4173,7.5
35001,2021-02-01,335357,309922,25435,7.6
35003,2021-02-01,1217,1122,95,7.8
35005,2021-02-01,29105,26790,2315,8
35006,2021-02-01,9762,8702,1060,10.9
35007,2021-02-01,5454,5077,377,6.9
35009,2021-02-01,23164,21859,1305,5.6
35011,2021-02-01,719,682,37,5.1
35013,2021-02-01,98394,90614,7780,7.9
35015,2021-02-01,33434,30890,2544,7.6
35017,2021-02-01,11740,10748,992,8.4
35019,2021-02-01,1592,1471,121,7.6
35021,2021-02-01,277,264,13,4.7
35023,2021-02-01,2007,1879,128,6.4
35025,2021-02-01,28906,25486,3420,11.8
35027,2021-02-01,9376,8493,883,9.4
35028,2021-02-01,10403,10061,342,3.3
35029,2021-02-01,10197,8388,1809,17.7
35031,2021-02-01,24913,22173,2740,11
35033,2021-02-01,2050,1889,161,7.9
35035,2021-02-01,26169,24165,2004,7.7
35037,2021-02-01,3167,2913,254,8
35039,2021-02-01,17314,15855,1459,8.4
35041,2021-02-01,8118,7617,501,6.2
35043,2021-02-01,67291,61775,5516,8.2
35045,2021-02-01,49958,44964,4994,10
35047,2021-02-01,10678,9779,899,8.4
35049,2021-02-01,70700,65082,5618,7.9
35051,2021-02-01,4264,3859,405,9.5
35053,2021-02-01,6404,5966,438,6.8
35055,2021-02-01,15029,13354,1675,11.1
35057,2021-02-01,5339,4850,489,9.2
35059,2021-02-01,1622,1548,74,4.6
35061,2021-02-01,30659,28187,2472,8.1
36001,2021-02-01,156831,146971,9860,6.3
36003,2021-02-01,19928,18522,1406,7.1
36005,2021-02-01,592225,487414,104811,17.7
36007,2021-02-01,80813,74613,6200,7.7
36009,2021-02-01,33600,31002,2598,7.7
36011,2021-02-01,34959,32503,2456,7
36013,2021-02-01,52520,48195,4325,8.2
36015,2021-02-01,34730,32127,2603,7.5
36017,2021-02-01,21625,20185,1440,6.7
36019,2021-02-01,35278,32853,2425,6.9
36021,2021-02-01,29516,27811,1705,5.8
36023,2021-02-01,22819,21134,1685,7.4
36025,2021-02-01,18715,17455,1260,6.7
36027,2021-02-01,140217,131238,8979,6.4
36029,2021-02-01,435203,400829,34374,7.9
36031,2021-02-01,16633,15427,1206,7.3
36033,2021-02-01,19360,18007,1353,7
36035,2021-02-01,22423,20590,1833,8.2
36037,2021-02-01,28687,26803,1884,6.6
36039,2021-02-01,20481,19003,1478,7.2
36041,2021-02-01,2037,1890,147,7.2
36043,2021-02-01,27494,25069,2425,8.8
36045,2021-02-01,42669,39304,3365,7.9
36047,2021-02-01,NA,992427,155956,13.6
36049,2021-02-01,11475,10560,915,8
36051,2021-02-01,30133,28202,1931,6.4
36053,2021-02-01,31811,29621,2190,6.9
36055,2021-02-01,362350,335844,26506,7.3
36057,2021-02-01,21622,19838,1784,8.3
36059,2021-02-01,683303,638165,45138,6.6
36061,2021-02-01,853458,766490,86968,10.2
36063,2021-02-01,96585,88564,8021,8.3
36065,2021-02-01,99442,92013,7429,7.5
36067,2021-02-01,216222,200694,15528,7.2
36069,2021-02-01,54897,51445,3452,6.3
36071,2021-02-01,179911,167810,12101,6.7
36073,2021-02-01,17242,15953,1289,7.5
36075,2021-02-01,51324,47196,4128,8
36077,2021-02-01,26364,24575,1789,6.8
36079,2021-02-01,49369,46355,3014,6.1
36081,2021-02-01,NA,947336,140847,12.9
36083,2021-02-01,80680,75614,5066,6.3
36085,2021-02-01,210440,185856,24584,11.7
36087,2021-02-01,150013,140578,9435,6.3
36089,2021-02-01,43244,40122,3122,7.2
36091,2021-02-01,118374,111675,6699,5.7
36093,2021-02-01,76517,71176,5341,7
36095,2021-02-01,14429,13438,991,6.9
36097,2021-02-01,7845,7222,623,7.9
36099,2021-02-01,15059,13973,1086,7.2
36101,2021-02-01,41698,38628,3070,7.4
36103,2021-02-01,748025,697339,50686,6.8
36105,2021-02-01,35162,32642,2520,7.2
36107,2021-02-01,21815,20340,1475,6.8
36109,2021-02-01,47728,45175,2553,5.3
36111,2021-02-01,84661,78894,5767,6.8
36113,2021-02-01,30961,28633,2328,7.5
36115,2021-02-01,27396,25524,1872,6.8
36117,2021-02-01,43280,40446,2834,6.5
36119,2021-02-01,470399,437897,32502,6.9
36121,2021-02-01,17591,16281,1310,7.4
36123,2021-02-01,11567,10891,676,5.8
37001,2021-02-01,82230,77620,4610,5.6
37003,2021-02-01,17844,17009,835,4.7
37005,2021-02-01,4153,3908,245,5.9
37007,2021-02-01,10610,9815,795,7.5
37009,2021-02-01,12792,12145,647,5.1
37011,2021-02-01,7498,7130,368,4.9
37013,2021-02-01,19856,18751,1105,5.6
37015,2021-02-01,7729,7248,481,6.2
37017,2021-02-01,14678,13760,918,6.3
37019,2021-02-01,52153,48381,3772,7.2
37021,2021-02-01,136845,129672,7173,5.2
37023,2021-02-01,40690,38514,2176,5.3
37025,2021-02-01,109437,103733,5704,5.2
37027,2021-02-01,36408,34271,2137,5.9
37029,2021-02-01,4598,4396,202,4.4
37031,2021-02-01,31668,30055,1613,5.1
37033,2021-02-01,9716,9122,594,6.1
37035,2021-02-01,78772,74495,4277,5.4
37037,2021-02-01,36022,34528,1494,4.1
37039,2021-02-01,10753,10125,628,5.8
37041,2021-02-01,5603,5270,333,5.9
37043,2021-02-01,4079,3844,235,5.8
37045,2021-02-01,48830,45826,3004,6.2
37047,2021-02-01,22287,20598,1689,7.6
37049,2021-02-01,41221,38912,2309,5.6
37051,2021-02-01,127132,117207,9925,7.8
37053,2021-02-01,14071,13299,772,5.5
37055,2021-02-01,18605,16725,1880,10.1
37057,2021-02-01,79725,75426,4299,5.4
37059,2021-02-01,20213,19230,983,4.9
37061,2021-02-01,24949,23710,1239,5
37063,2021-02-01,173105,164587,8518,4.9
37065,2021-02-01,21073,19141,1932,9.2
37067,2021-02-01,185852,175313,10539,5.7
37069,2021-02-01,31694,29973,1721,5.4
37071,2021-02-01,110321,103622,6699,6.1
37073,2021-02-01,5133,4882,251,4.9
37075,2021-02-01,3002,2733,269,9
37077,2021-02-01,29913,28523,1390,4.6
37079,2021-02-01,9736,9274,462,4.7
37081,2021-02-01,257649,240856,16793,6.5
37083,2021-02-01,20297,18600,1697,8.4
37085,2021-02-01,53834,50592,3242,6
37087,2021-02-01,28935,27448,1487,5.1
37089,2021-02-01,53153,50568,2585,4.9
37091,2021-02-01,9008,8420,588,6.5
37093,2021-02-01,19988,18497,1491,7.5
37095,2021-02-01,1692,1518,174,10.3
37097,2021-02-01,89538,84689,4849,5.4
37099,2021-02-01,19490,18413,1077,5.5
37101,2021-02-01,100392,95410,4982,5
37103,2021-02-01,4233,4024,209,4.9
37105,2021-02-01,26091,24564,1527,5.9
37107,2021-02-01,27801,26231,1570,5.6
37109,2021-02-01,43690,41609,2081,4.8
37111,2021-02-01,20539,19449,1090,5.3
37113,2021-02-01,15704,14890,814,5.2
37115,2021-02-01,9753,9242,511,5.2
37117,2021-02-01,9047,8465,582,6.4
37119,2021-02-01,621951,586204,35747,5.7
37121,2021-02-01,5815,5445,370,6.4
37123,2021-02-01,11525,10916,609,5.3
37125,2021-02-01,40961,38845,2116,5.2
37127,2021-02-01,42951,39954,2997,7
37129,2021-02-01,122412,116197,6215,5.1
37131,2021-02-01,7671,7114,557,7.3
37133,2021-02-01,65680,61866,3814,5.8
37135,2021-02-01,79372,76195,3177,4
37137,2021-02-01,5316,5041,275,5.2
37139,2021-02-01,16650,15587,1063,6.4
37141,2021-02-01,28517,27076,1441,5.1
37143,2021-02-01,4896,4606,290,5.9
37145,2021-02-01,18396,17303,1093,5.9
37147,2021-02-01,90571,85540,5031,5.6
37149,2021-02-01,9040,8569,471,5.2
37151,2021-02-01,64297,60730,3567,5.5
37153,2021-02-01,16883,15503,1380,8.2
37155,2021-02-01,50492,46292,4200,8.3
37157,2021-02-01,39237,36626,2611,6.7
37159,2021-02-01,65491,61655,3836,5.9
37161,2021-02-01,24885,23036,1849,7.4
37163,2021-02-01,28654,27173,1481,5.2
37165,2021-02-01,11463,10217,1246,10.9
37167,2021-02-01,30055,28482,1573,5.2
37169,2021-02-01,21288,20223,1065,5
37171,2021-02-01,32660,30974,1686,5.2
37173,2021-02-01,6688,6283,405,6.1
37175,2021-02-01,14129,13438,691,4.9
37177,2021-02-01,1295,1170,125,9.7
37179,2021-02-01,122835,117259,5576,4.5
37181,2021-02-01,17007,15464,1543,9.1
37183,2021-02-01,594702,566888,27814,4.7
37185,2021-02-01,6506,5954,552,8.5
37187,2021-02-01,4426,4059,367,8.3
37189,2021-02-01,28645,27406,1239,4.3
37191,2021-02-01,50717,47763,2954,5.8
37193,2021-02-01,28281,26760,1521,5.4
37195,2021-02-01,34369,31868,2501,7.3
37197,2021-02-01,17379,16507,872,5
37199,2021-02-01,8296,7877,419,5.1
38001,2021-02-01,956,913,43,4.5
38003,2021-02-01,5212,4984,228,4.4
38005,2021-02-01,2349,2179,170,7.2
38007,2021-02-01,373,358,15,4
38009,2021-02-01,2887,2668,219,7.6
38011,2021-02-01,1594,1543,51,3.2
38013,2021-02-01,1017,946,71,7
38015,2021-02-01,51257,48825,2432,4.7
38017,2021-02-01,105525,100912,4613,4.4
38019,2021-02-01,1866,1785,81,4.3
38021,2021-02-01,2263,2176,87,3.8
38023,2021-02-01,1347,1301,46,3.4
38025,2021-02-01,2759,2624,135,4.9
38027,2021-02-01,1163,1094,69,5.9
38029,2021-02-01,1473,1373,100,6.8
38031,2021-02-01,1518,1460,58,3.8
38033,2021-02-01,832,800,32,3.8
38035,2021-02-01,36604,34924,1680,4.6
38037,2021-02-01,1169,1123,46,3.9
38039,2021-02-01,988,947,41,4.1
38041,2021-02-01,1343,1266,77,5.7
38043,2021-02-01,1278,1181,97,7.6
38045,2021-02-01,1995,1926,69,3.5
38047,2021-02-01,849,804,45,5.3
38049,2021-02-01,3039,2822,217,7.1
38051,2021-02-01,1093,1032,61,5.6
38053,2021-02-01,8164,7512,652,8
38055,2021-02-01,4619,4365,254,5.5
38057,2021-02-01,3445,3211,234,6.8
38059,2021-02-01,17006,16014,992,5.8
38061,2021-02-01,6316,6012,304,4.8
38063,2021-02-01,1373,1291,82,6
38065,2021-02-01,877,827,50,5.7
38067,2021-02-01,3261,3049,212,6.5
38069,2021-02-01,1687,1606,81,4.8
38071,2021-02-01,5555,5293,262,4.7
38073,2021-02-01,2817,2717,100,3.5
38075,2021-02-01,1200,1137,63,5.3
38077,2021-02-01,8467,8138,329,3.9
38079,2021-02-01,4558,3964,594,13
38081,2021-02-01,2776,2695,81,2.9
38083,2021-02-01,659,608,51,7.7
38085,2021-02-01,1197,1151,46,3.8
38087,2021-02-01,370,358,12,3.2
38089,2021-02-01,17521,16328,1193,6.8
38091,2021-02-01,913,875,38,4.2
38093,2021-02-01,10427,9948,479,4.6
38095,2021-02-01,1109,1053,56,5
38097,2021-02-01,4476,4304,172,3.8
38099,2021-02-01,4974,4681,293,5.9
38101,2021-02-01,31183,29183,2000,6.4
38103,2021-02-01,1888,1767,121,6.4
38105,2021-02-01,20671,18829,1842,8.9
39001,2021-02-01,10967,10052,915,8.3
39003,2021-02-01,49021,45713,3308,6.7
39005,2021-02-01,26946,25559,1387,5.1
39007,2021-02-01,43115,40321,2794,6.5
39009,2021-02-01,29043,27499,1544,5.3
39011,2021-02-01,24302,23237,1065,4.4
39013,2021-02-01,28316,26314,2002,7.1
39015,2021-02-01,19262,18022,1240,6.4
39017,2021-02-01,192381,182885,9496,4.9
39019,2021-02-01,12791,11966,825,6.4
39021,2021-02-01,19737,18819,918,4.7
39023,2021-02-01,62910,59341,3569,5.7
39025,2021-02-01,105718,100433,5285,5
39027,2021-02-01,17878,16353,1525,8.5
39029,2021-02-01,46485,43482,3003,6.5
39031,2021-02-01,13675,12729,946,6.9
39033,2021-02-01,18471,17353,1118,6.1
39035,2021-02-01,575772,544683,31089,5.4
39037,2021-02-01,25642,24433,1209,4.7
39039,2021-02-01,17564,16672,892,5.1
39041,2021-02-01,112735,107955,4780,4.2
39043,2021-02-01,34648,32019,2629,7.6
39045,2021-02-01,79232,75176,4056,5.1
39047,2021-02-01,13840,13040,800,5.8
39049,2021-02-01,709936,669201,40735,5.7
39051,2021-02-01,21679,20481,1198,5.5
39053,2021-02-01,12190,11417,773,6.3
39055,2021-02-01,45792,44163,1629,3.6
39057,2021-02-01,82971,78980,3991,4.8
39059,2021-02-01,17945,16736,1209,6.7
39061,2021-02-01,412263,389530,22733,5.5
39063,2021-02-01,41842,39878,1964,4.7
39065,2021-02-01,14168,13382,786,5.5
39067,2021-02-01,6525,6062,463,7.1
39069,2021-02-01,12827,12008,819,6.4
39071,2021-02-01,17563,16362,1201,6.8
39073,2021-02-01,13050,12292,758,5.8
39075,2021-02-01,20767,20122,645,3.1
39077,2021-02-01,27035,24941,2094,7.7
39079,2021-02-01,13151,12238,913,6.9
39081,2021-02-01,27114,25176,1938,7.1
39083,2021-02-01,31287,29830,1457,4.7
39085,2021-02-01,118741,113524,5217,4.4
39087,2021-02-01,23467,22222,1245,5.3
39089,2021-02-01,90966,86727,4239,4.7
39091,2021-02-01,22353,21315,1038,4.6
39093,2021-02-01,144432,137687,6745,4.7
39095,2021-02-01,204325,190416,13909,6.8
39097,2021-02-01,20981,20025,956,4.6
39099,2021-02-01,99345,92234,7111,7.2
39101,2021-02-01,28045,26543,1502,5.4
39103,2021-02-01,91650,88371,3279,3.6
39105,2021-02-01,9099,8410,689,7.6
39107,2021-02-01,23050,22203,847,3.7
39109,2021-02-01,54099,51475,2624,4.9
39111,2021-02-01,5579,5146,433,7.8
39113,2021-02-01,252669,236844,15825,6.3
39115,2021-02-01,6704,6141,563,8.4
39117,2021-02-01,16930,16037,893,5.3
39119,2021-02-01,40516,37962,2554,6.3
39121,2021-02-01,4581,4213,368,8
39123,2021-02-01,19581,17952,1629,8.3
39125,2021-02-01,8678,8260,418,4.8
39127,2021-02-01,16041,14970,1071,6.7
39129,2021-02-01,26674,25291,1383,5.2
39131,2021-02-01,10875,10113,762,7
39133,2021-02-01,85664,80968,4696,5.5
39135,2021-02-01,21105,20109,996,4.7
39137,2021-02-01,18621,17822,799,4.3
39139,2021-02-01,52434,49188,3246,6.2
39141,2021-02-01,35242,33425,1817,5.2
39143,2021-02-01,29890,28134,1756,5.9
39145,2021-02-01,29320,27322,1998,6.8
39147,2021-02-01,26939,25550,1389,5.2
39149,2021-02-01,23774,22642,1132,4.8
39151,2021-02-01,184109,172917,11192,6.1
39153,2021-02-01,269358,252729,16629,6.2
39155,2021-02-01,83967,77359,6608,7.9
39157,2021-02-01,43905,41477,2428,5.5
39159,2021-02-01,29465,28276,1189,4
39161,2021-02-01,14686,14013,673,4.6
39163,2021-02-01,5617,5220,397,7.1
39165,2021-02-01,118404,112963,5441,4.6
39167,2021-02-01,26284,24625,1659,6.3
39169,2021-02-01,59459,56977,2482,4.2
39171,2021-02-01,18524,17641,883,4.8
39173,2021-02-01,68800,65445,3355,4.9
39175,2021-02-01,12883,12345,538,4.2
40001,2021-02-01,8563,8204,359,4.2
40003,2021-02-01,2822,2755,67,2.4
40005,2021-02-01,5446,5037,409,7.5
40007,2021-02-01,2595,2538,57,2.2
40009,2021-02-01,10054,9358,696,6.9
40011,2021-02-01,4256,4073,183,4.3
40013,2021-02-01,23515,22479,1036,4.4
40015,2021-02-01,12248,11645,603,4.9
40017,2021-02-01,76124,72761,3363,4.4
40019,2021-02-01,21908,20745,1163,5.3
40021,2021-02-01,20551,19526,1025,5
40023,2021-02-01,5722,5319,403,7
40025,2021-02-01,1531,1501,30,2
40027,2021-02-01,143239,136955,6284,4.4
40029,2021-02-01,2503,2320,183,7.3
40031,2021-02-01,48464,46158,2306,4.8
40033,2021-02-01,2737,2630,107,3.9
40035,2021-02-01,5843,5585,258,4.4
40037,2021-02-01,31382,29641,1741,5.5
40039,2021-02-01,15177,14448,729,4.8
40041,2021-02-01,18806,18041,765,4.1
40043,2021-02-01,2712,2606,106,3.9
40045,2021-02-01,2225,2121,104,4.7
40047,2021-02-01,26827,25567,1260,4.7
40049,2021-02-01,13124,12427,697,5.3
40051,2021-02-01,26866,25557,1309,4.9
40053,2021-02-01,2872,2797,75,2.6
40055,2021-02-01,1964,1825,139,7.1
40057,2021-02-01,1241,1199,42,3.4
40059,2021-02-01,1885,1831,54,2.9
40061,2021-02-01,4458,4116,342,7.7
40063,2021-02-01,5585,5194,391,7
40065,2021-02-01,11068,10709,359,3.2
40067,2021-02-01,2650,2522,128,4.8
40069,2021-02-01,3719,3491,228,6.1
40071,2021-02-01,18106,17133,973,5.4
40073,2021-02-01,8838,8537,301,3.4
40075,2021-02-01,3691,3528,163,4.4
40077,2021-02-01,3223,2899,324,10.1
40079,2021-02-01,19993,18449,1544,7.7
40081,2021-02-01,15814,15080,734,4.6
40083,2021-02-01,22459,21492,967,4.3
40085,2021-02-01,6697,6502,195,2.9
40087,2021-02-01,20095,19230,865,4.3
40089,2021-02-01,15782,14844,938,5.9
40091,2021-02-01,7231,6645,586,8.1
40093,2021-02-01,3800,3645,155,4.1
40095,2021-02-01,6917,6585,332,4.8
40097,2021-02-01,19841,18919,922,4.6
40099,2021-02-01,6048,5743,305,5
40101,2021-02-01,29854,28148,1706,5.7
40103,2021-02-01,5656,5481,175,3.1
40105,2021-02-01,4744,4532,212,4.5
40107,2021-02-01,4519,4230,289,6.4
40109,2021-02-01,388287,367421,20866,5.4
40111,2021-02-01,15742,14672,1070,6.8
40113,2021-02-01,20563,19434,1129,5.5
40115,2021-02-01,14450,13819,631,4.4
40117,2021-02-01,7347,6950,397,5.4
40119,2021-02-01,38504,36876,1628,4.2
40121,2021-02-01,16754,15670,1084,6.5
40123,2021-02-01,20089,19077,1012,5
40125,2021-02-01,32889,31145,1744,5.3
40127,2021-02-01,4663,4367,296,6.3
40129,2021-02-01,1897,1824,73,3.8
40131,2021-02-01,44787,42660,2127,4.7
40133,2021-02-01,9397,8778,619,6.6
40135,2021-02-01,16906,15964,942,5.6
40137,2021-02-01,18730,17517,1213,6.5
40139,2021-02-01,11836,11594,242,2
40141,2021-02-01,3144,3018,126,4
40143,2021-02-01,323787,305880,17907,5.5
40145,2021-02-01,38132,36300,1832,4.8
40147,2021-02-01,22488,21366,1122,5
40149,2021-02-01,5192,4861,331,6.4
40151,2021-02-01,4755,4632,123,2.6
40153,2021-02-01,8807,8268,539,6.1
41001,2021-02-01,7360,6839,521,7.1
41003,2021-02-01,47260,44861,2399,5.1
41005,2021-02-01,221314,207489,13825,6.2
41007,2021-02-01,19120,17421,1699,8.9
41009,2021-02-01,24548,22764,1784,7.3
41011,2021-02-01,27489,25416,2073,7.5
41013,2021-02-01,10578,9586,992,9.4
41015,2021-02-01,9001,8268,733,8.1
41017,2021-02-01,100425,92977,7448,7.4
41019,2021-02-01,48390,45160,3230,6.7
41021,2021-02-01,1001,947,54,5.4
41023,2021-02-01,3202,2886,316,9.9
41025,2021-02-01,3729,3468,261,7
41027,2021-02-01,13742,12862,880,6.4
41029,2021-02-01,107796,100461,7335,6.8
41031,2021-02-01,10654,9734,920,8.6
41033,2021-02-01,37282,34537,2745,7.4
41035,2021-02-01,29834,27329,2505,8.4
41037,2021-02-01,3696,3460,236,6.4
41039,2021-02-01,179664,167221,12443,6.9
41041,2021-02-01,20428,18653,1775,8.7
41043,2021-02-01,59624,55470,4154,7
41045,2021-02-01,12824,12108,716,5.6
41047,2021-02-01,166602,155895,10707,6.4
41049,2021-02-01,5888,5525,363,6.2
41051,2021-02-01,461574,429240,32334,7
41053,2021-02-01,41249,38750,2499,6.1
41055,2021-02-01,986,937,49,5
41057,2021-02-01,11699,10825,874,7.5
41059,2021-02-01,37776,35116,2660,7
41061,2021-02-01,12327,11257,1070,8.7
41063,2021-02-01,3508,3247,261,7.4
41065,2021-02-01,12960,11988,972,7.5
41067,2021-02-01,326347,308206,18141,5.6
41069,2021-02-01,713,685,28,3.9
41071,2021-02-01,55064,51721,3343,6.1
42001,2021-02-01,54490,51406,3084,5.7
42003,2021-02-01,627450,578107,49343,7.9
42005,2021-02-01,31432,28308,3124,9.9
42007,2021-02-01,81951,74357,7594,9.3
42009,2021-02-01,23094,21093,2001,8.7
42011,2021-02-01,208727,191443,17284,8.3
42013,2021-02-01,58861,54246,4615,7.8
42015,2021-02-01,27994,26017,1977,7.1
42017,2021-02-01,336123,313551,22572,6.7
42019,2021-02-01,96450,89360,7090,7.4
42021,2021-02-01,55486,50475,5011,9
42023,2021-02-01,2047,1853,194,9.5
42025,2021-02-01,31589,28811,2778,8.8
42027,2021-02-01,73534,69271,4263,5.8
42029,2021-02-01,278175,263522,14653,5.3
42031,2021-02-01,16959,15567,1392,8.2
42033,2021-02-01,35783,32408,3375,9.4
42035,2021-02-01,17655,16113,1542,8.7
42037,2021-02-01,33473,30884,2589,7.7
42039,2021-02-01,38215,34818,3397,8.9
42041,2021-02-01,129857,122500,7357,5.7
42043,2021-02-01,143622,132381,11241,7.8
42045,2021-02-01,293041,270440,22601,7.7
42047,2021-02-01,14632,13387,1245,8.5
42049,2021-02-01,126512,113953,12559,9.9
42051,2021-02-01,56127,49658,6469,11.5
42053,2021-02-01,1810,1608,202,11.2
42055,2021-02-01,75645,70684,4961,6.6
42057,2021-02-01,7654,7013,641,8.4
42059,2021-02-01,16020,14557,1463,9.1
42061,2021-02-01,19667,17598,2069,10.5
42063,2021-02-01,37692,34362,3330,8.8
42065,2021-02-01,19915,18147,1768,8.9
42067,2021-02-01,12674,11763,911,7.2
42069,2021-02-01,103142,93962,9180,8.9
42071,2021-02-01,277787,260263,17524,6.3
42073,2021-02-01,40009,35844,4165,10.4
42075,2021-02-01,71101,66084,5017,7.1
42077,2021-02-01,191058,175031,16027,8.4
42079,2021-02-01,156590,140312,16278,10.4
42081,2021-02-01,55143,50248,4895,8.9
42083,2021-02-01,16958,15505,1453,8.6
42085,2021-02-01,47574,43203,4371,9.2
42087,2021-02-01,21173,19472,1701,8
42089,2021-02-01,79928,72339,7589,9.5
42091,2021-02-01,444442,416886,27556,6.2
42093,2021-02-01,9056,8561,495,5.5
42095,2021-02-01,158214,146321,11893,7.5
42097,2021-02-01,41594,37897,3697,8.9
42099,2021-02-01,24049,22531,1518,6.3
42101,2021-02-01,712339,632326,80013,11.2
42103,2021-02-01,24090,21909,2181,9.1
42105,2021-02-01,7220,6548,672,9.3
42107,2021-02-01,65551,59718,5833,8.9
42109,2021-02-01,19565,18170,1395,7.1
42111,2021-02-01,33271,30276,2995,9
42113,2021-02-01,2678,2411,267,10
42115,2021-02-01,19803,18359,1444,7.3
42117,2021-02-01,18738,17093,1645,8.8
42119,2021-02-01,19198,18006,1192,6.2
42121,2021-02-01,21765,19781,1984,9.1
42123,2021-02-01,18461,16943,1518,8.2
42125,2021-02-01,104418,95081,9337,8.9
42127,2021-02-01,22326,20280,2046,9.2
42129,2021-02-01,175131,160423,14708,8.4
42131,2021-02-01,13271,12122,1149,8.7
42133,2021-02-01,233341,217527,15814,6.8
44001,2021-02-01,24895,23187,1708,6.9
44003,2021-02-01,87479,81218,6261,7.2
44005,2021-02-01,42691,39356,3335,7.8
44007,2021-02-01,316528,289993,26535,8.4
44009,2021-02-01,65678,60817,4861,7.4
45001,2021-02-01,10084,9541,543,5.4
45003,2021-02-01,75952,72537,3415,4.5
45005,2021-02-01,2631,2383,248,9.4
45007,2021-02-01,91114,86671,4443,4.9
45009,2021-02-01,4786,4336,450,9.4
45011,2021-02-01,7971,7345,626,7.9
45013,2021-02-01,75985,72396,3589,4.7
45015,2021-02-01,105111,100063,5048,4.8
45017,2021-02-01,6569,6204,365,5.6
45019,2021-02-01,211218,201008,10210,4.8
45021,2021-02-01,25071,23448,1623,6.5
45023,2021-02-01,13548,12537,1011,7.5
45025,2021-02-01,21768,20507,1261,5.8
45027,2021-02-01,12634,11823,811,6.4
45029,2021-02-01,16643,15674,969,5.8
45031,2021-02-01,30303,28539,1764,5.8
45033,2021-02-01,13423,12478,945,7
45035,2021-02-01,77648,73940,3708,4.8
45037,2021-02-01,10848,10348,500,4.6
45039,2021-02-01,9588,8919,669,7
45041,2021-02-01,67056,63619,3437,5.1
45043,2021-02-01,25842,24131,1711,6.6
45045,2021-02-01,256234,244781,11453,4.5
45047,2021-02-01,31634,29808,1826,5.8
45049,2021-02-01,8088,7701,387,4.8
45051,2021-02-01,144776,134469,10307,7.1
45053,2021-02-01,12741,12140,601,4.7
45055,2021-02-01,29482,28062,1420,4.8
45057,2021-02-01,42432,40024,2408,5.7
45059,2021-02-01,30189,28519,1670,5.5
45061,2021-02-01,6764,6304,460,6.8
45063,2021-02-01,150832,144742,6090,4
45065,2021-02-01,3377,3158,219,6.5
45067,2021-02-01,13330,12297,1033,7.7
45069,2021-02-01,9213,8373,840,9.1
45071,2021-02-01,19376,18530,846,4.4
45073,2021-02-01,34890,33280,1610,4.6
45075,2021-02-01,34856,32029,2827,8.1
45077,2021-02-01,57444,54884,2560,4.5
45079,2021-02-01,199686,189149,10537,5.3
45081,2021-02-01,8695,8312,383,4.4
45083,2021-02-01,158953,151164,7789,4.9
45085,2021-02-01,43917,41328,2589,5.9
45087,2021-02-01,12067,11151,916,7.6
45089,2021-02-01,11773,10907,866,7.4
45091,2021-02-01,143613,136695,6918,4.8
46003,2021-02-01,1501,1468,33,2.2
46005,2021-02-01,9363,9077,286,3.1
46007,2021-02-01,1074,1029,45,4.2
46009,2021-02-01,2882,2788,94,3.3
46011,2021-02-01,18772,18176,596,3.2
46013,2021-02-01,20818,20172,646,3.1
46015,2021-02-01,2419,2356,63,2.6
46017,2021-02-01,729,703,26,3.6
46019,2021-02-01,4979,4785,194,3.9
46021,2021-02-01,808,781,27,3.3
46023,2021-02-01,3745,3595,150,4
46025,2021-02-01,2404,2316,88,3.7
46027,2021-02-01,7598,7375,223,2.9
46029,2021-02-01,15449,14896,553,3.6
46031,2021-02-01,1388,1338,50,3.6
46033,2021-02-01,4135,3959,176,4.3
46035,2021-02-01,10995,10668,327,3
46037,2021-02-01,2721,2567,154,5.7
46039,2021-02-01,2469,2335,134,5.4
46041,2021-02-01,2253,2161,92,4.1
46043,2021-02-01,1588,1541,47,3
46045,2021-02-01,2063,2003,60,2.9
46047,2021-02-01,2976,2828,148,5
46049,2021-02-01,1057,1031,26,2.5
46051,2021-02-01,4457,4245,212,4.8
46053,2021-02-01,2030,1965,65,3.2
46055,2021-02-01,1105,1076,29,2.6
46057,2021-02-01,3385,3293,92,2.7
46059,2021-02-01,1833,1790,43,2.3
46061,2021-02-01,1786,1701,85,4.8
46063,2021-02-01,738,719,19,2.6
46065,2021-02-01,9986,9702,284,2.8
46067,2021-02-01,3679,3542,137,3.7
46069,2021-02-01,696,682,14,2
46071,2021-02-01,1164,1095,69,5.9
46073,2021-02-01,1243,1217,26,2.1
46075,2021-02-01,478,461,17,3.6
46077,2021-02-01,2735,2644,91,3.3
46079,2021-02-01,6570,6376,194,3
46081,2021-02-01,13597,13185,412,3
46083,2021-02-01,36144,35190,954,2.6
46085,2021-02-01,1620,1545,75,4.6
46087,2021-02-01,3144,3052,92,2.9
46089,2021-02-01,1039,993,46,4.4
46091,2021-02-01,2460,2362,98,4
46093,2021-02-01,14021,13562,459,3.3
46095,2021-02-01,726,699,27,3.7
46097,2021-02-01,1131,1092,39,3.4
46099,2021-02-01,114206,110406,3800,3.3
46101,2021-02-01,4016,3894,122,3
46102,2021-02-01,3768,3431,337,8.9
46103,2021-02-01,57333,55351,1982,3.5
46105,2021-02-01,1422,1373,49,3.4
46107,2021-02-01,996,969,27,2.7
46109,2021-02-01,4839,4563,276,5.7
46111,2021-02-01,1200,1161,39,3.3
46115,2021-02-01,3171,3050,121,3.8
46117,2021-02-01,1933,1858,75,3.9
46119,2021-02-01,816,796,20,2.5
46121,2021-02-01,3050,2915,135,4.4
46123,2021-02-01,3057,2988,69,2.3
46125,2021-02-01,4747,4599,148,3.1
46127,2021-02-01,8534,8212,322,3.8
46129,2021-02-01,2136,1999,137,6.4
46135,2021-02-01,11711,11377,334,2.9
46137,2021-02-01,969,937,32,3.3
47001,2021-02-01,34880,33213,1667,4.8
47003,2021-02-01,20770,19761,1009,4.9
47005,2021-02-01,6736,6308,428,6.4
47007,2021-02-01,4270,3970,300,7
47009,2021-02-01,64364,61547,2817,4.4
47011,2021-02-01,52191,49748,2443,4.7
47013,2021-02-01,14992,14075,917,6.1
47015,2021-02-01,6562,6293,269,4.1
47017,2021-02-01,12116,11468,648,5.3
47019,2021-02-01,23719,22473,1246,5.3
47021,2021-02-01,21617,20802,815,3.8
47023,2021-02-01,8462,8102,360,4.3
47025,2021-02-01,13038,12329,709,5.4
47027,2021-02-01,2753,2564,189,6.9
47029,2021-02-01,14541,13402,1139,7.8
47031,2021-02-01,25506,24323,1183,4.6
47033,2021-02-01,6889,6563,326,4.7
47035,2021-02-01,22833,21324,1509,6.6
47037,2021-02-01,400888,383277,17611,4.4
47039,2021-02-01,4349,4068,281,6.5
47041,2021-02-01,7664,7243,421,5.5
47043,2021-02-01,26704,25690,1014,3.8
47045,2021-02-01,15803,14928,875,5.5
47047,2021-02-01,19116,18212,904,4.7
47049,2021-02-01,7507,7134,373,5
47051,2021-02-01,19633,18750,883,4.5
47053,2021-02-01,21828,20725,1103,5.1
47055,2021-02-01,14513,13834,679,4.7
47057,2021-02-01,9628,9082,546,5.7
47059,2021-02-01,28738,27197,1541,5.4
47061,2021-02-01,5029,4710,319,6.3
47063,2021-02-01,28401,27080,1321,4.7
47065,2021-02-01,181551,173348,8203,4.5
47067,2021-02-01,2147,2019,128,6
47069,2021-02-01,9202,8573,629,6.8
47071,2021-02-01,10296,9713,583,5.7
47073,2021-02-01,23490,22244,1246,5.3
47075,2021-02-01,7757,7240,517,6.7
47077,2021-02-01,11989,11367,622,5.2
47079,2021-02-01,13340,12612,728,5.5
47081,2021-02-01,11248,10810,438,3.9
47083,2021-02-01,3223,3003,220,6.8
47085,2021-02-01,8694,8278,416,4.8
47087,2021-02-01,4864,4586,278,5.7
47089,2021-02-01,25051,23774,1277,5.1
47091,2021-02-01,7858,7461,397,5.1
47093,2021-02-01,246055,236574,9481,3.9
47095,2021-02-01,1717,1570,147,8.6
47097,2021-02-01,9813,9182,631,6.4
47099,2021-02-01,19219,18234,985,5.1
47101,2021-02-01,5329,5056,273,5.1
47103,2021-02-01,16003,15263,740,4.6
47105,2021-02-01,23815,22814,1001,4.2
47107,2021-02-01,23352,22188,1164,5
47109,2021-02-01,8376,7791,585,7
47111,2021-02-01,11232,10736,496,4.4
47113,2021-02-01,48932,46514,2418,4.9
47115,2021-02-01,12306,11675,631,5.1
47117,2021-02-01,15198,14489,709,4.7
47119,2021-02-01,49753,47497,2256,4.5
47121,2021-02-01,5253,4921,332,6.3
47123,2021-02-01,20219,19326,893,4.4
47125,2021-02-01,86836,82331,4505,5.2
47127,2021-02-01,3615,3491,124,3.4
47129,2021-02-01,7853,7405,448,5.7
47131,2021-02-01,12274,11537,737,6
47133,2021-02-01,9907,9384,523,5.3
47135,2021-02-01,3047,2820,227,7.4
47137,2021-02-01,2202,2089,113,5.1
47139,2021-02-01,7396,7023,373,5
47141,2021-02-01,35436,33809,1627,4.6
47143,2021-02-01,13110,12283,827,6.3
47145,2021-02-01,23522,22281,1241,5.3
47147,2021-02-01,37688,36220,1468,3.9
47149,2021-02-01,185366,178058,7308,3.9
47151,2021-02-01,8218,7696,522,6.4
47153,2021-02-01,6121,5789,332,5.4
47155,2021-02-01,52520,49042,3478,6.6
47157,2021-02-01,446499,416024,30475,6.8
47159,2021-02-01,9374,8995,379,4
47161,2021-02-01,5470,5189,281,5.1
47163,2021-02-01,69576,66098,3478,5
47165,2021-02-01,102812,98848,3964,3.9
47167,2021-02-01,27650,26310,1340,4.8
47169,2021-02-01,5483,5231,252,4.6
47171,2021-02-01,7111,6618,493,6.9
47173,2021-02-01,7726,7330,396,5.1
47175,2021-02-01,2000,1884,116,5.8
47177,2021-02-01,16965,16012,953,5.6
47179,2021-02-01,59806,57172,2634,4.4
47181,2021-02-01,6506,6150,356,5.5
47183,2021-02-01,15607,14905,702,4.5
47185,2021-02-01,12105,11517,588,4.9
47187,2021-02-01,129080,125136,3944,3.1
47189,2021-02-01,77299,74462,2837,3.7
48001,2021-02-01,23500,21981,1519,6.5
48003,2021-02-01,8961,8196,765,8.5
48005,2021-02-01,35544,32558,2986,8.4
48007,2021-02-01,9110,8264,846,9.3
48009,2021-02-01,3928,3702,226,5.8
48011,2021-02-01,938,894,44,4.7
48013,2021-02-01,22184,20369,1815,8.2
48015,2021-02-01,13669,12698,971,7.1
48017,2021-02-01,2531,2375,156,6.2
48019,2021-02-01,10070,9438,632,6.3
48021,2021-02-01,43512,40905,2607,6
48023,2021-02-01,1816,1744,72,4
48025,2021-02-01,10071,8987,1084,10.8
48027,2021-02-01,145530,134688,10842,7.5
48029,2021-02-01,952997,886055,66942,7
48031,2021-02-01,6729,6457,272,4
48033,2021-02-01,498,482,16,3.2
48035,2021-02-01,8521,8017,504,5.9
48037,2021-02-01,39036,36125,2911,7.5
48039,2021-02-01,177303,161305,15998,9
48041,2021-02-01,119760,113245,6515,5.4
48043,2021-02-01,4135,3882,253,6.1
48045,2021-02-01,591,557,34,5.8
48047,2021-02-01,2632,2331,301,11.4
48049,2021-02-01,15360,14329,1031,6.7
48051,2021-02-01,8426,7871,555,6.6
48053,2021-02-01,24356,23150,1206,5
48055,2021-02-01,19750,18496,1254,6.3
48057,2021-02-01,12674,11878,796,6.3
48059,2021-02-01,6070,5690,380,6.3
48061,2021-02-01,170294,151785,18509,10.9
48063,2021-02-01,5092,4685,407,8
48065,2021-02-01,3020,2867,153,5.1
48067,2021-02-01,12398,11295,1103,8.9
48069,2021-02-01,3466,3309,157,4.5
48071,2021-02-01,19950,17813,2137,10.7
48073,2021-02-01,21658,19837,1821,8.4
48075,2021-02-01,3196,3058,138,4.3
48077,2021-02-01,4861,4533,328,6.7
48079,2021-02-01,1172,1084,88,7.5
48081,2021-02-01,1345,1254,91,6.8
48083,2021-02-01,2930,2694,236,8.1
48085,2021-02-01,575418,541458,33960,5.9
48087,2021-02-01,1083,1020,63,5.8
48089,2021-02-01,9721,9097,624,6.4
48091,2021-02-01,76061,71512,4549,6
48093,2021-02-01,5798,5444,354,6.1
48095,2021-02-01,1366,1293,73,5.3
48097,2021-02-01,19284,17989,1295,6.7
48099,2021-02-01,24217,22447,1770,7.3
48101,2021-02-01,601,563,38,6.3
48103,2021-02-01,1613,1381,232,14.4
48105,2021-02-01,1508,1373,135,9
48107,2021-02-01,2500,2335,165,6.6
48109,2021-02-01,1222,1154,68,5.6
48111,2021-02-01,3769,3635,134,3.6
48113,2021-02-01,NA,NA,101125,7.4
48115,2021-02-01,4635,4202,433,9.3
48117,2021-02-01,8886,8470,416,4.7
48119,2021-02-01,2455,2305,150,6.1
48121,2021-02-01,507686,477362,30324,6
48123,2021-02-01,9241,8614,627,6.8
48125,2021-02-01,681,638,43,6.3
48127,2021-02-01,6192,5734,458,7.4
48129,2021-02-01,1469,1391,78,5.3
48131,2021-02-01,4781,4180,601,12.6
48133,2021-02-01,7304,6730,574,7.9
48135,2021-02-01,79658,70201,9457,11.9
48137,2021-02-01,1422,1353,69,4.9
48139,2021-02-01,94856,89088,5768,6.1
48141,2021-02-01,367701,337227,30474,8.3
48143,2021-02-01,20614,19370,1244,6
48145,2021-02-01,6730,6292,438,6.5
48147,2021-02-01,17090,16169,921,5.4
48149,2021-02-01,11813,11146,667,5.6
48151,2021-02-01,1641,1547,94,5.7
48153,2021-02-01,2591,2393,198,7.6
48155,2021-02-01,580,556,24,4.1
48157,2021-02-01,393084,361814,31270,8
48159,2021-02-01,5034,4736,298,5.9
48161,2021-02-01,6387,5779,608,9.5
48163,2021-02-01,9346,8717,629,6.7
48165,2021-02-01,9995,9369,626,6.3
48167,2021-02-01,163563,149210,14353,8.8
48169,2021-02-01,2019,1884,135,6.7
48171,2021-02-01,13384,12786,598,4.5
48173,2021-02-01,812,783,29,3.6
48175,2021-02-01,3184,2896,288,9
48177,2021-02-01,9874,9311,563,5.7
48179,2021-02-01,7655,6947,708,9.2
48181,2021-02-01,65068,61160,3908,6
48183,2021-02-01,56345,51599,4746,8.4
48185,2021-02-01,11227,10258,969,8.6
48187,2021-02-01,81801,77027,4774,5.8
48189,2021-02-01,12049,11106,943,7.8
48191,2021-02-01,1115,1037,78,7
48193,2021-02-01,3874,3668,206,5.3
48195,2021-02-01,2503,2402,101,4
48197,2021-02-01,1750,1653,97,5.5
48199,2021-02-01,25264,22823,2441,9.7
48201,2021-02-01,NA,NA,190161,8.4
48203,2021-02-01,29155,26692,2463,8.4
48205,2021-02-01,2635,2564,71,2.7
48207,2021-02-01,2699,2567,132,4.9
48209,2021-02-01,123081,116063,7018,5.7
48211,2021-02-01,1758,1660,98,5.6
48213,2021-02-01,37875,35312,2563,6.8
48215,2021-02-01,365291,321332,43959,12
48217,2021-02-01,16387,15277,1110,6.8
48219,2021-02-01,10557,9699,858,8.1
48221,2021-02-01,27928,25929,1999,7.2
48223,2021-02-01,17744,16744,1000,5.6
48225,2021-02-01,9979,9290,689,6.9
48227,2021-02-01,13418,12247,1171,8.7
48229,2021-02-01,1890,1748,142,7.5
48231,2021-02-01,44238,41206,3032,6.9
48233,2021-02-01,8534,7841,693,8.1
48235,2021-02-01,765,718,47,6.1
48237,2021-02-01,3287,3027,260,7.9
48239,2021-02-01,7236,6769,467,6.5
48241,2021-02-01,12910,11291,1619,12.5
48243,2021-02-01,1011,951,60,5.9
48245,2021-02-01,106675,93258,13417,12.6
48247,2021-02-01,1898,1694,204,10.7
48249,2021-02-01,15686,13571,2115,13.5
48251,2021-02-01,83591,78007,5584,6.7
48253,2021-02-01,5868,5397,471,8
48255,2021-02-01,6972,6493,479,6.9
48257,2021-02-01,68264,63708,4556,6.7
48259,2021-02-01,22539,21417,1122,5
48261,2021-02-01,183,170,13,7.1
48263,2021-02-01,445,430,15,3.4
48265,2021-02-01,21543,20264,1279,5.9
48267,2021-02-01,1848,1739,109,5.9
48269,2021-02-01,275,271,4,1.5
48271,2021-02-01,1380,1283,97,7
48273,2021-02-01,13747,12519,1228,8.9
48275,2021-02-01,1513,1419,94,6.2
48277,2021-02-01,24004,22189,1815,7.6
48279,2021-02-01,5462,5109,353,6.5
48281,2021-02-01,9174,8591,583,6.4
48283,2021-02-01,3495,3259,236,6.8
48285,2021-02-01,8397,7879,518,6.2
48287,2021-02-01,9045,8513,532,5.9
48289,2021-02-01,6249,5673,576,9.2
48291,2021-02-01,34040,29844,4196,12.3
48293,2021-02-01,8471,7750,721,8.5
48295,2021-02-01,1574,1496,78,5
48297,2021-02-01,4983,4523,460,9.2
48299,2021-02-01,8571,8001,570,6.7
48301,2021-02-01,283,279,4,1.4
48303,2021-02-01,158915,149566,9349,5.9
48305,2021-02-01,2821,2664,157,5.6
48307,2021-02-01,3273,2995,278,8.5
48309,2021-02-01,122799,115135,7664,6.2
48311,2021-02-01,674,652,22,3.3
48313,2021-02-01,4547,4159,388,8.5
48315,2021-02-01,4289,3906,383,8.9
48317,2021-02-01,2501,2332,169,6.8
48319,2021-02-01,1763,1650,113,6.4
48321,2021-02-01,16397,14627,1770,10.8
48323,2021-02-01,25279,20926,4353,17.2
48325,2021-02-01,21939,20513,1426,6.5
48327,2021-02-01,891,835,56,6.3
48329,2021-02-01,94622,86758,7864,8.3
48331,2021-02-01,10024,9210,814,8.1
48333,2021-02-01,1954,1847,107,5.5
48335,2021-02-01,2420,2200,220,9.1
48337,2021-02-01,9022,8395,627,6.9
48339,2021-02-01,283811,261741,22070,7.8
48341,2021-02-01,10830,10316,514,4.7
48343,2021-02-01,4783,4141,642,13.4
48345,2021-02-01,444,419,25,5.6
48347,2021-02-01,28700,26648,2052,7.1
48349,2021-02-01,23374,21810,1564,6.7
48351,2021-02-01,5156,4517,639,12.4
48353,2021-02-01,7310,6858,452,6.2
48355,2021-02-01,163250,148346,14904,9.1
48357,2021-02-01,3983,3723,260,6.5
48359,2021-02-01,917,876,41,4.5
48361,2021-02-01,36358,32307,4051,11.1
48363,2021-02-01,13118,12077,1041,7.9
48365,2021-02-01,9207,8352,855,9.3
48367,2021-02-01,68777,64553,4224,6.1
48369,2021-02-01,5181,4999,182,3.5
48371,2021-02-01,6741,6124,617,9.2
48373,2021-02-01,18915,16998,1917,10.1
48375,2021-02-01,55011,51850,3161,5.7
48377,2021-02-01,3192,2745,447,14
48379,2021-02-01,6297,5981,316,5
48381,2021-02-01,73554,70104,3450,4.7
48383,2021-02-01,1754,1572,182,10.4
48385,2021-02-01,1119,1028,91,8.1
48387,2021-02-01,5314,4894,420,7.9
48389,2021-02-01,8227,7556,671,8.2
48391,2021-02-01,3093,2812,281,9.1
48393,2021-02-01,420,396,24,5.7
48395,2021-02-01,7605,7078,527,6.9
48397,2021-02-01,53814,50646,3168,5.9
48399,2021-02-01,4568,4330,238,5.2
48401,2021-02-01,22223,20433,1790,8.1
48403,2021-02-01,4067,3578,489,12
48405,2021-02-01,3027,2707,320,10.6
48407,2021-02-01,11901,10755,1146,9.6
48409,2021-02-01,29380,26103,3277,11.2
48411,2021-02-01,2188,2043,145,6.6
48413,2021-02-01,1176,1085,91,7.7
48415,2021-02-01,6091,5555,536,8.8
48417,2021-02-01,1765,1664,101,5.7
48419,2021-02-01,11423,10568,855,7.5
48421,2021-02-01,1365,1311,54,4
48423,2021-02-01,109681,102129,7552,6.9
48425,2021-02-01,4380,4072,308,7
48427,2021-02-01,27543,22207,5336,19.4
48429,2021-02-01,4112,3833,279,6.8
48431,2021-02-01,574,533,41,7.1
48433,2021-02-01,577,543,34,5.9
48435,2021-02-01,1194,1068,126,10.6
48437,2021-02-01,2601,2439,162,6.2
48439,2021-02-01,NA,NA,77466,7.1
48441,2021-02-01,66686,62860,3826,5.7
48443,2021-02-01,408,390,18,4.4
48445,2021-02-01,4870,4473,397,8.2
48447,2021-02-01,651,611,40,6.1
48449,2021-02-01,13711,12786,925,6.7
48451,2021-02-01,54096,50590,3506,6.5
48453,2021-02-01,750908,708948,41960,5.6
48455,2021-02-01,5459,4958,501,9.2
48457,2021-02-01,7615,6794,821,10.8
48459,2021-02-01,17488,16044,1444,8.3
48461,2021-02-01,1944,1821,123,6.3
48463,2021-02-01,11421,10588,833,7.3
48465,2021-02-01,22899,21157,1742,7.6
48467,2021-02-01,26514,24843,1671,6.3
48469,2021-02-01,40878,37359,3519,8.6
48471,2021-02-01,24338,22389,1949,8
48473,2021-02-01,23910,21863,2047,8.6
48475,2021-02-01,5884,5294,590,10
48477,2021-02-01,15727,14669,1058,6.7
48479,2021-02-01,116050,106121,9929,8.6
48481,2021-02-01,21537,19917,1620,7.5
48483,2021-02-01,2320,2132,188,8.1
48485,2021-02-01,55293,51318,3975,7.2
48487,2021-02-01,5127,4695,432,8.4
48489,2021-02-01,6797,5860,937,13.8
48491,2021-02-01,323814,306205,17609,5.4
48493,2021-02-01,24952,23501,1451,5.8
48495,2021-02-01,4018,3617,401,10
48497,2021-02-01,32343,30265,2078,6.4
48499,2021-02-01,18444,17122,1322,7.2
48501,2021-02-01,3384,3008,376,11.1
48503,2021-02-01,7737,7267,470,6.1
48505,2021-02-01,4355,3706,649,14.9
48507,2021-02-01,3562,2998,564,15.8
49001,2021-02-01,2836,2735,101,3.6
49003,2021-02-01,26639,25778,861,3.2
49005,2021-02-01,65695,63980,1715,2.6
49007,2021-02-01,8551,8112,439,5.1
49009,2021-02-01,344,325,19,5.5
49011,2021-02-01,177589,172040,5549,3.1
49013,2021-02-01,7496,6971,525,7
49015,2021-02-01,4347,4101,246,5.7
49017,2021-02-01,2276,1971,305,13.4
49019,2021-02-01,5691,5171,520,9.1
49021,2021-02-01,25446,24525,921,3.6
49023,2021-02-01,6027,5854,173,2.9
49025,2021-02-01,3563,3386,177,5
49027,2021-02-01,5851,5669,182,3.1
49029,2021-02-01,5649,5481,168,3
49031,2021-02-01,474,446,28,5.9
49033,2021-02-01,984,934,50,5.1
49035,2021-02-01,641040,617753,23287,3.6
49037,2021-02-01,5130,4649,481,9.4
49039,2021-02-01,12831,12357,474,3.7
49041,2021-02-01,9752,9327,425,4.4
49043,2021-02-01,25159,24281,878,3.5
49045,2021-02-01,35203,33868,1335,3.8
49047,2021-02-01,12868,11858,1010,7.8
49049,2021-02-01,319589,309835,9754,3.1
49051,2021-02-01,16171,15577,594,3.7
49053,2021-02-01,81171,78036,3135,3.9
49055,2021-02-01,1304,1188,116,8.9
49057,2021-02-01,131251,126169,5082,3.9
50001,2021-02-01,19057,18526,531,2.8
50003,2021-02-01,15807,15170,637,4
50005,2021-02-01,13385,12907,478,3.6
50007,2021-02-01,87681,85311,2370,2.7
50009,2021-02-01,2435,2319,116,4.8
50011,2021-02-01,24411,23628,783,3.2
50013,2021-02-01,3762,3623,139,3.7
50015,2021-02-01,12167,11688,479,3.9
50017,2021-02-01,14597,14142,455,3.1
50019,2021-02-01,11680,11160,520,4.5
50021,2021-02-01,27301,26248,1053,3.9
50023,2021-02-01,31241,30400,841,2.7
50025,2021-02-01,19867,19046,821,4.1
50027,2021-02-01,26790,25931,859,3.2
51001,2021-02-01,15384,14365,1019,6.6
51003,2021-02-01,53952,51572,2380,4.4
51005,2021-02-01,6614,6225,389,5.9
51007,2021-02-01,5923,5611,312,5.3
51009,2021-02-01,14222,13499,723,5.1
51011,2021-02-01,6825,6435,390,5.7
51013,2021-02-01,147714,141770,5944,4
51015,2021-02-01,36241,34781,1460,4
51017,2021-02-01,2216,2048,168,7.6
51019,2021-02-01,36668,34912,1756,4.8
51021,2021-02-01,2802,2669,133,4.7
51023,2021-02-01,16805,16121,684,4.1
51025,2021-02-01,5745,5287,458,8
51027,2021-02-01,6225,5651,574,9.2
51029,2021-02-01,6173,5690,483,7.8
51031,2021-02-01,24720,23406,1314,5.3
51033,2021-02-01,14425,13538,887,6.1
51035,2021-02-01,12690,11969,721,5.7
51036,2021-02-01,3448,3235,213,6.2
51037,2021-02-01,4963,4697,266,5.4
51041,2021-02-01,178718,169741,8977,5
51043,2021-02-01,7244,6952,292,4
51045,2021-02-01,2237,2137,100,4.5
51047,2021-02-01,23861,22785,1076,4.5
51049,2021-02-01,4457,4179,278,6.2
51051,2021-02-01,4643,4310,333,7.2
51053,2021-02-01,12988,12148,840,6.5
51057,2021-02-01,5384,5029,355,6.6
51059,2021-02-01,610760,581670,29090,4.8
51061,2021-02-01,35599,34163,1436,4
51063,2021-02-01,7937,7583,354,4.5
51065,2021-02-01,13351,12738,613,4.6
51067,2021-02-01,25393,24147,1246,4.9
51069,2021-02-01,47673,45864,1809,3.8
51071,2021-02-01,7667,7298,369,4.8
51073,2021-02-01,18757,17866,891,4.8
51075,2021-02-01,10712,10259,453,4.2
51077,2021-02-01,8377,7996,381,4.5
51079,2021-02-01,9860,9449,411,4.2
51081,2021-02-01,4157,3873,284,6.8
51083,2021-02-01,14773,13851,922,6.2
51085,2021-02-01,55627,53353,2274,4.1
51087,2021-02-01,172996,163495,9501,5.5
51089,2021-02-01,23670,22198,1472,6.2
51091,2021-02-01,1162,1111,51,4.4
51093,2021-02-01,18661,17771,890,4.8
51095,2021-02-01,35458,33523,1935,5.5
51097,2021-02-01,3799,3616,183,4.8
51099,2021-02-01,13717,13160,557,4.1
51101,2021-02-01,8729,8297,432,4.9
51103,2021-02-01,5356,4869,487,9.1
51105,2021-02-01,8118,7657,461,5.7
51107,2021-02-01,216585,207244,9341,4.3
51109,2021-02-01,19671,18771,900,4.6
51111,2021-02-01,5160,4891,269,5.2
51113,2021-02-01,7173,6926,247,3.4
51115,2021-02-01,3943,3789,154,3.9
51117,2021-02-01,12452,11684,768,6.2
51119,2021-02-01,4949,4721,228,4.6
51121,2021-02-01,48742,46861,1881,3.9
51125,2021-02-01,7046,6703,343,4.9
51127,2021-02-01,12029,11544,485,4
51131,2021-02-01,5146,4710,436,8.5
51133,2021-02-01,5587,5134,453,8.1
51135,2021-02-01,6953,6584,369,5.3
51137,2021-02-01,16680,15837,843,5.1
51139,2021-02-01,11686,10858,828,7.1
51141,2021-02-01,6938,6506,432,6.2
51143,2021-02-01,29390,27809,1581,5.4
51145,2021-02-01,13440,12892,548,4.1
51147,2021-02-01,10016,9391,625,6.2
51149,2021-02-01,14382,13482,900,6.3
51153,2021-02-01,238927,225768,13159,5.5
51155,2021-02-01,15884,14997,887,5.6
51157,2021-02-01,3569,3429,140,3.9
51159,2021-02-01,3993,3791,202,5.1
51161,2021-02-01,47756,45718,2038,4.3
51163,2021-02-01,10224,9680,544,5.3
51165,2021-02-01,40441,38792,1649,4.1
51167,2021-02-01,10944,10275,669,6.1
51169,2021-02-01,8708,8324,384,4.4
51171,2021-02-01,21865,20819,1046,4.8
51173,2021-02-01,13010,12261,749,5.8
51175,2021-02-01,8765,8368,397,4.5
51177,2021-02-01,65320,61963,3357,5.1
51179,2021-02-01,70482,66978,3504,5
51181,2021-02-01,3468,3287,181,5.2
51183,2021-02-01,3586,3243,343,9.6
51185,2021-02-01,15425,14358,1067,6.9
51187,2021-02-01,19685,18709,976,5
51191,2021-02-01,25236,24040,1196,4.7
51193,2021-02-01,9247,8646,601,6.5
51195,2021-02-01,12788,11897,891,7
51197,2021-02-01,13390,12602,788,5.9
51199,2021-02-01,31555,30145,1410,4.5
51510,2021-02-01,97540,92498,5042,5.2
51520,2021-02-01,7133,6666,467,6.5
51530,2021-02-01,3333,3178,155,4.7
51540,2021-02-01,24540,23298,1242,5.1
51550,2021-02-01,119158,112840,6318,5.3
51570,2021-02-01,8175,7638,537,6.6
51580,2021-02-01,2322,2135,187,8.1
51590,2021-02-01,19000,17382,1618,8.5
51595,2021-02-01,2302,2050,252,10.9
51600,2021-02-01,12656,12096,560,4.4
51610,2021-02-01,8118,7836,282,3.5
51620,2021-02-01,3647,3310,337,9.2
51630,2021-02-01,13686,12790,896,6.5
51640,2021-02-01,2802,2655,147,5.2
51650,2021-02-01,62994,58227,4767,7.6
51660,2021-02-01,23735,22479,1256,5.3
51670,2021-02-01,9469,8484,985,10.4
51678,2021-02-01,2052,1922,130,6.3
51680,2021-02-01,34980,32600,2380,6.8
51683,2021-02-01,21075,19927,1148,5.4
51685,2021-02-01,9197,8684,513,5.6
51690,2021-02-01,5586,5037,549,9.8
51700,2021-02-01,87453,80763,6690,7.6
51710,2021-02-01,109314,100629,8685,7.9
51720,2021-02-01,1619,1516,103,6.4
51730,2021-02-01,13103,11226,1877,14.3
51735,2021-02-01,6084,5867,217,3.6
51740,2021-02-01,43967,39860,4107,9.3
51750,2021-02-01,8489,8022,467,5.5
51760,2021-02-01,115000,106066,8934,7.8
51770,2021-02-01,48094,44902,3192,6.6
51775,2021-02-01,12403,11811,592,4.8
51790,2021-02-01,12016,11377,639,5.3
51800,2021-02-01,43665,40993,2672,6.1
51810,2021-02-01,224134,212925,11209,5
51820,2021-02-01,10513,9925,588,5.6
51830,2021-02-01,6512,6071,441,6.8
51840,2021-02-01,14526,13835,691,4.8
53001,2021-02-01,9660,8986,674,7
53003,2021-02-01,10178,9737,441,4.3
53005,2021-02-01,99896,93204,6692,6.7
53007,2021-02-01,41385,38421,2964,7.2
53009,2021-02-01,28636,26407,2229,7.8
53011,2021-02-01,231507,216399,15108,6.5
53013,2021-02-01,1680,1560,120,7.1
53015,2021-02-01,46725,43205,3520,7.5
53017,2021-02-01,20434,18949,1485,7.3
53019,2021-02-01,2411,2161,250,10.4
53021,2021-02-01,42642,39196,3446,8.1
53023,2021-02-01,775,716,59,7.6
53025,2021-02-01,47230,43343,3887,8.2
53027,2021-02-01,28458,25856,2602,9.1
53029,2021-02-01,35168,32870,2298,6.5
53031,2021-02-01,12384,11440,944,7.6
53033,2021-02-01,NA,NA,69845,5.3
53035,2021-02-01,122777,115312,7465,6.1
53037,2021-02-01,21090,19414,1676,7.9
53039,2021-02-01,9735,9025,710,7.3
53041,2021-02-01,34469,32022,2447,7.1
53043,2021-02-01,4585,4307,278,6.1
53045,2021-02-01,24542,22568,1974,8
53047,2021-02-01,18985,17349,1636,8.6
53049,2021-02-01,8578,7804,774,9
53051,2021-02-01,4826,4347,479,9.9
53053,2021-02-01,430525,399823,30702,7.1
53055,2021-02-01,8041,7520,521,6.5
53057,2021-02-01,59568,54992,4576,7.7
53059,2021-02-01,5304,4877,427,8.1
53061,2021-02-01,450388,422593,27795,6.2
53063,2021-02-01,247920,230773,17147,6.9
53065,2021-02-01,18015,16496,1519,8.4
53067,2021-02-01,140491,131920,8571,6.1
53069,2021-02-01,1410,1309,101,7.2
53071,2021-02-01,29598,27810,1788,6
53073,2021-02-01,110000,102032,7968,7.2
53075,2021-02-01,21888,20792,1096,5
53077,2021-02-01,128075,116972,11103,8.7
54001,2021-02-01,7523,6967,556,7.4
54003,2021-02-01,57413,54584,2829,4.9
54005,2021-02-01,7370,6775,595,8.1
54007,2021-02-01,5123,4583,540,10.5
54009,2021-02-01,9983,9189,794,8
54011,2021-02-01,41976,39426,2550,6.1
54013,2021-02-01,2485,2066,419,16.9
54015,2021-02-01,3167,2791,376,11.9
54017,2021-02-01,3777,3541,236,6.2
54019,2021-02-01,16053,14658,1395,8.7
54021,2021-02-01,2431,2201,230,9.5
54023,2021-02-01,5999,5616,383,6.4
54025,2021-02-01,15528,14457,1071,6.9
54027,2021-02-01,11029,10501,528,4.8
54029,2021-02-01,13131,12062,1069,8.1
54031,2021-02-01,5952,5556,396,6.7
54033,2021-02-01,33700,31484,2216,6.6
54035,2021-02-01,12642,11663,979,7.7
54037,2021-02-01,30163,28911,1252,4.2
54039,2021-02-01,82203,76472,5731,7
54041,2021-02-01,6164,5538,626,10.2
54043,2021-02-01,7376,6710,666,9
54045,2021-02-01,11075,10070,1005,9.1
54047,2021-02-01,4407,3946,461,10.5
54049,2021-02-01,25585,23897,1688,6.6
54051,2021-02-01,13647,12459,1188,8.7
54053,2021-02-01,10418,9648,770,7.4
54055,2021-02-01,20924,19290,1634,7.8
54057,2021-02-01,12236,11439,797,6.5
54059,2021-02-01,6651,5926,725,10.9
54061,2021-02-01,55567,52927,2640,4.8
54063,2021-02-01,6053,5734,319,5.3
54065,2021-02-01,8381,7976,405,4.8
54067,2021-02-01,9628,8847,781,8.1
54069,2021-02-01,20432,19022,1410,6.9
54071,2021-02-01,3701,3546,155,4.2
54073,2021-02-01,2699,2426,273,10.1
54075,2021-02-01,4187,3924,263,6.3
54077,2021-02-01,15814,14831,983,6.2
54079,2021-02-01,27123,25577,1546,5.7
54081,2021-02-01,29971,27818,2153,7.2
54083,2021-02-01,12219,11195,1024,8.4
54085,2021-02-01,4330,3963,367,8.5
54087,2021-02-01,5171,4529,642,12.4
54089,2021-02-01,4279,3978,301,7
54091,2021-02-01,7852,7382,470,6
54093,2021-02-01,3319,3052,267,8
54095,2021-02-01,3240,2912,328,10.1
54097,2021-02-01,9474,8647,827,8.7
54099,2021-02-01,15940,14814,1126,7.1
54101,2021-02-01,3318,3023,295,8.9
54103,2021-02-01,6915,6264,651,9.4
54105,2021-02-01,2281,2033,248,10.9
54107,2021-02-01,35989,33320,2669,7.4
54109,2021-02-01,6351,5780,571,9
55001,2021-02-01,7911,7205,706,8.9
55003,2021-02-01,7429,6920,509,6.9
55005,2021-02-01,23954,22567,1387,5.8
55007,2021-02-01,7262,6643,619,8.5
55009,2021-02-01,139380,133420,5960,4.3
55011,2021-02-01,6344,5938,406,6.4
55013,2021-02-01,7064,6512,552,7.8
55015,2021-02-01,27318,26341,977,3.6
55017,2021-02-01,34196,32159,2037,6
55019,2021-02-01,17762,16894,868,4.9
55021,2021-02-01,31390,29915,1475,4.7
55023,2021-02-01,7472,6986,486,6.5
55025,2021-02-01,319604,308533,11071,3.5
55027,2021-02-01,47173,45091,2082,4.4
55029,2021-02-01,13766,12735,1031,7.5
55031,2021-02-01,22740,21410,1330,5.8
55033,2021-02-01,24366,23169,1197,4.9
55035,2021-02-01,59643,57143,2500,4.2
55037,2021-02-01,2201,2061,140,6.4
55039,2021-02-01,57092,54727,2365,4.1
55041,2021-02-01,3818,3478,340,8.9
55043,2021-02-01,28080,26950,1130,4
55045,2021-02-01,20796,19957,839,4
55047,2021-02-01,9065,8517,548,6
55049,2021-02-01,13649,12971,678,5
55051,2021-02-01,2545,2319,226,8.9
55053,2021-02-01,9600,8869,731,7.6
55055,2021-02-01,45534,43473,2061,4.5
55057,2021-02-01,13202,12400,802,6.1
55059,2021-02-01,86695,82096,4599,5.3
55061,2021-02-01,10791,10367,424,3.9
55063,2021-02-01,66101,63437,2664,4
55065,2021-02-01,9967,9577,390,3.9
55067,2021-02-01,9434,8851,583,6.2
55069,2021-02-01,14661,13902,759,5.2
55071,2021-02-01,40253,38413,1840,4.6
55073,2021-02-01,72629,69862,2767,3.8
55075,2021-02-01,19529,18408,1121,5.7
55077,2021-02-01,7757,7231,526,6.8
55078,2021-02-01,1568,1420,148,9.4
55079,2021-02-01,456111,427857,28254,6.2
55081,2021-02-01,23355,22311,1044,4.5
55083,2021-02-01,20355,19272,1083,5.3
55085,2021-02-01,17424,16312,1112,6.4
55087,2021-02-01,102930,98792,4138,4
55089,2021-02-01,47576,45802,1774,3.7
55091,2021-02-01,4072,3835,237,5.8
55093,2021-02-01,24492,23246,1246,5.1
55095,2021-02-01,24524,22876,1648,6.7
55097,2021-02-01,37815,36096,1719,4.5
55099,2021-02-01,6108,5788,320,5.2
55101,2021-02-01,95966,90270,5696,5.9
55103,2021-02-01,9094,8674,420,4.6
55105,2021-02-01,84919,80241,4678,5.5
55107,2021-02-01,6733,6309,424,6.3
55109,2021-02-01,48955,46532,2423,4.9
55111,2021-02-01,33589,31675,1914,5.7
55113,2021-02-01,7727,7170,557,7.2
55115,2021-02-01,20942,19878,1064,5.1
55117,2021-02-01,61604,59277,2327,3.8
55119,2021-02-01,11382,10779,603,5.3
55121,2021-02-01,15635,14772,863,5.5
55123,2021-02-01,15099,14360,739,4.9
55125,2021-02-01,10046,9358,688,6.8
55127,2021-02-01,56164,53401,2763,4.9
55129,2021-02-01,7777,7260,517,6.6
55131,2021-02-01,74901,71933,2968,4
55133,2021-02-01,218020,209584,8436,3.9
55135,2021-02-01,25649,24414,1235,4.8
55137,2021-02-01,11263,10563,700,6.2
55139,2021-02-01,91790,88189,3601,3.9
55141,2021-02-01,34347,32314,2033,5.9
56001,2021-02-01,19919,19019,900,4.5
56003,2021-02-01,5298,4935,363,6.9
56005,2021-02-01,23276,21532,1744,7.5
56007,2021-02-01,8057,7613,444,5.5
56009,2021-02-01,7893,7309,584,7.4
56011,2021-02-01,3894,3720,174,4.5
56013,2021-02-01,19340,18059,1281,6.6
56015,2021-02-01,6667,6353,314,4.7
56017,2021-02-01,2247,2116,131,5.8
56019,2021-02-01,4100,3825,275,6.7
56021,2021-02-01,50863,48057,2806,5.5
56023,2021-02-01,9453,8947,506,5.4
56025,2021-02-01,40623,37023,3600,8.9
56027,2021-02-01,1284,1218,66,5.1
56029,2021-02-01,14803,13838,965,6.5
56031,2021-02-01,4689,4432,257,5.5
56033,2021-02-01,16405,15367,1038,6.3
56035,2021-02-01,3928,3583,345,8.8
56037,2021-02-01,20457,18901,1556,7.6
56039,2021-02-01,14769,14123,646,4.4
56041,2021-02-01,9233,8579,654,7.1
56043,2021-02-01,3987,3773,214,5.4
56045,2021-02-01,3860,3684,176,4.6
72001,2021-02-01,4008,3474,534,13.3
72003,2021-02-01,11428,10472,956,8.4
72005,2021-02-01,13825,12630,1195,8.6
72007,2021-02-01,6178,5652,526,8.5
72009,2021-02-01,6004,5481,523,8.7
72011,2021-02-01,8540,7900,640,7.5
72013,2021-02-01,22972,21099,1873,8.2
72015,2021-02-01,4486,4084,402,9
72017,2021-02-01,5541,5041,500,9
72019,2021-02-01,6878,6294,584,8.5
72021,2021-02-01,62783,58060,4723,7.5
72023,2021-02-01,13426,12416,1010,7.5
72025,2021-02-01,45586,42503,3083,6.8
72027,2021-02-01,9158,8512,646,7.1
72029,2021-02-01,15582,14407,1175,7.5
72031,2021-02-01,59259,54902,4357,7.4
72033,2021-02-01,7530,6923,607,8.1
72035,2021-02-01,15269,14343,926,6.1
72037,2021-02-01,3470,3166,304,8.8
72039,2021-02-01,3512,3113,399,11.4
72041,2021-02-01,14573,13777,796,5.5
72043,2021-02-01,9462,8573,889,9.4
72045,2021-02-01,4669,4238,431,9.2
72047,2021-02-01,8508,7640,868,10.2
72049,2021-02-01,847,789,58,6.8
72051,2021-02-01,12770,11982,788,6.2
72053,2021-02-01,10249,9308,941,9.2
72054,2021-02-01,3134,2805,329,10.5
72055,2021-02-01,3850,3371,479,12.4
72057,2021-02-01,10531,9768,763,7.2
72059,2021-02-01,4470,4014,456,10.2
72061,2021-02-01,36249,34586,1663,4.6
72063,2021-02-01,17466,16568,898,5.1
72065,2021-02-01,12714,11747,967,7.6
72067,2021-02-01,5170,4763,407,7.9
72069,2021-02-01,16295,15014,1281,7.9
72071,2021-02-01,11212,10374,838,7.5
72073,2021-02-01,4257,3754,503,11.8
72075,2021-02-01,14680,13638,1042,7.1
72077,2021-02-01,11690,10780,910,7.8
72079,2021-02-01,5030,4490,540,10.7
72081,2021-02-01,6487,5746,741,11.4
72083,2021-02-01,2630,2355,275,10.5
72085,2021-02-01,10751,9945,806,7.5
72087,2021-02-01,8069,7353,716,8.9
72089,2021-02-01,5941,5390,551,9.3
72091,2021-02-01,10739,9925,814,7.6
72093,2021-02-01,1895,1708,187,9.9
72095,2021-02-01,2654,2365,289,10.9
72097,2021-02-01,20576,18869,1707,8.3
72099,2021-02-01,9931,9091,840,8.5
72101,2021-02-01,7622,6924,698,9.2
72103,2021-02-01,7742,7191,551,7.1
72105,2021-02-01,6837,6127,710,10.4
72107,2021-02-01,4669,4143,526,11.3
72109,2021-02-01,4062,3632,430,10.6
72111,2021-02-01,5409,4844,565,10.4
72113,2021-02-01,43203,39519,3684,8.5
72115,2021-02-01,5803,5286,517,8.9
72117,2021-02-01,4416,4026,390,8.8
72119,2021-02-01,16357,14954,1403,8.6
72121,2021-02-01,5766,5255,511,8.9
72123,2021-02-01,6531,5881,650,10
72125,2021-02-01,9385,8566,819,8.7
72127,2021-02-01,129590,120910,8680,6.7
72129,2021-02-01,10972,10155,817,7.4
72131,2021-02-01,9570,8606,964,10.1
72133,2021-02-01,8959,8330,629,7
72135,2021-02-01,26293,24647,1646,6.3
72137,2021-02-01,27951,26051,1900,6.8
72139,2021-02-01,25987,24534,1453,5.6
72141,2021-02-01,6194,5665,529,8.5
72143,2021-02-01,9392,8521,871,9.3
72145,2021-02-01,12688,11430,1258,9.9
72147,2021-02-01,2471,2182,289,11.7
72149,2021-02-01,6842,6037,805,11.8
72151,2021-02-01,8238,7352,886,10.8
72153,2021-02-01,8970,7925,1045,11.6
